Year,Area_Type,State_UT,Crime_Category,Crime_Subcategory,Victim_Gender,Victim_Age_Group,Cases_Reported,Cases_Solved,Cases_Pending,Cases_Investigated,Cases_Not_Investigated
2001,Urban,West Bengal,Crime Against Men,Murder,Female,13-17,2662,2288,374,2570,92
2001,Urban,Gujarat,Crime Against Men,Robbery,Female,0-12,2353,1863,490,2060,293
2008,Rural,Tamil Nadu,Crime Against Men,Robbery,Male,60+,2072,1505,567,1775,297
2009,Rural,Himachal Pradesh,Crime Against Men,Extortion,Male,13-17,4277,3527,750,3828,449
2010,Rural,Uttarakhand,Other Crimes,Corruption,Female,60+,5505,2191,3314,5124,381
2003,Urban,Kerala,Other Crimes,Fraud,Male,46-60,3565,1206,2359,3243,322
2008,Rural,Nagaland,Crime Against Men,Robbery,Female,31-45,5558,4921,637,5524,34
2007,Rural,Tripura,Crime Against Children,Child Labor,Male,18-30,9631,871,8760,8446,1185
2006,Rural,Karnataka,Other Crimes,Corruption,Female,46-60,5480,4489,991,5176,304
2008,Urban,Jharkhand,Crime Against Men,Assault,Male,0-12,6438,4987,1451,5154,1284
2001,Urban,Rajasthan,Crime Against Men,Extortion,Female,31-45,9326,8396,930,8667,659
2008,Urban,Uttarakhand,Property Crime,Theft,Female,46-60,8716,7174,1542,7307,1409
2007,Rural,Nagaland,Other Crimes,Fraud,Male,60+,5917,1789,4128,2557,3360
2006,Urban,Arunachal Pradesh,Property Crime,Burglary,Male,46-60,2443,1416,1027,1658,785
2003,Urban,Maharashtra,Crime Against Children,Child Abuse,Male,60+,2674,578,2096,2639,35
2009,Rural,Assam,Crime Against Women,Dowry Deaths,Male,18-30,3991,2851,1140,3071,920
2005,Rural,Uttarakhand,Crime Against Children,Kidnapping,Male,18-30,3404,218,3186,1620,1784
2001,Rural,Jharkhand,Other Crimes,Fraud,Male,0-12,3277,4,3273,3107,170
2006,Rural,Nagaland,Crime Against Women,Molestation,Male,46-60,3610,577,3033,2329,1281
2004,Urban,Jharkhand,Crime Against Men,Assault,Female,46-60,2260,963,1297,1571,689
2005,Rural,Delhi,Crime Against Women,Rape,Female,46-60,3991,2257,1734,3475,516
2003,Urban,Arunachal Pradesh,Crime Against Women,Dowry Deaths,Female,46-60,821,106,715,693,128
2002,Urban,Jammu & Kashmir,Crime Against Men,Robbery,Male,13-17,4566,1846,2720,3312,1254
2009,Urban,Andhra Pradesh,Crime Against Children,Kidnapping,Male,31-45,9799,8228,1571,9252,547
2005,Urban,Odisha,Other Crimes,Cyber Crime,Male,18-30,9198,5195,4003,7557,1641
2010,Urban,Andhra Pradesh,Property Crime,Burglary,Female,18-30,5454,1014,4440,2593,2861
2004,Urban,Bihar,Other Crimes,Corruption,Female,46-60,6426,1086,5340,4442,1984
2002,Rural,Kerala,Crime Against Women,Dowry Deaths,Female,13-17,3408,2395,1013,2780,628
2001,Urban,Rajasthan,Crime Against Children,Child Labor,Male,46-60,4693,1498,3195,4056,637
2008,Urban,Jharkhand,Crime Against Women,Domestic Violence,Female,18-30,1561,1483,78,1530,31
2008,Urban,Andhra Pradesh,Crime Against Women,Rape,Male,18-30,7050,2828,4222,3083,3967
2005,Urban,Kerala,Crime Against Children,Child Labor,Female,46-60,6094,4495,1599,5372,722
2002,Rural,Nagaland,Crime Against Children,Trafficking,Male,0-12,2248,1243,1005,1509,739
2004,Urban,Karnataka,Other Crimes,Cyber Crime,Female,31-45,3529,1264,2265,2124,1405
2009,Urban,Meghalaya,Crime Against Men,Assault,Female,0-12,9096,375,8721,7789,1307
2007,Urban,Punjab,Property Crime,Arson,Female,0-12,6862,4745,2117,6288,574
2007,Urban,Chhattisgarh,Crime Against Women,Dowry Deaths,Male,18-30,8654,3190,5464,6943,1711
2001,Urban,Jammu & Kashmir,Crime Against Women,Domestic Violence,Male,46-60,8151,3406,4745,6571,1580
2002,Urban,Maharashtra,Other Crimes,Cyber Crime,Female,60+,6851,6388,463,6824,27
2007,Urban,Tripura,Other Crimes,Fraud,Female,0-12,6977,2908,4069,6860,117
2001,Urban,Bihar,Other Crimes,Fraud,Male,13-17,9788,7053,2735,7937,1851
2008,Rural,Maharashtra,Crime Against Men,Robbery,Male,18-30,3616,2633,983,3404,212
2007,Rural,Punjab,Property Crime,Theft,Female,31-45,1003,861,142,998,5
2006,Urban,Assam,Other Crimes,Drug Offense,Female,18-30,7243,496,6747,1057,6186
2006,Urban,West Bengal,Property Crime,Theft,Female,60+,1093,296,797,881,212
2008,Rural,Karnataka,Crime Against Children,Trafficking,Male,46-60,9786,3502,6284,7122,2664
2004,Urban,Delhi,Crime Against Children,Child Abuse,Female,18-30,1005,22,983,804,201
2007,Rural,Gujarat,Other Crimes,Fraud,Female,13-17,7336,7257,79,7298,38
2004,Rural,Nagaland,Crime Against Women,Dowry Deaths,Male,46-60,4294,2816,1478,4229,65
2006,Urban,Haryana,Crime Against Women,Molestation,Female,18-30,7197,5013,2184,6224,973
2003,Rural,Odisha,Crime Against Men,Extortion,Male,13-17,677,359,318,506,171
2010,Rural,Tamil Nadu,Crime Against Men,Assault,Male,31-45,1916,1648,268,1699,217
2002,Rural,Sikkim,Crime Against Children,Trafficking,Male,31-45,1979,1389,590,1792,187
2004,Rural,Odisha,Crime Against Women,Rape,Female,31-45,4948,1613,3335,4402,546
2004,Urban,Jharkhand,Other Crimes,Fraud,Female,13-17,6792,367,6425,4811,1981
2006,Urban,Jharkhand,Crime Against Women,Domestic Violence,Male,0-12,3571,689,2882,1868,1703
2004,Rural,Chhattisgarh,Crime Against Children,Child Labor,Male,60+,2051,985,1066,1847,204
2004,Urban,Rajasthan,Crime Against Children,Child Abuse,Female,46-60,5398,2716,2682,3168,2230
2007,Rural,Karnataka,Property Crime,Burglary,Male,13-17,9727,1885,7842,8684,1043
2004,Rural,Delhi,Crime Against Women,Domestic Violence,Female,18-30,4257,2489,1768,4238,19
2009,Urban,Uttarakhand,Crime Against Men,Murder,Female,18-30,8127,6069,2058,7159,968
2010,Rural,Uttar Pradesh,Property Crime,Vandalism,Female,0-12,3662,2276,1386,2722,940
2008,Rural,Telangana,Crime Against Women,Molestation,Female,0-12,3930,1293,2637,3098,832
2009,Rural,West Bengal,Property Crime,Vandalism,Female,0-12,7199,7000,199,7136,63
2001,Urban,Madhya Pradesh,Property Crime,Vandalism,Male,13-17,4232,636,3596,3839,393
2005,Rural,Delhi,Property Crime,Theft,Female,31-45,75,67,8,72,3
2010,Rural,Tamil Nadu,Crime Against Children,Kidnapping,Female,60+,509,289,220,306,203
2006,Urban,Uttar Pradesh,Other Crimes,Fraud,Male,0-12,9134,5624,3510,7291,1843
2008,Urban,Andhra Pradesh,Crime Against Children,Child Abuse,Male,46-60,9083,2165,6918,5120,3963
2005,Rural,Gujarat,Crime Against Children,Child Labor,Male,13-17,90,13,77,46,44
2003,Urban,Uttarakhand,Crime Against Women,Domestic Violence,Male,46-60,8554,4136,4418,5965,2589
2002,Rural,Goa,Crime Against Women,Rape,Male,0-12,882,435,447,641,241
2002,Rural,Haryana,Crime Against Women,Dowry Deaths,Male,31-45,2531,72,2459,1448,1083
2001,Urban,Tamil Nadu,Property Crime,Arson,Female,18-30,2610,557,2053,2107,503
2001,Rural,Manipur,Crime Against Children,Child Labor,Male,13-17,4741,1574,3167,4109,632
2010,Urban,Uttarakhand,Crime Against Children,Trafficking,Female,13-17,6659,2944,3715,5706,953
2003,Rural,Jammu & Kashmir,Other Crimes,Corruption,Male,60+,9113,4215,4898,6740,2373
2010,Urban,Tripura,Crime Against Men,Extortion,Female,46-60,6824,5107,1717,6009,815
2005,Urban,Punjab,Crime Against Men,Murder,Male,13-17,1117,960,157,1003,114
2010,Rural,Sikkim,Crime Against Women,Molestation,Female,18-30,2063,124,1939,1221,842
2007,Rural,Delhi,Other Crimes,Cyber Crime,Female,46-60,399,285,114,384,15
2009,Rural,Manipur,Other Crimes,Cyber Crime,Male,60+,8650,685,7965,2421,6229
2007,Rural,Haryana,Other Crimes,Cyber Crime,Male,46-60,550,193,357,528,22
2002,Urban,Sikkim,Crime Against Children,Trafficking,Male,13-17,2692,2663,29,2681,11
2006,Urban,Chhattisgarh,Other Crimes,Corruption,Female,31-45,5026,3573,1453,4244,782
2002,Rural,Tamil Nadu,Crime Against Men,Murder,Male,18-30,2687,1911,776,2174,513
2009,Urban,Uttar Pradesh,Crime Against Women,Dowry Deaths,Male,31-45,5058,4864,194,4963,95
2004,Rural,Chhattisgarh,Crime Against Men,Assault,Male,46-60,3545,160,3385,3370,175
2004,Rural,Tamil Nadu,Crime Against Men,Murder,Male,60+,6656,3736,2920,4956,1700
2007,Urban,Manipur,Crime Against Women,Molestation,Male,60+,2059,465,1594,643,1416
2005,Urban,Manipur,Crime Against Women,Rape,Female,31-45,7012,2788,4224,5752,1260
2001,Rural,Tamil Nadu,Property Crime,Burglary,Female,18-30,5077,2172,2905,4897,180
2002,Urban,Uttarakhand,Crime Against Children,Trafficking,Male,18-30,173,98,75,138,35
2009,Urban,Mizoram,Crime Against Children,Child Abuse,Male,31-45,4250,143,4107,2068,2182
2001,Rural,Delhi,Property Crime,Theft,Female,60+,8702,6330,2372,7229,1473
2001,Urban,Tripura,Property Crime,Burglary,Male,0-12,4870,3018,1852,4630,240
2010,Rural,Jammu & Kashmir,Other Crimes,Drug Offense,Female,13-17,3162,181,2981,2801,361
2003,Urban,Manipur,Crime Against Women,Rape,Female,13-17,4177,2708,1469,3610,567
2008,Urban,Nagaland,Crime Against Children,Kidnapping,Male,18-30,4544,2500,2044,3370,1174
2007,Rural,West Bengal,Property Crime,Arson,Male,60+,1416,1329,87,1332,84
2010,Urban,Mizoram,Property Crime,Vandalism,Male,46-60,9382,5133,4249,8014,1368
2004,Urban,Andhra Pradesh,Property Crime,Arson,Female,18-30,2858,2157,701,2686,172
2008,Rural,Karnataka,Other Crimes,Drug Offense,Female,18-30,5692,4743,949,5687,5
2005,Rural,Assam,Crime Against Women,Dowry Deaths,Female,60+,9382,4762,4620,4840,4542
2008,Urban,Bihar,Other Crimes,Drug Offense,Male,31-45,8712,2637,6075,2704,6008
2005,Rural,Assam,Property Crime,Arson,Female,31-45,764,92,672,472,292
2010,Urban,Himachal Pradesh,Crime Against Children,Child Abuse,Female,0-12,3696,3514,182,3606,90
2010,Urban,Kerala,Crime Against Children,Kidnapping,Female,46-60,57,36,21,39,18
2002,Urban,Karnataka,Crime Against Men,Robbery,Male,0-12,1334,873,461,1222,112
2010,Rural,Bihar,Property Crime,Burglary,Female,31-45,1458,988,470,1169,289
2008,Rural,Uttar Pradesh,Property Crime,Vandalism,Male,31-45,5695,3867,1828,4091,1604
2002,Urban,Telangana,Other Crimes,Fraud,Female,31-45,9046,322,8724,584,8462
2002,Rural,Karnataka,Property Crime,Vandalism,Female,18-30,7105,6929,176,7008,97
2002,Urban,Sikkim,Crime Against Women,Domestic Violence,Male,13-17,7128,2837,4291,5722,1406
2002,Rural,Uttarakhand,Other Crimes,Corruption,Male,18-30,6548,5752,796,6254,294
2005,Urban,Kerala,Crime Against Women,Domestic Violence,Female,46-60,7414,1956,5458,5900,1514
2004,Rural,Uttar Pradesh,Crime Against Women,Molestation,Male,60+,4834,2033,2801,3925,909
2004,Rural,Kerala,Crime Against Women,Rape,Female,0-12,2385,1772,613,1913,472
2004,Rural,Goa,Crime Against Men,Extortion,Male,18-30,3065,2193,872,2271,794
2002,Urban,Haryana,Property Crime,Vandalism,Male,13-17,8421,682,7739,5031,3390
2006,Rural,Manipur,Crime Against Women,Domestic Violence,Female,13-17,4664,3469,1195,4632,32
2009,Urban,Maharashtra,Crime Against Men,Assault,Female,31-45,3794,3384,410,3476,318
2006,Rural,Gujarat,Crime Against Men,Assault,Male,31-45,5726,358,5368,3704,2022
2005,Urban,Jammu & Kashmir,Crime Against Children,Child Labor,Male,18-30,911,342,569,656,255
2001,Urban,Tripura,Crime Against Children,Trafficking,Male,60+,7220,1661,5559,1741,5479
2007,Urban,Sikkim,Other Crimes,Corruption,Male,60+,8666,4825,3841,5275,3391
2004,Rural,Kerala,Property Crime,Theft,Male,18-30,2866,2773,93,2833,33
2001,Rural,Himachal Pradesh,Crime Against Children,Child Abuse,Male,13-17,8456,7081,1375,7326,1130
2006,Rural,Tripura,Property Crime,Arson,Female,31-45,4740,3222,1518,3431,1309
2006,Urban,Sikkim,Other Crimes,Fraud,Female,60+,4080,2062,2018,2301,1779
2001,Rural,Tamil Nadu,Crime Against Women,Rape,Female,60+,4694,541,4153,1554,3140
2008,Urban,Gujarat,Property Crime,Theft,Female,31-45,87,68,19,80,7
2009,Urban,Bihar,Crime Against Women,Molestation,Male,46-60,6681,945,5736,5195,1486
2003,Urban,Manipur,Crime Against Women,Dowry Deaths,Female,13-17,1591,951,640,1293,298
2008,Urban,Himachal Pradesh,Other Crimes,Cyber Crime,Female,0-12,9713,9589,124,9689,24
2009,Rural,Jammu & Kashmir,Crime Against Women,Rape,Male,31-45,9057,8900,157,9037,20
2001,Urban,Uttar Pradesh,Crime Against Men,Murder,Male,13-17,807,73,734,330,477
2002,Rural,Gujarat,Crime Against Women,Rape,Male,46-60,3655,1977,1678,2177,1478
2005,Rural,Assam,Crime Against Men,Assault,Female,31-45,5453,1912,3541,2021,3432
2006,Rural,Arunachal Pradesh,Crime Against Children,Child Labor,Female,0-12,1230,285,945,1043,187
2001,Rural,Andhra Pradesh,Property Crime,Theft,Male,18-30,7014,2331,4683,2925,4089
2005,Rural,Mizoram,Crime Against Women,Molestation,Female,60+,4949,4102,847,4280,669
2005,Urban,Karnataka,Crime Against Men,Murder,Female,31-45,9143,4020,5123,7933,1210
2010,Rural,Arunachal Pradesh,Property Crime,Vandalism,Female,13-17,7179,2697,4482,5006,2173
2008,Urban,Delhi,Property Crime,Burglary,Female,0-12,3216,1547,1669,2881,335
2004,Rural,Odisha,Crime Against Women,Rape,Male,18-30,2383,482,1901,1500,883
2008,Rural,Uttarakhand,Crime Against Men,Extortion,Male,31-45,8372,4337,4035,5862,2510
2001,Urban,Bihar,Crime Against Children,Trafficking,Male,13-17,2452,628,1824,1561,891
2003,Rural,Odisha,Crime Against Men,Assault,Female,13-17,5382,1310,4072,2337,3045
2005,Rural,Uttar Pradesh,Other Crimes,Corruption,Male,31-45,834,755,79,762,72
2004,Rural,Assam,Other Crimes,Cyber Crime,Female,60+,4638,732,3906,4188,450
2001,Rural,Goa,Crime Against Children,Child Abuse,Female,13-17,9190,8839,351,9043,147
2010,Rural,Bihar,Crime Against Children,Child Labor,Male,46-60,1474,799,675,1466,8
2008,Rural,Assam,Crime Against Children,Child Labor,Female,60+,1882,1635,247,1836,46
2009,Rural,Meghalaya,Crime Against Children,Child Labor,Male,18-30,8259,1625,6634,7737,522
2005,Urban,Meghalaya,Crime Against Children,Kidnapping,Male,18-30,4723,3837,886,4050,673
2003,Rural,Tripura,Crime Against Women,Rape,Male,0-12,71,55,16,68,3
2007,Urban,Delhi,Property Crime,Burglary,Female,46-60,6315,547,5768,1706,4609
2006,Rural,Chhattisgarh,Crime Against Women,Molestation,Male,46-60,8395,262,8133,3022,5373
2008,Urban,Sikkim,Property Crime,Arson,Male,60+,2850,2567,283,2828,22
2004,Urban,Meghalaya,Crime Against Children,Kidnapping,Female,13-17,1697,1386,311,1692,5
2010,Rural,Punjab,Other Crimes,Fraud,Male,60+,7684,3357,4327,3714,3970
2003,Rural,Kerala,Crime Against Men,Extortion,Male,18-30,4400,1214,3186,3167,1233
2007,Urban,Karnataka,Crime Against Children,Child Abuse,Female,18-30,8857,3946,4911,4723,4134
2005,Urban,Himachal Pradesh,Crime Against Women,Dowry Deaths,Female,18-30,9576,1874,7702,3378,6198
2008,Urban,Delhi,Other Crimes,Fraud,Female,31-45,796,727,69,740,56
2010,Rural,Tamil Nadu,Other Crimes,Cyber Crime,Male,18-30,287,54,233,71,216
2004,Rural,Punjab,Crime Against Children,Child Abuse,Female,18-30,7481,6287,1194,6657,824
2005,Urban,Meghalaya,Property Crime,Arson,Male,60+,3461,857,2604,1891,1570
2010,Urban,Punjab,Property Crime,Vandalism,Female,13-17,1239,703,536,1199,40
2004,Rural,Madhya Pradesh,Crime Against Children,Child Abuse,Female,46-60,7357,1304,6053,3425,3932
2002,Rural,Chhattisgarh,Other Crimes,Drug Offense,Male,18-30,2748,1756,992,1797,951
2009,Rural,Maharashtra,Crime Against Women,Molestation,Female,60+,3759,2137,1622,3710,49
2010,Rural,Jharkhand,Crime Against Men,Extortion,Female,46-60,8041,1159,6882,5879,2162
2005,Urban,Haryana,Crime Against Children,Child Labor,Male,0-12,8073,615,7458,1197,6876
2003,Urban,Jharkhand,Property Crime,Vandalism,Male,13-17,6180,404,5776,3592,2588
2006,Rural,Mizoram,Other Crimes,Corruption,Male,60+,4041,643,3398,1154,2887
2002,Rural,Telangana,Crime Against Women,Dowry Deaths,Female,0-12,7128,3709,3419,6679,449
2001,Rural,Mizoram,Crime Against Men,Assault,Male,0-12,276,105,171,181,95
2003,Urban,Uttar Pradesh,Property Crime,Burglary,Male,18-30,1170,1040,130,1148,22
2002,Urban,Sikkim,Crime Against Women,Dowry Deaths,Female,13-17,8824,5726,3098,6444,2380
2006,Rural,Tamil Nadu,Crime Against Men,Robbery,Male,31-45,7301,952,6349,3750,3551
2003,Urban,Karnataka,Other Crimes,Cyber Crime,Male,31-45,3776,1887,1889,2113,1663
2005,Rural,Manipur,Property Crime,Arson,Male,0-12,7498,2819,4679,4340,3158
2005,Urban,Haryana,Crime Against Men,Robbery,Male,18-30,3692,3011,681,3589,103
2004,Urban,Manipur,Crime Against Men,Extortion,Female,60+,3756,2560,1196,3379,377
2009,Rural,Sikkim,Crime Against Children,Child Labor,Female,18-30,1967,244,1723,376,1591
2008,Urban,Madhya Pradesh,Crime Against Children,Child Abuse,Female,13-17,4225,1951,2274,4173,52
2003,Rural,Tamil Nadu,Crime Against Men,Robbery,Female,0-12,5955,2385,3570,3763,2192
2007,Rural,Kerala,Property Crime,Vandalism,Female,46-60,6132,2598,3534,2739,3393
2009,Rural,West Bengal,Crime Against Women,Dowry Deaths,Male,60+,5174,3011,2163,4045,1129
2009,Urban,Haryana,Other Crimes,Cyber Crime,Male,46-60,6365,671,5694,3040,3325
2005,Rural,Rajasthan,Crime Against Women,Rape,Female,46-60,6893,3248,3645,5831,1062
2001,Urban,West Bengal,Other Crimes,Cyber Crime,Female,46-60,7094,3670,3424,5873,1221
2008,Urban,Gujarat,Property Crime,Theft,Male,0-12,7915,1853,6062,4283,3632
2007,Urban,Assam,Other Crimes,Drug Offense,Female,60+,1649,330,1319,1108,541
2007,Urban,Punjab,Crime Against Children,Child Abuse,Male,0-12,4215,3841,374,4195,20
2008,Rural,West Bengal,Property Crime,Theft,Male,0-12,6614,3435,3179,3886,2728
2002,Rural,Odisha,Other Crimes,Fraud,Male,18-30,2119,1237,882,1801,318
2006,Rural,Mizoram,Crime Against Children,Kidnapping,Male,60+,8760,5916,2844,7585,1175
2009,Rural,Jharkhand,Crime Against Women,Molestation,Female,60+,2217,930,1287,1147,1070
2005,Urban,Manipur,Crime Against Children,Kidnapping,Female,13-17,9019,1218,7801,7525,1494
2008,Rural,Telangana,Crime Against Children,Kidnapping,Female,18-30,8334,2574,5760,2790,5544
2008,Urban,Arunachal Pradesh,Property Crime,Burglary,Female,60+,8095,5024,3071,7205,890
2008,Urban,Nagaland,Property Crime,Burglary,Female,13-17,8494,2233,6261,6069,2425
2007,Rural,Maharashtra,Crime Against Men,Robbery,Male,31-45,7730,696,7034,5043,2687
2006,Rural,Rajasthan,Crime Against Men,Robbery,Female,46-60,7220,5497,1723,6431,789
2008,Urban,Meghalaya,Crime Against Men,Assault,Female,46-60,6561,6401,160,6405,156
2009,Urban,Bihar,Other Crimes,Drug Offense,Male,60+,3977,2549,1428,3559,418
2009,Urban,Gujarat,Property Crime,Burglary,Male,0-12,8401,3767,4634,4635,3766
2001,Urban,Jharkhand,Crime Against Men,Robbery,Male,60+,6093,4085,2008,5238,855
2008,Urban,Andhra Pradesh,Crime Against Men,Murder,Male,31-45,2658,1795,863,2292,366
2002,Urban,Jammu & Kashmir,Crime Against Women,Domestic Violence,Female,0-12,7330,6818,512,7010,320
2002,Rural,Karnataka,Property Crime,Arson,Male,31-45,9137,6576,2561,8951,186
2008,Rural,Uttar Pradesh,Property Crime,Arson,Female,60+,9423,5176,4247,5842,3581
2001,Rural,West Bengal,Crime Against Women,Molestation,Female,31-45,6620,1901,4719,2790,3830
2001,Urban,Tamil Nadu,Other Crimes,Drug Offense,Male,46-60,7603,1509,6094,4570,3033
2009,Urban,West Bengal,Other Crimes,Corruption,Male,18-30,4361,1394,2967,1731,2630
2003,Rural,Karnataka,Other Crimes,Fraud,Female,13-17,2595,1146,1449,1238,1357
2001,Urban,Jammu & Kashmir,Crime Against Men,Assault,Male,46-60,5873,1885,3988,2127,3746
2008,Urban,Jammu & Kashmir,Other Crimes,Fraud,Male,31-45,3518,2388,1130,2613,905
2001,Rural,Delhi,Crime Against Children,Child Abuse,Female,60+,1573,992,581,1228,345
2008,Urban,Andhra Pradesh,Property Crime,Vandalism,Male,60+,6356,4244,2112,5475,881
2005,Rural,Bihar,Other Crimes,Corruption,Female,60+,6075,5096,979,6003,72
2008,Urban,Nagaland,Other Crimes,Drug Offense,Female,46-60,7376,1953,5423,6500,876
2006,Rural,Madhya Pradesh,Property Crime,Burglary,Male,31-45,9461,4341,5120,6023,3438
2009,Rural,Rajasthan,Property Crime,Arson,Female,13-17,5539,4651,888,4663,876
2009,Urban,Delhi,Property Crime,Vandalism,Female,0-12,7524,7066,458,7118,406
2007,Rural,Chhattisgarh,Other Crimes,Cyber Crime,Male,13-17,6588,5041,1547,5129,1459
2007,Urban,Sikkim,Property Crime,Theft,Female,60+,7239,3114,4125,3809,3430
2007,Urban,Punjab,Crime Against Women,Rape,Female,18-30,1302,817,485,827,475
2008,Urban,Assam,Crime Against Men,Extortion,Female,0-12,5895,3232,2663,4437,1458
2001,Urban,Maharashtra,Crime Against Men,Assault,Male,31-45,5182,4029,1153,5104,78
2005,Urban,Andhra Pradesh,Property Crime,Burglary,Female,31-45,9682,1570,8112,1844,7838
2010,Rural,Karnataka,Other Crimes,Cyber Crime,Male,31-45,4549,124,4425,418,4131
2006,Urban,Arunachal Pradesh,Crime Against Men,Extortion,Male,46-60,7449,6143,1306,6591,858
2004,Urban,Himachal Pradesh,Crime Against Women,Rape,Male,31-45,2543,1924,619,2292,251
2005,Rural,Rajasthan,Crime Against Children,Kidnapping,Male,0-12,991,339,652,983,8
2008,Urban,Assam,Crime Against Men,Extortion,Female,60+,5213,4906,307,5136,77
2006,Urban,Uttarakhand,Other Crimes,Fraud,Female,18-30,2027,805,1222,1862,165
2008,Urban,Bihar,Other Crimes,Corruption,Female,13-17,9744,7598,2146,8551,1193
2008,Rural,Maharashtra,Crime Against Women,Domestic Violence,Female,18-30,8477,954,7523,5214,3263
2004,Rural,Chhattisgarh,Property Crime,Vandalism,Female,60+,4229,557,3672,3487,742
2010,Urban,Uttarakhand,Crime Against Children,Trafficking,Female,60+,5793,689,5104,4109,1684
2004,Rural,Sikkim,Crime Against Men,Murder,Male,46-60,5646,1644,4002,2635,3011
2007,Urban,Mizoram,Property Crime,Arson,Female,60+,5313,757,4556,2988,2325
2001,Rural,Tripura,Property Crime,Theft,Male,60+,4410,413,3997,3566,844
2006,Urban,Uttar Pradesh,Crime Against Men,Extortion,Male,13-17,3622,1574,2048,3451,171
2008,Urban,Sikkim,Crime Against Men,Robbery,Male,18-30,6159,1957,4202,2327,3832
2002,Urban,Jammu & Kashmir,Property Crime,Theft,Female,0-12,7786,6588,1198,7112,674
2004,Rural,Gujarat,Crime Against Children,Trafficking,Male,0-12,3083,2950,133,2986,97
2005,Rural,Bihar,Crime Against Men,Extortion,Female,13-17,7247,3531,3716,5170,2077
2005,Urban,Goa,Crime Against Men,Murder,Female,60+,1534,222,1312,537,997
2009,Rural,Meghalaya,Crime Against Women,Dowry Deaths,Male,60+,4470,2056,2414,4259,211
2005,Urban,Uttar Pradesh,Other Crimes,Drug Offense,Female,13-17,8274,6637,1637,8021,253
2002,Rural,Madhya Pradesh,Crime Against Men,Murder,Female,18-30,7519,342,7177,650,6869
2006,Urban,Sikkim,Crime Against Children,Child Abuse,Male,18-30,8432,4434,3998,6846,1586
2007,Rural,Kerala,Other Crimes,Cyber Crime,Female,18-30,501,479,22,485,16
2002,Urban,Delhi,Crime Against Men,Extortion,Male,31-45,3987,1154,2833,3222,765
2009,Rural,Telangana,Property Crime,Arson,Female,46-60,4181,1205,2976,2653,1528
2009,Urban,Rajasthan,Property Crime,Arson,Male,0-12,8851,786,8065,5096,3755
2006,Rural,Bihar,Crime Against Women,Dowry Deaths,Female,46-60,9491,2453,7038,9436,55
2002,Urban,Rajasthan,Other Crimes,Corruption,Female,31-45,4096,1838,2258,3511,585
2007,Rural,Mizoram,Property Crime,Vandalism,Male,13-17,3711,2635,1076,2764,947
2002,Rural,Uttar Pradesh,Crime Against Men,Assault,Male,13-17,650,375,275,463,187
2005,Rural,Delhi,Property Crime,Vandalism,Female,46-60,9849,1994,7855,2186,7663
2008,Rural,Assam,Crime Against Women,Rape,Male,0-12,1222,916,306,1190,32
2002,Rural,Karnataka,Crime Against Children,Kidnapping,Male,18-30,5063,1098,3965,4790,273
2008,Urban,Jammu & Kashmir,Property Crime,Vandalism,Female,31-45,2077,1756,321,2029,48
2005,Urban,Punjab,Property Crime,Theft,Male,0-12,3433,330,3103,2356,1077
2004,Rural,Delhi,Crime Against Men,Extortion,Male,13-17,7939,7046,893,7337,602
2010,Urban,Sikkim,Crime Against Men,Extortion,Male,0-12,8762,8617,145,8757,5
2005,Rural,Bihar,Crime Against Men,Extortion,Female,0-12,907,286,621,842,65
2006,Rural,Jharkhand,Other Crimes,Corruption,Female,46-60,4132,538,3594,2134,1998
2003,Rural,Uttar Pradesh,Crime Against Children,Kidnapping,Female,0-12,325,106,219,218,107
2001,Urban,Odisha,Crime Against Men,Assault,Female,0-12,4240,2357,1883,3637,603
2002,Rural,Tripura,Other Crimes,Corruption,Female,0-12,4358,3920,438,3924,434
2008,Rural,Himachal Pradesh,Other Crimes,Fraud,Female,46-60,3089,393,2696,2481,608
2005,Rural,Kerala,Crime Against Men,Extortion,Male,31-45,1583,462,1121,462,1121
2002,Rural,Maharashtra,Property Crime,Burglary,Female,31-45,5902,5877,25,5887,15
2005,Rural,Madhya Pradesh,Property Crime,Vandalism,Male,46-60,9285,5961,3324,8673,612
2005,Rural,Punjab,Crime Against Children,Child Labor,Female,60+,278,210,68,254,24
2008,Urban,Karnataka,Property Crime,Burglary,Male,13-17,806,527,279,747,59
2009,Urban,Delhi,Property Crime,Vandalism,Female,0-12,5209,2739,2470,3547,1662
2006,Rural,Kerala,Crime Against Children,Child Abuse,Female,46-60,6999,4440,2559,5855,1144
2003,Urban,Karnataka,Crime Against Children,Trafficking,Male,13-17,8990,1603,7387,6755,2235
2008,Rural,Andhra Pradesh,Other Crimes,Drug Offense,Female,46-60,3611,2475,1136,3603,8
2005,Urban,Maharashtra,Property Crime,Arson,Female,18-30,2848,1335,1513,2612,236
2004,Rural,Sikkim,Crime Against Women,Rape,Female,13-17,6688,1041,5647,3705,2983
2004,Urban,West Bengal,Other Crimes,Drug Offense,Female,0-12,6976,2104,4872,4769,2207
2004,Rural,Karnataka,Crime Against Women,Dowry Deaths,Male,60+,8198,7203,995,8182,16
2008,Urban,Mizoram,Property Crime,Burglary,Female,60+,8349,5239,3110,6886,1463
2008,Urban,Telangana,Property Crime,Arson,Male,60+,9522,2552,6970,3980,5542
2001,Rural,Nagaland,Property Crime,Theft,Male,31-45,7842,2321,5521,3710,4132
2001,Urban,Goa,Other Crimes,Drug Offense,Female,31-45,5156,4692,464,4725,431
2008,Urban,Jammu & Kashmir,Crime Against Men,Robbery,Male,13-17,937,896,41,937,0
2009,Urban,Karnataka,Crime Against Children,Child Labor,Female,18-30,3229,505,2724,2003,1226
2004,Urban,Assam,Property Crime,Burglary,Female,31-45,1666,1023,643,1640,26
2004,Rural,Jharkhand,Crime Against Men,Extortion,Male,60+,4335,591,3744,2230,2105
2001,Urban,Jharkhand,Crime Against Women,Dowry Deaths,Male,31-45,697,331,366,621,76
2010,Rural,Himachal Pradesh,Other Crimes,Corruption,Female,18-30,2574,992,1582,2287,287
2001,Rural,Rajasthan,Crime Against Men,Extortion,Male,46-60,1537,97,1440,1380,157
2001,Rural,West Bengal,Other Crimes,Fraud,Female,18-30,3456,1637,1819,2647,809
2008,Urban,Andhra Pradesh,Crime Against Children,Trafficking,Male,13-17,4597,76,4521,4116,481
2010,Rural,West Bengal,Property Crime,Theft,Female,60+,9255,4492,4763,8580,675
2001,Urban,Himachal Pradesh,Crime Against Women,Rape,Female,0-12,4111,3103,1008,3777,334
2002,Urban,Manipur,Property Crime,Arson,Male,60+,817,683,134,698,119
2006,Urban,Gujarat,Crime Against Children,Kidnapping,Female,18-30,2359,1974,385,2078,281
2005,Urban,Nagaland,Crime Against Children,Kidnapping,Male,31-45,221,204,17,220,1
2003,Rural,Bihar,Crime Against Children,Kidnapping,Male,13-17,2554,1674,880,2200,354
2009,Rural,Delhi,Crime Against Women,Dowry Deaths,Female,18-30,2030,1073,957,1792,238
2009,Rural,Andhra Pradesh,Crime Against Children,Child Abuse,Female,60+,2208,1657,551,1802,406
2010,Urban,Rajasthan,Crime Against Children,Child Labor,Male,60+,1545,1145,400,1272,273
2003,Urban,Punjab,Property Crime,Arson,Female,60+,5654,3734,1920,4070,1584
2001,Rural,Haryana,Crime Against Women,Domestic Violence,Male,18-30,6628,5767,861,6241,387
2006,Urban,Madhya Pradesh,Crime Against Men,Assault,Female,18-30,5629,767,4862,971,4658
2008,Urban,Jammu & Kashmir,Crime Against Men,Robbery,Female,31-45,7048,4732,2316,5402,1646
2008,Urban,Mizoram,Crime Against Women,Rape,Male,31-45,8303,6150,2153,6333,1970
2001,Urban,Andhra Pradesh,Crime Against Men,Assault,Male,13-17,5217,328,4889,449,4768
2002,Rural,Goa,Crime Against Women,Rape,Female,13-17,3769,1770,1999,2450,1319
2010,Rural,Maharashtra,Crime Against Children,Trafficking,Female,46-60,6665,295,6370,3117,3548
2006,Urban,Delhi,Crime Against Men,Extortion,Male,18-30,9207,3878,5329,5948,3259
2009,Urban,Tamil Nadu,Crime Against Men,Extortion,Female,18-30,9999,1094,8905,9627,372
2005,Rural,Delhi,Crime Against Women,Molestation,Female,60+,5683,2124,3559,2130,3553
2004,Urban,Rajasthan,Other Crimes,Fraud,Male,31-45,6779,4238,2541,4574,2205
2001,Rural,Uttarakhand,Crime Against Women,Rape,Female,60+,8087,6524,1563,6688,1399
2005,Urban,Madhya Pradesh,Other Crimes,Cyber Crime,Male,0-12,2711,1574,1137,1960,751
2007,Rural,West Bengal,Other Crimes,Drug Offense,Male,60+,7314,6296,1018,6360,954
2001,Rural,Himachal Pradesh,Crime Against Men,Murder,Male,60+,7194,257,6937,5221,1973
2007,Rural,Madhya Pradesh,Crime Against Women,Domestic Violence,Male,0-12,1861,736,1125,761,1100
2005,Rural,Mizoram,Crime Against Children,Trafficking,Female,18-30,6345,482,5863,4661,1684
2003,Urban,Punjab,Crime Against Women,Molestation,Female,31-45,8628,4866,3762,4896,3732
2009,Rural,Kerala,Crime Against Women,Rape,Female,31-45,2737,1281,1456,2496,241
2004,Rural,Assam,Crime Against Men,Assault,Male,60+,9394,511,8883,6001,3393
2004,Urban,Haryana,Property Crime,Arson,Female,60+,5606,4760,846,5566,40
2003,Rural,Maharashtra,Crime Against Men,Robbery,Male,0-12,2281,2029,252,2228,53
2006,Rural,Uttar Pradesh,Crime Against Women,Domestic Violence,Female,31-45,5575,2467,3108,2828,2747
2001,Urban,West Bengal,Crime Against Women,Rape,Male,0-12,5265,1172,4093,5003,262
2007,Rural,Chhattisgarh,Crime Against Men,Robbery,Male,60+,8793,6,8787,704,8089
2010,Rural,Nagaland,Crime Against Women,Dowry Deaths,Female,46-60,5882,3391,2491,4774,1108
2003,Rural,Himachal Pradesh,Other Crimes,Drug Offense,Female,46-60,5782,2395,3387,3214,2568
2009,Urban,Rajasthan,Crime Against Children,Kidnapping,Male,18-30,8029,7573,456,8002,27
2002,Rural,Bihar,Crime Against Men,Assault,Male,31-45,6198,3692,2506,5725,473
2009,Urban,Nagaland,Crime Against Children,Trafficking,Female,46-60,3214,2993,221,3201,13
2010,Rural,Andhra Pradesh,Crime Against Children,Child Abuse,Male,18-30,8899,1959,6940,3074,5825
2009,Rural,Chhattisgarh,Property Crime,Burglary,Male,13-17,3877,956,2921,2586,1291
2001,Rural,Uttarakhand,Property Crime,Theft,Male,13-17,259,221,38,235,24
2007,Urban,Karnataka,Other Crimes,Corruption,Male,46-60,5433,4444,989,4686,747
2002,Urban,Andhra Pradesh,Property Crime,Theft,Female,18-30,2910,1345,1565,2644,266
2006,Urban,Goa,Crime Against Children,Child Abuse,Male,13-17,7549,6272,1277,6509,1040
2009,Rural,Sikkim,Crime Against Women,Domestic Violence,Male,13-17,2658,1008,1650,2302,356
2002,Urban,Odisha,Property Crime,Theft,Male,31-45,3762,2912,850,3514,248
2010,Urban,Nagaland,Property Crime,Arson,Female,60+,437,10,427,284,153
2005,Rural,Odisha,Crime Against Women,Rape,Male,0-12,2486,1269,1217,1981,505
2001,Urban,Mizoram,Property Crime,Burglary,Female,13-17,7472,4438,3034,5296,2176
2006,Urban,Jammu & Kashmir,Crime Against Women,Domestic Violence,Female,13-17,7545,5551,1994,6622,923
2008,Urban,Sikkim,Other Crimes,Drug Offense,Female,60+,8610,6475,2135,7410,1200
2003,Rural,Himachal Pradesh,Crime Against Children,Trafficking,Female,31-45,6214,3139,3075,3834,2380
2001,Rural,Haryana,Crime Against Men,Assault,Female,18-30,5969,5277,692,5756,213
2006,Rural,Tripura,Property Crime,Arson,Female,0-12,2047,469,1578,2045,2
2004,Urban,Chhattisgarh,Other Crimes,Fraud,Male,31-45,3886,2123,1763,2987,899
2003,Urban,Karnataka,Property Crime,Vandalism,Male,46-60,8423,5860,2563,7122,1301
2005,Rural,Uttarakhand,Property Crime,Theft,Male,46-60,2064,1476,588,1556,508
2010,Urban,Delhi,Crime Against Men,Assault,Male,31-45,6019,3453,2566,4066,1953
2007,Urban,Chhattisgarh,Property Crime,Vandalism,Female,0-12,7112,1328,5784,2751,4361
2008,Rural,Uttar Pradesh,Crime Against Women,Domestic Violence,Female,31-45,8685,7985,700,8063,622
2006,Urban,Goa,Crime Against Men,Murder,Female,13-17,3810,3363,447,3511,299
2004,Rural,Assam,Property Crime,Burglary,Male,18-30,5460,174,5286,2926,2534
2007,Urban,Haryana,Crime Against Children,Kidnapping,Female,46-60,3800,3495,305,3585,215
2004,Rural,Karnataka,Other Crimes,Fraud,Female,31-45,5494,1303,4191,4029,1465
2009,Urban,Arunachal Pradesh,Crime Against Children,Kidnapping,Female,0-12,1819,370,1449,959,860
2003,Rural,West Bengal,Crime Against Women,Domestic Violence,Female,13-17,100,45,55,97,3
2005,Urban,Manipur,Crime Against Children,Child Labor,Female,31-45,9478,7941,1537,9369,109
2001,Urban,Jharkhand,Other Crimes,Cyber Crime,Female,60+,3318,2552,766,2568,750
2005,Urban,Odisha,Other Crimes,Corruption,Male,31-45,5954,4648,1306,5937,17
2003,Rural,Tamil Nadu,Other Crimes,Corruption,Female,13-17,2608,1852,756,2123,485
2002,Rural,West Bengal,Other Crimes,Corruption,Female,0-12,7819,3059,4760,7256,563
2010,Rural,Odisha,Other Crimes,Corruption,Male,18-30,2946,814,2132,1330,1616
2009,Urban,Punjab,Property Crime,Theft,Female,0-12,8704,8673,31,8676,28
2002,Urban,Jammu & Kashmir,Crime Against Children,Child Labor,Male,31-45,3680,61,3619,598,3082
2008,Rural,Arunachal Pradesh,Property Crime,Arson,Female,13-17,667,89,578,363,304
2003,Urban,Haryana,Crime Against Men,Robbery,Male,18-30,6848,2605,4243,6142,706
2006,Urban,Uttar Pradesh,Crime Against Men,Assault,Female,13-17,2580,1782,798,2043,537
2002,Urban,Karnataka,Property Crime,Theft,Female,31-45,7033,2305,4728,5555,1478
2001,Urban,Jharkhand,Crime Against Children,Trafficking,Female,0-12,5519,3401,2118,4159,1360
2006,Rural,Haryana,Crime Against Children,Trafficking,Female,46-60,6407,4916,1491,5631,776
2006,Urban,Jammu & Kashmir,Crime Against Children,Trafficking,Female,46-60,8633,2121,6512,6963,1670
2009,Urban,Uttarakhand,Property Crime,Arson,Female,46-60,5890,347,5543,4222,1668
2004,Urban,Uttar Pradesh,Crime Against Women,Molestation,Female,31-45,6249,4439,1810,5002,1247
2002,Urban,Jharkhand,Crime Against Men,Extortion,Male,46-60,7376,4219,3157,6196,1180
2008,Urban,Tamil Nadu,Property Crime,Theft,Male,13-17,3486,3134,352,3210,276
2003,Urban,Haryana,Crime Against Men,Robbery,Female,13-17,8166,5285,2881,8140,26
2002,Urban,Uttar Pradesh,Other Crimes,Drug Offense,Male,18-30,3681,2430,1251,3306,375
2009,Urban,Maharashtra,Crime Against Men,Assault,Female,46-60,740,256,484,470,270
2002,Rural,Chhattisgarh,Property Crime,Theft,Male,46-60,5436,704,4732,3502,1934
2010,Rural,Jammu & Kashmir,Other Crimes,Drug Offense,Female,18-30,9026,955,8071,3985,5041
2009,Rural,Tamil Nadu,Other Crimes,Cyber Crime,Male,0-12,3612,2073,1539,3211,401
2010,Urban,Delhi,Other Crimes,Drug Offense,Female,13-17,3397,1691,1706,2247,1150
2002,Urban,Jharkhand,Property Crime,Vandalism,Female,46-60,2655,348,2307,1008,1647
2006,Rural,Tripura,Crime Against Women,Molestation,Male,18-30,6978,2539,4439,3564,3414
2006,Urban,Tripura,Crime Against Children,Trafficking,Male,0-12,9411,540,8871,8639,772
2005,Urban,Tamil Nadu,Crime Against Men,Robbery,Female,60+,3253,2546,707,3104,149
2004,Urban,Punjab,Other Crimes,Corruption,Male,60+,7769,3175,4594,7142,627
2007,Rural,Uttar Pradesh,Property Crime,Vandalism,Male,60+,2426,1,2425,1807,619
2003,Urban,Assam,Crime Against Men,Extortion,Female,13-17,4947,3147,1800,3311,1636
2001,Urban,Uttar Pradesh,Crime Against Children,Kidnapping,Female,18-30,5733,1807,3926,2813,2920
2002,Urban,Goa,Crime Against Children,Child Abuse,Female,0-12,2944,2941,3,2941,3
2002,Urban,Goa,Crime Against Men,Extortion,Female,0-12,8029,1741,6288,5333,2696
2005,Rural,Madhya Pradesh,Crime Against Children,Child Labor,Male,13-17,138,64,74,92,46
2009,Rural,Tamil Nadu,Crime Against Women,Molestation,Male,46-60,7216,250,6966,3831,3385
2008,Urban,Goa,Crime Against Children,Kidnapping,Male,13-17,5620,124,5496,3953,1667
2009,Rural,Telangana,Other Crimes,Fraud,Male,0-12,9374,3429,5945,7160,2214
2009,Rural,West Bengal,Crime Against Women,Rape,Male,18-30,6930,6002,928,6437,493
2007,Rural,Nagaland,Crime Against Women,Domestic Violence,Male,13-17,6131,3763,2368,4909,1222
2007,Rural,Tamil Nadu,Crime Against Men,Assault,Female,18-30,7604,1340,6264,2239,5365
2001,Rural,Uttarakhand,Property Crime,Theft,Female,31-45,7594,2568,5026,7133,461
2006,Rural,Telangana,Crime Against Children,Trafficking,Male,0-12,6016,294,5722,2661,3355
2002,Urban,Delhi,Crime Against Men,Assault,Male,18-30,4581,1675,2906,1849,2732
2009,Rural,Telangana,Other Crimes,Corruption,Male,46-60,3999,1363,2636,2975,1024
2003,Urban,Nagaland,Property Crime,Theft,Female,0-12,3640,3401,239,3565,75
2002,Urban,Mizoram,Crime Against Women,Domestic Violence,Female,60+,7192,3690,3502,5722,1470
2001,Rural,West Bengal,Crime Against Children,Child Abuse,Female,31-45,9444,8385,1059,9266,178
2004,Rural,Assam,Crime Against Women,Molestation,Female,0-12,566,91,475,204,362
2002,Rural,Jharkhand,Property Crime,Burglary,Male,13-17,7090,5616,1474,6449,641
2008,Rural,Manipur,Other Crimes,Corruption,Female,0-12,5723,3023,2700,5579,144
2010,Urban,Punjab,Crime Against Women,Domestic Violence,Male,60+,8842,7045,1797,8638,204
2004,Urban,Rajasthan,Crime Against Men,Assault,Male,46-60,3768,2079,1689,2834,934
2001,Urban,Assam,Other Crimes,Fraud,Female,46-60,355,232,123,318,37
2010,Urban,Uttar Pradesh,Crime Against Women,Molestation,Female,13-17,8359,7889,470,8155,204
2006,Urban,Gujarat,Crime Against Women,Molestation,Female,46-60,4244,593,3651,1840,2404
2002,Rural,Odisha,Crime Against Children,Trafficking,Female,31-45,5645,3679,1966,4480,1165
2010,Rural,Delhi,Crime Against Men,Extortion,Female,18-30,1377,360,1017,604,773
2002,Rural,Chhattisgarh,Crime Against Children,Trafficking,Male,46-60,758,413,345,425,333
2006,Urban,Jammu & Kashmir,Crime Against Children,Kidnapping,Male,46-60,6530,3013,3517,4493,2037
2009,Rural,Meghalaya,Crime Against Men,Murder,Female,31-45,9205,6636,2569,9068,137
2001,Rural,Nagaland,Crime Against Women,Molestation,Female,13-17,7775,2371,5404,7241,534
2008,Urban,Delhi,Crime Against Children,Child Abuse,Female,18-30,6187,3771,2416,5470,717
2010,Rural,West Bengal,Crime Against Children,Child Labor,Male,60+,8611,8516,95,8570,41
2002,Rural,Rajasthan,Crime Against Women,Dowry Deaths,Female,31-45,7345,3418,3927,5501,1844
2003,Urban,Uttarakhand,Other Crimes,Drug Offense,Male,60+,3297,23,3274,810,2487
2001,Urban,Punjab,Other Crimes,Fraud,Male,31-45,9426,2203,7223,3857,5569
2002,Rural,Arunachal Pradesh,Property Crime,Arson,Female,46-60,2876,543,2333,2384,492
2003,Rural,Goa,Crime Against Children,Trafficking,Male,13-17,4033,1972,2061,3953,80
2006,Rural,Chhattisgarh,Crime Against Women,Domestic Violence,Female,18-30,5920,4828,1092,4844,1076
2004,Urban,Arunachal Pradesh,Crime Against Women,Rape,Female,18-30,4351,1100,3251,3468,883
2005,Urban,Manipur,Crime Against Children,Child Labor,Male,31-45,8165,5861,2304,6468,1697
2007,Urban,Assam,Other Crimes,Cyber Crime,Male,60+,4537,1724,2813,2006,2531
2008,Rural,Goa,Other Crimes,Cyber Crime,Male,46-60,1031,1002,29,1030,1
2001,Urban,Haryana,Crime Against Women,Rape,Female,18-30,7585,4123,3462,5815,1770
2001,Urban,Telangana,Property Crime,Theft,Female,18-30,777,118,659,747,30
2009,Rural,Tamil Nadu,Other Crimes,Drug Offense,Female,13-17,1333,247,1086,280,1053
2003,Urban,Madhya Pradesh,Crime Against Women,Rape,Male,46-60,3376,66,3310,2083,1293
2006,Rural,Gujarat,Crime Against Men,Extortion,Female,31-45,9477,746,8731,7252,2225
2009,Rural,Chhattisgarh,Crime Against Children,Trafficking,Male,60+,7446,2,7444,4047,3399
2003,Urban,Tripura,Crime Against Children,Child Abuse,Male,31-45,7263,6755,508,7032,231
2008,Rural,Delhi,Crime Against Children,Kidnapping,Female,31-45,6396,1623,4773,4721,1675
2001,Urban,Uttarakhand,Crime Against Women,Molestation,Female,46-60,6427,4640,1787,6376,51
2006,Urban,Madhya Pradesh,Crime Against Men,Extortion,Male,31-45,6678,2836,3842,5880,798
2005,Rural,Kerala,Property Crime,Burglary,Female,13-17,1958,1026,932,1354,604
2007,Urban,Meghalaya,Property Crime,Theft,Female,13-17,1712,1144,568,1427,285
2009,Rural,Karnataka,Crime Against Women,Domestic Violence,Female,18-30,4460,3602,858,3768,692
2009,Urban,Manipur,Crime Against Women,Molestation,Male,0-12,9264,49,9215,4734,4530
2005,Rural,Uttar Pradesh,Crime Against Children,Child Labor,Female,46-60,6976,516,6460,2702,4274
2008,Rural,Bihar,Crime Against Children,Child Abuse,Male,0-12,6646,4924,1722,5438,1208
2010,Urban,Jharkhand,Other Crimes,Corruption,Male,46-60,5754,5451,303,5553,201
2002,Urban,Goa,Other Crimes,Drug Offense,Male,13-17,675,71,604,440,235
2010,Rural,Tripura,Crime Against Children,Child Labor,Female,13-17,9055,6528,2527,8119,936
2009,Rural,Andhra Pradesh,Property Crime,Arson,Male,0-12,2487,316,2171,2443,44
2009,Urban,Tamil Nadu,Crime Against Children,Child Labor,Male,31-45,8239,2737,5502,6449,1790
2006,Rural,Mizoram,Crime Against Men,Extortion,Female,60+,2651,539,2112,1960,691
2005,Rural,Bihar,Crime Against Women,Domestic Violence,Male,18-30,7140,5209,1931,6756,384
2007,Urban,Uttar Pradesh,Crime Against Children,Child Labor,Male,31-45,3641,2797,844,3605,36
2002,Rural,Tamil Nadu,Property Crime,Arson,Male,13-17,6285,2006,4279,6009,276
2004,Urban,Jharkhand,Crime Against Women,Dowry Deaths,Female,31-45,2452,1005,1447,1210,1242
2007,Rural,Uttar Pradesh,Crime Against Women,Domestic Violence,Female,31-45,5736,2163,3573,2811,2925
2009,Urban,West Bengal,Crime Against Women,Domestic Violence,Female,46-60,5824,439,5385,1552,4272
2008,Urban,Chhattisgarh,Crime Against Men,Murder,Male,60+,8446,5099,3347,7441,1005
2007,Urban,Kerala,Crime Against Children,Child Labor,Male,0-12,9021,1953,7068,2586,6435
2002,Urban,Jharkhand,Other Crimes,Fraud,Male,31-45,238,166,72,206,32
2007,Rural,Nagaland,Crime Against Men,Murder,Female,18-30,2039,1432,607,1921,118
2002,Urban,Manipur,Property Crime,Theft,Male,18-30,2805,1015,1790,2665,140
2007,Urban,Gujarat,Property Crime,Theft,Male,18-30,1219,939,280,998,221
2004,Rural,Uttar Pradesh,Crime Against Men,Assault,Female,0-12,3145,2041,1104,2702,443
2001,Urban,Maharashtra,Other Crimes,Drug Offense,Male,60+,9545,8345,1200,8776,769
2002,Rural,Madhya Pradesh,Crime Against Women,Dowry Deaths,Male,60+,1096,156,940,686,410
2005,Urban,Manipur,Other Crimes,Fraud,Female,13-17,7294,6376,918,6918,376
2009,Urban,Uttarakhand,Crime Against Men,Assault,Female,13-17,435,85,350,193,242
2006,Rural,Arunachal Pradesh,Property Crime,Theft,Female,18-30,6816,4080,2736,6694,122
2007,Urban,Gujarat,Crime Against Children,Trafficking,Male,31-45,7252,803,6449,1354,5898
2002,Rural,Tamil Nadu,Other Crimes,Corruption,Female,46-60,1342,833,509,1235,107
2008,Urban,Kerala,Crime Against Children,Child Labor,Female,18-30,2966,270,2696,355,2611
2004,Rural,Odisha,Property Crime,Theft,Female,31-45,8488,2626,5862,4811,3677
2008,Urban,Tripura,Crime Against Women,Molestation,Male,0-12,3188,2814,374,3083,105
2007,Urban,Odisha,Property Crime,Vandalism,Male,0-12,5637,2225,3412,3495,2142
2002,Urban,Tamil Nadu,Crime Against Men,Assault,Female,0-12,3240,2914,326,3113,127
2009,Urban,Assam,Property Crime,Arson,Female,13-17,4221,1713,2508,3485,736
2008,Rural,Delhi,Other Crimes,Drug Offense,Male,18-30,9710,5551,4159,5579,4131
2010,Urban,Gujarat,Crime Against Children,Kidnapping,Female,18-30,1731,980,751,1662,69
2004,Rural,Odisha,Crime Against Women,Dowry Deaths,Female,46-60,7854,3912,3942,4878,2976
2001,Urban,Madhya Pradesh,Other Crimes,Cyber Crime,Female,31-45,8966,935,8031,4349,4617
2005,Urban,Jharkhand,Crime Against Men,Robbery,Male,13-17,4216,4076,140,4152,64
2002,Urban,Jammu & Kashmir,Crime Against Men,Robbery,Female,13-17,3979,3334,645,3838,141
2008,Rural,Chhattisgarh,Other Crimes,Corruption,Male,60+,5546,5499,47,5506,40
2002,Urban,Meghalaya,Other Crimes,Fraud,Male,46-60,1668,864,804,870,798
2005,Urban,Rajasthan,Crime Against Women,Rape,Female,60+,2577,2187,390,2231,346
2002,Rural,Nagaland,Crime Against Children,Trafficking,Male,60+,452,290,162,427,25
2003,Rural,Uttar Pradesh,Crime Against Men,Robbery,Male,60+,4805,4558,247,4758,47
2008,Rural,Himachal Pradesh,Crime Against Men,Extortion,Female,18-30,6127,1027,5100,1121,5006
2008,Urban,Andhra Pradesh,Crime Against Children,Trafficking,Female,13-17,4030,2686,1344,2987,1043
2004,Rural,Odisha,Crime Against Women,Dowry Deaths,Male,0-12,5203,2012,3191,4414,789
2001,Urban,Andhra Pradesh,Crime Against Children,Trafficking,Male,0-12,970,556,414,932,38
2007,Urban,Delhi,Property Crime,Arson,Female,13-17,9875,1603,8272,5401,4474
2002,Rural,Uttar Pradesh,Crime Against Men,Assault,Female,60+,1594,773,821,1037,557
2004,Rural,Jharkhand,Property Crime,Theft,Male,31-45,286,212,74,222,64
2007,Rural,West Bengal,Property Crime,Theft,Male,46-60,7745,5193,2552,7643,102
2002,Urban,Sikkim,Crime Against Men,Murder,Female,60+,1768,1451,317,1732,36
2002,Rural,Maharashtra,Crime Against Women,Rape,Female,13-17,4387,1369,3018,3107,1280
2004,Rural,West Bengal,Other Crimes,Drug Offense,Male,46-60,3803,1706,2097,2963,840
2003,Urban,Maharashtra,Crime Against Men,Extortion,Male,18-30,4281,3440,841,3735,546
2007,Urban,Bihar,Crime Against Women,Rape,Female,46-60,589,330,259,405,184
2008,Rural,Sikkim,Crime Against Women,Molestation,Female,0-12,3781,30,3751,196,3585
2003,Rural,Chhattisgarh,Other Crimes,Cyber Crime,Female,31-45,1441,847,594,1286,155
2001,Rural,Goa,Crime Against Men,Assault,Male,60+,1804,1720,84,1752,52
2002,Urban,Uttar Pradesh,Other Crimes,Drug Offense,Male,60+,7819,7771,48,7780,39
2010,Rural,Maharashtra,Crime Against Men,Murder,Male,60+,7833,190,7643,3405,4428
2002,Rural,Punjab,Crime Against Children,Child Abuse,Female,31-45,9246,8884,362,8927,319
2009,Rural,Uttar Pradesh,Crime Against Men,Assault,Male,31-45,2536,2314,222,2431,105
2007,Rural,Mizoram,Other Crimes,Drug Offense,Female,18-30,7005,2603,4402,3011,3994
2004,Urban,Punjab,Other Crimes,Fraud,Male,46-60,4199,821,3378,1573,2626
2002,Urban,Tripura,Crime Against Children,Kidnapping,Male,18-30,9434,8046,1388,8274,1160
2009,Urban,Jammu & Kashmir,Other Crimes,Fraud,Male,31-45,6572,946,5626,4313,2259
2003,Urban,Delhi,Crime Against Women,Molestation,Female,46-60,6140,5373,767,5373,767
2010,Urban,Jammu & Kashmir,Crime Against Women,Dowry Deaths,Male,60+,8018,929,7089,7756,262
2005,Rural,Nagaland,Other Crimes,Cyber Crime,Male,13-17,3247,3053,194,3175,72
2010,Rural,Jharkhand,Other Crimes,Fraud,Female,0-12,6438,3525,2913,6169,269
2008,Rural,West Bengal,Property Crime,Theft,Male,31-45,530,195,335,460,70
2008,Rural,Rajasthan,Crime Against Women,Dowry Deaths,Male,0-12,5691,1088,4603,5547,144
2007,Urban,Meghalaya,Other Crimes,Drug Offense,Female,13-17,3897,1656,2241,3755,142
2001,Urban,Arunachal Pradesh,Crime Against Children,Child Labor,Male,60+,5149,1632,3517,2451,2698
2002,Rural,Punjab,Crime Against Men,Robbery,Female,18-30,5752,5323,429,5567,185
2006,Rural,Uttarakhand,Crime Against Children,Kidnapping,Female,18-30,8873,6024,2849,8246,627
2002,Urban,Karnataka,Crime Against Children,Child Abuse,Male,31-45,7748,5945,1803,7634,114
2003,Rural,Madhya Pradesh,Property Crime,Burglary,Male,46-60,1981,1695,286,1704,277
2006,Urban,Bihar,Crime Against Children,Child Labor,Female,31-45,2028,311,1717,1064,964
2006,Urban,Jammu & Kashmir,Crime Against Men,Murder,Male,46-60,8297,4175,4122,6701,1596
2008,Rural,Tamil Nadu,Crime Against Children,Child Abuse,Male,18-30,7853,6104,1749,7477,376
2006,Urban,Tripura,Property Crime,Vandalism,Male,60+,7975,6481,1494,7059,916
2001,Rural,Assam,Crime Against Children,Child Labor,Male,60+,8218,6518,1700,6565,1653
2006,Urban,Bihar,Crime Against Children,Child Labor,Female,46-60,5388,93,5295,321,5067
2003,Urban,Andhra Pradesh,Other Crimes,Cyber Crime,Female,46-60,3715,2488,1227,2784,931
2004,Rural,Manipur,Crime Against Men,Assault,Female,31-45,4070,556,3514,1576,2494
2005,Urban,Tamil Nadu,Crime Against Children,Kidnapping,Male,60+,2595,2332,263,2526,69
2003,Rural,West Bengal,Crime Against Men,Robbery,Male,0-12,1848,651,1197,1191,657
2008,Rural,Haryana,Crime Against Men,Assault,Male,46-60,3876,3252,624,3366,510
2009,Urban,Jammu & Kashmir,Crime Against Men,Robbery,Male,13-17,3675,866,2809,2672,1003
2003,Rural,Jharkhand,Property Crime,Burglary,Female,46-60,8270,3714,4556,4350,3920
2006,Urban,Andhra Pradesh,Property Crime,Burglary,Male,13-17,9419,3462,5957,6599,2820
2004,Rural,West Bengal,Property Crime,Arson,Female,18-30,3669,3115,554,3158,511
2008,Urban,Odisha,Crime Against Children,Child Labor,Female,46-60,4332,4147,185,4272,60
2004,Urban,Chhattisgarh,Property Crime,Arson,Female,60+,8402,1189,7213,4012,4390
2010,Urban,West Bengal,Crime Against Women,Molestation,Female,18-30,9775,6454,3321,6905,2870
2004,Rural,Maharashtra,Crime Against Men,Extortion,Male,0-12,9641,6101,3540,9238,403
2006,Rural,Odisha,Crime Against Women,Molestation,Female,0-12,5246,834,4412,4521,725
2006,Urban,Mizoram,Crime Against Men,Robbery,Male,0-12,4343,2845,1498,3936,407
2010,Rural,Telangana,Other Crimes,Cyber Crime,Male,13-17,3776,3742,34,3762,14
2002,Rural,Arunachal Pradesh,Other Crimes,Fraud,Male,60+,6955,2295,4660,5379,1576
2001,Urban,Telangana,Property Crime,Theft,Female,46-60,1068,120,948,605,463
2004,Rural,Delhi,Property Crime,Burglary,Female,18-30,3987,2466,1521,3939,48
2005,Rural,Madhya Pradesh,Property Crime,Arson,Female,13-17,3390,285,3105,3095,295
2003,Urban,Arunachal Pradesh,Crime Against Women,Dowry Deaths,Female,46-60,5644,4335,1309,5038,606
2004,Rural,Punjab,Other Crimes,Fraud,Male,13-17,5655,207,5448,3708,1947
2006,Rural,Andhra Pradesh,Crime Against Children,Child Labor,Male,60+,7637,2233,5404,2343,5294
2005,Urban,Telangana,Crime Against Children,Trafficking,Male,46-60,8795,4146,4649,6943,1852
2003,Rural,Tamil Nadu,Other Crimes,Cyber Crime,Female,13-17,2032,1767,265,1775,257
2006,Rural,Goa,Other Crimes,Cyber Crime,Female,60+,8738,4842,3896,5411,3327
2004,Rural,Meghalaya,Other Crimes,Fraud,Male,31-45,7235,33,7202,4429,2806
2009,Urban,Goa,Crime Against Men,Extortion,Female,60+,522,391,131,518,4
2006,Urban,Himachal Pradesh,Property Crime,Burglary,Male,60+,2134,882,1252,958,1176
2003,Urban,Gujarat,Other Crimes,Cyber Crime,Female,31-45,5026,3757,1269,4148,878
2005,Urban,Arunachal Pradesh,Other Crimes,Fraud,Female,60+,476,95,381,395,81
2009,Urban,Rajasthan,Other Crimes,Drug Offense,Male,46-60,4918,358,4560,2690,2228
2006,Urban,Goa,Crime Against Women,Rape,Male,13-17,7639,2636,5003,5842,1797
2004,Rural,Delhi,Crime Against Women,Rape,Female,46-60,3680,1742,1938,3557,123
2003,Urban,Gujarat,Crime Against Women,Dowry Deaths,Female,0-12,4443,4207,236,4373,70
2004,Rural,Goa,Crime Against Children,Kidnapping,Male,13-17,3154,1468,1686,1507,1647
2003,Rural,Odisha,Crime Against Women,Domestic Violence,Female,13-17,9350,8081,1269,9091,259
2002,Urban,Tamil Nadu,Property Crime,Burglary,Female,60+,8380,2519,5861,4169,4211
2004,Urban,Gujarat,Crime Against Men,Extortion,Male,0-12,2975,1725,1250,2822,153
2010,Urban,Madhya Pradesh,Other Crimes,Drug Offense,Male,0-12,6739,6247,492,6738,1
2009,Rural,Maharashtra,Property Crime,Theft,Male,18-30,2887,2866,21,2874,13
2007,Urban,Haryana,Crime Against Children,Child Labor,Female,46-60,3967,1689,2278,3918,49
2007,Rural,Bihar,Crime Against Women,Domestic Violence,Female,13-17,7735,6069,1666,7543,192
2006,Urban,Sikkim,Property Crime,Theft,Female,46-60,6889,1878,5011,3582,3307
2002,Urban,Uttar Pradesh,Crime Against Men,Robbery,Male,60+,8886,2614,6272,4614,4272
2010,Urban,Chhattisgarh,Other Crimes,Corruption,Male,46-60,900,418,482,729,171
2005,Urban,Punjab,Crime Against Women,Rape,Male,13-17,6503,2733,3770,5232,1271
2009,Urban,Rajasthan,Crime Against Children,Trafficking,Female,60+,1955,1892,63,1952,3
2002,Urban,Himachal Pradesh,Property Crime,Theft,Male,31-45,5678,4121,1557,4473,1205
2003,Rural,Arunachal Pradesh,Other Crimes,Corruption,Male,13-17,5871,4399,1472,4777,1094
2009,Rural,Madhya Pradesh,Other Crimes,Drug Offense,Male,46-60,3348,1302,2046,2801,547
2009,Urban,Jammu & Kashmir,Crime Against Men,Extortion,Male,31-45,9376,8222,1154,8486,890
2007,Rural,Goa,Crime Against Children,Child Abuse,Male,0-12,8696,468,8228,6216,2480
2007,Urban,Delhi,Other Crimes,Drug Offense,Male,13-17,5905,2643,3262,4950,955
2006,Rural,Chhattisgarh,Crime Against Women,Domestic Violence,Female,31-45,8910,2763,6147,3709,5201
2004,Rural,Mizoram,Other Crimes,Corruption,Female,18-30,6067,6014,53,6023,44
2008,Rural,West Bengal,Crime Against Women,Molestation,Female,0-12,6315,3007,3308,5412,903
2005,Urban,Gujarat,Crime Against Women,Domestic Violence,Female,46-60,5279,254,5025,2187,3092
2001,Rural,Himachal Pradesh,Crime Against Men,Assault,Female,31-45,457,96,361,383,74
2010,Urban,Jharkhand,Property Crime,Burglary,Female,60+,3680,866,2814,3195,485
2002,Rural,Odisha,Crime Against Women,Rape,Female,0-12,225,57,168,196,29
2009,Rural,Delhi,Other Crimes,Cyber Crime,Male,46-60,5717,5255,462,5255,462
2003,Rural,Bihar,Other Crimes,Drug Offense,Female,31-45,2962,1185,1777,2406,556
2010,Urban,Meghalaya,Crime Against Children,Child Abuse,Male,31-45,9822,6618,3204,7440,2382
2008,Urban,Telangana,Crime Against Men,Extortion,Male,60+,1411,708,703,1068,343
2010,Rural,Telangana,Crime Against Children,Trafficking,Male,18-30,7979,746,7233,5853,2126
2008,Urban,Haryana,Crime Against Children,Trafficking,Male,18-30,2951,2237,714,2360,591
2001,Rural,Andhra Pradesh,Crime Against Men,Robbery,Female,31-45,2363,591,1772,1209,1154
2005,Rural,Jammu & Kashmir,Crime Against Children,Child Abuse,Male,31-45,3441,420,3021,1305,2136
2008,Rural,Haryana,Crime Against Children,Trafficking,Male,60+,7786,2390,5396,7756,30
2006,Rural,Uttar Pradesh,Other Crimes,Corruption,Female,0-12,5819,3237,2582,4198,1621
2010,Rural,Meghalaya,Property Crime,Theft,Female,18-30,1336,609,727,1312,24
2006,Urban,Rajasthan,Crime Against Women,Molestation,Male,18-30,619,397,222,422,197
2002,Urban,Tamil Nadu,Other Crimes,Corruption,Male,60+,8354,3459,4895,4786,3568
2009,Rural,Andhra Pradesh,Other Crimes,Cyber Crime,Female,0-12,3536,912,2624,2313,1223
2009,Rural,Goa,Property Crime,Vandalism,Female,13-17,4199,421,3778,1869,2330
2004,Rural,Arunachal Pradesh,Property Crime,Arson,Female,46-60,1105,978,127,1018,87
2002,Urban,Odisha,Other Crimes,Drug Offense,Female,13-17,3435,2946,489,3222,213
2009,Urban,Himachal Pradesh,Crime Against Children,Kidnapping,Female,0-12,4797,1218,3579,3021,1776
2005,Rural,Arunachal Pradesh,Other Crimes,Cyber Crime,Male,31-45,9448,1944,7504,8425,1023
2008,Urban,Chhattisgarh,Crime Against Men,Assault,Female,60+,6699,4544,2155,4893,1806
2009,Urban,West Bengal,Crime Against Men,Extortion,Female,31-45,3163,1508,1655,2703,460
2008,Rural,Bihar,Crime Against Women,Domestic Violence,Male,31-45,1258,205,1053,948,310
2008,Urban,Uttar Pradesh,Crime Against Children,Kidnapping,Female,13-17,2190,527,1663,710,1480
2008,Urban,Odisha,Property Crime,Burglary,Female,31-45,3015,1615,1400,2845,170
2008,Rural,Chhattisgarh,Crime Against Children,Kidnapping,Female,13-17,4365,4210,155,4332,33
2004,Urban,Karnataka,Property Crime,Arson,Male,31-45,538,166,372,312,226
2003,Urban,Assam,Property Crime,Theft,Female,18-30,3963,787,3176,3819,144
2010,Urban,Delhi,Property Crime,Vandalism,Male,46-60,2271,1075,1196,1371,900
2008,Urban,Nagaland,Property Crime,Arson,Female,46-60,8146,5682,2464,6346,1800
2006,Rural,Bihar,Property Crime,Theft,Female,18-30,9355,7216,2139,8560,795
2003,Rural,Sikkim,Crime Against Women,Dowry Deaths,Male,18-30,248,157,91,244,4
2004,Rural,Assam,Other Crimes,Corruption,Female,18-30,7445,5762,1683,7091,354
2009,Rural,Himachal Pradesh,Crime Against Children,Child Labor,Male,60+,9796,1267,8529,5219,4577
2003,Urban,Sikkim,Crime Against Women,Dowry Deaths,Female,46-60,2911,2081,830,2697,214
2006,Urban,Delhi,Crime Against Children,Kidnapping,Female,46-60,8882,3972,4910,4701,4181
2002,Urban,Himachal Pradesh,Crime Against Men,Extortion,Female,31-45,5178,2038,3140,3771,1407
2001,Rural,Jammu & Kashmir,Property Crime,Vandalism,Female,60+,1993,922,1071,1427,566
2003,Urban,Karnataka,Other Crimes,Corruption,Female,13-17,5992,1134,4858,3114,2878
2007,Rural,Madhya Pradesh,Crime Against Women,Domestic Violence,Female,0-12,8178,4358,3820,8055,123
2010,Rural,Arunachal Pradesh,Crime Against Women,Domestic Violence,Male,31-45,9188,5757,3431,8515,673
2002,Rural,West Bengal,Other Crimes,Drug Offense,Male,0-12,9230,7631,1599,8836,394
2008,Rural,Arunachal Pradesh,Crime Against Children,Child Abuse,Male,0-12,2146,2125,21,2129,17
2005,Rural,Andhra Pradesh,Crime Against Children,Trafficking,Female,13-17,6508,1046,5462,3589,2919
2004,Rural,Telangana,Crime Against Children,Child Labor,Male,0-12,7267,6063,1204,6201,1066
2003,Rural,Goa,Other Crimes,Cyber Crime,Female,18-30,5180,133,5047,2553,2627
2005,Rural,Haryana,Property Crime,Theft,Female,60+,7469,5008,2461,5066,2403
2006,Rural,Tripura,Crime Against Children,Child Labor,Female,46-60,115,44,71,53,62
2005,Urban,Nagaland,Other Crimes,Corruption,Female,31-45,5477,3922,1555,3931,1546
2007,Rural,Rajasthan,Crime Against Women,Dowry Deaths,Female,46-60,2640,1417,1223,1485,1155
2006,Urban,Punjab,Other Crimes,Fraud,Female,60+,8476,2036,6440,7833,643
2003,Rural,Punjab,Property Crime,Burglary,Female,13-17,5477,3331,2146,4228,1249
2003,Rural,Jammu & Kashmir,Crime Against Men,Robbery,Male,0-12,5943,72,5871,5114,829
2010,Rural,Gujarat,Property Crime,Arson,Female,60+,7281,1524,5757,2067,5214
2009,Urban,Uttar Pradesh,Crime Against Children,Kidnapping,Male,46-60,8813,7744,1069,8758,55
2001,Urban,Maharashtra,Other Crimes,Corruption,Male,0-12,295,259,36,276,19
2010,Rural,Rajasthan,Crime Against Men,Assault,Male,31-45,6128,3432,2696,4377,1751
2005,Urban,Chhattisgarh,Property Crime,Vandalism,Female,0-12,7488,6231,1257,6425,1063
2001,Rural,Karnataka,Crime Against Women,Rape,Female,31-45,7565,4110,3455,6790,775
2005,Rural,Odisha,Property Crime,Theft,Male,31-45,3534,417,3117,2800,734
2006,Urban,Assam,Property Crime,Arson,Male,0-12,9511,6146,3365,8610,901
2006,Rural,Maharashtra,Crime Against Men,Robbery,Male,0-12,289,149,140,156,133
2006,Urban,Bihar,Crime Against Men,Robbery,Female,60+,9325,3470,5855,5374,3951
2002,Urban,Andhra Pradesh,Crime Against Children,Kidnapping,Male,0-12,7063,6084,979,6207,856
2007,Urban,Rajasthan,Crime Against Children,Child Labor,Female,31-45,7225,5571,1654,5725,1500
2003,Urban,Bihar,Other Crimes,Corruption,Male,0-12,5791,552,5239,887,4904
2010,Urban,Madhya Pradesh,Other Crimes,Cyber Crime,Female,0-12,2623,2182,441,2273,350
2004,Rural,Himachal Pradesh,Other Crimes,Fraud,Female,46-60,8704,7936,768,8586,118
2001,Rural,Tamil Nadu,Crime Against Men,Extortion,Male,0-12,604,368,236,479,125
2004,Rural,Jammu & Kashmir,Crime Against Children,Child Abuse,Male,13-17,6295,1969,4326,3493,2802
2009,Rural,Mizoram,Other Crimes,Corruption,Male,60+,2777,1423,1354,2370,407
2004,Urban,Sikkim,Other Crimes,Drug Offense,Male,60+,7971,5752,2219,5781,2190
2006,Urban,Manipur,Crime Against Men,Extortion,Male,60+,1623,521,1102,998,625
2002,Urban,Jharkhand,Crime Against Men,Murder,Male,0-12,5056,613,4443,2666,2390
2006,Urban,Madhya Pradesh,Crime Against Men,Assault,Male,13-17,2167,1979,188,2127,40
2005,Urban,Andhra Pradesh,Crime Against Men,Assault,Female,31-45,5712,2602,3110,3613,2099
2007,Urban,Nagaland,Crime Against Children,Child Abuse,Male,46-60,5328,3427,1901,3590,1738
2004,Urban,Chhattisgarh,Crime Against Men,Extortion,Female,31-45,5426,2807,2619,4210,1216
2001,Rural,Odisha,Crime Against Women,Rape,Male,60+,6029,4420,1609,4980,1049
2004,Rural,Jammu & Kashmir,Crime Against Women,Domestic Violence,Male,60+,651,431,220,514,137
2006,Urban,Karnataka,Other Crimes,Cyber Crime,Male,46-60,7472,6417,1055,7151,321
2003,Urban,Uttar Pradesh,Crime Against Women,Molestation,Male,46-60,9181,8260,921,9145,36
2005,Urban,Arunachal Pradesh,Crime Against Children,Child Abuse,Female,31-45,9291,2285,7006,9093,198
2007,Urban,Uttar Pradesh,Property Crime,Theft,Male,60+,3623,1160,2463,2447,1176
2002,Rural,Meghalaya,Crime Against Children,Child Abuse,Male,31-45,2083,1908,175,2054,29
2001,Rural,Goa,Crime Against Men,Assault,Male,31-45,3579,1093,2486,2331,1248
2006,Urban,Andhra Pradesh,Other Crimes,Drug Offense,Female,60+,7696,843,6853,6247,1449
2004,Urban,Assam,Other Crimes,Fraud,Male,0-12,6726,2503,4223,6431,295
2001,Rural,Chhattisgarh,Crime Against Men,Extortion,Male,0-12,1676,862,814,1655,21
2006,Rural,Andhra Pradesh,Crime Against Women,Molestation,Male,31-45,9126,8403,723,8823,303
2007,Rural,Karnataka,Other Crimes,Fraud,Female,18-30,4667,4578,89,4662,5
2005,Urban,Haryana,Property Crime,Burglary,Female,31-45,8584,2998,5586,3304,5280
2002,Urban,Punjab,Crime Against Women,Domestic Violence,Male,18-30,4432,2230,2202,2438,1994
2010,Rural,Maharashtra,Crime Against Men,Assault,Male,13-17,6361,546,5815,5019,1342
2001,Urban,Meghalaya,Property Crime,Burglary,Male,60+,2151,1522,629,1764,387
2009,Rural,Bihar,Crime Against Women,Rape,Male,46-60,7788,2582,5206,2720,5068
2005,Rural,Jharkhand,Crime Against Men,Robbery,Male,18-30,6360,4360,2000,5805,555
2004,Urban,Kerala,Property Crime,Vandalism,Female,0-12,7695,5844,1851,6351,1344
2006,Rural,Mizoram,Crime Against Men,Murder,Male,46-60,6760,2173,4587,5162,1598
2008,Rural,Mizoram,Other Crimes,Drug Offense,Male,60+,6951,87,6864,5194,1757
2003,Urban,Mizoram,Other Crimes,Drug Offense,Male,60+,9873,9650,223,9846,27
2010,Urban,Tamil Nadu,Crime Against Men,Murder,Male,13-17,211,186,25,203,8
2002,Rural,Karnataka,Other Crimes,Fraud,Male,46-60,1042,435,607,584,458
2005,Urban,Jharkhand,Crime Against Women,Domestic Violence,Female,18-30,9401,2383,7018,5080,4321
2008,Rural,Telangana,Crime Against Women,Dowry Deaths,Male,13-17,7938,1771,6167,5970,1968
2001,Rural,Mizoram,Crime Against Men,Assault,Male,31-45,2646,2291,355,2395,251
2009,Urban,Uttarakhand,Crime Against Men,Assault,Female,46-60,9735,9691,44,9716,19
2002,Urban,Haryana,Crime Against Children,Child Abuse,Male,13-17,7681,1166,6515,1790,5891
2001,Urban,Jammu & Kashmir,Other Crimes,Drug Offense,Female,13-17,2902,2375,527,2671,231
2002,Urban,Punjab,Property Crime,Burglary,Male,31-45,4951,654,4297,2238,2713
2003,Rural,Tripura,Crime Against Men,Extortion,Female,18-30,7157,5723,1434,6322,835
2003,Rural,Manipur,Other Crimes,Fraud,Male,13-17,1262,803,459,934,328
2002,Urban,Jammu & Kashmir,Crime Against Men,Murder,Male,60+,2450,1214,1236,2404,46
2004,Urban,Punjab,Property Crime,Vandalism,Male,60+,6897,5679,1218,6085,812
2002,Urban,Rajasthan,Crime Against Men,Murder,Male,46-60,6495,4121,2374,4387,2108
2010,Urban,Madhya Pradesh,Crime Against Children,Kidnapping,Male,18-30,2298,919,1379,1231,1067
2006,Rural,Gujarat,Property Crime,Arson,Female,60+,5870,4537,1333,5193,677
2009,Urban,Delhi,Crime Against Women,Rape,Male,13-17,2723,1463,1260,1920,803
2006,Rural,Delhi,Property Crime,Theft,Female,13-17,1494,141,1353,933,561
2006,Urban,Meghalaya,Other Crimes,Drug Offense,Female,46-60,4059,2421,1638,2978,1081
2007,Urban,Jharkhand,Property Crime,Vandalism,Male,31-45,4522,2176,2346,4089,433
2010,Rural,Maharashtra,Crime Against Men,Murder,Female,18-30,7586,2713,4873,4819,2767
2001,Rural,Haryana,Property Crime,Theft,Female,31-45,9323,6608,2715,7134,2189
2004,Urban,Telangana,Other Crimes,Cyber Crime,Male,46-60,3716,3023,693,3322,394
2005,Urban,Assam,Property Crime,Arson,Male,13-17,5744,283,5461,4324,1420
2010,Rural,Uttarakhand,Property Crime,Vandalism,Male,46-60,1567,496,1071,625,942
2005,Urban,Haryana,Crime Against Men,Extortion,Female,13-17,427,56,371,160,267
2006,Rural,Delhi,Crime Against Men,Robbery,Male,13-17,1561,1327,234,1394,167
2005,Rural,Gujarat,Crime Against Children,Child Abuse,Male,18-30,4432,1398,3034,4023,409
2001,Rural,Chhattisgarh,Crime Against Children,Child Abuse,Male,18-30,3504,1489,2015,2140,1364
2001,Rural,Telangana,Crime Against Men,Extortion,Male,31-45,4704,4198,506,4314,390
2001,Rural,West Bengal,Crime Against Women,Dowry Deaths,Female,0-12,5973,3837,2136,5562,411
2009,Rural,Gujarat,Property Crime,Burglary,Male,0-12,4433,2064,2369,2245,2188
2004,Rural,Tamil Nadu,Crime Against Women,Dowry Deaths,Male,18-30,5287,3035,2252,3688,1599
2001,Urban,Karnataka,Crime Against Women,Dowry Deaths,Female,46-60,5887,3782,2105,5300,587
2007,Urban,Chhattisgarh,Crime Against Women,Rape,Female,46-60,6509,994,5515,1014,5495
2010,Urban,Rajasthan,Other Crimes,Corruption,Female,31-45,8194,4146,4048,5962,2232
2002,Rural,Telangana,Crime Against Children,Child Abuse,Female,46-60,4570,1747,2823,2669,1901
2009,Urban,Sikkim,Crime Against Men,Robbery,Female,18-30,4671,533,4138,2293,2378
2007,Rural,West Bengal,Crime Against Children,Child Abuse,Female,31-45,6768,4635,2133,5567,1201
2004,Urban,Mizoram,Property Crime,Theft,Male,18-30,7839,2404,5435,7473,366
2007,Rural,West Bengal,Crime Against Men,Robbery,Female,60+,8866,5095,3771,5652,3214
2002,Urban,Chhattisgarh,Crime Against Women,Rape,Male,18-30,1703,1638,65,1702,1
2009,Rural,Delhi,Crime Against Men,Murder,Female,13-17,7454,5375,2079,7166,288
2001,Urban,Manipur,Crime Against Women,Domestic Violence,Male,0-12,6561,2971,3590,5344,1217
2006,Urban,Uttar Pradesh,Other Crimes,Corruption,Male,46-60,7670,5466,2204,6617,1053
2005,Urban,Meghalaya,Property Crime,Theft,Female,60+,211,24,187,158,53
2003,Rural,Uttarakhand,Crime Against Women,Molestation,Male,13-17,6316,3215,3101,5707,609
2006,Urban,Andhra Pradesh,Crime Against Children,Child Abuse,Male,46-60,7763,7409,354,7544,219
2010,Rural,Telangana,Crime Against Women,Domestic Violence,Male,13-17,5350,4465,885,5254,96
2002,Urban,Arunachal Pradesh,Other Crimes,Fraud,Female,18-30,7499,7308,191,7430,69
2010,Urban,Haryana,Crime Against Men,Robbery,Male,60+,6823,730,6093,1107,5716
2007,Rural,Uttarakhand,Crime Against Women,Molestation,Male,31-45,9322,5516,3806,9044,278
2009,Urban,Kerala,Crime Against Children,Child Labor,Female,31-45,2101,1937,164,2031,70
2006,Rural,Maharashtra,Crime Against Men,Assault,Male,60+,3693,2574,1119,2940,753
2003,Rural,Gujarat,Crime Against Women,Dowry Deaths,Male,46-60,4877,4790,87,4824,53
2004,Urban,Odisha,Property Crime,Burglary,Female,31-45,8184,6534,1650,7592,592
2002,Rural,Gujarat,Crime Against Men,Murder,Male,60+,9688,5175,4513,8403,1285
2010,Urban,Kerala,Crime Against Men,Murder,Female,0-12,9097,7606,1491,7814,1283
2010,Urban,Delhi,Crime Against Men,Robbery,Male,31-45,3218,1841,1377,3043,175
2001,Urban,Andhra Pradesh,Other Crimes,Corruption,Male,60+,5141,3489,1652,4555,586
2009,Rural,Jammu & Kashmir,Crime Against Women,Dowry Deaths,Male,18-30,6931,6067,864,6738,193
2010,Urban,Andhra Pradesh,Property Crime,Vandalism,Female,31-45,421,368,53,398,23
2006,Rural,Tripura,Crime Against Men,Robbery,Female,18-30,4816,2161,2655,3226,1590
2010,Rural,Kerala,Crime Against Children,Trafficking,Male,0-12,7015,906,6109,3531,3484
2003,Urban,Goa,Property Crime,Vandalism,Male,60+,5755,3438,2317,5481,274
2004,Urban,Mizoram,Property Crime,Arson,Male,18-30,1997,1459,538,1842,155
2005,Urban,Meghalaya,Other Crimes,Fraud,Female,0-12,3688,56,3632,187,3501
2002,Urban,Delhi,Other Crimes,Cyber Crime,Female,60+,5344,2882,2462,4304,1040
2004,Urban,Manipur,Other Crimes,Drug Offense,Male,60+,439,317,122,394,45
2009,Rural,Chhattisgarh,Crime Against Children,Trafficking,Male,60+,5144,1148,3996,3871,1273
2005,Rural,Maharashtra,Other Crimes,Corruption,Male,46-60,908,845,63,893,15
2009,Urban,Jammu & Kashmir,Crime Against Children,Kidnapping,Male,13-17,366,65,301,316,50
2004,Urban,Gujarat,Other Crimes,Fraud,Female,60+,2454,288,2166,1004,1450
2009,Rural,Tripura,Crime Against Women,Domestic Violence,Male,0-12,1057,355,702,803,254
2009,Urban,Chhattisgarh,Crime Against Children,Trafficking,Female,46-60,4417,112,4305,356,4061
2006,Urban,Jharkhand,Property Crime,Vandalism,Male,0-12,6568,5098,1470,6495,73
2001,Urban,Sikkim,Other Crimes,Corruption,Female,60+,8031,156,7875,7647,384
2005,Rural,Delhi,Crime Against Men,Murder,Female,31-45,830,567,263,625,205
2005,Rural,Madhya Pradesh,Crime Against Children,Child Labor,Female,18-30,7661,3809,3852,5163,2498
2002,Urban,Maharashtra,Property Crime,Vandalism,Male,60+,4434,2925,1509,3765,669
2008,Urban,Jharkhand,Crime Against Women,Dowry Deaths,Male,13-17,2900,364,2536,1594,1306
2003,Rural,Punjab,Other Crimes,Cyber Crime,Male,60+,2713,679,2034,2637,76
2009,Urban,Mizoram,Crime Against Men,Extortion,Male,13-17,449,289,160,313,136
2007,Rural,Telangana,Crime Against Women,Rape,Male,0-12,1643,566,1077,1383,260
2010,Urban,Himachal Pradesh,Crime Against Men,Assault,Male,31-45,6753,5249,1504,5728,1025
2009,Urban,Odisha,Other Crimes,Cyber Crime,Female,13-17,7130,3782,3348,6039,1091
2008,Rural,Haryana,Other Crimes,Fraud,Female,46-60,4161,2030,2131,3261,900
2008,Urban,Gujarat,Crime Against Children,Child Abuse,Male,18-30,3956,3276,680,3955,1
2001,Rural,Sikkim,Crime Against Men,Extortion,Male,46-60,8212,5927,2285,6121,2091
2006,Rural,Meghalaya,Property Crime,Theft,Male,60+,8118,2452,5666,3284,4834
2002,Rural,Andhra Pradesh,Crime Against Children,Kidnapping,Male,60+,7033,1747,5286,5058,1975
2002,Urban,Goa,Crime Against Men,Extortion,Female,0-12,8485,5210,3275,8404,81
2008,Urban,Uttarakhand,Crime Against Children,Kidnapping,Male,0-12,4121,1294,2827,2643,1478
2008,Rural,Andhra Pradesh,Crime Against Women,Domestic Violence,Female,46-60,3298,1705,1593,2298,1000
2010,Rural,Chhattisgarh,Crime Against Men,Assault,Male,46-60,1651,1238,413,1331,320
2006,Urban,Uttar Pradesh,Crime Against Men,Assault,Male,60+,6247,577,5670,1981,4266
2010,Rural,Tamil Nadu,Property Crime,Arson,Female,31-45,2029,539,1490,2012,17
2005,Urban,Maharashtra,Other Crimes,Corruption,Male,46-60,2463,2398,65,2462,1
2008,Urban,Haryana,Crime Against Children,Kidnapping,Male,13-17,3805,115,3690,2161,1644
2008,Rural,Odisha,Property Crime,Vandalism,Female,13-17,4026,2394,1632,2680,1346
2001,Rural,Tripura,Other Crimes,Corruption,Male,31-45,3134,1437,1697,2932,202
2002,Urban,West Bengal,Crime Against Children,Child Labor,Female,60+,287,119,168,137,150
2006,Urban,Haryana,Crime Against Children,Trafficking,Male,31-45,9399,4892,4507,8394,1005
2003,Rural,Haryana,Property Crime,Burglary,Male,31-45,346,321,25,341,5
2002,Rural,Haryana,Crime Against Children,Child Labor,Male,46-60,6093,2384,3709,3650,2443
2001,Rural,Tamil Nadu,Crime Against Children,Child Labor,Female,0-12,7408,6588,820,6860,548
2004,Urban,Punjab,Other Crimes,Cyber Crime,Female,13-17,4955,3244,1711,4891,64
2010,Urban,Punjab,Property Crime,Vandalism,Female,60+,2051,750,1301,1368,683
2002,Urban,Manipur,Property Crime,Arson,Female,0-12,5929,2620,3309,5423,506
2004,Urban,Gujarat,Other Crimes,Cyber Crime,Female,31-45,8654,5263,3391,8399,255
2009,Rural,Arunachal Pradesh,Other Crimes,Drug Offense,Male,31-45,6830,3832,2998,4375,2455
2002,Rural,Goa,Crime Against Children,Child Labor,Male,46-60,319,0,319,19,300
2003,Rural,Punjab,Property Crime,Burglary,Male,31-45,9669,8690,979,9520,149
2006,Urban,Punjab,Crime Against Women,Dowry Deaths,Female,13-17,4594,2058,2536,3329,1265
2010,Urban,Himachal Pradesh,Property Crime,Arson,Female,13-17,2160,411,1749,877,1283
2008,Urban,Bihar,Crime Against Children,Child Labor,Male,60+,6837,1116,5721,6173,664
2001,Urban,Telangana,Other Crimes,Corruption,Male,0-12,4164,3407,757,3464,700
2007,Urban,Haryana,Property Crime,Theft,Female,31-45,2904,2710,194,2746,158
2005,Urban,Maharashtra,Other Crimes,Fraud,Female,0-12,5291,2378,2913,3523,1768
2002,Rural,Sikkim,Crime Against Children,Child Labor,Female,0-12,4209,1124,3085,3965,244
2004,Rural,Himachal Pradesh,Crime Against Children,Kidnapping,Male,13-17,3875,3177,698,3435,440
2009,Rural,Arunachal Pradesh,Property Crime,Vandalism,Female,46-60,8924,4818,4106,6915,2009
2009,Urban,Bihar,Crime Against Children,Kidnapping,Female,18-30,7531,4658,2873,5835,1696
2006,Rural,Uttarakhand,Crime Against Men,Extortion,Male,46-60,9916,2734,7182,4501,5415
2009,Rural,Mizoram,Other Crimes,Drug Offense,Male,13-17,9973,3705,6268,9127,846
2005,Rural,Madhya Pradesh,Property Crime,Vandalism,Female,0-12,6316,5132,1184,6288,28
2002,Urban,Uttar Pradesh,Crime Against Women,Rape,Male,18-30,4040,1295,2745,1741,2299
2007,Rural,Andhra Pradesh,Other Crimes,Corruption,Female,13-17,158,31,127,132,26
2007,Rural,Telangana,Crime Against Women,Domestic Violence,Male,31-45,4021,376,3645,1533,2488
2002,Urban,Chhattisgarh,Crime Against Men,Robbery,Male,46-60,3051,1202,1849,2055,996
2001,Urban,Chhattisgarh,Property Crime,Vandalism,Male,13-17,7948,4417,3531,5400,2548
2010,Rural,Mizoram,Crime Against Women,Rape,Male,18-30,9997,63,9934,1653,8344
2004,Rural,Meghalaya,Other Crimes,Corruption,Female,18-30,7225,3134,4091,3752,3473
2010,Rural,Nagaland,Crime Against Men,Assault,Male,31-45,3862,2723,1139,2911,951
2007,Rural,Maharashtra,Property Crime,Vandalism,Male,60+,6564,1319,5245,5901,663
2007,Rural,Haryana,Crime Against Children,Trafficking,Female,13-17,9891,9068,823,9456,435
2010,Rural,Nagaland,Crime Against Women,Domestic Violence,Female,60+,9202,3097,6105,5789,3413
2009,Urban,Mizoram,Crime Against Children,Child Abuse,Female,13-17,4958,2965,1993,3702,1256
2005,Urban,Jharkhand,Crime Against Children,Child Abuse,Female,31-45,1394,398,996,659,735
2009,Urban,Tripura,Other Crimes,Fraud,Female,18-30,855,226,629,437,418
2006,Rural,Meghalaya,Property Crime,Theft,Female,0-12,8935,8419,516,8870,65
2010,Urban,Jammu & Kashmir,Crime Against Women,Molestation,Female,46-60,8675,5109,3566,7982,693
2002,Rural,Maharashtra,Property Crime,Theft,Male,18-30,53,39,14,41,12
2002,Urban,West Bengal,Crime Against Women,Domestic Violence,Female,0-12,386,191,195,335,51
2006,Urban,Arunachal Pradesh,Crime Against Women,Domestic Violence,Female,0-12,9348,1219,8129,6558,2790
2008,Rural,Kerala,Crime Against Children,Trafficking,Male,46-60,4603,45,4558,4139,464
2005,Urban,Goa,Other Crimes,Fraud,Female,0-12,9774,6200,3574,9530,244
2007,Rural,Mizoram,Other Crimes,Cyber Crime,Female,31-45,3005,436,2569,856,2149
2006,Rural,Karnataka,Other Crimes,Corruption,Male,60+,7437,3135,4302,7356,81
2010,Rural,Punjab,Crime Against Women,Molestation,Female,0-12,498,309,189,386,112
2008,Urban,Madhya Pradesh,Property Crime,Arson,Male,46-60,1157,1148,9,1156,1
2005,Rural,Chhattisgarh,Crime Against Children,Child Abuse,Male,31-45,4121,880,3241,2680,1441
2003,Urban,Haryana,Other Crimes,Corruption,Female,0-12,7147,1586,5561,3242,3905
2003,Urban,Himachal Pradesh,Property Crime,Theft,Female,60+,1560,720,840,1111,449
2006,Rural,Jharkhand,Other Crimes,Cyber Crime,Male,18-30,97,33,64,89,8
2010,Urban,Jammu & Kashmir,Other Crimes,Cyber Crime,Male,46-60,9908,2289,7619,4141,5767
2009,Rural,Manipur,Crime Against Children,Child Labor,Female,31-45,6441,3013,3428,6066,375
2009,Rural,Haryana,Crime Against Men,Extortion,Female,31-45,6843,6676,167,6784,59
2009,Rural,Bihar,Crime Against Women,Rape,Male,0-12,2454,2242,212,2347,107
2001,Rural,Delhi,Crime Against Men,Murder,Female,46-60,8110,7456,654,7865,245
2003,Rural,Jammu & Kashmir,Crime Against Men,Extortion,Female,13-17,1124,252,872,454,670
2003,Rural,Kerala,Property Crime,Burglary,Female,60+,4138,68,4070,262,3876
2007,Urban,Maharashtra,Crime Against Men,Extortion,Female,13-17,9889,8913,976,9287,602
2010,Urban,Jharkhand,Crime Against Children,Child Labor,Male,0-12,2883,2114,769,2378,505
2007,Rural,Telangana,Crime Against Children,Kidnapping,Male,13-17,5103,1937,3166,4213,890
2010,Rural,Delhi,Other Crimes,Drug Offense,Male,31-45,4410,1519,2891,3900,510
2009,Rural,Andhra Pradesh,Crime Against Men,Assault,Female,31-45,3574,2567,1007,3456,118
2007,Urban,Maharashtra,Crime Against Women,Rape,Female,46-60,1943,1724,219,1797,146
2010,Rural,Arunachal Pradesh,Crime Against Men,Extortion,Female,46-60,67,12,55,62,5
2009,Rural,Mizoram,Crime Against Children,Child Labor,Male,18-30,5697,2631,3066,3721,1976
2006,Urban,Himachal Pradesh,Crime Against Children,Child Labor,Female,31-45,8468,7873,595,7906,562
2004,Rural,Uttar Pradesh,Crime Against Children,Kidnapping,Female,31-45,2832,48,2784,1990,842
2009,Rural,Kerala,Crime Against Men,Robbery,Female,31-45,9066,115,8951,5052,4014
2006,Rural,Punjab,Property Crime,Theft,Male,18-30,9122,4220,4902,6708,2414
2010,Rural,Bihar,Property Crime,Vandalism,Female,60+,257,39,218,99,158
2007,Rural,Tamil Nadu,Property Crime,Burglary,Female,31-45,7183,2994,4189,6175,1008
2003,Urban,Odisha,Other Crimes,Fraud,Female,0-12,3725,3187,538,3616,109
2008,Rural,Goa,Property Crime,Vandalism,Female,0-12,3753,792,2961,2293,1460
2009,Urban,West Bengal,Crime Against Men,Extortion,Male,31-45,4847,955,3892,4707,140
2004,Rural,Maharashtra,Crime Against Women,Molestation,Male,18-30,6404,3814,2590,6313,91
2010,Urban,Madhya Pradesh,Crime Against Children,Child Labor,Female,60+,2595,1148,1447,2042,553
2006,Urban,Telangana,Crime Against Children,Trafficking,Female,31-45,9219,4497,4722,7365,1854
2006,Rural,Odisha,Other Crimes,Fraud,Female,13-17,6719,6128,591,6678,41
2005,Rural,Nagaland,Crime Against Men,Murder,Female,31-45,5030,965,4065,1402,3628
2002,Rural,Bihar,Crime Against Men,Robbery,Female,0-12,2671,1693,978,2060,611
2005,Rural,Mizoram,Other Crimes,Drug Offense,Male,0-12,3966,797,3169,3872,94
2003,Urban,Maharashtra,Crime Against Children,Child Labor,Female,13-17,4921,3514,1407,4292,629
2005,Rural,Telangana,Property Crime,Theft,Male,46-60,8660,3761,4899,5123,3537
2003,Urban,Madhya Pradesh,Property Crime,Vandalism,Male,0-12,3461,805,2656,2633,828
2007,Rural,Tamil Nadu,Property Crime,Burglary,Male,18-30,8611,799,7812,2224,6387
2009,Urban,Kerala,Crime Against Children,Kidnapping,Male,60+,1873,615,1258,1822,51
2008,Rural,Tripura,Crime Against Children,Kidnapping,Female,31-45,3384,3034,350,3379,5
2010,Urban,Telangana,Crime Against Children,Child Labor,Male,0-12,3970,3598,372,3699,271
2002,Urban,Jammu & Kashmir,Property Crime,Burglary,Male,18-30,1429,350,1079,649,780
2004,Rural,Odisha,Crime Against Men,Extortion,Female,46-60,9895,8815,1080,8936,959
2002,Rural,Madhya Pradesh,Other Crimes,Cyber Crime,Female,0-12,3521,672,2849,3450,71
2006,Rural,Jharkhand,Property Crime,Burglary,Male,31-45,9422,7598,1824,8893,529
2006,Rural,Uttar Pradesh,Crime Against Women,Rape,Female,60+,959,639,320,917,42
2009,Urban,Uttar Pradesh,Property Crime,Burglary,Male,13-17,5922,4075,1847,4588,1334
2001,Rural,Chhattisgarh,Property Crime,Theft,Male,13-17,9605,9379,226,9522,83
2001,Rural,Uttarakhand,Crime Against Women,Dowry Deaths,Male,13-17,9907,2024,7883,4571,5336
2008,Rural,Uttar Pradesh,Crime Against Men,Extortion,Female,31-45,7401,4582,2819,6467,934
2005,Urban,Maharashtra,Crime Against Men,Assault,Female,13-17,1484,691,793,1046,438
2008,Urban,Manipur,Property Crime,Theft,Female,31-45,7219,728,6491,4263,2956
2010,Rural,Nagaland,Crime Against Women,Dowry Deaths,Male,13-17,5986,4134,1852,5076,910
2006,Rural,Bihar,Other Crimes,Cyber Crime,Male,31-45,3011,1190,1821,2054,957
2002,Urban,Chhattisgarh,Crime Against Men,Assault,Male,13-17,1984,1945,39,1950,34
2010,Urban,Uttar Pradesh,Crime Against Women,Dowry Deaths,Male,0-12,9051,385,8666,7900,1151
2010,Urban,Nagaland,Property Crime,Arson,Male,0-12,7545,7502,43,7536,9
2008,Rural,West Bengal,Crime Against Children,Trafficking,Female,18-30,3343,2523,820,2990,353
2006,Rural,Odisha,Crime Against Women,Domestic Violence,Male,18-30,3703,2221,1482,3621,82
2004,Rural,Telangana,Crime Against Men,Extortion,Male,18-30,6388,6273,115,6350,38
2008,Rural,Nagaland,Crime Against Children,Trafficking,Male,46-60,1318,1035,283,1275,43
2005,Rural,Karnataka,Crime Against Men,Robbery,Male,18-30,8592,6303,2289,7802,790
2006,Rural,Telangana,Crime Against Women,Domestic Violence,Male,60+,8189,2677,5512,5872,2317
2004,Rural,Maharashtra,Crime Against Men,Assault,Female,46-60,4664,1108,3556,1445,3219
2010,Urban,Jharkhand,Crime Against Children,Trafficking,Female,60+,6990,4440,2550,6152,838
2005,Rural,Gujarat,Crime Against Children,Kidnapping,Female,60+,5865,5470,395,5570,295
2005,Urban,Uttar Pradesh,Other Crimes,Drug Offense,Female,46-60,3912,120,3792,3289,623
2002,Rural,Tamil Nadu,Crime Against Children,Kidnapping,Male,13-17,2311,367,1944,1977,334
2009,Urban,Manipur,Crime Against Women,Domestic Violence,Female,46-60,7359,270,7089,4898,2461
2008,Urban,Mizoram,Crime Against Women,Dowry Deaths,Male,60+,8429,6821,1608,7354,1075
2009,Rural,Bihar,Crime Against Children,Kidnapping,Female,60+,2342,1004,1338,1392,950
2001,Urban,Nagaland,Crime Against Men,Extortion,Female,18-30,4944,3049,1895,4855,89
2007,Rural,Tamil Nadu,Property Crime,Arson,Female,18-30,950,251,699,837,113
2008,Rural,Meghalaya,Property Crime,Vandalism,Male,60+,3517,3399,118,3506,11
2008,Urban,Uttar Pradesh,Crime Against Women,Rape,Male,18-30,1805,657,1148,1423,382
2005,Urban,Gujarat,Crime Against Men,Robbery,Female,31-45,6829,299,6530,3821,3008
2009,Rural,Arunachal Pradesh,Property Crime,Burglary,Female,60+,2548,518,2030,849,1699
2005,Urban,Nagaland,Crime Against Children,Child Abuse,Female,13-17,6963,1678,5285,1846,5117
2003,Urban,Delhi,Crime Against Men,Murder,Male,18-30,3200,2101,1099,2351,849
2007,Rural,West Bengal,Crime Against Women,Rape,Male,31-45,9329,617,8712,9027,302
2003,Rural,Nagaland,Crime Against Men,Assault,Male,60+,5060,1377,3683,1921,3139
2005,Rural,Rajasthan,Crime Against Women,Dowry Deaths,Male,18-30,1279,559,720,775,504
2003,Rural,Andhra Pradesh,Property Crime,Arson,Male,0-12,9165,5582,3583,8918,247
2009,Rural,Kerala,Crime Against Men,Robbery,Male,18-30,1056,755,301,1055,1
2010,Rural,Bihar,Other Crimes,Cyber Crime,Male,18-30,5387,5120,267,5371,16
2002,Urban,Uttarakhand,Property Crime,Arson,Male,0-12,8248,297,7951,6757,1491
2001,Urban,Madhya Pradesh,Other Crimes,Corruption,Male,18-30,4278,2641,1637,2735,1543
2009,Rural,West Bengal,Other Crimes,Drug Offense,Male,60+,7330,1114,6216,4384,2946
2001,Urban,Andhra Pradesh,Crime Against Children,Kidnapping,Female,60+,4665,3962,703,4168,497
2010,Urban,Telangana,Crime Against Women,Domestic Violence,Male,18-30,4294,1376,2918,2203,2091
2009,Rural,Delhi,Property Crime,Burglary,Male,13-17,5819,1853,3966,5291,528
2003,Urban,Bihar,Other Crimes,Corruption,Male,60+,2426,101,2325,1669,757
2006,Rural,Sikkim,Property Crime,Arson,Female,0-12,2355,689,1666,2342,13
2007,Urban,Meghalaya,Crime Against Men,Extortion,Female,13-17,9711,8857,854,9428,283
2010,Rural,Haryana,Crime Against Women,Rape,Male,60+,2762,155,2607,2344,418
2006,Rural,Uttarakhand,Property Crime,Theft,Male,18-30,4278,265,4013,2383,1895
2002,Rural,Gujarat,Other Crimes,Drug Offense,Female,46-60,1487,1095,392,1111,376
2006,Urban,Mizoram,Property Crime,Burglary,Female,60+,4751,4332,419,4538,213
2009,Urban,Kerala,Crime Against Women,Domestic Violence,Female,18-30,2532,443,2089,2227,305
2007,Rural,West Bengal,Crime Against Women,Dowry Deaths,Female,18-30,4492,1704,2788,4007,485
2010,Rural,Telangana,Property Crime,Vandalism,Male,31-45,9134,3867,5267,9059,75
2010,Urban,Haryana,Crime Against Men,Murder,Male,13-17,6347,2885,3462,4580,1767
2006,Rural,Maharashtra,Crime Against Men,Murder,Male,31-45,686,556,130,630,56
2008,Rural,Rajasthan,Other Crimes,Fraud,Male,13-17,8499,3500,4999,4135,4364
2006,Urban,Jharkhand,Other Crimes,Drug Offense,Male,0-12,7139,1583,5556,6073,1066
2006,Rural,Tripura,Other Crimes,Corruption,Female,46-60,6983,2748,4235,2748,4235
2001,Rural,Chhattisgarh,Crime Against Women,Rape,Male,46-60,3497,2819,678,2930,567
2007,Rural,Jharkhand,Other Crimes,Corruption,Female,60+,5019,3493,1526,3550,1469
2007,Rural,Manipur,Crime Against Women,Molestation,Female,0-12,9334,3905,5429,5322,4012
2002,Rural,Andhra Pradesh,Property Crime,Theft,Female,0-12,7818,4427,3391,5958,1860
2002,Rural,Rajasthan,Property Crime,Burglary,Female,13-17,8546,1710,6836,2002,6544
2005,Urban,Haryana,Property Crime,Arson,Female,46-60,9118,7680,1438,8311,807
2005,Rural,Chhattisgarh,Crime Against Women,Domestic Violence,Female,13-17,7056,6170,886,6608,448
2003,Rural,Uttar Pradesh,Other Crimes,Fraud,Female,46-60,6788,6365,423,6376,412
2005,Rural,Karnataka,Crime Against Women,Molestation,Female,0-12,7889,3166,4723,3804,4085
2004,Urban,Goa,Crime Against Men,Murder,Female,46-60,2105,354,1751,444,1661
2007,Rural,Haryana,Crime Against Children,Kidnapping,Male,18-30,5989,2747,3242,3637,2352
2002,Urban,Himachal Pradesh,Crime Against Men,Murder,Female,13-17,6685,4541,2144,5998,687
2004,Urban,Himachal Pradesh,Property Crime,Arson,Female,46-60,8388,369,8019,6346,2042
2002,Rural,Gujarat,Crime Against Women,Molestation,Female,60+,7273,3102,4171,6888,385
2002,Rural,Maharashtra,Crime Against Children,Kidnapping,Female,0-12,5485,4153,1332,4335,1150
2007,Urban,Nagaland,Crime Against Women,Molestation,Female,0-12,7185,880,6305,6032,1153
2009,Rural,Meghalaya,Crime Against Men,Robbery,Female,0-12,7380,3575,3805,7251,129
2007,Rural,Haryana,Crime Against Children,Child Labor,Female,60+,1811,1621,190,1689,122
2001,Rural,Andhra Pradesh,Crime Against Men,Extortion,Female,31-45,4121,935,3186,2925,1196
2003,Urban,Assam,Crime Against Women,Rape,Female,18-30,7655,1487,6168,5382,2273
2001,Urban,Jammu & Kashmir,Crime Against Women,Domestic Violence,Male,13-17,6814,3988,2826,4391,2423
2002,Urban,Jharkhand,Other Crimes,Fraud,Female,46-60,8900,8869,31,8870,30
2009,Rural,Madhya Pradesh,Crime Against Men,Extortion,Female,46-60,8876,7203,1673,8550,326
2010,Urban,Jammu & Kashmir,Other Crimes,Cyber Crime,Female,13-17,9524,4714,4810,8943,581
2009,Rural,Sikkim,Property Crime,Vandalism,Male,13-17,6849,4158,2691,6561,288
2009,Urban,Meghalaya,Property Crime,Theft,Female,0-12,3393,2203,1190,3099,294
2010,Urban,Kerala,Crime Against Men,Robbery,Female,46-60,7193,4675,2518,5763,1430
2006,Rural,Rajasthan,Property Crime,Burglary,Female,60+,7129,6900,229,6962,167
2001,Rural,Assam,Property Crime,Vandalism,Female,18-30,3622,706,2916,1864,1758
2004,Urban,Jharkhand,Property Crime,Vandalism,Male,46-60,7421,2522,4899,4921,2500
2001,Urban,Gujarat,Crime Against Children,Kidnapping,Male,13-17,9106,1197,7909,8195,911
2002,Rural,Mizoram,Property Crime,Theft,Female,13-17,3752,2349,1403,2732,1020
2010,Urban,Kerala,Other Crimes,Cyber Crime,Male,0-12,8445,6359,2086,6377,2068
2004,Rural,Tripura,Property Crime,Vandalism,Male,60+,2194,400,1794,1080,1114
2008,Urban,Punjab,Crime Against Men,Murder,Male,0-12,7558,3743,3815,6661,897
2009,Urban,Uttar Pradesh,Crime Against Children,Child Abuse,Male,18-30,7493,1563,5930,2142,5351
2003,Rural,Delhi,Property Crime,Theft,Male,60+,9362,5217,4145,7573,1789
2001,Rural,Chhattisgarh,Crime Against Men,Assault,Male,13-17,4330,2851,1479,3022,1308
2003,Rural,Karnataka,Crime Against Women,Domestic Violence,Male,0-12,7071,6300,771,6400,671
2005,Urban,Odisha,Property Crime,Arson,Male,13-17,7237,5519,1718,6538,699
2009,Rural,Gujarat,Crime Against Women,Dowry Deaths,Female,46-60,7602,132,7470,4248,3354
2009,Urban,Assam,Crime Against Children,Child Abuse,Male,18-30,7824,4381,3443,6622,1202
2007,Urban,West Bengal,Crime Against Men,Murder,Male,0-12,827,624,203,642,185
2006,Rural,Delhi,Property Crime,Burglary,Female,0-12,4253,2566,1687,2788,1465
2010,Urban,Haryana,Crime Against Men,Murder,Female,18-30,7912,7490,422,7887,25
2008,Urban,Maharashtra,Property Crime,Vandalism,Male,13-17,2624,1899,725,2243,381
2009,Rural,Kerala,Crime Against Men,Robbery,Female,0-12,725,575,150,699,26
2005,Urban,Telangana,Crime Against Children,Trafficking,Male,60+,6355,1658,4697,5370,985
2010,Urban,Uttarakhand,Crime Against Children,Trafficking,Male,13-17,3500,1082,2418,2510,990
2004,Rural,Haryana,Crime Against Men,Assault,Female,18-30,1935,1255,680,1558,377
2001,Urban,Nagaland,Crime Against Women,Dowry Deaths,Male,31-45,5929,417,5512,5627,302
2004,Urban,Nagaland,Crime Against Women,Domestic Violence,Male,46-60,4794,3515,1279,4756,38
2005,Urban,Bihar,Crime Against Children,Trafficking,Female,46-60,5893,5009,884,5892,1
2006,Rural,Mizoram,Other Crimes,Fraud,Female,46-60,5437,15,5422,5435,2
2004,Rural,Tripura,Crime Against Women,Dowry Deaths,Male,60+,7899,3247,4652,3484,4415
2003,Urban,Mizoram,Other Crimes,Fraud,Male,18-30,8772,7449,1323,7746,1026
2009,Urban,Karnataka,Crime Against Children,Kidnapping,Male,18-30,916,532,384,804,112
2005,Rural,Karnataka,Crime Against Men,Extortion,Female,31-45,8710,2255,6455,7557,1153
2010,Urban,Maharashtra,Crime Against Men,Robbery,Male,46-60,94,80,14,84,10
2004,Urban,Tamil Nadu,Crime Against Women,Dowry Deaths,Male,18-30,6104,1933,4171,4872,1232
2007,Rural,Nagaland,Property Crime,Vandalism,Female,0-12,7885,7112,773,7476,409
2010,Urban,Odisha,Crime Against Women,Domestic Violence,Male,60+,2035,1276,759,1839,196
2009,Rural,Andhra Pradesh,Other Crimes,Cyber Crime,Female,18-30,3250,284,2966,2995,255
2010,Rural,Andhra Pradesh,Crime Against Children,Kidnapping,Male,0-12,64,57,7,60,4
2002,Rural,West Bengal,Other Crimes,Fraud,Female,13-17,2792,401,2391,2091,701
2002,Rural,Kerala,Crime Against Women,Dowry Deaths,Female,0-12,5490,4320,1170,4566,924
2007,Urban,Andhra Pradesh,Other Crimes,Cyber Crime,Male,31-45,7964,1307,6657,2312,5652
2010,Rural,Andhra Pradesh,Crime Against Children,Trafficking,Female,13-17,953,695,258,699,254
2010,Urban,Haryana,Property Crime,Arson,Male,60+,1593,1537,56,1561,32
2004,Urban,Tripura,Crime Against Women,Dowry Deaths,Female,13-17,8536,1071,7465,5776,2760
2010,Rural,Kerala,Property Crime,Arson,Female,0-12,6209,1345,4864,5752,457
2001,Rural,Meghalaya,Crime Against Children,Kidnapping,Male,31-45,3150,344,2806,753,2397
2004,Urban,Meghalaya,Crime Against Children,Kidnapping,Male,31-45,7784,1568,6216,4631,3153
2009,Rural,West Bengal,Property Crime,Theft,Female,60+,9837,7284,2553,9400,437
2003,Rural,West Bengal,Property Crime,Theft,Male,31-45,1050,804,246,989,61
2009,Urban,Arunachal Pradesh,Crime Against Children,Child Labor,Male,13-17,2005,51,1954,525,1480
2004,Rural,Andhra Pradesh,Property Crime,Arson,Female,0-12,1490,932,558,1336,154
2003,Rural,Punjab,Property Crime,Theft,Male,31-45,3626,2342,1284,3128,498
2005,Rural,Mizoram,Crime Against Women,Rape,Male,13-17,7499,4139,3360,6478,1021
2010,Urban,Tamil Nadu,Crime Against Women,Domestic Violence,Female,18-30,3697,639,3058,924,2773
2007,Urban,Kerala,Crime Against Women,Domestic Violence,Male,13-17,6945,6371,574,6489,456
2010,Rural,Odisha,Other Crimes,Cyber Crime,Male,46-60,1835,566,1269,1602,233
2006,Urban,Andhra Pradesh,Crime Against Children,Child Labor,Female,31-45,2825,930,1895,1838,987
2009,Rural,Mizoram,Property Crime,Vandalism,Male,0-12,679,238,441,311,368
2007,Rural,Goa,Property Crime,Burglary,Male,13-17,3439,3209,230,3218,221
2006,Rural,Goa,Crime Against Men,Extortion,Female,31-45,8580,6634,1946,7791,789
2001,Rural,Jammu & Kashmir,Crime Against Women,Rape,Male,60+,1478,450,1028,585,893
2010,Urban,Assam,Crime Against Children,Child Labor,Female,31-45,4223,3128,1095,3605,618
2006,Urban,Delhi,Crime Against Women,Domestic Violence,Male,60+,852,540,312,544,308
2005,Urban,Punjab,Other Crimes,Corruption,Female,46-60,8120,3322,4798,7738,382
2009,Urban,Jammu & Kashmir,Crime Against Women,Dowry Deaths,Female,31-45,3955,2773,1182,3329,626
2002,Urban,Madhya Pradesh,Crime Against Men,Extortion,Female,31-45,6871,357,6514,3544,3327
2007,Urban,Punjab,Property Crime,Burglary,Male,0-12,3460,2662,798,3401,59
2007,Rural,Jharkhand,Crime Against Men,Robbery,Female,31-45,95,36,59,41,54
2010,Urban,Jammu & Kashmir,Other Crimes,Drug Offense,Female,18-30,3481,2413,1068,3245,236
2009,Rural,Odisha,Property Crime,Arson,Female,60+,2401,1196,1205,1923,478
2005,Urban,Arunachal Pradesh,Crime Against Women,Dowry Deaths,Male,13-17,1589,178,1411,1404,185
2005,Urban,Odisha,Property Crime,Theft,Female,60+,5063,2610,2453,5009,54
2009,Rural,Bihar,Other Crimes,Drug Offense,Male,46-60,9399,1992,7407,9398,1
2008,Urban,Bihar,Other Crimes,Corruption,Male,13-17,5593,5270,323,5327,266
2005,Urban,Andhra Pradesh,Property Crime,Theft,Male,31-45,9815,9647,168,9680,135
2010,Rural,Uttarakhand,Other Crimes,Cyber Crime,Female,60+,9795,429,9366,8416,1379
2001,Rural,Karnataka,Crime Against Women,Dowry Deaths,Female,0-12,7561,4829,2732,4897,2664
2002,Urban,Bihar,Crime Against Children,Child Labor,Male,18-30,7262,2085,5177,4912,2350
2007,Rural,Madhya Pradesh,Crime Against Children,Kidnapping,Male,0-12,6199,6119,80,6128,71
2001,Rural,Tripura,Crime Against Men,Robbery,Male,0-12,5271,2938,2333,5106,165
2007,Rural,Himachal Pradesh,Crime Against Women,Rape,Female,18-30,1668,1488,180,1661,7
2005,Urban,Odisha,Other Crimes,Drug Offense,Female,18-30,2997,535,2462,1479,1518
2002,Rural,Madhya Pradesh,Property Crime,Burglary,Male,60+,4111,2239,1872,3582,529
2004,Urban,Odisha,Crime Against Men,Extortion,Male,0-12,5823,3605,2218,3712,2111
2002,Rural,Karnataka,Crime Against Women,Dowry Deaths,Female,31-45,3553,1022,2531,1442,2111
2004,Rural,Telangana,Property Crime,Theft,Female,31-45,5211,551,4660,3184,2027
2006,Rural,Odisha,Crime Against Men,Robbery,Male,46-60,3277,350,2927,447,2830
2010,Urban,Arunachal Pradesh,Crime Against Women,Rape,Female,31-45,1794,325,1469,1293,501
2002,Rural,Kerala,Other Crimes,Corruption,Female,13-17,918,143,775,494,424
2003,Urban,Uttarakhand,Crime Against Women,Rape,Male,60+,1246,884,362,1102,144
2006,Urban,Haryana,Crime Against Women,Molestation,Female,18-30,6633,2091,4542,2483,4150
2005,Rural,Assam,Crime Against Men,Extortion,Male,18-30,8071,4153,3918,5075,2996
2010,Urban,Chhattisgarh,Crime Against Women,Domestic Violence,Female,13-17,5854,5369,485,5383,471
2004,Rural,Bihar,Other Crimes,Cyber Crime,Male,60+,2890,1784,1106,2542,348
2005,Urban,Odisha,Property Crime,Theft,Female,31-45,1479,740,739,751,728
2010,Rural,Tamil Nadu,Crime Against Men,Assault,Female,31-45,569,318,251,386,183
2010,Rural,Delhi,Other Crimes,Corruption,Male,60+,1265,991,274,1014,251
2006,Rural,Telangana,Other Crimes,Drug Offense,Female,46-60,2423,2298,125,2423,0
2003,Rural,Bihar,Property Crime,Vandalism,Female,18-30,2206,1026,1180,1959,247
2009,Urban,Punjab,Other Crimes,Cyber Crime,Female,31-45,5936,3757,2179,3768,2168
2004,Rural,Kerala,Crime Against Women,Domestic Violence,Female,0-12,3909,2105,1804,2497,1412
2002,Rural,Madhya Pradesh,Crime Against Men,Assault,Male,13-17,9198,2158,7040,2768,6430
2007,Rural,Himachal Pradesh,Other Crimes,Corruption,Male,31-45,2636,822,1814,1518,1118
2002,Urban,Haryana,Other Crimes,Cyber Crime,Male,46-60,1049,786,263,976,73
2004,Rural,Bihar,Crime Against Men,Robbery,Female,13-17,4297,3794,503,4161,136
2009,Rural,Meghalaya,Crime Against Men,Murder,Male,13-17,5661,2416,3245,2858,2803
2006,Urban,Punjab,Other Crimes,Drug Offense,Male,46-60,6352,1143,5209,4023,2329
2003,Urban,Odisha,Crime Against Women,Dowry Deaths,Female,60+,854,791,63,792,62
2004,Rural,Madhya Pradesh,Crime Against Men,Murder,Male,46-60,493,58,435,208,285
2006,Urban,Nagaland,Other Crimes,Fraud,Male,46-60,70,6,64,28,42
2001,Urban,Gujarat,Crime Against Men,Robbery,Female,31-45,2641,2086,555,2268,373
2006,Urban,West Bengal,Crime Against Children,Kidnapping,Female,60+,6160,918,5242,2355,3805
2001,Rural,Nagaland,Crime Against Children,Child Labor,Female,60+,4034,1417,2617,3935,99
2001,Rural,Arunachal Pradesh,Crime Against Children,Child Abuse,Female,13-17,7327,3144,4183,4876,2451
2004,Urban,Uttar Pradesh,Crime Against Women,Molestation,Female,13-17,7630,1752,5878,4468,3162
2006,Urban,Sikkim,Crime Against Men,Extortion,Female,0-12,4243,3063,1180,4019,224
2008,Urban,Gujarat,Crime Against Men,Extortion,Female,13-17,534,529,5,534,0
2010,Rural,Gujarat,Other Crimes,Corruption,Female,18-30,948,920,28,943,5
2005,Rural,Assam,Property Crime,Arson,Female,31-45,2826,1701,1125,1946,880
2007,Rural,Madhya Pradesh,Crime Against Women,Dowry Deaths,Female,18-30,1529,1273,256,1280,249
2002,Rural,Rajasthan,Crime Against Women,Dowry Deaths,Female,60+,6213,3929,2284,4809,1404
2009,Rural,Tripura,Property Crime,Theft,Female,0-12,7478,3299,4179,4981,2497
2004,Rural,Arunachal Pradesh,Property Crime,Theft,Male,18-30,2273,1882,391,2179,94
2010,Urban,Uttarakhand,Crime Against Men,Extortion,Male,18-30,8360,4320,4040,6999,1361
2006,Rural,Tripura,Crime Against Children,Child Labor,Male,31-45,8931,3944,4987,4601,4330
2010,Urban,Manipur,Crime Against Women,Molestation,Male,31-45,9617,6484,3133,8438,1179
2001,Rural,Meghalaya,Crime Against Women,Domestic Violence,Male,46-60,3743,2,3741,3054,689
2009,Urban,Manipur,Other Crimes,Cyber Crime,Male,13-17,2988,1386,1602,1618,1370
2001,Urban,Jharkhand,Crime Against Children,Child Abuse,Female,18-30,3337,930,2407,3330,7
2001,Urban,Goa,Crime Against Women,Dowry Deaths,Male,0-12,2174,1225,949,1652,522
2009,Urban,Manipur,Other Crimes,Fraud,Male,18-30,3617,2019,1598,3614,3
2006,Rural,Tamil Nadu,Property Crime,Theft,Female,60+,6612,1745,4867,4050,2562
2005,Urban,Himachal Pradesh,Crime Against Children,Child Abuse,Female,46-60,7743,552,7191,5540,2203
2008,Urban,Assam,Crime Against Men,Robbery,Male,60+,5402,810,4592,3812,1590
2002,Rural,Rajasthan,Crime Against Men,Robbery,Male,31-45,2137,889,1248,2023,114
2008,Urban,Jharkhand,Crime Against Women,Domestic Violence,Male,0-12,79,23,56,42,37
2009,Urban,Kerala,Other Crimes,Corruption,Female,60+,8612,3557,5055,7156,1456
2008,Urban,Jharkhand,Crime Against Women,Domestic Violence,Female,0-12,4615,1373,3242,3425,1190
2008,Urban,Delhi,Property Crime,Burglary,Male,18-30,5060,612,4448,2023,3037
2002,Urban,Tamil Nadu,Crime Against Children,Trafficking,Male,31-45,2908,130,2778,1352,1556
2004,Rural,Meghalaya,Crime Against Children,Child Labor,Male,18-30,1317,406,911,916,401
2002,Urban,Jharkhand,Crime Against Women,Molestation,Male,46-60,6111,1186,4925,2846,3265
2008,Urban,Delhi,Property Crime,Theft,Male,60+,1105,1045,60,1053,52
2004,Urban,Telangana,Property Crime,Arson,Male,18-30,8329,7425,904,7666,663
2008,Rural,Punjab,Crime Against Men,Robbery,Female,60+,4684,617,4067,1085,3599
2008,Rural,Rajasthan,Crime Against Children,Child Labor,Male,46-60,3944,518,3426,2281,1663
2005,Urban,Himachal Pradesh,Crime Against Children,Child Abuse,Female,46-60,7684,6818,866,7673,11
2005,Rural,Uttar Pradesh,Crime Against Men,Murder,Male,18-30,703,631,72,657,46
2010,Urban,Mizoram,Crime Against Children,Child Abuse,Male,31-45,7454,5509,1945,5803,1651
2010,Urban,Madhya Pradesh,Crime Against Children,Trafficking,Female,46-60,8215,5431,2784,7225,990
2007,Rural,Goa,Crime Against Men,Murder,Female,18-30,1133,1038,95,1054,79
2002,Rural,Uttarakhand,Crime Against Women,Domestic Violence,Female,13-17,5751,3857,1894,4879,872
2003,Urban,Telangana,Crime Against Children,Child Abuse,Female,13-17,2026,204,1822,1709,317
2002,Urban,Chhattisgarh,Other Crimes,Fraud,Male,46-60,1998,1161,837,1381,617
2004,Rural,Haryana,Property Crime,Theft,Male,13-17,3900,1229,2671,2972,928
2006,Rural,Bihar,Crime Against Men,Extortion,Male,31-45,5324,3866,1458,5020,304
2004,Rural,Delhi,Other Crimes,Drug Offense,Female,13-17,957,392,565,570,387
2009,Urban,Andhra Pradesh,Crime Against Men,Murder,Male,46-60,1615,139,1476,150,1465
2002,Urban,Jammu & Kashmir,Property Crime,Arson,Male,0-12,5023,328,4695,1632,3391
2009,Urban,Tripura,Crime Against Children,Trafficking,Male,18-30,9842,2487,7355,6408,3434
2008,Urban,Madhya Pradesh,Property Crime,Vandalism,Male,31-45,9448,4518,4930,6447,3001
2005,Urban,Delhi,Crime Against Children,Child Labor,Female,60+,6067,1553,4514,4781,1286
2003,Urban,Kerala,Other Crimes,Drug Offense,Male,13-17,1208,215,993,810,398
2010,Rural,Arunachal Pradesh,Crime Against Women,Domestic Violence,Male,18-30,2441,579,1862,1877,564
2010,Urban,Nagaland,Other Crimes,Drug Offense,Female,18-30,6036,51,5985,4598,1438
2009,Rural,Sikkim,Property Crime,Theft,Female,0-12,5826,600,5226,5706,120
2003,Urban,Assam,Crime Against Men,Murder,Female,18-30,6568,5076,1492,6249,319
2006,Rural,Karnataka,Crime Against Women,Dowry Deaths,Male,13-17,5160,386,4774,3910,1250
2005,Urban,Gujarat,Crime Against Women,Rape,Male,31-45,628,159,469,219,409
2009,Urban,Madhya Pradesh,Other Crimes,Cyber Crime,Female,0-12,927,836,91,884,43
2005,Urban,Kerala,Other Crimes,Corruption,Female,31-45,6067,5712,355,5857,210
2002,Urban,Bihar,Other Crimes,Corruption,Male,13-17,8545,7462,1083,8292,253
2008,Rural,Tamil Nadu,Other Crimes,Cyber Crime,Female,13-17,3572,51,3521,2238,1334
2009,Urban,West Bengal,Property Crime,Arson,Male,18-30,6557,2763,3794,3462,3095
2003,Rural,Gujarat,Crime Against Women,Dowry Deaths,Female,0-12,4945,2545,2400,3150,1795
2008,Rural,West Bengal,Other Crimes,Fraud,Male,18-30,8074,4750,3324,8058,16
2006,Urban,Sikkim,Other Crimes,Cyber Crime,Female,60+,6153,3883,2270,4580,1573
2003,Urban,Manipur,Other Crimes,Cyber Crime,Male,13-17,8960,4465,4495,6871,2089
2008,Urban,Goa,Other Crimes,Drug Offense,Male,0-12,7893,7303,590,7807,86
2006,Urban,Manipur,Property Crime,Vandalism,Female,31-45,7335,5693,1642,6385,950
2009,Urban,Goa,Crime Against Women,Dowry Deaths,Female,18-30,4343,1497,2846,3885,458
2006,Urban,Jharkhand,Other Crimes,Corruption,Male,0-12,5002,3315,1687,4650,352
2002,Urban,Himachal Pradesh,Crime Against Children,Kidnapping,Male,18-30,145,64,81,80,65
2005,Urban,Arunachal Pradesh,Property Crime,Burglary,Female,13-17,5398,1753,3645,2520,2878
2007,Rural,Telangana,Other Crimes,Fraud,Male,13-17,7246,2603,4643,6840,406
2010,Urban,Maharashtra,Crime Against Children,Child Labor,Male,46-60,5768,3977,1791,4460,1308
2006,Urban,Odisha,Crime Against Children,Kidnapping,Female,0-12,1902,1732,170,1782,120
2004,Urban,Sikkim,Other Crimes,Fraud,Female,0-12,277,221,56,270,7
2009,Urban,Goa,Crime Against Children,Kidnapping,Female,31-45,9058,6454,2604,7638,1420
2004,Urban,Karnataka,Crime Against Men,Robbery,Female,46-60,968,932,36,965,3
2009,Rural,Sikkim,Property Crime,Theft,Male,31-45,2098,1028,1070,1319,779
2002,Urban,Haryana,Crime Against Men,Assault,Female,31-45,3121,2305,816,2475,646
2005,Urban,Rajasthan,Crime Against Children,Child Abuse,Female,60+,110,11,99,91,19
2006,Urban,Madhya Pradesh,Crime Against Men,Robbery,Female,13-17,8954,5718,3236,8668,286
2009,Rural,Jammu & Kashmir,Crime Against Men,Murder,Male,31-45,4171,596,3575,652,3519
2005,Urban,West Bengal,Crime Against Children,Child Abuse,Female,18-30,8310,478,7832,8291,19
2001,Urban,Uttar Pradesh,Other Crimes,Cyber Crime,Male,13-17,9576,7929,1647,7980,1596
2002,Rural,Kerala,Crime Against Women,Dowry Deaths,Female,18-30,7123,3661,3462,3804,3319
2007,Rural,Tripura,Other Crimes,Fraud,Male,60+,2870,473,2397,715,2155
2010,Urban,Uttar Pradesh,Crime Against Children,Trafficking,Male,13-17,7817,1401,6416,6384,1433
2007,Rural,Uttar Pradesh,Crime Against Men,Assault,Male,60+,3560,2369,1191,2817,743
2001,Urban,Nagaland,Crime Against Children,Trafficking,Male,0-12,5252,2946,2306,5152,100
2001,Urban,Delhi,Property Crime,Burglary,Male,18-30,1003,948,55,951,52
2007,Rural,Meghalaya,Crime Against Women,Molestation,Male,31-45,2018,1018,1000,1883,135
2004,Rural,Himachal Pradesh,Property Crime,Burglary,Female,60+,1590,888,702,1053,537
2003,Rural,Jharkhand,Crime Against Men,Murder,Male,18-30,8701,2391,6310,5554,3147
2003,Urban,Chhattisgarh,Other Crimes,Cyber Crime,Male,18-30,5337,5096,241,5247,90
2005,Urban,Gujarat,Crime Against Men,Robbery,Female,18-30,3534,2631,903,2762,772
2008,Rural,Gujarat,Crime Against Men,Robbery,Female,60+,5708,2590,3118,3432,2276
2002,Rural,West Bengal,Property Crime,Burglary,Female,31-45,3605,859,2746,1158,2447
2007,Urban,Nagaland,Crime Against Women,Rape,Female,13-17,5273,5192,81,5231,42
2003,Urban,Andhra Pradesh,Other Crimes,Drug Offense,Female,46-60,891,87,804,189,702
2010,Urban,Meghalaya,Property Crime,Vandalism,Male,60+,5194,2259,2935,3714,1480
2001,Rural,Punjab,Crime Against Men,Murder,Female,18-30,6353,3533,2820,5299,1054
2008,Urban,Telangana,Other Crimes,Corruption,Female,0-12,6199,2121,4078,3928,2271
2009,Urban,Uttar Pradesh,Other Crimes,Corruption,Male,13-17,6363,6190,173,6215,148
2010,Urban,Sikkim,Crime Against Women,Dowry Deaths,Male,13-17,3430,454,2976,3355,75
2007,Urban,Haryana,Other Crimes,Drug Offense,Male,60+,7270,1563,5707,2977,4293
2010,Urban,Uttarakhand,Property Crime,Vandalism,Male,60+,1969,1555,414,1873,96
2008,Urban,Delhi,Property Crime,Vandalism,Female,0-12,9050,4802,4248,8151,899
2005,Rural,Gujarat,Crime Against Men,Extortion,Female,60+,3932,886,3046,2080,1852
2005,Urban,Andhra Pradesh,Crime Against Children,Child Labor,Male,46-60,1746,73,1673,1292,454
2007,Rural,Nagaland,Other Crimes,Drug Offense,Male,0-12,6037,5880,157,5989,48
2003,Urban,Himachal Pradesh,Property Crime,Vandalism,Male,0-12,4546,1284,3262,4415,131
2005,Rural,Punjab,Property Crime,Vandalism,Male,0-12,6319,4767,1552,5295,1024
2007,Urban,Himachal Pradesh,Crime Against Children,Child Labor,Female,46-60,457,201,256,238,219
2006,Rural,West Bengal,Other Crimes,Corruption,Female,31-45,6507,5313,1194,5667,840
2010,Rural,Maharashtra,Other Crimes,Corruption,Female,13-17,2160,2043,117,2065,95
2005,Urban,Telangana,Other Crimes,Cyber Crime,Female,18-30,6987,5034,1953,6764,223
2003,Rural,Assam,Property Crime,Vandalism,Female,0-12,5634,4194,1440,5624,10
2001,Rural,Tamil Nadu,Crime Against Men,Murder,Female,46-60,2852,240,2612,965,1887
2006,Urban,Gujarat,Property Crime,Arson,Male,18-30,5099,776,4323,3090,2009
2006,Urban,Kerala,Property Crime,Vandalism,Male,18-30,8633,2634,5999,5747,2886
2003,Rural,Gujarat,Crime Against Women,Rape,Female,46-60,8933,6450,2483,8478,455
2009,Urban,Karnataka,Crime Against Women,Rape,Female,46-60,1170,259,911,484,686
2007,Rural,Karnataka,Crime Against Women,Domestic Violence,Female,0-12,6273,2356,3917,4521,1752
2003,Rural,Maharashtra,Crime Against Children,Child Abuse,Male,13-17,5248,894,4354,4901,347
2003,Rural,Jammu & Kashmir,Crime Against Women,Dowry Deaths,Female,0-12,5222,3379,1843,3803,1419
2002,Rural,Bihar,Crime Against Women,Dowry Deaths,Male,46-60,3945,1001,2944,3175,770
2009,Urban,Kerala,Property Crime,Arson,Male,60+,1227,718,509,881,346
2002,Urban,Kerala,Crime Against Men,Robbery,Male,0-12,525,121,404,244,281
2010,Urban,Jammu & Kashmir,Other Crimes,Fraud,Male,31-45,5464,629,4835,701,4763
2004,Urban,Telangana,Crime Against Men,Robbery,Female,31-45,2536,1816,720,2107,429
2004,Rural,Tamil Nadu,Crime Against Men,Extortion,Female,0-12,4999,3148,1851,4655,344
2009,Urban,Chhattisgarh,Crime Against Women,Molestation,Male,46-60,9862,8446,1416,9278,584
2004,Urban,Arunachal Pradesh,Property Crime,Vandalism,Female,31-45,9195,7380,1815,7535,1660
2009,Rural,Goa,Crime Against Children,Kidnapping,Female,46-60,5427,4286,1141,5323,104
2003,Urban,Tamil Nadu,Other Crimes,Cyber Crime,Female,18-30,8249,5307,2942,5836,2413
2004,Urban,Rajasthan,Property Crime,Theft,Male,13-17,5496,1570,3926,3449,2047
2005,Rural,Rajasthan,Crime Against Men,Assault,Male,13-17,6093,3211,2882,3993,2100
2004,Urban,Mizoram,Other Crimes,Cyber Crime,Male,31-45,795,294,501,358,437
2005,Rural,Haryana,Crime Against Men,Extortion,Male,13-17,6975,1693,5282,6579,396
2007,Urban,Uttar Pradesh,Crime Against Children,Kidnapping,Female,0-12,3049,2506,543,2551,498
2007,Urban,Kerala,Crime Against Children,Kidnapping,Female,46-60,696,394,302,539,157
2008,Urban,Telangana,Crime Against Women,Domestic Violence,Male,60+,8996,4761,4235,7034,1962
2010,Rural,Uttarakhand,Crime Against Women,Molestation,Male,60+,9898,1639,8259,2246,7652
2008,Urban,Andhra Pradesh,Other Crimes,Fraud,Male,31-45,168,0,168,139,29
2009,Urban,Delhi,Crime Against Children,Kidnapping,Female,0-12,5518,5482,36,5515,3
2003,Rural,Haryana,Crime Against Women,Dowry Deaths,Male,13-17,3599,1068,2531,1194,2405
2008,Urban,Odisha,Other Crimes,Drug Offense,Female,18-30,1029,599,430,822,207
2001,Rural,Karnataka,Other Crimes,Corruption,Male,60+,2031,1211,820,1809,222
2004,Urban,Mizoram,Other Crimes,Corruption,Male,13-17,750,426,324,488,262
2001,Rural,Haryana,Crime Against Men,Murder,Female,0-12,5739,2368,3371,3798,1941
2009,Rural,Haryana,Crime Against Children,Trafficking,Male,0-12,5892,5159,733,5354,538
2003,Rural,Goa,Crime Against Women,Molestation,Female,13-17,4014,3438,576,3623,391
2007,Rural,Bihar,Property Crime,Theft,Female,46-60,2825,1081,1744,1394,1431
2008,Rural,Meghalaya,Crime Against Men,Murder,Female,46-60,5885,1754,4131,2571,3314
2009,Urban,Rajasthan,Property Crime,Theft,Female,0-12,409,280,129,340,69
2001,Rural,Arunachal Pradesh,Crime Against Men,Murder,Female,46-60,3033,2844,189,2851,182
2004,Urban,Haryana,Crime Against Children,Child Labor,Female,0-12,7430,3460,3970,6576,854
2003,Rural,Himachal Pradesh,Crime Against Women,Dowry Deaths,Female,46-60,4160,3507,653,4131,29
2007,Urban,Arunachal Pradesh,Crime Against Children,Kidnapping,Female,13-17,8926,2149,6777,2322,6604
2005,Rural,Karnataka,Crime Against Men,Extortion,Male,46-60,8439,5822,2617,7151,1288
2001,Rural,Gujarat,Crime Against Men,Murder,Female,13-17,2392,626,1766,2277,115
2003,Urban,Goa,Crime Against Women,Molestation,Female,18-30,4378,783,3595,1261,3117
2009,Rural,Tamil Nadu,Crime Against Men,Assault,Female,31-45,9781,833,8948,4876,4905
2006,Urban,Tamil Nadu,Crime Against Women,Domestic Violence,Female,0-12,1082,145,937,420,662
2006,Rural,Tamil Nadu,Other Crimes,Fraud,Female,18-30,2286,1549,737,2241,45
2007,Urban,Maharashtra,Crime Against Children,Kidnapping,Male,18-30,6766,3055,3711,6561,205
2005,Rural,Uttarakhand,Crime Against Women,Rape,Female,31-45,7246,5802,1444,7146,100
2008,Urban,Haryana,Crime Against Children,Trafficking,Male,13-17,5922,1769,4153,2872,3050
2007,Urban,Punjab,Crime Against Men,Robbery,Female,60+,9596,2324,7272,3058,6538
2004,Rural,Kerala,Property Crime,Arson,Female,18-30,9401,3052,6349,5543,3858
2004,Rural,Himachal Pradesh,Crime Against Men,Extortion,Female,31-45,6140,3740,2400,4241,1899
2001,Rural,Jammu & Kashmir,Crime Against Children,Trafficking,Female,31-45,8455,6907,1548,7774,681
2003,Urban,Tripura,Crime Against Women,Molestation,Male,0-12,3661,1427,2234,3500,161
2004,Rural,Arunachal Pradesh,Crime Against Children,Child Abuse,Male,13-17,1254,756,498,963,291
2003,Urban,Karnataka,Property Crime,Theft,Female,18-30,3448,1685,1763,2739,709
2008,Rural,Meghalaya,Crime Against Men,Assault,Female,60+,3881,3149,732,3168,713
2004,Rural,Arunachal Pradesh,Crime Against Men,Murder,Male,13-17,2236,1068,1168,1836,400
2004,Urban,Jharkhand,Crime Against Men,Murder,Male,18-30,4587,1990,2597,4023,564
2004,Urban,Maharashtra,Crime Against Children,Child Labor,Male,46-60,7100,2890,4210,4286,2814
2003,Rural,Jharkhand,Property Crime,Burglary,Male,13-17,6194,5132,1062,5805,389
2004,Rural,Arunachal Pradesh,Crime Against Women,Domestic Violence,Female,60+,6369,2848,3521,5678,691
2009,Urban,Gujarat,Property Crime,Theft,Male,13-17,316,18,298,275,41
2008,Rural,Rajasthan,Crime Against Children,Kidnapping,Female,0-12,7533,7226,307,7341,192
2006,Urban,Odisha,Other Crimes,Cyber Crime,Female,18-30,440,349,91,411,29
2005,Rural,Bihar,Crime Against Children,Trafficking,Male,46-60,1513,612,901,646,867
2006,Rural,Arunachal Pradesh,Crime Against Children,Trafficking,Male,0-12,1962,870,1092,1530,432
2003,Urban,Maharashtra,Crime Against Men,Murder,Male,46-60,5196,2083,3113,4906,290
2004,Urban,Telangana,Crime Against Children,Kidnapping,Female,31-45,9203,7636,1567,7746,1457
2003,Rural,Jammu & Kashmir,Crime Against Women,Rape,Male,18-30,3632,7,3625,3475,157
2004,Urban,Kerala,Property Crime,Vandalism,Female,18-30,1921,883,1038,1543,378
2001,Rural,Sikkim,Other Crimes,Drug Offense,Male,60+,581,293,288,521,60
2002,Rural,Madhya Pradesh,Crime Against Men,Assault,Female,60+,480,386,94,426,54
2001,Urban,Odisha,Crime Against Children,Child Abuse,Male,0-12,9144,6976,2168,9026,118
2002,Rural,Jammu & Kashmir,Other Crimes,Corruption,Female,31-45,6460,64,6396,1999,4461
2003,Rural,Delhi,Property Crime,Arson,Male,13-17,355,354,1,355,0
2010,Urban,Chhattisgarh,Property Crime,Theft,Male,46-60,8221,3090,5131,7175,1046
2001,Rural,Jharkhand,Crime Against Men,Extortion,Female,13-17,1563,558,1005,1462,101
2005,Urban,Gujarat,Crime Against Men,Assault,Female,60+,7477,4220,3257,5108,2369
2009,Rural,Rajasthan,Crime Against Women,Domestic Violence,Female,46-60,8850,5399,3451,5564,3286
2006,Rural,Uttar Pradesh,Crime Against Men,Assault,Female,0-12,891,166,725,839,52
2009,Rural,Assam,Crime Against Children,Child Abuse,Male,31-45,6895,5150,1745,5429,1466
2001,Urban,Maharashtra,Other Crimes,Drug Offense,Male,0-12,4214,2720,1494,3696,518
2008,Urban,Bihar,Crime Against Women,Molestation,Male,60+,210,208,2,209,1
2001,Rural,Tamil Nadu,Crime Against Women,Dowry Deaths,Female,60+,9444,3944,5500,4768,4676
2001,Urban,Gujarat,Crime Against Women,Rape,Female,0-12,5787,2227,3560,4297,1490
2002,Rural,Goa,Crime Against Children,Trafficking,Male,13-17,3035,2303,732,2366,669
2008,Rural,Telangana,Crime Against Women,Molestation,Female,18-30,1139,1107,32,1133,6
2005,Rural,Karnataka,Crime Against Children,Trafficking,Female,18-30,9864,5977,3887,9075,789
2005,Rural,Manipur,Crime Against Women,Molestation,Male,13-17,5436,2028,3408,4758,678
2002,Urban,Maharashtra,Crime Against Men,Assault,Male,0-12,5568,2592,2976,4335,1233
2006,Urban,Telangana,Crime Against Women,Dowry Deaths,Female,0-12,3953,366,3587,2302,1651
2006,Rural,Haryana,Property Crime,Theft,Female,31-45,1705,135,1570,1349,356
2006,Urban,Gujarat,Other Crimes,Fraud,Female,18-30,8784,7479,1305,8069,715
2010,Rural,Delhi,Other Crimes,Corruption,Female,0-12,4825,2599,2226,3325,1500
2010,Urban,Goa,Crime Against Women,Domestic Violence,Male,18-30,6710,1492,5218,4363,2347
2006,Urban,Chhattisgarh,Property Crime,Arson,Male,31-45,294,130,164,241,53
2003,Rural,Haryana,Crime Against Women,Domestic Violence,Male,46-60,7514,2585,4929,2658,4856
2003,Rural,Rajasthan,Property Crime,Theft,Male,46-60,900,806,94,878,22
2004,Urban,Haryana,Crime Against Women,Molestation,Female,46-60,778,231,547,690,88
2010,Urban,Rajasthan,Crime Against Women,Molestation,Male,60+,5508,2633,2875,3103,2405
2004,Rural,Uttar Pradesh,Crime Against Children,Trafficking,Male,18-30,2148,382,1766,394,1754
2006,Urban,Madhya Pradesh,Crime Against Women,Rape,Male,46-60,2397,1373,1024,1869,528
2001,Rural,Odisha,Crime Against Women,Molestation,Female,13-17,408,76,332,306,102
2009,Rural,Arunachal Pradesh,Property Crime,Burglary,Female,18-30,8895,1704,7191,6575,2320
2002,Rural,Arunachal Pradesh,Crime Against Women,Rape,Female,46-60,3615,3010,605,3045,570
2005,Urban,Meghalaya,Crime Against Men,Extortion,Female,46-60,4025,169,3856,311,3714
2009,Rural,Maharashtra,Property Crime,Arson,Female,46-60,3797,1167,2630,2765,1032
2007,Rural,Mizoram,Property Crime,Burglary,Male,31-45,291,77,214,110,181
2004,Rural,Bihar,Crime Against Children,Child Labor,Male,46-60,2555,1469,1086,1744,811
2008,Rural,Jammu & Kashmir,Property Crime,Vandalism,Male,60+,8819,3326,5493,5703,3116
2003,Urban,Odisha,Crime Against Women,Rape,Male,31-45,2174,1338,836,1764,410
2002,Rural,Punjab,Crime Against Women,Domestic Violence,Female,60+,4866,1845,3021,3707,1159
2001,Rural,Telangana,Other Crimes,Drug Offense,Male,13-17,2802,1226,1576,2368,434
2004,Rural,Karnataka,Crime Against Men,Murder,Female,31-45,564,90,474,352,212
2006,Urban,Goa,Other Crimes,Fraud,Female,13-17,8425,2363,6062,3655,4770
2010,Rural,Arunachal Pradesh,Property Crime,Theft,Male,13-17,5719,2494,3225,5191,528
2009,Urban,Nagaland,Crime Against Children,Trafficking,Male,13-17,6702,2231,4471,4074,2628
2001,Urban,Delhi,Crime Against Children,Kidnapping,Female,60+,2620,1552,1068,2573,47
2001,Urban,Madhya Pradesh,Crime Against Men,Assault,Female,31-45,3953,3770,183,3838,115
2005,Urban,Madhya Pradesh,Crime Against Men,Extortion,Male,31-45,7970,7770,200,7861,109
2004,Rural,Himachal Pradesh,Crime Against Women,Molestation,Female,18-30,1458,402,1056,526,932
2005,Urban,Rajasthan,Crime Against Children,Trafficking,Male,0-12,4595,4469,126,4487,108
2006,Rural,Kerala,Other Crimes,Cyber Crime,Male,31-45,295,145,150,189,106
2007,Urban,Uttarakhand,Other Crimes,Corruption,Female,46-60,2573,2468,105,2468,105
2001,Rural,Mizoram,Crime Against Women,Rape,Male,18-30,9134,7816,1318,8675,459
2003,Rural,Madhya Pradesh,Crime Against Children,Child Abuse,Female,0-12,1771,1548,223,1598,173
2008,Urban,Bihar,Other Crimes,Corruption,Female,13-17,1668,1473,195,1574,94
2001,Urban,West Bengal,Property Crime,Vandalism,Female,13-17,5350,1673,3677,3633,1717
2001,Rural,Mizoram,Crime Against Children,Child Abuse,Male,13-17,699,668,31,676,23
2001,Rural,West Bengal,Crime Against Children,Child Labor,Male,0-12,9880,625,9255,1512,8368
2006,Urban,Andhra Pradesh,Other Crimes,Corruption,Male,13-17,7616,2578,5038,2781,4835
2003,Rural,Goa,Crime Against Women,Domestic Violence,Female,60+,2090,1904,186,1963,127
2009,Rural,Uttar Pradesh,Other Crimes,Fraud,Female,18-30,3558,27,3531,1459,2099
2001,Rural,Tamil Nadu,Property Crime,Vandalism,Female,18-30,4416,1708,2708,2016,2400
2009,Rural,Haryana,Crime Against Women,Molestation,Male,13-17,4474,1249,3225,2760,1714
2007,Rural,Jharkhand,Crime Against Children,Trafficking,Male,46-60,3982,1355,2627,2357,1625
2001,Urban,Meghalaya,Crime Against Women,Domestic Violence,Female,13-17,2722,797,1925,2411,311
2008,Urban,Telangana,Crime Against Women,Domestic Violence,Male,18-30,3941,2823,1118,3429,512
2007,Urban,West Bengal,Crime Against Children,Trafficking,Female,18-30,8668,5169,3499,6237,2431
2001,Rural,Delhi,Crime Against Men,Murder,Female,46-60,2140,2076,64,2135,5
2001,Rural,Uttar Pradesh,Property Crime,Burglary,Female,46-60,2167,1632,535,2035,132
2004,Urban,Mizoram,Other Crimes,Cyber Crime,Male,46-60,3655,2261,1394,2859,796
2010,Rural,Madhya Pradesh,Crime Against Men,Robbery,Male,13-17,9587,1364,8223,4419,5168
2001,Rural,Goa,Crime Against Children,Trafficking,Male,46-60,3034,2883,151,2943,91
2002,Urban,Manipur,Other Crimes,Drug Offense,Female,60+,9415,7044,2371,8045,1370
2007,Rural,Karnataka,Crime Against Women,Domestic Violence,Female,46-60,341,162,179,173,168
2003,Rural,Telangana,Property Crime,Vandalism,Female,18-30,9146,3552,5594,4709,4437
2010,Rural,Madhya Pradesh,Crime Against Children,Trafficking,Male,18-30,5650,4546,1104,4766,884
2002,Rural,Assam,Other Crimes,Corruption,Male,0-12,3485,1911,1574,1957,1528
2004,Urban,Haryana,Crime Against Men,Assault,Male,13-17,1830,483,1347,899,931
2005,Urban,Himachal Pradesh,Other Crimes,Cyber Crime,Male,13-17,1753,313,1440,1722,31
2005,Urban,Himachal Pradesh,Property Crime,Theft,Female,0-12,1243,984,259,991,252
2005,Rural,Punjab,Crime Against Children,Child Labor,Female,13-17,4304,890,3414,1650,2654
2002,Urban,Andhra Pradesh,Property Crime,Vandalism,Male,13-17,6994,2154,4840,6477,517
2010,Urban,Meghalaya,Crime Against Children,Child Labor,Female,0-12,6734,1833,4901,4627,2107
2001,Urban,Rajasthan,Other Crimes,Cyber Crime,Male,13-17,4646,312,4334,518,4128
2008,Urban,Arunachal Pradesh,Crime Against Men,Assault,Female,31-45,1357,766,591,1109,248
2007,Rural,Arunachal Pradesh,Crime Against Children,Child Labor,Male,46-60,9201,4244,4957,7435,1766
2010,Rural,Nagaland,Crime Against Men,Extortion,Male,31-45,2251,1805,446,1957,294
2001,Rural,Sikkim,Crime Against Men,Robbery,Female,18-30,5590,523,5067,893,4697
2005,Rural,Himachal Pradesh,Crime Against Children,Trafficking,Male,0-12,9912,5846,4066,7296,2616
2008,Urban,Meghalaya,Other Crimes,Drug Offense,Male,46-60,6100,4653,1447,5725,375
2009,Rural,Tripura,Crime Against Women,Molestation,Female,13-17,9208,7541,1667,8067,1141
2004,Urban,Assam,Other Crimes,Corruption,Male,13-17,7298,6077,1221,6632,666
2007,Rural,Bihar,Crime Against Women,Dowry Deaths,Male,0-12,6626,6537,89,6624,2
2009,Rural,Kerala,Crime Against Children,Child Labor,Male,18-30,2338,138,2200,793,1545
2006,Urban,Nagaland,Crime Against Children,Child Labor,Female,46-60,3972,1790,2182,2357,1615
2002,Rural,Mizoram,Other Crimes,Drug Offense,Male,0-12,4232,510,3722,4050,182
2003,Urban,Tamil Nadu,Crime Against Children,Trafficking,Female,31-45,1541,473,1068,1150,391
2008,Rural,Andhra Pradesh,Crime Against Men,Robbery,Female,31-45,851,454,397,680,171
2001,Rural,Goa,Other Crimes,Drug Offense,Male,18-30,1741,248,1493,427,1314
2004,Rural,Meghalaya,Other Crimes,Drug Offense,Male,18-30,5818,712,5106,1001,4817
2009,Urban,Mizoram,Crime Against Children,Child Labor,Female,18-30,3478,254,3224,2557,921
2002,Rural,Delhi,Crime Against Men,Assault,Female,31-45,5183,4294,889,4430,753
2010,Urban,Telangana,Other Crimes,Corruption,Female,46-60,6844,6682,162,6822,22
2002,Urban,Uttar Pradesh,Crime Against Women,Domestic Violence,Male,0-12,4681,2350,2331,3380,1301
2006,Rural,Arunachal Pradesh,Crime Against Women,Rape,Female,18-30,9628,1129,8499,4068,5560
2005,Urban,Odisha,Other Crimes,Fraud,Female,60+,3920,920,3000,1960,1960
2004,Rural,Karnataka,Other Crimes,Cyber Crime,Male,31-45,3171,1035,2136,1749,1422
2003,Urban,Uttar Pradesh,Property Crime,Burglary,Female,18-30,4454,4378,76,4429,25
2005,Urban,Tripura,Crime Against Men,Extortion,Female,60+,5671,2714,2957,2717,2954
2008,Rural,Chhattisgarh,Crime Against Women,Molestation,Female,31-45,1444,345,1099,1383,61
2010,Urban,Assam,Other Crimes,Corruption,Female,0-12,6336,1185,5151,5937,399
2009,Rural,Manipur,Crime Against Men,Robbery,Male,13-17,7987,75,7912,5331,2656
2002,Urban,Karnataka,Property Crime,Burglary,Female,60+,1051,333,718,988,63
2001,Rural,Tamil Nadu,Crime Against Men,Murder,Female,0-12,8303,6293,2010,6501,1802
2002,Urban,Manipur,Property Crime,Burglary,Female,13-17,4099,2614,1485,3524,575
2004,Urban,Karnataka,Crime Against Women,Molestation,Female,60+,8544,7789,755,7998,546
2010,Urban,Bihar,Crime Against Children,Kidnapping,Male,31-45,7492,4296,3196,5542,1950
2010,Urban,Kerala,Crime Against Children,Kidnapping,Male,46-60,5712,5339,373,5431,281
2010,Urban,Telangana,Property Crime,Vandalism,Female,60+,1658,95,1563,1055,603
2007,Rural,Delhi,Other Crimes,Cyber Crime,Male,0-12,2670,362,2308,2386,284
2005,Rural,Haryana,Property Crime,Vandalism,Male,60+,4010,793,3217,2532,1478
2003,Urban,Andhra Pradesh,Crime Against Children,Child Labor,Male,13-17,5086,4250,836,4607,479
2006,Urban,Odisha,Crime Against Children,Child Abuse,Male,60+,9227,8000,1227,8415,812
2004,Urban,Nagaland,Crime Against Women,Dowry Deaths,Male,31-45,352,46,306,233,119
2009,Rural,Assam,Crime Against Men,Murder,Male,60+,6414,4101,2313,5901,513
2007,Urban,Telangana,Property Crime,Burglary,Female,60+,7774,584,7190,7194,580
2007,Urban,Nagaland,Crime Against Women,Domestic Violence,Male,46-60,8172,6661,1511,7315,857
2002,Rural,Chhattisgarh,Other Crimes,Cyber Crime,Male,18-30,8744,1406,7338,2885,5859
2010,Urban,Haryana,Crime Against Women,Rape,Male,60+,787,403,384,738,49
2005,Rural,Chhattisgarh,Crime Against Women,Domestic Violence,Female,13-17,1586,879,707,1099,487
2005,Urban,Mizoram,Crime Against Women,Domestic Violence,Female,31-45,3557,764,2793,1707,1850
2004,Urban,Telangana,Crime Against Men,Extortion,Female,60+,9547,6252,3295,7815,1732
2010,Urban,Andhra Pradesh,Crime Against Children,Trafficking,Female,46-60,4589,4041,548,4445,144
2005,Urban,Tamil Nadu,Crime Against Men,Extortion,Male,0-12,119,105,14,115,4
2004,Urban,Sikkim,Crime Against Children,Trafficking,Male,46-60,7952,140,7812,5761,2191
2010,Rural,Punjab,Crime Against Women,Rape,Male,13-17,4248,2030,2218,2653,1595
2005,Urban,Punjab,Crime Against Children,Child Abuse,Male,0-12,3562,270,3292,2683,879
2002,Urban,Rajasthan,Crime Against Men,Murder,Female,13-17,7284,4916,2368,5570,1714
2001,Rural,Delhi,Other Crimes,Corruption,Male,46-60,1709,1613,96,1640,69
2008,Urban,Delhi,Property Crime,Vandalism,Female,0-12,8703,1938,6765,7221,1482
2009,Rural,Jharkhand,Other Crimes,Corruption,Male,31-45,4301,4211,90,4234,67
2010,Rural,West Bengal,Crime Against Women,Domestic Violence,Male,13-17,833,23,810,508,325
2003,Rural,Delhi,Other Crimes,Cyber Crime,Female,18-30,1066,797,269,907,159
2004,Urban,Jharkhand,Property Crime,Arson,Male,31-45,2457,29,2428,1371,1086
2008,Rural,Chhattisgarh,Crime Against Children,Child Abuse,Female,31-45,2106,491,1615,2038,68
2003,Rural,Odisha,Crime Against Children,Trafficking,Male,60+,9701,7235,2466,7535,2166
2001,Rural,Delhi,Crime Against Men,Murder,Female,60+,2426,488,1938,1541,885
2004,Urban,Rajasthan,Crime Against Children,Child Abuse,Female,0-12,362,73,289,228,134
2006,Urban,Telangana,Crime Against Children,Child Labor,Female,18-30,976,741,235,920,56
2009,Rural,Haryana,Crime Against Children,Child Abuse,Male,13-17,9218,1850,7368,7167,2051
2007,Urban,Telangana,Crime Against Men,Extortion,Male,18-30,6928,4449,2479,6657,271
2008,Rural,Kerala,Crime Against Women,Rape,Female,60+,6179,726,5453,4740,1439
2006,Urban,Uttarakhand,Other Crimes,Fraud,Female,0-12,8517,6083,2434,7634,883
2002,Urban,Arunachal Pradesh,Crime Against Children,Trafficking,Female,0-12,3619,807,2812,2119,1500
2007,Urban,Gujarat,Crime Against Children,Child Abuse,Male,13-17,5090,2307,2783,2920,2170
2004,Urban,Madhya Pradesh,Crime Against Women,Molestation,Male,46-60,3952,3547,405,3649,303
2003,Rural,Odisha,Crime Against Children,Trafficking,Female,0-12,2287,1865,422,1945,342
2007,Rural,Goa,Crime Against Children,Kidnapping,Female,60+,4185,867,3318,3521,664
2010,Urban,Gujarat,Crime Against Men,Murder,Female,46-60,3808,1329,2479,1744,2064
2002,Urban,Nagaland,Other Crimes,Corruption,Male,0-12,4402,2112,2290,3324,1078
2003,Rural,Uttar Pradesh,Crime Against Men,Robbery,Female,18-30,5986,353,5633,4214,1772
2010,Urban,Arunachal Pradesh,Crime Against Children,Trafficking,Male,18-30,3784,3526,258,3663,121
2008,Urban,Sikkim,Crime Against Women,Dowry Deaths,Male,60+,3709,3582,127,3706,3
2003,Rural,Uttarakhand,Crime Against Women,Molestation,Female,60+,4103,2274,1829,2563,1540
2003,Urban,Maharashtra,Crime Against Children,Trafficking,Male,0-12,3935,1332,2603,2213,1722
2007,Rural,Kerala,Property Crime,Vandalism,Female,31-45,2470,6,2464,597,1873
2007,Rural,Punjab,Property Crime,Vandalism,Male,0-12,6931,5572,1359,5949,982
2007,Urban,Nagaland,Crime Against Men,Extortion,Male,31-45,6978,2922,4056,5239,1739
2010,Urban,Maharashtra,Crime Against Women,Molestation,Male,46-60,8085,3363,4722,5079,3006
2007,Rural,Delhi,Crime Against Women,Domestic Violence,Male,46-60,5874,1321,4553,3614,2260
2006,Urban,Odisha,Crime Against Men,Murder,Male,0-12,4119,1573,2546,3101,1018
2003,Rural,Nagaland,Crime Against Women,Molestation,Female,0-12,1071,656,415,900,171
2007,Rural,Karnataka,Crime Against Children,Trafficking,Female,0-12,7141,1323,5818,3651,3490
2008,Rural,Uttarakhand,Crime Against Children,Kidnapping,Female,46-60,930,586,344,629,301
2006,Rural,Jharkhand,Other Crimes,Corruption,Male,13-17,1124,999,125,1124,0
2005,Rural,Haryana,Other Crimes,Drug Offense,Female,46-60,8868,8322,546,8848,20
2006,Rural,Sikkim,Property Crime,Burglary,Female,13-17,9127,1960,7167,1967,7160
2006,Urban,Arunachal Pradesh,Crime Against Women,Rape,Female,46-60,1333,441,892,634,699
2002,Urban,Maharashtra,Property Crime,Burglary,Female,31-45,7243,6570,673,7011,232
2005,Urban,Mizoram,Property Crime,Theft,Male,31-45,8628,8027,601,8221,407
2004,Urban,Sikkim,Crime Against Men,Murder,Male,0-12,2534,755,1779,2324,210
2007,Urban,Arunachal Pradesh,Property Crime,Theft,Female,13-17,2227,1787,440,1965,262
2003,Urban,Bihar,Property Crime,Burglary,Male,31-45,6991,2237,4754,4547,2444
2002,Rural,Meghalaya,Crime Against Men,Robbery,Female,60+,9355,544,8811,5759,3596
2008,Urban,Sikkim,Crime Against Men,Extortion,Female,60+,2205,1581,624,2057,148
2009,Urban,Chhattisgarh,Other Crimes,Drug Offense,Male,46-60,7889,1650,6239,2430,5459
2007,Rural,Telangana,Crime Against Women,Molestation,Female,13-17,5068,3617,1451,3846,1222
2008,Urban,West Bengal,Crime Against Children,Child Abuse,Female,18-30,2569,1898,671,2430,139
2002,Rural,Tamil Nadu,Crime Against Men,Murder,Female,31-45,7644,1494,6150,4449,3195
2008,Urban,Karnataka,Crime Against Children,Child Abuse,Male,60+,397,191,206,245,152
2008,Rural,Chhattisgarh,Crime Against Children,Child Abuse,Female,0-12,1545,635,910,1240,305
2002,Urban,West Bengal,Crime Against Men,Murder,Male,60+,9844,8844,1000,9356,488
2009,Urban,Delhi,Crime Against Children,Child Labor,Female,18-30,7731,580,7151,811,6920
2010,Rural,Telangana,Crime Against Women,Rape,Female,0-12,7389,2319,5070,3723,3666
2003,Rural,Himachal Pradesh,Crime Against Men,Murder,Female,0-12,5682,1068,4614,2080,3602
2009,Urban,Bihar,Crime Against Women,Dowry Deaths,Male,13-17,2586,1023,1563,1535,1051
2009,Urban,Tamil Nadu,Crime Against Men,Assault,Male,0-12,6042,3829,2213,5506,536
2007,Urban,Nagaland,Property Crime,Vandalism,Female,0-12,6440,4092,2348,5255,1185
2010,Urban,Odisha,Crime Against Men,Murder,Female,18-30,8519,4322,4197,6982,1537
2007,Urban,Sikkim,Other Crimes,Cyber Crime,Female,31-45,2759,1315,1444,2092,667
2003,Rural,Kerala,Crime Against Men,Murder,Male,31-45,3974,57,3917,3466,508
2010,Rural,Meghalaya,Crime Against Children,Kidnapping,Female,60+,6109,701,5408,3622,2487
2010,Urban,Nagaland,Property Crime,Arson,Female,0-12,71,7,64,62,9
2001,Urban,Himachal Pradesh,Crime Against Women,Molestation,Male,0-12,120,72,48,100,20
2009,Rural,Goa,Crime Against Men,Murder,Male,0-12,7465,3059,4406,5599,1866
2008,Urban,Andhra Pradesh,Other Crimes,Cyber Crime,Female,0-12,264,8,256,244,20
2010,Rural,Bihar,Crime Against Women,Dowry Deaths,Female,46-60,1402,1378,24,1387,15
2005,Urban,Punjab,Crime Against Men,Extortion,Female,60+,2184,1708,476,1901,283
2009,Rural,Arunachal Pradesh,Crime Against Children,Child Labor,Male,31-45,7488,5152,2336,7047,441
2005,Urban,Meghalaya,Crime Against Men,Assault,Male,13-17,1881,1240,641,1582,299
2001,Urban,Arunachal Pradesh,Crime Against Men,Assault,Female,18-30,4083,4008,75,4012,71
2005,Urban,Manipur,Property Crime,Burglary,Male,60+,2498,780,1718,1815,683
2008,Rural,Delhi,Other Crimes,Fraud,Male,13-17,5705,2851,2854,5456,249
2001,Rural,West Bengal,Other Crimes,Corruption,Female,13-17,9786,5964,3822,8202,1584
2010,Urban,Goa,Other Crimes,Fraud,Male,60+,3638,3620,18,3634,4
2003,Rural,Andhra Pradesh,Other Crimes,Cyber Crime,Female,18-30,4539,4449,90,4505,34
2005,Urban,Himachal Pradesh,Property Crime,Arson,Male,46-60,7298,6808,490,7064,234
2004,Urban,Arunachal Pradesh,Other Crimes,Cyber Crime,Male,13-17,4560,1671,2889,2682,1878
2004,Urban,Odisha,Property Crime,Arson,Male,13-17,459,456,3,459,0
2009,Rural,Kerala,Crime Against Women,Dowry Deaths,Female,0-12,8685,359,8326,874,7811
2008,Urban,Gujarat,Crime Against Women,Rape,Male,18-30,7964,6956,1008,7080,884
2002,Rural,Andhra Pradesh,Crime Against Women,Dowry Deaths,Male,60+,8885,934,7951,6559,2326
2002,Rural,Nagaland,Crime Against Women,Molestation,Male,31-45,9550,819,8731,4520,5030
2004,Rural,Andhra Pradesh,Crime Against Children,Child Abuse,Male,60+,2845,1100,1745,2103,742
2003,Rural,Jammu & Kashmir,Other Crimes,Fraud,Male,46-60,6509,1304,5205,5938,571
2006,Rural,Rajasthan,Other Crimes,Corruption,Female,46-60,9742,405,9337,8484,1258
2008,Urban,Rajasthan,Crime Against Men,Assault,Female,46-60,6144,1105,5039,2375,3769
2003,Urban,Punjab,Crime Against Children,Kidnapping,Male,13-17,996,637,359,899,97
2006,Urban,Arunachal Pradesh,Other Crimes,Fraud,Female,31-45,7226,33,7193,4038,3188
2006,Urban,Goa,Property Crime,Vandalism,Female,13-17,3282,873,2409,923,2359
2009,Urban,Nagaland,Crime Against Men,Extortion,Male,31-45,3877,3229,648,3326,551
2003,Rural,Jharkhand,Property Crime,Burglary,Male,13-17,9591,9025,566,9094,497
2007,Urban,Chhattisgarh,Other Crimes,Corruption,Female,46-60,1445,36,1409,702,743
2004,Rural,Haryana,Crime Against Men,Assault,Male,0-12,2534,2004,530,2533,1
2008,Urban,Madhya Pradesh,Crime Against Women,Domestic Violence,Male,13-17,5536,2984,2552,4471,1065
2003,Urban,Jammu & Kashmir,Property Crime,Vandalism,Male,0-12,5730,1891,3839,4353,1377
2004,Rural,Goa,Crime Against Children,Child Labor,Male,60+,8616,5667,2949,6438,2178
2003,Rural,Haryana,Crime Against Women,Dowry Deaths,Female,0-12,9190,7368,1822,7444,1746
2009,Urban,Haryana,Other Crimes,Cyber Crime,Male,46-60,4932,1186,3746,4110,822
2004,Urban,Gujarat,Other Crimes,Drug Offense,Male,0-12,7496,821,6675,1035,6461
2001,Rural,Kerala,Crime Against Children,Trafficking,Male,46-60,6278,3259,3019,4987,1291
2003,Urban,Sikkim,Crime Against Women,Domestic Violence,Female,13-17,5895,2087,3808,2117,3778
2008,Urban,Bihar,Crime Against Children,Kidnapping,Male,31-45,6593,1042,5551,5821,772
2001,Urban,Rajasthan,Property Crime,Vandalism,Male,18-30,8416,240,8176,4092,4324
2006,Rural,Uttar Pradesh,Crime Against Women,Rape,Male,0-12,9063,3463,5600,3694,5369
2005,Urban,Haryana,Other Crimes,Corruption,Male,60+,7885,3944,3941,4149,3736
2009,Urban,Nagaland,Crime Against Men,Extortion,Female,46-60,3699,1881,1818,2285,1414
2005,Rural,Jammu & Kashmir,Crime Against Women,Domestic Violence,Male,31-45,5281,3473,1808,3897,1384
2010,Urban,Chhattisgarh,Property Crime,Arson,Male,18-30,649,63,586,546,103
2008,Rural,West Bengal,Property Crime,Burglary,Male,13-17,1689,1400,289,1655,34
2008,Rural,Haryana,Crime Against Men,Murder,Male,18-30,4915,3440,1475,4733,182
2007,Urban,Sikkim,Crime Against Men,Assault,Male,13-17,119,78,41,88,31
2005,Rural,Tamil Nadu,Crime Against Children,Child Abuse,Female,60+,1016,607,409,990,26
2005,Rural,Gujarat,Crime Against Men,Murder,Male,60+,2898,1463,1435,2696,202
2008,Urban,West Bengal,Other Crimes,Fraud,Female,13-17,1448,946,502,1370,78
2003,Rural,Madhya Pradesh,Crime Against Men,Assault,Female,60+,8580,7578,1002,7854,726
2006,Rural,Uttarakhand,Other Crimes,Corruption,Male,46-60,2365,162,2203,2175,190
2007,Rural,Rajasthan,Crime Against Children,Child Labor,Female,60+,8794,6997,1797,7048,1746
2007,Rural,Rajasthan,Crime Against Men,Assault,Female,31-45,9227,2184,7043,4918,4309
2010,Urban,Jharkhand,Property Crime,Vandalism,Male,0-12,5104,4171,933,4900,204
2010,Rural,Tripura,Property Crime,Theft,Male,13-17,7317,4224,3093,6026,1291
2003,Urban,Tamil Nadu,Other Crimes,Drug Offense,Male,46-60,3916,519,3397,3251,665
2001,Urban,Odisha,Crime Against Men,Murder,Female,31-45,6464,3069,3395,4392,2072
2010,Rural,West Bengal,Property Crime,Vandalism,Male,46-60,8531,7309,1222,8026,505
2003,Urban,Uttar Pradesh,Crime Against Men,Murder,Female,46-60,3328,1345,1983,2000,1328
2008,Rural,Uttarakhand,Crime Against Women,Rape,Female,18-30,4594,2990,1604,4545,49
2005,Rural,Mizoram,Property Crime,Arson,Male,0-12,1873,1250,623,1388,485
2008,Rural,Jammu & Kashmir,Crime Against Women,Domestic Violence,Female,60+,4611,2040,2571,2546,2065
2010,Urban,Sikkim,Crime Against Children,Trafficking,Female,31-45,3578,3370,208,3532,46
2006,Rural,Gujarat,Property Crime,Arson,Female,46-60,9027,6136,2891,8686,341
2010,Rural,Chhattisgarh,Other Crimes,Fraud,Male,0-12,4136,3604,532,3735,401
2007,Urban,Nagaland,Crime Against Men,Murder,Female,18-30,6836,3425,3411,3465,3371
2010,Urban,Assam,Crime Against Children,Child Abuse,Female,60+,2459,1821,638,2056,403
2001,Rural,Goa,Crime Against Men,Extortion,Male,31-45,1247,531,716,723,524
2009,Urban,Goa,Other Crimes,Fraud,Male,31-45,460,446,14,456,4
2005,Rural,Haryana,Other Crimes,Cyber Crime,Female,18-30,492,165,327,374,118
2010,Urban,Meghalaya,Other Crimes,Fraud,Male,18-30,1382,434,948,515,867
2010,Urban,Bihar,Crime Against Children,Kidnapping,Male,18-30,7457,1014,6443,5799,1658
2009,Rural,Tripura,Crime Against Women,Dowry Deaths,Female,46-60,7832,7102,730,7545,287
2006,Urban,Gujarat,Crime Against Women,Molestation,Male,13-17,1590,1301,289,1502,88
2003,Urban,Bihar,Other Crimes,Corruption,Female,31-45,8697,3927,4770,5688,3009
2009,Urban,Rajasthan,Crime Against Men,Robbery,Female,60+,6695,2626,4069,2976,3719
2007,Urban,Tripura,Property Crime,Vandalism,Female,31-45,3844,2318,1526,2368,1476
2002,Urban,Haryana,Crime Against Women,Dowry Deaths,Male,46-60,2030,496,1534,776,1254
2009,Rural,West Bengal,Property Crime,Vandalism,Male,31-45,5433,2651,2782,3277,2156
2005,Urban,Sikkim,Other Crimes,Drug Offense,Female,18-30,1665,961,704,1656,9
2002,Urban,Mizoram,Crime Against Children,Child Abuse,Male,13-17,4698,904,3794,4322,376
2003,Rural,Meghalaya,Property Crime,Burglary,Male,60+,343,178,165,315,28
2001,Rural,Sikkim,Property Crime,Vandalism,Male,31-45,5883,5371,512,5632,251
2004,Rural,West Bengal,Crime Against Men,Assault,Female,18-30,4345,3985,360,4181,164
2006,Rural,Sikkim,Property Crime,Theft,Female,46-60,6810,653,6157,5852,958
2007,Rural,Bihar,Property Crime,Vandalism,Male,60+,3817,1155,2662,2875,942
2003,Rural,Tripura,Crime Against Men,Robbery,Male,18-30,7503,724,6779,4697,2806
2003,Rural,Punjab,Crime Against Men,Extortion,Male,46-60,2026,713,1313,1234,792
2002,Urban,Haryana,Crime Against Women,Rape,Male,46-60,9063,280,8783,6250,2813
2010,Rural,Karnataka,Property Crime,Theft,Male,46-60,388,341,47,370,18
2002,Rural,Telangana,Crime Against Men,Robbery,Female,18-30,6621,2417,4204,2672,3949
2007,Rural,Kerala,Other Crimes,Cyber Crime,Male,31-45,5600,1456,4144,4022,1578
2007,Rural,Sikkim,Crime Against Children,Trafficking,Female,13-17,5751,5051,700,5326,425
2004,Urban,Telangana,Other Crimes,Cyber Crime,Male,31-45,3368,333,3035,503,2865
2003,Urban,Madhya Pradesh,Crime Against Men,Assault,Male,13-17,3228,2691,537,2933,295
2001,Rural,Chhattisgarh,Other Crimes,Drug Offense,Female,60+,6021,5870,151,6007,14
2009,Urban,Tamil Nadu,Crime Against Children,Child Labor,Female,46-60,9523,4243,5280,5928,3595
2007,Urban,Himachal Pradesh,Property Crime,Arson,Male,0-12,4836,2169,2667,4013,823
2004,Urban,Madhya Pradesh,Crime Against Women,Molestation,Female,46-60,7433,2616,4817,5190,2243
2004,Rural,Madhya Pradesh,Property Crime,Arson,Female,0-12,9181,711,8470,1794,7387
2010,Urban,Uttar Pradesh,Property Crime,Arson,Male,46-60,3598,2887,711,3000,598
2008,Rural,Assam,Property Crime,Arson,Male,0-12,4353,3941,412,4013,340
2007,Rural,Gujarat,Other Crimes,Fraud,Male,31-45,1083,68,1015,949,134
2009,Rural,Jammu & Kashmir,Crime Against Men,Robbery,Female,18-30,2649,2629,20,2630,19
2006,Rural,Manipur,Crime Against Women,Molestation,Female,0-12,338,320,18,336,2
2009,Rural,Chhattisgarh,Property Crime,Burglary,Female,13-17,644,82,562,554,90
2004,Rural,Delhi,Other Crimes,Corruption,Female,0-12,2628,1560,1068,2321,307
2004,Rural,Andhra Pradesh,Property Crime,Arson,Male,46-60,2128,788,1340,1348,780
2007,Rural,Andhra Pradesh,Other Crimes,Fraud,Female,18-30,3988,3871,117,3932,56
2007,Rural,Andhra Pradesh,Other Crimes,Corruption,Female,60+,2159,1274,885,1414,745
2010,Urban,Assam,Crime Against Men,Extortion,Female,0-12,7575,2093,5482,5746,1829
2006,Urban,Mizoram,Crime Against Children,Kidnapping,Female,60+,5719,4247,1472,5537,182
2005,Rural,Punjab,Property Crime,Burglary,Male,18-30,6593,6161,432,6300,293
2009,Urban,Chhattisgarh,Other Crimes,Fraud,Male,31-45,1948,325,1623,1086,862
2008,Rural,Uttarakhand,Property Crime,Vandalism,Male,60+,3504,3107,397,3468,36
2003,Rural,Uttar Pradesh,Crime Against Children,Trafficking,Female,18-30,251,137,114,201,50
2001,Urban,Delhi,Crime Against Children,Kidnapping,Male,46-60,5150,4374,776,5022,128
2009,Urban,Tamil Nadu,Crime Against Women,Domestic Violence,Male,18-30,4159,1452,2707,3922,237
2001,Urban,Goa,Crime Against Women,Molestation,Male,31-45,1685,1543,142,1660,25
2004,Urban,Jharkhand,Property Crime,Burglary,Female,13-17,8985,325,8660,6019,2966
2005,Urban,Meghalaya,Other Crimes,Cyber Crime,Male,13-17,4460,1660,2800,2586,1874
2002,Rural,Odisha,Crime Against Children,Child Labor,Female,46-60,1121,236,885,611,510
2010,Rural,Maharashtra,Other Crimes,Corruption,Male,31-45,3511,145,3366,1296,2215
2009,Urban,Jharkhand,Other Crimes,Fraud,Male,46-60,6935,5811,1124,5908,1027
2002,Rural,Chhattisgarh,Other Crimes,Cyber Crime,Female,13-17,3674,2540,1134,2762,912
2007,Rural,Goa,Crime Against Women,Rape,Male,46-60,5203,4147,1056,4197,1006
2002,Urban,Meghalaya,Other Crimes,Fraud,Female,18-30,2127,1584,543,2039,88
2009,Rural,Goa,Other Crimes,Drug Offense,Male,13-17,3228,2193,1035,2727,501
2003,Urban,Tamil Nadu,Crime Against Women,Dowry Deaths,Female,46-60,5370,2566,2804,4684,686
2004,Urban,Madhya Pradesh,Other Crimes,Drug Offense,Male,0-12,2055,1584,471,2051,4
2007,Rural,Haryana,Crime Against Women,Domestic Violence,Female,31-45,241,102,139,113,128
2004,Urban,Gujarat,Crime Against Women,Dowry Deaths,Female,46-60,4022,197,3825,1065,2957
2006,Rural,Andhra Pradesh,Crime Against Men,Extortion,Female,0-12,1144,884,260,1107,37
2004,Rural,Maharashtra,Crime Against Women,Molestation,Female,60+,9811,7921,1890,8417,1394
2009,Urban,Himachal Pradesh,Other Crimes,Corruption,Male,13-17,4980,2413,2567,4883,97
2002,Rural,Punjab,Crime Against Women,Rape,Female,0-12,8080,531,7549,6235,1845
2008,Urban,Tripura,Crime Against Men,Murder,Female,0-12,152,147,5,151,1
2006,Rural,Karnataka,Crime Against Women,Domestic Violence,Male,13-17,4650,403,4247,4212,438
2001,Urban,Nagaland,Property Crime,Vandalism,Female,31-45,3650,2473,1177,2566,1084
2004,Urban,Delhi,Crime Against Children,Child Labor,Male,60+,1559,411,1148,1154,405
2005,Urban,Andhra Pradesh,Crime Against Women,Molestation,Male,13-17,4790,999,3791,3203,1587
2004,Urban,Mizoram,Crime Against Children,Child Abuse,Female,18-30,9265,2038,7227,5432,3833
2009,Rural,Delhi,Crime Against Women,Dowry Deaths,Female,46-60,4472,3580,892,3619,853
2001,Urban,Andhra Pradesh,Crime Against Men,Assault,Female,46-60,9897,2267,7630,2959,6938
2005,Urban,Jammu & Kashmir,Crime Against Children,Kidnapping,Female,18-30,8386,5130,3256,7821,565
2008,Urban,Uttarakhand,Crime Against Children,Child Abuse,Male,31-45,5833,983,4850,5776,57
2009,Urban,Nagaland,Crime Against Men,Robbery,Female,46-60,9949,8994,955,9197,752
2006,Rural,Chhattisgarh,Property Crime,Theft,Female,0-12,6131,2279,3852,5162,969
2008,Rural,Punjab,Crime Against Men,Assault,Male,46-60,6960,2482,4478,3106,3854
2010,Urban,Maharashtra,Property Crime,Vandalism,Male,46-60,1036,1021,15,1024,12
2010,Rural,Andhra Pradesh,Property Crime,Vandalism,Male,13-17,3895,3891,4,3894,1
2006,Rural,Himachal Pradesh,Crime Against Men,Murder,Female,60+,3552,1429,2123,2963,589
2003,Urban,Punjab,Property Crime,Vandalism,Female,0-12,3789,563,3226,3335,454
2008,Urban,Kerala,Crime Against Men,Extortion,Female,0-12,4047,2951,1096,3279,768
2003,Rural,Manipur,Crime Against Women,Domestic Violence,Female,31-45,2618,578,2040,1817,801
2003,Rural,Madhya Pradesh,Crime Against Children,Trafficking,Female,60+,9662,4863,4799,9113,549
2001,Rural,Mizoram,Crime Against Women,Rape,Female,18-30,9956,7363,2593,7670,2286
2005,Urban,Gujarat,Property Crime,Burglary,Male,46-60,2602,332,2270,1769,833
2007,Urban,Madhya Pradesh,Crime Against Women,Rape,Male,60+,2727,1259,1468,1839,888
2004,Urban,Sikkim,Crime Against Women,Rape,Female,31-45,8075,2856,5219,5684,2391
2006,Urban,Karnataka,Property Crime,Arson,Male,31-45,3885,446,3439,3348,537
2001,Urban,Himachal Pradesh,Other Crimes,Corruption,Female,60+,3362,1428,1934,1824,1538
2005,Rural,Nagaland,Crime Against Children,Kidnapping,Male,46-60,3245,116,3129,556,2689
2009,Urban,Assam,Crime Against Women,Molestation,Female,13-17,5136,3694,1442,3834,1302
2007,Rural,Mizoram,Other Crimes,Corruption,Male,31-45,4490,828,3662,4381,109
2009,Rural,Uttarakhand,Crime Against Children,Trafficking,Female,60+,9550,4467,5083,7405,2145
2010,Rural,Manipur,Crime Against Children,Kidnapping,Female,13-17,2239,1856,383,2069,170
2003,Rural,Sikkim,Crime Against Women,Domestic Violence,Male,31-45,3250,2239,1011,2481,769
2006,Urban,Assam,Crime Against Women,Molestation,Male,46-60,5985,3935,2050,4412,1573
2002,Rural,Himachal Pradesh,Crime Against Children,Child Abuse,Female,18-30,3558,1208,2350,1303,2255
2001,Urban,Bihar,Crime Against Women,Domestic Violence,Female,31-45,6706,1163,5543,3022,3684
2007,Rural,Chhattisgarh,Crime Against Children,Kidnapping,Male,60+,9305,3768,5537,7438,1867
2008,Urban,Haryana,Other Crimes,Fraud,Female,13-17,7890,933,6957,3319,4571
2008,Urban,Tamil Nadu,Crime Against Women,Domestic Violence,Male,18-30,7844,4979,2865,6615,1229
2008,Rural,Jharkhand,Property Crime,Theft,Male,31-45,8221,4814,3407,7616,605
2001,Rural,Meghalaya,Crime Against Women,Rape,Male,18-30,5527,2685,2842,3512,2015
2006,Urban,Kerala,Other Crimes,Cyber Crime,Female,60+,5728,5219,509,5483,245
2008,Rural,Goa,Crime Against Women,Dowry Deaths,Female,18-30,6764,842,5922,4019,2745
2008,Urban,Telangana,Crime Against Children,Child Abuse,Male,31-45,7452,437,7015,6203,1249
2005,Urban,Nagaland,Other Crimes,Fraud,Male,18-30,6811,2692,4119,3830,2981
2001,Rural,Chhattisgarh,Crime Against Women,Molestation,Female,60+,1430,229,1201,1083,347
2004,Urban,West Bengal,Crime Against Men,Extortion,Male,31-45,5369,2563,2806,3412,1957
2004,Urban,Mizoram,Other Crimes,Drug Offense,Male,31-45,4990,3790,1200,4411,579
2008,Urban,Chhattisgarh,Crime Against Women,Dowry Deaths,Female,0-12,1686,133,1553,1221,465
2003,Urban,Maharashtra,Crime Against Children,Trafficking,Female,0-12,166,109,57,166,0
2002,Urban,Bihar,Other Crimes,Cyber Crime,Male,0-12,5478,3680,1798,4422,1056
2008,Rural,Odisha,Crime Against Men,Assault,Male,46-60,2903,1287,1616,2882,21
2004,Rural,Himachal Pradesh,Property Crime,Theft,Male,46-60,3966,802,3164,2191,1775
2001,Urban,Madhya Pradesh,Other Crimes,Drug Offense,Male,60+,6258,1665,4593,3990,2268
2001,Rural,Tamil Nadu,Crime Against Men,Assault,Female,18-30,3652,3236,416,3419,233
2006,Rural,Rajasthan,Crime Against Men,Assault,Male,60+,9916,537,9379,6633,3283
2006,Rural,West Bengal,Property Crime,Burglary,Male,13-17,1834,21,1813,1689,145
2006,Urban,Gujarat,Crime Against Men,Assault,Male,60+,4699,481,4218,3237,1462
2004,Urban,Telangana,Property Crime,Arson,Female,60+,6009,645,5364,5527,482
2008,Rural,Nagaland,Other Crimes,Fraud,Female,60+,6983,2396,4587,4471,2512
2005,Urban,Mizoram,Crime Against Men,Murder,Female,13-17,5583,1756,3827,4994,589
2006,Rural,Odisha,Crime Against Men,Murder,Male,0-12,4073,2147,1926,2672,1401
2008,Urban,Nagaland,Crime Against Women,Rape,Male,13-17,4987,3493,1494,4275,712
2004,Rural,Maharashtra,Crime Against Men,Assault,Male,31-45,911,588,323,605,306
2005,Rural,Karnataka,Property Crime,Arson,Male,18-30,9827,7381,2446,8144,1683
2001,Rural,Madhya Pradesh,Crime Against Women,Rape,Female,31-45,1037,395,642,682,355
2002,Urban,Uttarakhand,Crime Against Men,Extortion,Male,60+,9999,4578,5421,9788,211
2003,Urban,Tripura,Other Crimes,Drug Offense,Female,46-60,6963,2807,4156,3150,3813
2001,Urban,Madhya Pradesh,Crime Against Men,Extortion,Female,46-60,6255,4918,1337,5165,1090
2008,Rural,Mizoram,Crime Against Children,Trafficking,Female,31-45,2189,1006,1183,1695,494
2006,Urban,Haryana,Crime Against Men,Extortion,Female,60+,4959,3149,1810,4911,48
2005,Urban,Sikkim,Crime Against Men,Robbery,Female,13-17,6138,1659,4479,2304,3834
2002,Urban,Arunachal Pradesh,Crime Against Men,Extortion,Male,13-17,9125,8372,753,8702,423
2005,Rural,Jammu & Kashmir,Crime Against Women,Molestation,Male,46-60,5051,4283,768,4793,258
2008,Urban,Assam,Crime Against Women,Molestation,Male,13-17,2744,385,2359,434,2310
2009,Urban,Gujarat,Crime Against Children,Kidnapping,Male,31-45,2838,1109,1729,2828,10
2002,Rural,Haryana,Crime Against Children,Child Abuse,Male,18-30,708,249,459,291,417
2001,Rural,Chhattisgarh,Crime Against Women,Dowry Deaths,Female,18-30,4076,4064,12,4067,9
2009,Rural,Arunachal Pradesh,Property Crime,Theft,Female,18-30,5932,805,5127,4358,1574
2008,Urban,Karnataka,Property Crime,Burglary,Female,13-17,1069,971,98,1063,6
2009,Urban,Goa,Crime Against Women,Rape,Female,13-17,154,107,47,112,42
2003,Urban,Chhattisgarh,Other Crimes,Fraud,Male,13-17,3864,46,3818,2956,908
2006,Urban,Jammu & Kashmir,Property Crime,Theft,Male,31-45,8571,5017,3554,8322,249
2006,Urban,Goa,Property Crime,Theft,Male,13-17,7937,631,7306,6811,1126
2008,Rural,Bihar,Other Crimes,Drug Offense,Female,46-60,812,616,196,763,49
2010,Rural,Uttarakhand,Crime Against Children,Child Labor,Male,0-12,4044,1664,2380,3343,701
2003,Urban,Gujarat,Crime Against Men,Murder,Male,0-12,1125,371,754,587,538
2001,Urban,Delhi,Crime Against Men,Murder,Male,0-12,373,189,184,200,173
2004,Urban,Telangana,Crime Against Women,Rape,Female,13-17,1112,581,531,683,429
2005,Urban,West Bengal,Other Crimes,Cyber Crime,Male,46-60,7523,6111,1412,7268,255
2004,Urban,Assam,Crime Against Women,Domestic Violence,Female,31-45,4938,800,4138,2590,2348
2005,Urban,Goa,Crime Against Women,Domestic Violence,Female,13-17,4246,745,3501,1102,3144
2007,Rural,Uttarakhand,Crime Against Men,Robbery,Female,18-30,5881,1054,4827,4960,921
2003,Rural,Gujarat,Crime Against Children,Kidnapping,Male,0-12,4799,1042,3757,3948,851
2009,Urban,Tripura,Crime Against Women,Molestation,Male,46-60,5955,5305,650,5631,324
2009,Urban,Gujarat,Crime Against Children,Child Abuse,Female,13-17,9624,7056,2568,7402,2222
2008,Rural,Chhattisgarh,Other Crimes,Drug Offense,Male,0-12,5076,2063,3013,3219,1857
2003,Rural,Delhi,Crime Against Children,Trafficking,Female,60+,5475,1585,3890,2980,2495
2005,Rural,Assam,Crime Against Men,Murder,Female,0-12,7167,1832,5335,3903,3264
2002,Urban,Kerala,Crime Against Men,Robbery,Male,46-60,2143,337,1806,1492,651
2004,Rural,Mizoram,Crime Against Children,Child Labor,Female,0-12,6222,3642,2580,5709,513
2006,Urban,Rajasthan,Other Crimes,Cyber Crime,Female,0-12,2136,747,1389,1686,450
2004,Rural,Madhya Pradesh,Property Crime,Burglary,Female,13-17,4166,1596,2570,1615,2551
2002,Rural,Andhra Pradesh,Property Crime,Vandalism,Female,13-17,4404,3031,1373,4175,229
2010,Rural,Assam,Crime Against Children,Child Abuse,Male,46-60,631,568,63,597,34
2004,Urban,Goa,Property Crime,Arson,Female,18-30,5547,4613,934,5248,299
2009,Urban,West Bengal,Property Crime,Vandalism,Female,18-30,7746,3474,4272,5769,1977
2009,Urban,Andhra Pradesh,Other Crimes,Drug Offense,Female,46-60,8385,5543,2842,7275,1110
2009,Urban,Mizoram,Crime Against Women,Molestation,Male,46-60,7128,5572,1556,6653,475
2002,Urban,Jammu & Kashmir,Crime Against Children,Kidnapping,Male,31-45,9286,6232,3054,7578,1708
2002,Rural,Tripura,Property Crime,Theft,Female,18-30,390,311,79,373,17
2004,Urban,Maharashtra,Property Crime,Burglary,Male,13-17,2181,2118,63,2148,33
2001,Rural,Goa,Property Crime,Arson,Male,13-17,9045,3430,5615,7786,1259
2007,Urban,Meghalaya,Crime Against Men,Assault,Female,60+,4999,419,4580,1817,3182
2001,Rural,Maharashtra,Crime Against Women,Domestic Violence,Male,31-45,9317,7591,1726,9296,21
2009,Urban,Jammu & Kashmir,Crime Against Children,Child Abuse,Female,18-30,1823,83,1740,1683,140
2003,Urban,Maharashtra,Crime Against Men,Assault,Male,13-17,1661,272,1389,472,1189
2010,Urban,Jammu & Kashmir,Property Crime,Arson,Male,31-45,313,204,109,230,83
2005,Urban,Bihar,Property Crime,Arson,Female,0-12,4822,2423,2399,2476,2346
2002,Rural,Assam,Other Crimes,Drug Offense,Male,31-45,2169,50,2119,1587,582
2010,Urban,Kerala,Other Crimes,Fraud,Female,0-12,8619,930,7689,5627,2992
2004,Urban,Himachal Pradesh,Crime Against Women,Dowry Deaths,Female,18-30,5337,1122,4215,1673,3664
2008,Urban,Sikkim,Crime Against Women,Molestation,Female,13-17,7023,3344,3679,6695,328
2006,Urban,Punjab,Property Crime,Arson,Male,31-45,5809,3571,2238,5065,744
2007,Urban,Telangana,Other Crimes,Drug Offense,Female,31-45,1762,1152,610,1695,67
2010,Rural,Chhattisgarh,Crime Against Children,Child Labor,Female,13-17,9236,442,8794,6828,2408
2002,Urban,Delhi,Crime Against Children,Kidnapping,Female,0-12,2401,1951,450,2083,318
2001,Rural,Punjab,Property Crime,Theft,Male,60+,3254,2443,811,3140,114
2006,Urban,Maharashtra,Other Crimes,Corruption,Female,18-30,8793,2029,6764,7724,1069
2003,Urban,Jharkhand,Other Crimes,Drug Offense,Male,0-12,5019,660,4359,3150,1869
2008,Urban,Telangana,Crime Against Women,Domestic Violence,Female,46-60,1435,56,1379,257,1178
2010,Urban,Arunachal Pradesh,Crime Against Men,Extortion,Female,46-60,6571,5783,788,5964,607
2002,Rural,Jharkhand,Other Crimes,Fraud,Female,46-60,8983,4883,4100,5345,3638
2009,Rural,Jharkhand,Property Crime,Burglary,Male,46-60,8574,7652,922,7978,596
2005,Urban,Assam,Crime Against Women,Rape,Female,0-12,7112,6307,805,6768,344
2008,Rural,Gujarat,Crime Against Men,Murder,Female,46-60,8128,7448,680,7724,404
2001,Urban,West Bengal,Other Crimes,Corruption,Male,13-17,4086,493,3593,3915,171
2010,Rural,Assam,Crime Against Men,Assault,Male,46-60,5697,1404,4293,2305,3392
2008,Urban,Andhra Pradesh,Property Crime,Burglary,Female,18-30,823,548,275,795,28
2002,Urban,West Bengal,Crime Against Men,Assault,Male,0-12,8041,6780,1261,7437,604
2002,Rural,Uttarakhand,Crime Against Children,Child Labor,Female,13-17,128,2,126,92,36
2010,Rural,Arunachal Pradesh,Crime Against Women,Rape,Female,46-60,8015,4362,3653,7953,62
2009,Rural,Haryana,Crime Against Children,Child Labor,Female,60+,7495,263,7232,6596,899
2009,Urban,Bihar,Crime Against Women,Molestation,Male,46-60,7704,3759,3945,6197,1507
2001,Rural,Telangana,Property Crime,Vandalism,Female,0-12,9199,173,9026,6794,2405
2009,Urban,Uttar Pradesh,Property Crime,Theft,Male,60+,6878,3070,3808,3241,3637
2009,Urban,Uttar Pradesh,Property Crime,Burglary,Female,31-45,4190,494,3696,3925,265
2002,Rural,Jharkhand,Crime Against Children,Trafficking,Male,60+,3050,531,2519,1486,1564
2003,Urban,Delhi,Property Crime,Vandalism,Male,0-12,3598,2186,1412,3465,133
2009,Rural,Jammu & Kashmir,Crime Against Men,Murder,Female,0-12,5405,3951,1454,5190,215
2003,Rural,Punjab,Crime Against Men,Extortion,Male,18-30,5145,3839,1306,4917,228
2010,Rural,Manipur,Crime Against Women,Dowry Deaths,Male,31-45,490,38,452,490,0
2008,Urban,Himachal Pradesh,Other Crimes,Fraud,Male,13-17,4701,2043,2658,2590,2111
2010,Urban,Bihar,Crime Against Men,Extortion,Male,0-12,428,159,269,416,12
2007,Urban,Karnataka,Other Crimes,Drug Offense,Female,60+,9565,9191,374,9313,252
2004,Rural,Kerala,Property Crime,Burglary,Female,18-30,5970,4127,1843,5351,619
2006,Urban,West Bengal,Crime Against Women,Domestic Violence,Female,46-60,1708,1066,642,1532,176
2002,Rural,Karnataka,Property Crime,Vandalism,Male,60+,9055,3799,5256,4384,4671
2001,Urban,Himachal Pradesh,Other Crimes,Fraud,Male,46-60,2208,2002,206,2092,116
2005,Rural,Delhi,Crime Against Men,Extortion,Female,13-17,9852,5924,3928,9736,116
2010,Urban,Chhattisgarh,Property Crime,Arson,Male,13-17,4786,1071,3715,3607,1179
2010,Urban,Rajasthan,Property Crime,Arson,Male,60+,7421,1792,5629,4886,2535
2010,Urban,Jammu & Kashmir,Property Crime,Vandalism,Male,46-60,4624,1733,2891,2426,2198
2010,Rural,Himachal Pradesh,Property Crime,Theft,Female,60+,5934,1945,3989,2843,3091
2002,Rural,Chhattisgarh,Crime Against Women,Molestation,Female,60+,5275,1025,4250,1806,3469
2007,Urban,Manipur,Crime Against Men,Assault,Male,18-30,7281,467,6814,3713,3568
2006,Urban,Haryana,Other Crimes,Drug Offense,Male,0-12,5885,1366,4519,4147,1738
2001,Urban,Maharashtra,Crime Against Children,Child Labor,Male,46-60,1194,804,390,866,328
2003,Rural,Chhattisgarh,Crime Against Men,Extortion,Male,0-12,6912,4487,2425,6152,760
2008,Rural,Rajasthan,Crime Against Men,Assault,Female,60+,5135,1035,4100,4954,181
2002,Rural,Kerala,Crime Against Women,Dowry Deaths,Male,46-60,7654,3310,4344,4071,3583
2004,Rural,Meghalaya,Other Crimes,Fraud,Female,60+,4756,2154,2602,3642,1114
2001,Urban,Uttar Pradesh,Crime Against Men,Extortion,Male,31-45,3412,453,2959,2587,825
2001,Rural,Gujarat,Crime Against Children,Trafficking,Female,31-45,2728,2226,502,2644,84
2009,Rural,Andhra Pradesh,Crime Against Men,Robbery,Male,0-12,329,295,34,299,30
2004,Rural,Haryana,Crime Against Men,Assault,Female,13-17,7023,4288,2735,6928,95
2008,Urban,Sikkim,Property Crime,Burglary,Male,13-17,5304,4135,1169,4988,316
2006,Rural,West Bengal,Other Crimes,Corruption,Female,60+,9856,5128,4728,7209,2647
2005,Rural,Himachal Pradesh,Crime Against Children,Kidnapping,Female,60+,7769,2270,5499,3136,4633
2005,Rural,Tamil Nadu,Crime Against Children,Child Labor,Female,31-45,3635,379,3256,1456,2179
2007,Rural,Manipur,Crime Against Men,Assault,Male,60+,8387,2036,6351,6331,2056
2003,Urban,Meghalaya,Crime Against Children,Child Labor,Male,13-17,8674,5734,2940,8460,214
2008,Urban,Jammu & Kashmir,Crime Against Men,Extortion,Female,13-17,8277,7581,696,7958,319
2006,Urban,Punjab,Property Crime,Theft,Female,46-60,7332,5648,1684,7280,52
2007,Urban,Maharashtra,Property Crime,Arson,Male,13-17,3996,2743,1253,3065,931
2004,Rural,Andhra Pradesh,Crime Against Children,Kidnapping,Male,31-45,4481,4169,312,4340,141
2009,Rural,Haryana,Property Crime,Theft,Male,31-45,9322,7235,2087,9109,213
2009,Urban,Goa,Crime Against Children,Kidnapping,Female,18-30,6713,1875,4838,4756,1957
2004,Urban,Punjab,Crime Against Men,Extortion,Female,13-17,2926,2162,764,2566,360
2009,Rural,Uttar Pradesh,Crime Against Women,Domestic Violence,Male,60+,9654,9171,483,9236,418
2006,Rural,Telangana,Crime Against Men,Extortion,Male,31-45,3529,1201,2328,2305,1224
2003,Urban,Punjab,Property Crime,Theft,Female,60+,3556,2755,801,3373,183
2010,Rural,Karnataka,Other Crimes,Drug Offense,Female,46-60,8690,7985,705,8212,478
2005,Urban,Delhi,Property Crime,Vandalism,Male,60+,4859,3697,1162,4043,816
2004,Rural,Uttarakhand,Property Crime,Arson,Male,0-12,6252,6107,145,6190,62
2007,Rural,Jammu & Kashmir,Crime Against Women,Rape,Female,46-60,5331,580,4751,953,4378
2008,Urban,Telangana,Other Crimes,Drug Offense,Male,60+,6473,2440,4033,5704,769
2010,Urban,Telangana,Property Crime,Burglary,Female,60+,7518,1537,5981,2348,5170
2010,Urban,Odisha,Property Crime,Burglary,Male,46-60,9614,1375,8239,8519,1095
2004,Urban,Odisha,Crime Against Women,Rape,Male,0-12,1093,646,447,845,248
2006,Urban,Tamil Nadu,Crime Against Children,Kidnapping,Male,60+,3059,159,2900,1293,1766
2009,Urban,Maharashtra,Other Crimes,Drug Offense,Female,13-17,1453,1395,58,1452,1
2004,Urban,Sikkim,Crime Against Children,Kidnapping,Female,60+,6162,4499,1663,4516,1646
2002,Urban,Delhi,Property Crime,Arson,Male,0-12,4127,3369,758,4017,110
2008,Rural,Uttar Pradesh,Crime Against Children,Kidnapping,Female,60+,3956,1493,2463,3309,647
2006,Urban,Uttarakhand,Crime Against Men,Assault,Female,13-17,6440,2090,4350,6243,197
2007,Rural,Bihar,Crime Against Women,Dowry Deaths,Male,46-60,6164,5058,1106,5527,637
2003,Rural,Rajasthan,Crime Against Women,Rape,Female,60+,5173,3099,2074,3632,1541
2010,Rural,Haryana,Crime Against Men,Murder,Female,0-12,2048,476,1572,907,1141
2007,Urban,Assam,Other Crimes,Corruption,Male,46-60,7954,7841,113,7880,74
2007,Urban,Meghalaya,Crime Against Children,Child Abuse,Male,31-45,7051,1721,5330,3939,3112
2007,Urban,Assam,Other Crimes,Cyber Crime,Male,0-12,1756,1265,491,1557,199
2009,Rural,Sikkim,Property Crime,Arson,Female,0-12,234,112,122,123,111
2005,Rural,Manipur,Crime Against Children,Kidnapping,Male,60+,7982,6351,1631,6381,1601
2004,Urban,Mizoram,Other Crimes,Drug Offense,Male,46-60,1481,1405,76,1449,32
2001,Urban,Maharashtra,Crime Against Women,Molestation,Female,0-12,4236,1942,2294,2543,1693
2001,Urban,Kerala,Crime Against Women,Dowry Deaths,Female,46-60,2497,1923,574,2161,336
2005,Rural,Meghalaya,Crime Against Children,Trafficking,Female,13-17,4634,3388,1246,4090,544
2010,Rural,Maharashtra,Crime Against Men,Murder,Female,0-12,2898,2849,49,2869,29
2003,Urban,Gujarat,Property Crime,Theft,Male,0-12,5018,2585,2433,4138,880
2004,Rural,Sikkim,Crime Against Women,Domestic Violence,Female,31-45,854,434,420,651,203
2004,Urban,Kerala,Crime Against Women,Rape,Male,60+,3208,2861,347,2950,258
2010,Urban,Mizoram,Other Crimes,Fraud,Male,31-45,2015,810,1205,888,1127
2004,Urban,Karnataka,Property Crime,Burglary,Female,31-45,7240,2320,4920,2487,4753
2004,Urban,Manipur,Crime Against Women,Rape,Female,18-30,7356,3948,3408,6323,1033
2004,Urban,Himachal Pradesh,Crime Against Children,Child Labor,Female,60+,8181,7749,432,8157,24
2008,Urban,Bihar,Crime Against Men,Murder,Female,31-45,5092,139,4953,165,4927
2002,Rural,Himachal Pradesh,Other Crimes,Cyber Crime,Male,18-30,4462,444,4018,1300,3162
2009,Urban,Meghalaya,Crime Against Men,Extortion,Female,18-30,337,97,240,149,188
2007,Rural,Assam,Crime Against Men,Extortion,Male,31-45,8162,5326,2836,7137,1025
2004,Rural,Delhi,Crime Against Men,Murder,Female,60+,9151,4636,4515,7999,1152
2002,Urban,Meghalaya,Property Crime,Arson,Male,13-17,8994,8267,727,8789,205
2002,Rural,Bihar,Other Crimes,Corruption,Male,46-60,9231,7715,1516,8704,527
2006,Urban,Kerala,Crime Against Children,Child Labor,Male,60+,1384,557,827,931,453
2001,Rural,Andhra Pradesh,Other Crimes,Fraud,Female,13-17,9284,3084,6200,4897,4387
2005,Urban,Himachal Pradesh,Property Crime,Theft,Male,18-30,8605,2554,6051,3431,5174
2010,Urban,Jammu & Kashmir,Property Crime,Arson,Male,0-12,9832,3394,6438,8562,1270
2005,Urban,Chhattisgarh,Crime Against Men,Murder,Male,18-30,7223,1750,5473,2924,4299
2003,Rural,Assam,Crime Against Women,Rape,Female,13-17,3713,166,3547,386,3327
2002,Rural,West Bengal,Property Crime,Arson,Female,13-17,8113,7460,653,7932,181
2002,Urban,Telangana,Crime Against Women,Dowry Deaths,Male,18-30,7970,7361,609,7712,258
2008,Urban,Mizoram,Property Crime,Vandalism,Female,46-60,7254,3223,4031,5880,1374
2003,Rural,Goa,Crime Against Men,Extortion,Male,60+,9911,3187,6724,4128,5783
2006,Urban,Jammu & Kashmir,Crime Against Children,Trafficking,Male,46-60,8547,8470,77,8497,50
2007,Urban,Kerala,Crime Against Women,Molestation,Male,60+,3376,930,2446,1883,1493
2007,Rural,Maharashtra,Crime Against Women,Dowry Deaths,Female,18-30,5383,3767,1616,4137,1246
2003,Rural,Karnataka,Other Crimes,Corruption,Male,0-12,9374,1387,7987,6974,2400
2005,Urban,Assam,Property Crime,Theft,Male,60+,3041,812,2229,2966,75
2010,Rural,Rajasthan,Other Crimes,Drug Offense,Female,13-17,2504,1260,1244,1798,706
2003,Urban,Nagaland,Property Crime,Burglary,Female,0-12,5213,2933,2280,5002,211
2008,Rural,Odisha,Property Crime,Burglary,Male,60+,1697,31,1666,52,1645
2002,Urban,Arunachal Pradesh,Property Crime,Arson,Male,60+,9406,337,9069,345,9061
2003,Rural,Manipur,Crime Against Women,Dowry Deaths,Female,13-17,4942,1341,3601,4455,487
2006,Urban,Kerala,Property Crime,Arson,Female,46-60,8737,1941,6796,4463,4274
2002,Urban,Odisha,Property Crime,Theft,Female,60+,6311,3655,2656,5539,772
2006,Urban,Himachal Pradesh,Property Crime,Theft,Female,18-30,1032,52,980,448,584
2006,Rural,Tripura,Crime Against Men,Assault,Male,46-60,707,308,399,519,188
2001,Rural,Bihar,Property Crime,Vandalism,Male,18-30,7184,7026,158,7043,141
2008,Urban,Tamil Nadu,Crime Against Children,Kidnapping,Female,13-17,4061,2629,1432,3269,792
2003,Rural,Kerala,Crime Against Men,Murder,Male,0-12,7757,478,7279,3274,4483
2001,Urban,Uttarakhand,Crime Against Women,Domestic Violence,Male,0-12,2474,2399,75,2473,1
2010,Urban,Nagaland,Property Crime,Burglary,Male,18-30,1874,1643,231,1767,107
2005,Rural,Uttar Pradesh,Property Crime,Burglary,Female,13-17,6200,4430,1770,5763,437
2003,Urban,Arunachal Pradesh,Other Crimes,Cyber Crime,Male,31-45,5321,4001,1320,4407,914
2006,Urban,Tripura,Crime Against Children,Child Abuse,Female,60+,5455,4306,1149,4434,1021
2004,Rural,Delhi,Property Crime,Theft,Female,18-30,5650,5612,38,5612,38
2003,Urban,Jammu & Kashmir,Property Crime,Burglary,Male,13-17,3431,2307,1124,3084,347
2009,Rural,Mizoram,Crime Against Women,Dowry Deaths,Female,0-12,6782,5883,899,6035,747
2008,Rural,Jharkhand,Other Crimes,Corruption,Female,31-45,9704,7959,1745,8741,963
2001,Rural,Nagaland,Property Crime,Theft,Female,18-30,2917,825,2092,1269,1648
2001,Urban,Punjab,Property Crime,Vandalism,Male,60+,5690,1521,4169,5007,683
2006,Urban,Uttarakhand,Other Crimes,Cyber Crime,Male,31-45,7718,3981,3737,7445,273
2005,Rural,Delhi,Crime Against Women,Dowry Deaths,Female,18-30,2477,1975,502,2284,193
2004,Urban,Mizoram,Crime Against Women,Rape,Female,46-60,6370,4114,2256,4879,1491
2008,Urban,Karnataka,Crime Against Women,Molestation,Female,46-60,2321,1101,1220,1956,365
2004,Rural,Gujarat,Property Crime,Theft,Male,18-30,6395,5215,1180,6382,13
2007,Rural,Meghalaya,Other Crimes,Fraud,Female,31-45,2408,1127,1281,1866,542
2002,Urban,Goa,Crime Against Men,Robbery,Female,46-60,4263,2021,2242,2705,1558
2001,Rural,Arunachal Pradesh,Property Crime,Theft,Male,31-45,3518,1505,2013,1741,1777
2004,Urban,Nagaland,Crime Against Children,Child Labor,Female,0-12,85,20,65,29,56
2002,Urban,Arunachal Pradesh,Crime Against Women,Domestic Violence,Male,13-17,2965,2221,744,2500,465
2010,Rural,Meghalaya,Crime Against Men,Robbery,Male,31-45,3788,40,3748,900,2888
2010,Urban,Nagaland,Crime Against Women,Dowry Deaths,Male,46-60,9663,3562,6101,9591,72
2001,Rural,West Bengal,Other Crimes,Drug Offense,Male,46-60,8259,8240,19,8257,2
2010,Rural,Mizoram,Crime Against Men,Robbery,Male,46-60,1569,901,668,1449,120
2008,Urban,Uttarakhand,Crime Against Men,Extortion,Male,60+,8257,978,7279,2412,5845
2006,Rural,Gujarat,Property Crime,Theft,Male,31-45,4785,4720,65,4766,19
2005,Rural,Tamil Nadu,Crime Against Children,Child Labor,Female,18-30,7186,1876,5310,5564,1622
2002,Rural,Delhi,Crime Against Men,Robbery,Male,31-45,8561,6242,2319,7660,901
2007,Urban,Goa,Crime Against Children,Child Abuse,Male,46-60,6513,6445,68,6464,49
2005,Rural,West Bengal,Other Crimes,Corruption,Male,31-45,3072,751,2321,1297,1775
2007,Rural,Tripura,Property Crime,Theft,Male,46-60,370,44,326,308,62
2001,Rural,Mizoram,Other Crimes,Cyber Crime,Male,13-17,4425,3703,722,4000,425
2005,Rural,Sikkim,Crime Against Men,Assault,Male,13-17,2170,1038,1132,2004,166
2009,Rural,Himachal Pradesh,Crime Against Children,Trafficking,Male,18-30,9135,4250,4885,7724,1411
2007,Urban,Arunachal Pradesh,Property Crime,Burglary,Female,0-12,2128,784,1344,952,1176
2009,Rural,Jharkhand,Crime Against Children,Kidnapping,Female,31-45,8918,8421,497,8451,467
2008,Urban,Uttar Pradesh,Property Crime,Theft,Male,31-45,9708,4378,5330,9031,677
2009,Urban,Jammu & Kashmir,Other Crimes,Cyber Crime,Male,46-60,809,148,661,308,501
2008,Urban,Sikkim,Crime Against Men,Extortion,Female,13-17,9669,2424,7245,3958,5711
2008,Urban,Chhattisgarh,Crime Against Men,Murder,Female,18-30,9534,8938,596,9484,50
2007,Urban,Arunachal Pradesh,Crime Against Men,Assault,Male,0-12,3431,669,2762,826,2605
2002,Urban,Uttarakhand,Other Crimes,Drug Offense,Female,18-30,3267,2652,615,2962,305
2009,Urban,Mizoram,Crime Against Men,Extortion,Female,46-60,2935,2884,51,2895,40
2003,Urban,Madhya Pradesh,Other Crimes,Cyber Crime,Female,0-12,6680,2443,4237,6277,403
2009,Urban,Uttar Pradesh,Crime Against Women,Rape,Male,46-60,3473,2059,1414,2806,667
2010,Urban,Sikkim,Crime Against Children,Child Labor,Male,13-17,6000,2506,3494,4882,1118
2002,Rural,Maharashtra,Crime Against Men,Extortion,Male,0-12,4012,3848,164,3852,160
2006,Urban,Maharashtra,Crime Against Children,Child Abuse,Male,0-12,4649,4271,378,4302,347
2008,Urban,Karnataka,Other Crimes,Cyber Crime,Female,18-30,9157,516,8641,8745,412
2007,Urban,Tripura,Property Crime,Theft,Female,0-12,4695,3016,1679,4257,438
2010,Urban,Tripura,Property Crime,Burglary,Female,0-12,4353,50,4303,1539,2814
2009,Urban,Telangana,Property Crime,Burglary,Male,60+,6522,5368,1154,5393,1129
2006,Urban,Uttar Pradesh,Crime Against Children,Child Abuse,Female,46-60,109,27,82,102,7
2010,Rural,Jharkhand,Other Crimes,Corruption,Female,60+,8805,3357,5448,6656,2149
2010,Urban,Gujarat,Other Crimes,Cyber Crime,Female,18-30,1333,845,488,1275,58
2004,Rural,Madhya Pradesh,Other Crimes,Corruption,Female,18-30,5192,2077,3115,2465,2727
2002,Rural,Jharkhand,Other Crimes,Cyber Crime,Female,46-60,2737,2110,627,2602,135
2003,Rural,West Bengal,Crime Against Men,Robbery,Female,13-17,6334,4602,1732,5088,1246
2008,Rural,Gujarat,Crime Against Women,Rape,Male,18-30,9597,9555,42,9564,33
2007,Urban,Sikkim,Crime Against Women,Dowry Deaths,Female,46-60,5972,3302,2670,4775,1197
2008,Rural,Telangana,Crime Against Men,Extortion,Male,13-17,9878,6308,3570,9265,613
2003,Urban,Chhattisgarh,Property Crime,Vandalism,Female,13-17,1117,203,914,439,678
2007,Rural,Andhra Pradesh,Crime Against Children,Trafficking,Female,0-12,4994,3268,1726,4821,173
2004,Urban,Gujarat,Crime Against Children,Child Labor,Male,60+,585,229,356,288,297
2001,Urban,Maharashtra,Other Crimes,Corruption,Female,0-12,3896,1406,2490,3331,565
2006,Rural,Gujarat,Crime Against Children,Child Abuse,Male,0-12,3000,361,2639,395,2605
2005,Urban,Telangana,Other Crimes,Drug Offense,Male,0-12,9911,767,9144,6204,3707
2004,Rural,West Bengal,Crime Against Men,Murder,Male,31-45,5681,1368,4313,3282,2399
2006,Rural,Haryana,Crime Against Children,Child Labor,Female,18-30,9279,5017,4262,7469,1810
2004,Rural,Himachal Pradesh,Crime Against Men,Robbery,Male,18-30,2935,51,2884,160,2775
2010,Rural,Telangana,Crime Against Children,Child Abuse,Male,46-60,2753,681,2072,1759,994
2001,Urban,Haryana,Property Crime,Burglary,Male,46-60,1635,580,1055,1542,93
2004,Urban,Tripura,Property Crime,Arson,Male,13-17,2336,271,2065,401,1935
2010,Urban,Chhattisgarh,Crime Against Women,Molestation,Female,18-30,8007,1116,6891,1890,6117
2005,Rural,Tripura,Crime Against Women,Rape,Male,46-60,2732,1102,1630,2405,327
2006,Rural,Bihar,Crime Against Women,Rape,Female,46-60,5488,4032,1456,5318,170
2004,Rural,Telangana,Crime Against Children,Child Abuse,Male,0-12,3891,2816,1075,2818,1073
2004,Rural,Rajasthan,Other Crimes,Corruption,Male,31-45,4574,834,3740,990,3584
2007,Urban,Mizoram,Crime Against Children,Child Abuse,Male,60+,1379,437,942,547,832
2003,Rural,Tamil Nadu,Property Crime,Burglary,Female,0-12,7926,4287,3639,5069,2857
2004,Rural,West Bengal,Crime Against Women,Dowry Deaths,Female,60+,4051,589,3462,2370,1681
2008,Rural,Mizoram,Crime Against Men,Murder,Female,13-17,9297,5871,3426,8826,471
2009,Urban,Rajasthan,Other Crimes,Corruption,Male,60+,3938,1565,2373,2441,1497
2005,Urban,Odisha,Crime Against Men,Assault,Male,31-45,2434,1084,1350,1732,702
2002,Urban,Manipur,Crime Against Children,Kidnapping,Female,18-30,8989,7189,1800,7507,1482
2005,Rural,Goa,Crime Against Children,Trafficking,Female,46-60,2846,2579,267,2623,223
2002,Urban,Delhi,Crime Against Children,Kidnapping,Male,46-60,8387,3212,5175,4211,4176
2004,Rural,Chhattisgarh,Property Crime,Arson,Female,18-30,5338,45,5293,2130,3208
2007,Rural,Himachal Pradesh,Other Crimes,Cyber Crime,Female,46-60,8989,5179,3810,6047,2942
2007,Urban,Odisha,Property Crime,Vandalism,Male,31-45,9148,8899,249,9040,108
2006,Urban,Jharkhand,Property Crime,Vandalism,Female,31-45,4410,1916,2494,2468,1942
2005,Urban,Goa,Crime Against Men,Assault,Female,13-17,108,61,47,62,46
2001,Rural,Jharkhand,Property Crime,Theft,Female,31-45,8600,858,7742,8165,435
2007,Rural,Goa,Property Crime,Burglary,Male,60+,8325,7817,508,8152,173
2005,Urban,Gujarat,Crime Against Children,Kidnapping,Female,13-17,7264,4919,2345,5548,1716
2010,Urban,Mizoram,Crime Against Men,Robbery,Female,31-45,5046,498,4548,3798,1248
2001,Rural,West Bengal,Crime Against Men,Murder,Male,31-45,2889,1713,1176,2524,365
2005,Rural,Haryana,Other Crimes,Fraud,Female,31-45,6642,30,6612,5985,657
2002,Rural,Odisha,Crime Against Children,Child Abuse,Male,18-30,9838,1941,7897,5051,4787
2002,Rural,Bihar,Crime Against Women,Dowry Deaths,Male,0-12,862,214,648,459,403
2009,Urban,Telangana,Crime Against Women,Domestic Violence,Male,60+,1224,1002,222,1045,179
2010,Urban,Assam,Crime Against Men,Extortion,Male,31-45,222,150,72,175,47
2002,Rural,Madhya Pradesh,Crime Against Children,Trafficking,Male,60+,2354,1814,540,1994,360
2002,Rural,Kerala,Other Crimes,Drug Offense,Female,13-17,472,41,431,371,101
2010,Rural,Uttar Pradesh,Crime Against Women,Molestation,Female,0-12,4527,4381,146,4464,63
2001,Rural,Uttar Pradesh,Property Crime,Burglary,Female,60+,8874,3355,5519,5264,3610
2008,Rural,Goa,Crime Against Men,Murder,Male,0-12,7662,3759,3903,6433,1229
2009,Rural,Mizoram,Other Crimes,Drug Offense,Female,0-12,2545,1992,553,2280,265
2008,Urban,Telangana,Property Crime,Theft,Female,13-17,204,77,127,158,46
2009,Rural,Sikkim,Crime Against Women,Rape,Male,0-12,7321,1207,6114,5264,2057
2001,Rural,Chhattisgarh,Crime Against Women,Rape,Female,31-45,1451,406,1045,1059,392
2010,Urban,Manipur,Crime Against Children,Trafficking,Male,60+,5094,1655,3439,2682,2412
2007,Rural,Tripura,Crime Against Men,Assault,Female,31-45,7973,365,7608,7477,496
2010,Urban,Tamil Nadu,Crime Against Men,Robbery,Female,18-30,3941,1143,2798,1925,2016
2005,Rural,Jharkhand,Crime Against Women,Molestation,Male,18-30,1973,159,1814,771,1202
2008,Urban,Chhattisgarh,Crime Against Men,Assault,Female,31-45,8663,6411,2252,7601,1062
2010,Urban,Rajasthan,Crime Against Men,Murder,Female,13-17,5344,2484,2860,2650,2694
2001,Rural,Sikkim,Property Crime,Burglary,Female,46-60,4032,665,3367,2499,1533
2001,Urban,West Bengal,Crime Against Children,Child Labor,Female,0-12,8301,2405,5896,7578,723
2005,Urban,Uttarakhand,Property Crime,Theft,Male,13-17,2907,401,2506,2425,482
2009,Urban,Sikkim,Property Crime,Vandalism,Female,46-60,2396,879,1517,1852,544
2009,Urban,Manipur,Property Crime,Burglary,Male,60+,6026,1049,4977,3864,2162
2007,Urban,Chhattisgarh,Crime Against Children,Kidnapping,Male,13-17,6320,4401,1919,5806,514
2006,Rural,Mizoram,Crime Against Women,Domestic Violence,Female,18-30,5981,294,5687,3147,2834
2006,Rural,Gujarat,Property Crime,Theft,Male,46-60,8328,5483,2845,6915,1413
2009,Urban,Jharkhand,Crime Against Children,Trafficking,Female,0-12,5583,2327,3256,4624,959
2010,Rural,Assam,Other Crimes,Corruption,Male,31-45,6428,4238,2190,6078,350
2003,Urban,Bihar,Crime Against Children,Child Labor,Female,18-30,2726,35,2691,482,2244
2009,Urban,West Bengal,Property Crime,Theft,Female,60+,5309,1587,3722,3186,2123
2002,Rural,Jammu & Kashmir,Crime Against Men,Murder,Female,13-17,5151,4680,471,5133,18
2001,Urban,Odisha,Crime Against Women,Domestic Violence,Male,0-12,3719,26,3693,2183,1536
2005,Rural,Himachal Pradesh,Crime Against Men,Assault,Female,31-45,7982,6868,1114,7739,243
2002,Urban,West Bengal,Property Crime,Vandalism,Male,13-17,8154,634,7520,1823,6331
2001,Urban,Himachal Pradesh,Crime Against Children,Child Abuse,Female,13-17,372,351,21,359,13
2003,Urban,Bihar,Crime Against Women,Molestation,Male,46-60,2102,462,1640,611,1491
2006,Urban,Chhattisgarh,Crime Against Women,Molestation,Female,18-30,7720,1200,6520,5384,2336
2004,Urban,Bihar,Other Crimes,Drug Offense,Male,18-30,9081,1985,7096,4903,4178
2010,Urban,Gujarat,Crime Against Men,Murder,Female,13-17,6951,2292,4659,4784,2167
2010,Urban,Jharkhand,Crime Against Women,Dowry Deaths,Female,0-12,8302,5418,2884,7002,1300
2001,Urban,Nagaland,Crime Against Women,Rape,Female,31-45,8014,7965,49,7989,25
2009,Urban,Arunachal Pradesh,Property Crime,Burglary,Male,60+,5129,969,4160,3073,2056
2001,Rural,Nagaland,Crime Against Men,Assault,Male,31-45,8153,7080,1073,7645,508
2009,Urban,Uttarakhand,Property Crime,Vandalism,Female,31-45,5492,5114,378,5274,218
2004,Urban,Chhattisgarh,Crime Against Men,Murder,Female,46-60,4376,2406,1970,3072,1304
2010,Urban,Nagaland,Crime Against Men,Extortion,Female,13-17,1546,1410,136,1439,107
2004,Urban,Himachal Pradesh,Crime Against Women,Domestic Violence,Male,60+,7293,6999,294,7188,105
2009,Urban,Jharkhand,Other Crimes,Cyber Crime,Female,60+,1824,968,856,1229,595
2002,Urban,Goa,Crime Against Children,Child Labor,Male,13-17,8663,3310,5353,8599,64
2010,Rural,Manipur,Crime Against Children,Child Labor,Male,0-12,4763,32,4731,2520,2243
2006,Rural,Punjab,Crime Against Children,Child Abuse,Male,13-17,7854,7242,612,7681,173
2007,Rural,Telangana,Other Crimes,Fraud,Female,0-12,1379,322,1057,1331,48
2003,Rural,Nagaland,Crime Against Children,Child Abuse,Female,60+,8704,2291,6413,3231,5473
2008,Rural,Manipur,Crime Against Women,Dowry Deaths,Female,18-30,9600,2606,6994,3509,6091
2009,Urban,Goa,Other Crimes,Fraud,Male,60+,5002,4594,408,4699,303
2004,Rural,Maharashtra,Crime Against Men,Assault,Male,60+,4061,2907,1154,3191,870
2010,Urban,Assam,Crime Against Children,Kidnapping,Female,0-12,6467,5446,1021,5508,959
2003,Urban,Kerala,Crime Against Children,Child Labor,Male,31-45,8409,5046,3363,6168,2241
2010,Rural,Arunachal Pradesh,Property Crime,Vandalism,Male,46-60,2450,1295,1155,2232,218
2001,Rural,Karnataka,Crime Against Men,Robbery,Male,18-30,8494,714,7780,1036,7458
2004,Urban,Assam,Crime Against Children,Child Abuse,Male,46-60,7301,6043,1258,6338,963
2007,Urban,Uttarakhand,Property Crime,Burglary,Female,60+,1814,858,956,997,817
2008,Rural,Uttarakhand,Property Crime,Vandalism,Female,60+,5760,2757,3003,4126,1634
2010,Urban,West Bengal,Crime Against Women,Rape,Female,60+,1961,1296,665,1695,266
2009,Rural,Karnataka,Other Crimes,Cyber Crime,Female,60+,883,878,5,882,1
2006,Urban,Andhra Pradesh,Property Crime,Arson,Male,31-45,957,101,856,479,478
2002,Rural,Jammu & Kashmir,Crime Against Children,Trafficking,Male,18-30,590,166,424,247,343
2003,Urban,Goa,Crime Against Children,Child Abuse,Male,60+,196,103,93,111,85
2006,Rural,Haryana,Crime Against Children,Trafficking,Female,46-60,6477,3184,3293,6330,147
2003,Rural,Chhattisgarh,Other Crimes,Drug Offense,Male,46-60,9313,6437,2876,8403,910
2002,Rural,Maharashtra,Crime Against Children,Trafficking,Female,31-45,9634,2081,7553,6908,2726
2003,Rural,Punjab,Crime Against Children,Child Labor,Male,46-60,3821,3242,579,3625,196
2010,Rural,Assam,Crime Against Women,Rape,Male,46-60,1494,285,1209,1255,239
2001,Rural,Sikkim,Crime Against Children,Child Abuse,Male,13-17,8441,4058,4383,7275,1166
2009,Urban,Himachal Pradesh,Other Crimes,Drug Offense,Female,60+,3774,98,3676,2162,1612
2002,Urban,Jammu & Kashmir,Crime Against Men,Robbery,Male,46-60,4628,960,3668,1303,3325
2007,Urban,Himachal Pradesh,Crime Against Women,Dowry Deaths,Female,60+,5321,207,5114,3265,2056
2003,Urban,Delhi,Crime Against Children,Child Labor,Female,60+,9286,270,9016,5507,3779
2003,Urban,Maharashtra,Property Crime,Theft,Male,46-60,4812,1724,3088,3420,1392
2006,Rural,Haryana,Property Crime,Vandalism,Male,0-12,4651,2453,2198,3471,1180
2006,Rural,Delhi,Crime Against Women,Molestation,Female,60+,5222,1426,3796,2615,2607
2008,Urban,Goa,Crime Against Women,Molestation,Male,60+,5720,1797,3923,2477,3243
2010,Rural,Bihar,Property Crime,Theft,Female,60+,2271,1203,1068,1999,272
2008,Rural,Haryana,Other Crimes,Cyber Crime,Male,60+,4725,2913,1812,3681,1044
2007,Urban,Uttarakhand,Crime Against Women,Molestation,Female,60+,3807,44,3763,2112,1695
2010,Urban,Uttarakhand,Other Crimes,Drug Offense,Female,18-30,3741,931,2810,2024,1717
2002,Rural,Mizoram,Crime Against Men,Robbery,Female,18-30,9397,324,9073,6019,3378
2006,Rural,Arunachal Pradesh,Crime Against Women,Rape,Female,60+,5055,3809,1246,4726,329
2004,Urban,Jammu & Kashmir,Crime Against Children,Kidnapping,Male,60+,7165,2097,5068,5049,2116
2002,Rural,Rajasthan,Crime Against Women,Dowry Deaths,Male,46-60,7520,1615,5905,2414,5106
2009,Rural,Uttarakhand,Crime Against Women,Dowry Deaths,Female,13-17,5488,4369,1119,4638,850
2010,Urban,Uttarakhand,Crime Against Men,Robbery,Female,0-12,5576,1625,3951,3063,2513
2002,Urban,Jammu & Kashmir,Other Crimes,Cyber Crime,Female,0-12,6119,355,5764,4865,1254
2004,Rural,Mizoram,Crime Against Women,Rape,Female,18-30,1686,1244,442,1676,10
2002,Rural,Arunachal Pradesh,Crime Against Children,Kidnapping,Male,60+,936,822,114,909,27
2006,Urban,Maharashtra,Crime Against Children,Child Abuse,Male,0-12,1371,817,554,949,422
2004,Urban,Jharkhand,Crime Against Children,Trafficking,Male,0-12,3606,1358,2248,3495,111
2005,Urban,Uttarakhand,Crime Against Men,Assault,Male,60+,9115,1834,7281,3333,5782
2002,Urban,Rajasthan,Crime Against Men,Murder,Female,18-30,4580,1829,2751,3994,586
2005,Rural,Goa,Property Crime,Vandalism,Female,31-45,9835,1493,8342,9500,335
2006,Urban,Mizoram,Property Crime,Vandalism,Male,60+,4113,3524,589,3606,507
2002,Urban,Himachal Pradesh,Crime Against Men,Robbery,Female,60+,7344,5590,1754,6758,586
2001,Urban,West Bengal,Other Crimes,Corruption,Male,0-12,5845,411,5434,3701,2144
2003,Rural,Himachal Pradesh,Crime Against Men,Extortion,Male,31-45,2485,1580,905,2236,249
2003,Rural,Assam,Crime Against Men,Murder,Female,31-45,2165,1954,211,1965,200
2005,Rural,Assam,Crime Against Women,Rape,Female,13-17,1771,438,1333,976,795
2008,Rural,Sikkim,Crime Against Women,Molestation,Male,0-12,1351,165,1186,293,1058
2007,Urban,Manipur,Property Crime,Vandalism,Female,0-12,6338,6226,112,6336,2
2009,Urban,Maharashtra,Crime Against Men,Murder,Female,0-12,4491,2461,2030,3886,605
2007,Rural,Arunachal Pradesh,Crime Against Women,Domestic Violence,Female,13-17,5769,5012,757,5554,215
2008,Rural,Kerala,Crime Against Men,Assault,Male,60+,5074,1210,3864,3217,1857
2008,Rural,Mizoram,Crime Against Children,Trafficking,Male,13-17,4464,3794,670,4415,49
2009,Urban,Tamil Nadu,Crime Against Women,Molestation,Male,31-45,6103,475,5628,2756,3347
2002,Urban,Goa,Crime Against Children,Child Abuse,Female,60+,3294,161,3133,707,2587
2005,Rural,Maharashtra,Other Crimes,Corruption,Male,18-30,5059,3125,1934,3839,1220
2009,Urban,Delhi,Property Crime,Burglary,Female,31-45,4731,924,3807,2917,1814
2002,Urban,Odisha,Other Crimes,Corruption,Male,0-12,1297,863,434,1141,156
2009,Rural,Maharashtra,Property Crime,Theft,Male,46-60,8359,3766,4593,4750,3609
2007,Rural,Jharkhand,Crime Against Men,Assault,Male,60+,8474,2362,6112,3948,4526
2005,Urban,Meghalaya,Property Crime,Arson,Male,13-17,8664,2551,6113,3625,5039
2010,Urban,Bihar,Crime Against Men,Robbery,Male,46-60,3199,1507,1692,2599,600
2006,Urban,Arunachal Pradesh,Crime Against Children,Child Labor,Female,31-45,9904,4191,5713,8160,1744
2008,Rural,Kerala,Property Crime,Arson,Female,18-30,2264,2197,67,2218,46
2001,Rural,Arunachal Pradesh,Crime Against Men,Extortion,Female,13-17,6567,6232,335,6464,103
2008,Urban,Maharashtra,Crime Against Men,Robbery,Female,46-60,8700,4958,3742,8242,458
2006,Rural,Arunachal Pradesh,Property Crime,Burglary,Female,60+,8909,4781,4128,6204,2705
2006,Rural,Rajasthan,Property Crime,Theft,Male,46-60,2536,458,2078,1078,1458
2005,Rural,West Bengal,Other Crimes,Cyber Crime,Female,18-30,9533,611,8922,1352,8181
2010,Rural,Nagaland,Other Crimes,Drug Offense,Male,18-30,7207,2532,4675,3915,3292
2008,Urban,Mizoram,Crime Against Children,Trafficking,Male,13-17,8391,6302,2089,6818,1573
2007,Urban,Odisha,Crime Against Men,Extortion,Male,0-12,9098,6001,3097,7859,1239
2005,Rural,Tamil Nadu,Crime Against Women,Domestic Violence,Male,46-60,6687,977,5710,4478,2209
2006,Rural,Bihar,Other Crimes,Fraud,Female,13-17,6520,6283,237,6348,172
2003,Urban,Sikkim,Crime Against Women,Molestation,Male,18-30,7207,5635,1572,6876,331
2001,Urban,Karnataka,Crime Against Children,Kidnapping,Female,31-45,354,229,125,313,41
2004,Urban,Jammu & Kashmir,Property Crime,Arson,Male,60+,3135,2445,690,2793,342
2002,Rural,Arunachal Pradesh,Other Crimes,Cyber Crime,Male,0-12,3123,2913,210,2946,177
2001,Rural,Tamil Nadu,Crime Against Men,Robbery,Male,31-45,6586,3880,2706,5628,958
2010,Urban,Uttar Pradesh,Crime Against Men,Extortion,Female,13-17,2454,122,2332,1512,942
2001,Urban,Telangana,Other Crimes,Corruption,Male,0-12,1353,1333,20,1344,9
2009,Urban,Uttarakhand,Other Crimes,Fraud,Male,31-45,8801,1539,7262,2637,6164
2006,Urban,Assam,Crime Against Men,Extortion,Female,31-45,6992,1673,5319,4985,2007
2001,Urban,Mizoram,Crime Against Women,Dowry Deaths,Female,60+,8880,2815,6065,6295,2585
2008,Urban,Mizoram,Crime Against Children,Child Abuse,Male,13-17,2052,1521,531,1680,372
2008,Rural,Karnataka,Crime Against Men,Murder,Male,18-30,4982,4778,204,4861,121
2005,Rural,Andhra Pradesh,Crime Against Children,Trafficking,Male,46-60,4736,385,4351,2153,2583
2006,Urban,Andhra Pradesh,Crime Against Men,Robbery,Male,46-60,6822,2080,4742,6402,420
2006,Rural,Kerala,Crime Against Men,Assault,Male,31-45,6567,1583,4984,4922,1645
2010,Rural,Rajasthan,Crime Against Women,Dowry Deaths,Male,18-30,2642,526,2116,1343,1299
2008,Urban,Andhra Pradesh,Property Crime,Burglary,Male,31-45,3509,674,2835,2270,1239
2007,Rural,Andhra Pradesh,Other Crimes,Corruption,Female,46-60,3032,1183,1849,2085,947
2006,Rural,Uttar Pradesh,Crime Against Men,Extortion,Male,13-17,4196,794,3402,2260,1936
2007,Urban,Gujarat,Crime Against Children,Child Abuse,Female,18-30,7251,6794,457,6971,280
2002,Urban,Gujarat,Property Crime,Theft,Male,60+,8873,666,8207,3476,5397
2005,Rural,Punjab,Crime Against Children,Child Abuse,Female,46-60,2954,2097,857,2135,819
2005,Rural,Uttarakhand,Crime Against Women,Dowry Deaths,Female,13-17,3042,1334,1708,1643,1399
2007,Rural,Maharashtra,Crime Against Children,Trafficking,Female,31-45,2822,733,2089,944,1878
2008,Urban,Gujarat,Crime Against Women,Rape,Male,18-30,3235,2603,632,3066,169
2001,Rural,Assam,Crime Against Men,Extortion,Male,13-17,5092,1988,3104,4016,1076
2004,Urban,Uttarakhand,Other Crimes,Fraud,Male,31-45,5114,646,4468,2880,2234
2002,Urban,Nagaland,Other Crimes,Fraud,Female,31-45,5823,3590,2233,3816,2007
2009,Urban,Manipur,Other Crimes,Drug Offense,Male,31-45,333,120,213,306,27
2010,Urban,Tripura,Property Crime,Burglary,Male,13-17,940,508,432,736,204
2002,Rural,Mizoram,Crime Against Children,Trafficking,Female,46-60,3026,2409,617,2542,484
2005,Urban,Odisha,Crime Against Men,Robbery,Male,60+,5965,1598,4367,3533,2432
2008,Urban,Assam,Other Crimes,Corruption,Male,13-17,6292,5227,1065,5823,469
2005,Urban,Chhattisgarh,Other Crimes,Drug Offense,Female,46-60,3048,2978,70,2984,64
2006,Urban,Mizoram,Crime Against Children,Trafficking,Male,60+,8037,7106,931,7725,312
2006,Urban,Bihar,Crime Against Men,Extortion,Male,13-17,3880,2067,1813,3631,249
2008,Urban,Sikkim,Crime Against Children,Child Abuse,Female,13-17,8096,3555,4541,3917,4179
2005,Urban,Nagaland,Crime Against Children,Trafficking,Male,18-30,5102,3045,2057,3591,1511
2004,Urban,Uttarakhand,Crime Against Men,Murder,Female,18-30,9117,2896,6221,6547,2570
2009,Rural,Assam,Crime Against Men,Assault,Male,18-30,2369,1430,939,1601,768
2001,Urban,Bihar,Crime Against Men,Robbery,Female,0-12,6773,6725,48,6731,42
2001,Rural,Delhi,Crime Against Women,Dowry Deaths,Male,60+,9962,443,9519,7056,2906
2009,Rural,Himachal Pradesh,Property Crime,Theft,Female,46-60,5269,226,5043,4871,398
2008,Urban,Telangana,Other Crimes,Cyber Crime,Female,18-30,5256,1384,3872,1666,3590
2002,Urban,Jharkhand,Crime Against Children,Trafficking,Female,18-30,2079,1978,101,2066,13
2009,Urban,Sikkim,Other Crimes,Drug Offense,Female,18-30,712,111,601,120,592
2004,Rural,Uttarakhand,Property Crime,Arson,Male,0-12,5942,577,5365,630,5312
2010,Rural,Odisha,Crime Against Women,Domestic Violence,Female,31-45,3435,2692,743,2957,478
2002,Urban,Kerala,Crime Against Children,Child Abuse,Female,60+,6704,6048,656,6655,49
2005,Urban,Punjab,Crime Against Women,Molestation,Male,0-12,4773,1261,3512,2617,2156
2003,Urban,Tripura,Property Crime,Vandalism,Female,60+,3346,3005,341,3012,334
2009,Urban,Sikkim,Property Crime,Theft,Female,13-17,9492,254,9238,7063,2429
2007,Urban,Himachal Pradesh,Crime Against Children,Child Labor,Male,60+,5724,4431,1293,5309,415
2008,Rural,Bihar,Property Crime,Burglary,Female,60+,7460,6653,807,6703,757
2006,Urban,West Bengal,Crime Against Men,Extortion,Male,18-30,8536,2016,6520,7810,726
2009,Rural,Mizoram,Crime Against Women,Molestation,Male,0-12,8868,2520,6348,3660,5208
2001,Urban,Sikkim,Property Crime,Burglary,Female,18-30,1123,679,444,699,424
2005,Rural,Uttar Pradesh,Crime Against Women,Domestic Violence,Female,31-45,8340,8135,205,8311,29
2008,Urban,Uttarakhand,Crime Against Children,Trafficking,Female,18-30,1325,93,1232,1119,206
2010,Urban,Rajasthan,Crime Against Women,Rape,Female,31-45,263,78,185,185,78
2003,Rural,Tamil Nadu,Other Crimes,Fraud,Female,18-30,3498,2968,530,3364,134
2009,Urban,Delhi,Crime Against Men,Murder,Female,46-60,6793,1679,5114,5172,1621
2006,Rural,Delhi,Crime Against Men,Robbery,Male,18-30,2884,967,1917,2642,242
2005,Rural,Mizoram,Crime Against Children,Child Abuse,Male,60+,8490,4983,3507,6506,1984
2002,Rural,Arunachal Pradesh,Property Crime,Burglary,Female,18-30,3171,1568,1603,2513,658
2006,Urban,Uttarakhand,Crime Against Men,Assault,Female,60+,6800,717,6083,4225,2575
2006,Rural,Jharkhand,Crime Against Women,Dowry Deaths,Male,0-12,1585,100,1485,313,1272
2009,Rural,Meghalaya,Property Crime,Burglary,Female,0-12,3650,164,3486,2109,1541
2007,Urban,Nagaland,Crime Against Men,Extortion,Male,13-17,6615,5287,1328,5507,1108
2007,Rural,Chhattisgarh,Other Crimes,Drug Offense,Male,18-30,1033,811,222,985,48
2005,Rural,Uttarakhand,Other Crimes,Cyber Crime,Female,46-60,4403,4364,39,4390,13
2001,Rural,West Bengal,Property Crime,Burglary,Female,31-45,7262,6638,624,7216,46
2001,Urban,Manipur,Crime Against Children,Trafficking,Male,0-12,3076,3022,54,3030,46
2008,Urban,Mizoram,Crime Against Children,Trafficking,Female,18-30,5826,1494,4332,4512,1314
2003,Rural,Sikkim,Crime Against Men,Murder,Male,60+,6904,4549,2355,5622,1282
2007,Urban,Jharkhand,Crime Against Women,Rape,Female,31-45,1227,26,1201,948,279
2005,Urban,Mizoram,Crime Against Men,Extortion,Female,60+,4931,3170,1761,3529,1402
2007,Rural,Madhya Pradesh,Crime Against Women,Dowry Deaths,Female,0-12,568,531,37,543,25
2005,Rural,Uttar Pradesh,Property Crime,Vandalism,Male,60+,1934,358,1576,1572,362
2010,Urban,Jammu & Kashmir,Other Crimes,Cyber Crime,Female,0-12,7809,7441,368,7751,58
2008,Urban,Andhra Pradesh,Crime Against Women,Dowry Deaths,Male,60+,328,15,313,164,164
2004,Urban,West Bengal,Crime Against Children,Child Labor,Male,46-60,3997,2915,1082,3780,217
2003,Urban,Chhattisgarh,Crime Against Women,Dowry Deaths,Male,31-45,8987,985,8002,6003,2984
2010,Urban,Madhya Pradesh,Property Crime,Burglary,Female,18-30,1112,1076,36,1088,24
2010,Rural,Chhattisgarh,Crime Against Men,Extortion,Male,18-30,9416,7107,2309,8027,1389
2005,Rural,Tripura,Other Crimes,Corruption,Female,31-45,7298,2598,4700,4708,2590
2004,Rural,Punjab,Crime Against Children,Trafficking,Female,13-17,1110,433,677,965,145
2001,Urban,Assam,Other Crimes,Fraud,Female,46-60,6433,391,6042,5493,940
2006,Rural,Andhra Pradesh,Crime Against Children,Child Labor,Female,13-17,9738,8563,1175,9316,422
2002,Urban,Meghalaya,Crime Against Children,Child Abuse,Female,31-45,3291,2374,917,2393,898
2006,Urban,Odisha,Crime Against Children,Child Labor,Male,0-12,6237,47,6190,4652,1585
2009,Rural,Tripura,Other Crimes,Drug Offense,Male,60+,3723,2616,1107,3042,681
2010,Urban,Kerala,Crime Against Women,Dowry Deaths,Male,18-30,4143,1651,2492,3115,1028
2004,Urban,Goa,Crime Against Men,Murder,Female,13-17,3234,1547,1687,1656,1578
2003,Urban,Assam,Other Crimes,Cyber Crime,Female,0-12,5781,2494,3287,4733,1048
2004,Urban,Arunachal Pradesh,Property Crime,Vandalism,Male,18-30,2320,975,1345,1709,611
2004,Rural,Assam,Crime Against Children,Child Abuse,Female,60+,4128,822,3306,3743,385
2006,Rural,Rajasthan,Other Crimes,Fraud,Female,60+,8587,4616,3971,5094,3493
2004,Urban,Delhi,Crime Against Women,Rape,Female,18-30,4705,669,4036,3524,1181
2001,Rural,Jammu & Kashmir,Crime Against Men,Assault,Male,18-30,9157,7913,1244,7992,1165
2002,Rural,Telangana,Crime Against Women,Dowry Deaths,Male,31-45,2245,129,2116,2142,103
2006,Rural,Telangana,Property Crime,Burglary,Female,46-60,2553,2335,218,2365,188
2003,Urban,Haryana,Crime Against Children,Kidnapping,Male,46-60,5402,4972,430,5129,273
2003,Urban,Jharkhand,Crime Against Children,Child Abuse,Female,60+,1582,270,1312,281,1301
2001,Urban,Tripura,Crime Against Men,Robbery,Male,31-45,4005,253,3752,1287,2718
2001,Urban,Delhi,Property Crime,Vandalism,Female,46-60,6700,1206,5494,3341,3359
2005,Rural,Rajasthan,Crime Against Children,Child Labor,Male,13-17,4883,799,4084,4622,261
2009,Rural,Tripura,Other Crimes,Drug Offense,Male,31-45,7552,6788,764,7188,364
2010,Rural,Mizoram,Other Crimes,Fraud,Male,31-45,560,161,399,323,237
2005,Rural,Chhattisgarh,Other Crimes,Drug Offense,Male,46-60,3096,45,3051,3068,28
2009,Urban,Arunachal Pradesh,Crime Against Children,Child Abuse,Female,31-45,9612,5709,3903,8889,723
2003,Urban,Kerala,Crime Against Children,Child Labor,Male,46-60,988,943,45,973,15
2008,Rural,Assam,Other Crimes,Cyber Crime,Male,60+,3886,1049,2837,2225,1661
2004,Urban,Punjab,Crime Against Women,Domestic Violence,Male,18-30,9435,325,9110,9001,434
2008,Urban,Odisha,Crime Against Women,Molestation,Female,46-60,2794,105,2689,2432,362
2008,Rural,Odisha,Crime Against Men,Robbery,Male,60+,5573,3028,2545,5025,548
2008,Rural,Manipur,Crime Against Men,Robbery,Male,31-45,1251,549,702,906,345
2002,Urban,Nagaland,Crime Against Men,Murder,Male,60+,1925,1019,906,1443,482
2005,Urban,Madhya Pradesh,Property Crime,Burglary,Male,13-17,9563,6404,3159,8055,1508
2002,Rural,Punjab,Crime Against Children,Trafficking,Male,0-12,6877,3731,3146,3781,3096
2004,Urban,Tripura,Crime Against Men,Robbery,Male,60+,6808,3807,3001,5590,1218
2008,Rural,Manipur,Property Crime,Theft,Female,60+,6535,3235,3300,3626,2909
2006,Urban,Jharkhand,Crime Against Men,Assault,Male,60+,9249,632,8617,5927,3322
2002,Urban,Assam,Other Crimes,Fraud,Female,31-45,335,177,158,201,134
2008,Rural,Punjab,Crime Against Men,Extortion,Female,18-30,6181,3463,2718,4358,1823
2007,Rural,Himachal Pradesh,Other Crimes,Cyber Crime,Male,13-17,5204,1677,3527,2777,2427
2001,Urban,Tamil Nadu,Crime Against Men,Murder,Female,46-60,6640,5263,1377,6102,538
2008,Rural,Arunachal Pradesh,Other Crimes,Fraud,Male,0-12,6286,1769,4517,5632,654
2007,Urban,Jharkhand,Crime Against Men,Assault,Male,46-60,2158,1977,181,2020,138
2003,Rural,Madhya Pradesh,Crime Against Children,Child Abuse,Female,13-17,9635,9587,48,9606,29
2002,Urban,Madhya Pradesh,Property Crime,Burglary,Female,0-12,1233,656,577,704,529
2010,Rural,Kerala,Crime Against Men,Murder,Male,18-30,4746,2924,1822,3120,1626
2007,Rural,Rajasthan,Crime Against Children,Kidnapping,Male,0-12,8162,3762,4400,5708,2454
2005,Rural,Tripura,Crime Against Children,Trafficking,Male,13-17,7462,1049,6413,1295,6167
2004,Rural,Jammu & Kashmir,Other Crimes,Fraud,Female,60+,3189,2249,940,2432,757
2007,Urban,Sikkim,Crime Against Women,Domestic Violence,Male,18-30,1198,1133,65,1191,7
2006,Rural,West Bengal,Other Crimes,Drug Offense,Male,0-12,5894,3939,1955,5236,658
2008,Urban,Maharashtra,Crime Against Children,Child Abuse,Female,13-17,634,140,494,219,415
2002,Urban,Madhya Pradesh,Other Crimes,Cyber Crime,Female,60+,2855,1905,950,2488,367
2009,Urban,Gujarat,Property Crime,Burglary,Male,13-17,3811,2248,1563,2449,1362
2005,Rural,West Bengal,Crime Against Men,Assault,Male,0-12,1188,1094,94,1119,69
2007,Urban,Bihar,Other Crimes,Drug Offense,Male,31-45,7322,3278,4044,4091,3231
2006,Urban,Gujarat,Property Crime,Vandalism,Male,18-30,9035,786,8249,2202,6833
2004,Rural,Jharkhand,Crime Against Children,Kidnapping,Female,13-17,1429,667,762,732,697
2007,Urban,Nagaland,Crime Against Men,Extortion,Male,31-45,4834,3648,1186,3754,1080
2008,Urban,Gujarat,Property Crime,Arson,Female,60+,8977,4878,4099,5628,3349
2008,Urban,Uttarakhand,Crime Against Men,Extortion,Female,13-17,3920,3045,875,3429,491
2003,Urban,Telangana,Crime Against Men,Robbery,Male,60+,8408,5640,2768,6568,1840
2004,Rural,Jammu & Kashmir,Crime Against Women,Domestic Violence,Male,18-30,759,704,55,758,1
2007,Rural,Tripura,Crime Against Women,Dowry Deaths,Male,18-30,9353,6963,2390,9047,306
2008,Urban,Jharkhand,Crime Against Men,Robbery,Female,31-45,9162,3505,5657,8359,803
2009,Rural,Haryana,Crime Against Children,Child Labor,Female,31-45,5250,4666,584,5089,161
2004,Rural,Himachal Pradesh,Crime Against Women,Rape,Male,13-17,1904,1543,361,1616,288
2006,Urban,Uttarakhand,Crime Against Men,Extortion,Female,31-45,5805,2466,3339,5001,804
2008,Rural,Telangana,Other Crimes,Cyber Crime,Male,46-60,3967,2470,1497,3321,646
2006,Urban,Sikkim,Crime Against Children,Kidnapping,Male,18-30,5564,4494,1070,4673,891
2007,Rural,Telangana,Crime Against Women,Rape,Male,60+,8351,8289,62,8351,0
2004,Rural,Manipur,Crime Against Women,Rape,Female,13-17,789,49,740,438,351
2010,Urban,West Bengal,Crime Against Children,Child Abuse,Female,13-17,7712,4506,3206,5710,2002
2002,Rural,Sikkim,Crime Against Children,Child Abuse,Male,60+,5079,334,4745,1803,3276
2007,Rural,Haryana,Crime Against Children,Kidnapping,Male,46-60,7911,1423,6488,4100,3811
2010,Urban,Delhi,Crime Against Women,Rape,Female,0-12,2129,1282,847,1780,349
2005,Urban,Rajasthan,Crime Against Women,Dowry Deaths,Male,13-17,1728,1142,586,1647,81
2010,Urban,Manipur,Crime Against Men,Robbery,Male,31-45,9571,6088,3483,8800,771
2003,Rural,Manipur,Other Crimes,Cyber Crime,Male,0-12,8969,1512,7457,7335,1634
2004,Rural,Arunachal Pradesh,Other Crimes,Cyber Crime,Female,0-12,8133,7676,457,7765,368
2010,Rural,West Bengal,Crime Against Women,Rape,Female,60+,685,15,670,258,427
2002,Urban,Rajasthan,Other Crimes,Drug Offense,Male,0-12,8482,7655,827,8449,33
2005,Urban,Uttarakhand,Crime Against Men,Murder,Female,18-30,3933,483,3450,3347,586
2002,Rural,Jharkhand,Crime Against Women,Domestic Violence,Female,0-12,9169,8275,894,8468,701
2001,Urban,Gujarat,Crime Against Women,Molestation,Female,60+,5599,2663,2936,3052,2547
2009,Rural,Haryana,Other Crimes,Cyber Crime,Female,60+,4688,234,4454,1453,3235
2007,Urban,Madhya Pradesh,Other Crimes,Drug Offense,Male,31-45,99,66,33,86,13
2008,Urban,Arunachal Pradesh,Crime Against Children,Kidnapping,Female,13-17,6674,448,6226,736,5938
2008,Urban,Maharashtra,Crime Against Women,Domestic Violence,Male,0-12,7691,691,7000,6971,720
2008,Rural,Delhi,Crime Against Men,Extortion,Female,18-30,3986,3843,143,3906,80
2001,Rural,Assam,Other Crimes,Fraud,Female,46-60,3673,2342,1331,2452,1221
2006,Rural,Maharashtra,Other Crimes,Cyber Crime,Female,18-30,5828,1238,4590,4984,844
2008,Rural,Telangana,Other Crimes,Cyber Crime,Male,18-30,6712,2453,4259,3689,3023
2010,Rural,Haryana,Crime Against Children,Kidnapping,Male,0-12,66,62,4,65,1
2002,Urban,Jammu & Kashmir,Crime Against Children,Child Labor,Male,60+,636,550,86,635,1
2001,Urban,Mizoram,Crime Against Children,Kidnapping,Female,46-60,3822,836,2986,2166,1656
2001,Urban,Gujarat,Property Crime,Burglary,Female,60+,2970,2769,201,2809,161
2005,Urban,Tamil Nadu,Crime Against Men,Extortion,Male,0-12,6295,4326,1969,5961,334
2006,Urban,Madhya Pradesh,Crime Against Men,Robbery,Male,18-30,8019,6867,1152,7312,707
2006,Urban,Bihar,Crime Against Children,Child Abuse,Female,18-30,1460,671,789,729,731
2010,Rural,Goa,Crime Against Children,Kidnapping,Female,60+,8959,6853,2106,8488,471
2006,Urban,Rajasthan,Other Crimes,Drug Offense,Female,46-60,9116,841,8275,4065,5051
2008,Rural,Haryana,Crime Against Men,Assault,Female,60+,9994,1504,8490,8047,1947
2006,Urban,Goa,Crime Against Children,Child Abuse,Female,13-17,6779,4611,2168,6523,256
2009,Urban,Uttarakhand,Crime Against Women,Molestation,Female,0-12,3528,845,2683,3515,13
2008,Rural,Tamil Nadu,Property Crime,Vandalism,Male,60+,485,51,434,424,61
2007,Urban,Sikkim,Crime Against Men,Assault,Female,0-12,8352,4148,4204,5972,2380
2008,Rural,Manipur,Crime Against Men,Murder,Female,18-30,2644,426,2218,2060,584
2008,Rural,Tamil Nadu,Property Crime,Theft,Female,0-12,5127,1433,3694,2757,2370
2004,Rural,Tamil Nadu,Crime Against Men,Extortion,Female,13-17,1728,1318,410,1671,57
2006,Rural,Sikkim,Crime Against Men,Robbery,Male,60+,7158,2299,4859,5434,1724
2002,Urban,Bihar,Crime Against Children,Trafficking,Female,31-45,4806,1467,3339,2501,2305
2005,Urban,Telangana,Other Crimes,Fraud,Female,18-30,2491,1355,1136,1788,703
2007,Urban,Goa,Crime Against Children,Kidnapping,Female,46-60,9454,3586,5868,7437,2017
2010,Urban,Haryana,Property Crime,Arson,Female,60+,4997,3232,1765,3379,1618
2001,Urban,Jammu & Kashmir,Crime Against Men,Robbery,Female,60+,1410,807,603,811,599
2003,Rural,Bihar,Crime Against Men,Robbery,Male,46-60,6734,1358,5376,2600,4134
2007,Urban,Uttar Pradesh,Crime Against Children,Child Labor,Male,0-12,485,42,443,154,331
2005,Rural,Gujarat,Property Crime,Vandalism,Male,0-12,5850,2281,3569,5180,670
2001,Urban,Tripura,Crime Against Women,Rape,Female,31-45,1989,763,1226,1622,367
2003,Urban,Arunachal Pradesh,Other Crimes,Fraud,Female,18-30,4877,408,4469,3450,1427
2005,Rural,Andhra Pradesh,Property Crime,Vandalism,Male,46-60,7661,5818,1843,7090,571
2006,Rural,Nagaland,Crime Against Men,Murder,Female,46-60,2043,1924,119,1975,68
2003,Rural,Assam,Other Crimes,Cyber Crime,Female,0-12,2267,1350,917,1547,720
2003,Urban,Bihar,Property Crime,Burglary,Male,0-12,4576,249,4327,3641,935
2002,Rural,Jharkhand,Property Crime,Vandalism,Male,13-17,9947,8826,1121,9251,696
2004,Rural,Chhattisgarh,Property Crime,Vandalism,Male,13-17,7045,6853,192,6940,105
2002,Urban,Rajasthan,Crime Against Men,Assault,Female,31-45,2056,996,1060,1207,849
2002,Rural,Delhi,Crime Against Children,Child Abuse,Male,60+,7554,3092,4462,7133,421
2004,Rural,Tripura,Other Crimes,Corruption,Male,0-12,7927,3581,4346,4451,3476
2008,Urban,Maharashtra,Crime Against Men,Extortion,Female,13-17,311,259,52,276,35
2007,Urban,Odisha,Crime Against Children,Child Labor,Female,13-17,9377,147,9230,4491,4886
2004,Urban,Jammu & Kashmir,Crime Against Men,Murder,Female,46-60,1997,835,1162,957,1040
2009,Rural,Tamil Nadu,Crime Against Men,Assault,Female,18-30,3800,1104,2696,3159,641
2005,Urban,Delhi,Crime Against Women,Rape,Male,18-30,1774,515,1259,1628,146
2003,Urban,Andhra Pradesh,Other Crimes,Cyber Crime,Female,31-45,9903,1277,8626,8708,1195
2001,Urban,Jammu & Kashmir,Property Crime,Vandalism,Female,13-17,6613,5796,817,6209,404
2008,Rural,Arunachal Pradesh,Crime Against Children,Child Labor,Male,46-60,4640,2968,1672,3975,665
2003,Urban,Himachal Pradesh,Crime Against Children,Trafficking,Female,46-60,8623,93,8530,3460,5163
2002,Rural,Jharkhand,Crime Against Men,Extortion,Female,60+,2887,84,2803,1942,945
2005,Urban,Gujarat,Crime Against Children,Trafficking,Female,18-30,5822,922,4900,5671,151
2004,Rural,West Bengal,Other Crimes,Drug Offense,Male,31-45,1882,1288,594,1311,571
2003,Urban,Jammu & Kashmir,Property Crime,Arson,Male,18-30,2794,708,2086,2402,392
2001,Urban,Kerala,Property Crime,Arson,Male,60+,5050,1192,3858,3636,1414
2007,Rural,Jharkhand,Other Crimes,Fraud,Female,31-45,2599,2506,93,2507,92
2009,Rural,Tamil Nadu,Crime Against Men,Robbery,Female,0-12,7791,2696,5095,2941,4850
2008,Urban,Tripura,Crime Against Men,Murder,Female,46-60,9925,3789,6136,9162,763
2007,Urban,Haryana,Crime Against Children,Kidnapping,Male,0-12,9311,500,8811,6377,2934
2006,Urban,Haryana,Property Crime,Arson,Male,13-17,9031,6626,2405,8781,250
2001,Urban,Uttarakhand,Crime Against Children,Trafficking,Female,46-60,5786,3469,2317,5417,369
2009,Urban,Maharashtra,Crime Against Children,Trafficking,Male,46-60,215,90,125,120,95
2003,Urban,Tamil Nadu,Other Crimes,Fraud,Male,31-45,1844,1152,692,1458,386
2009,Rural,Maharashtra,Crime Against Women,Domestic Violence,Female,18-30,5154,2750,2404,3154,2000
2009,Urban,Arunachal Pradesh,Crime Against Men,Extortion,Male,60+,872,238,634,550,322
2006,Rural,Odisha,Crime Against Children,Child Labor,Male,18-30,6871,3598,3273,4977,1894
2007,Urban,Gujarat,Crime Against Women,Dowry Deaths,Female,18-30,7657,6145,1512,6810,847
2004,Rural,Bihar,Property Crime,Burglary,Male,13-17,5683,3359,2324,4576,1107
2010,Urban,Jharkhand,Other Crimes,Drug Offense,Female,0-12,5837,4534,1303,4670,1167
2002,Urban,Mizoram,Other Crimes,Corruption,Female,0-12,1503,41,1462,1207,296
2010,Rural,Bihar,Other Crimes,Drug Offense,Male,13-17,7556,3973,3583,6075,1481
2003,Urban,Mizoram,Property Crime,Vandalism,Male,31-45,4226,2767,1459,2991,1235
2010,Urban,Haryana,Crime Against Children,Trafficking,Female,0-12,511,86,425,116,395
2005,Rural,Tripura,Crime Against Children,Child Labor,Male,46-60,721,490,231,515,206
2007,Rural,Rajasthan,Other Crimes,Cyber Crime,Male,18-30,4312,1595,2717,2341,1971
2004,Urban,Maharashtra,Property Crime,Vandalism,Female,13-17,3269,2259,1010,3040,229
2008,Rural,Delhi,Property Crime,Arson,Male,0-12,5245,717,4528,4280,965
2002,Rural,Haryana,Crime Against Men,Robbery,Male,18-30,6372,64,6308,4812,1560
2007,Rural,Assam,Crime Against Men,Murder,Female,60+,7127,10,7117,989,6138
2005,Urban,Tripura,Crime Against Men,Assault,Male,0-12,1683,553,1130,811,872
2001,Urban,Nagaland,Crime Against Men,Assault,Male,60+,278,248,30,267,11
2003,Urban,Madhya Pradesh,Crime Against Women,Rape,Male,31-45,8964,5431,3533,8858,106
2010,Urban,Arunachal Pradesh,Crime Against Women,Domestic Violence,Female,18-30,3788,913,2875,1365,2423
2001,Rural,Madhya Pradesh,Crime Against Men,Extortion,Male,60+,5239,3926,1313,4560,679
2008,Urban,Karnataka,Other Crimes,Cyber Crime,Female,13-17,7857,702,7155,4604,3253
2003,Rural,Gujarat,Crime Against Children,Child Labor,Male,13-17,7036,6812,224,7023,13
2009,Rural,Tripura,Other Crimes,Corruption,Male,60+,7161,3048,4113,4321,2840
2002,Rural,Tripura,Other Crimes,Corruption,Male,18-30,4500,4328,172,4422,78
2007,Urban,Arunachal Pradesh,Property Crime,Arson,Female,31-45,9942,9444,498,9718,224
2008,Urban,Himachal Pradesh,Crime Against Women,Molestation,Male,46-60,2779,42,2737,1031,1748
2005,Rural,Bihar,Crime Against Children,Trafficking,Female,18-30,8688,5829,2859,6917,1771
2005,Urban,Bihar,Other Crimes,Drug Offense,Female,31-45,5319,3624,1695,5301,18
2008,Rural,Arunachal Pradesh,Other Crimes,Drug Offense,Male,13-17,468,441,27,464,4
2010,Urban,Bihar,Property Crime,Burglary,Female,13-17,5800,1761,4039,2296,3504
2003,Urban,Gujarat,Crime Against Men,Murder,Female,13-17,2428,360,2068,576,1852
2003,Urban,Himachal Pradesh,Crime Against Women,Dowry Deaths,Male,0-12,6218,4821,1397,4821,1397
2001,Urban,Rajasthan,Crime Against Women,Domestic Violence,Male,60+,4645,2171,2474,2327,2318
2004,Rural,Bihar,Crime Against Children,Kidnapping,Female,46-60,6712,742,5970,6261,451
2005,Rural,Himachal Pradesh,Crime Against Women,Domestic Violence,Male,18-30,5579,3181,2398,4464,1115
2001,Rural,Tamil Nadu,Crime Against Women,Domestic Violence,Female,13-17,6560,85,6475,3467,3093
2009,Urban,Andhra Pradesh,Crime Against Children,Trafficking,Female,31-45,6541,1944,4597,4180,2361
2002,Urban,Madhya Pradesh,Crime Against Men,Robbery,Female,13-17,1325,1323,2,1325,0
2008,Urban,Rajasthan,Crime Against Men,Extortion,Female,13-17,1831,889,942,1237,594
2001,Urban,Goa,Other Crimes,Cyber Crime,Female,46-60,4757,2017,2740,2254,2503
2007,Rural,Sikkim,Other Crimes,Fraud,Female,13-17,9995,834,9161,3867,6128
2004,Urban,Bihar,Crime Against Children,Child Abuse,Male,60+,3473,2690,783,2869,604
2010,Rural,Madhya Pradesh,Crime Against Women,Molestation,Female,0-12,3949,3564,385,3673,276
2005,Rural,Haryana,Crime Against Men,Murder,Female,31-45,6158,5206,952,6080,78
2007,Urban,Uttar Pradesh,Property Crime,Burglary,Female,46-60,4593,4195,398,4512,81
2008,Rural,Jammu & Kashmir,Crime Against Men,Murder,Male,18-30,9981,8359,1622,9110,871
2006,Urban,Delhi,Crime Against Women,Molestation,Male,46-60,3573,1609,1964,2681,892
2010,Urban,Odisha,Other Crimes,Corruption,Male,46-60,9896,3219,6677,9331,565
2005,Rural,Bihar,Crime Against Women,Rape,Female,31-45,7951,4689,3262,5296,2655
2010,Rural,Tamil Nadu,Other Crimes,Drug Offense,Male,13-17,5402,2834,2568,4792,610
2009,Rural,Manipur,Crime Against Children,Child Abuse,Male,46-60,4468,4000,468,4207,261
2008,Rural,Madhya Pradesh,Property Crime,Vandalism,Female,0-12,6559,1287,5272,3984,2575
2009,Rural,Bihar,Other Crimes,Drug Offense,Male,31-45,7806,6014,1792,6439,1367
2008,Urban,Gujarat,Crime Against Men,Extortion,Male,13-17,1486,10,1476,458,1028
2003,Urban,Punjab,Other Crimes,Cyber Crime,Female,0-12,536,20,516,95,441
2006,Urban,Chhattisgarh,Crime Against Women,Molestation,Male,46-60,4257,761,3496,2866,1391
2010,Urban,Arunachal Pradesh,Crime Against Women,Molestation,Male,0-12,3194,1359,1835,2786,408
2001,Urban,Bihar,Crime Against Children,Child Abuse,Female,31-45,8796,2658,6138,8154,642
2006,Urban,West Bengal,Property Crime,Burglary,Female,13-17,3148,971,2177,1170,1978
2004,Urban,Gujarat,Crime Against Children,Trafficking,Female,0-12,8528,38,8490,3930,4598
2008,Rural,Odisha,Property Crime,Vandalism,Female,46-60,6352,739,5613,3177,3175
2010,Urban,Tamil Nadu,Crime Against Men,Murder,Female,0-12,9726,1522,8204,3870,5856
2010,Rural,Goa,Crime Against Children,Child Abuse,Male,60+,3152,2088,1064,2540,612
2005,Rural,Kerala,Other Crimes,Drug Offense,Male,31-45,807,331,476,554,253
2006,Urban,Sikkim,Crime Against Children,Child Labor,Male,46-60,4629,2631,1998,3458,1171
2001,Rural,Punjab,Crime Against Men,Assault,Male,0-12,1562,804,758,1338,224
2002,Urban,Kerala,Crime Against Men,Robbery,Female,46-60,2625,751,1874,1614,1011
2008,Urban,Telangana,Crime Against Women,Dowry Deaths,Female,60+,6143,1544,4599,1984,4159
2005,Rural,Haryana,Property Crime,Burglary,Male,60+,6349,3313,3036,5580,769
2010,Rural,Haryana,Crime Against Men,Extortion,Female,46-60,619,226,393,315,304
2007,Urban,Assam,Crime Against Women,Domestic Violence,Female,46-60,5790,2276,3514,2696,3094
2005,Rural,Telangana,Crime Against Men,Assault,Male,18-30,4519,3766,753,4210,309
2007,Rural,Gujarat,Property Crime,Arson,Female,0-12,3904,1067,2837,1614,2290
2002,Rural,Himachal Pradesh,Other Crimes,Fraud,Female,60+,7687,7654,33,7675,12
2005,Urban,Uttarakhand,Other Crimes,Drug Offense,Female,60+,3763,332,3431,884,2879
2009,Urban,Karnataka,Crime Against Men,Extortion,Male,60+,6343,4596,1747,5802,541
2008,Rural,Maharashtra,Property Crime,Arson,Female,0-12,8280,49,8231,4575,3705
2008,Rural,Uttar Pradesh,Property Crime,Burglary,Male,18-30,231,41,190,196,35
2010,Urban,Telangana,Property Crime,Vandalism,Male,46-60,9359,5923,3436,6385,2974
2009,Rural,Uttarakhand,Property Crime,Burglary,Female,60+,6967,1386,5581,1608,5359
2007,Rural,Tamil Nadu,Crime Against Children,Child Abuse,Female,60+,4391,2639,1752,3281,1110
2007,Urban,Bihar,Crime Against Women,Rape,Male,31-45,6742,1540,5202,3240,3502
2005,Rural,Punjab,Crime Against Women,Molestation,Male,18-30,9392,939,8453,8115,1277
2007,Urban,Goa,Crime Against Men,Extortion,Male,46-60,5245,3459,1786,3580,1665
2005,Rural,Karnataka,Crime Against Children,Kidnapping,Female,60+,347,178,169,241,106
2005,Rural,Nagaland,Crime Against Children,Kidnapping,Female,31-45,5612,3672,1940,4725,887
2002,Urban,Himachal Pradesh,Property Crime,Theft,Female,13-17,3004,552,2452,630,2374
2002,Rural,West Bengal,Crime Against Men,Extortion,Female,18-30,6576,6143,433,6159,417
2010,Rural,Sikkim,Crime Against Children,Kidnapping,Female,46-60,5209,1218,3991,2526,2683
2010,Rural,Meghalaya,Other Crimes,Fraud,Female,46-60,7305,6875,430,7149,156
2009,Rural,Manipur,Crime Against Men,Murder,Female,60+,197,180,17,197,0
2010,Rural,Kerala,Property Crime,Theft,Female,60+,379,8,371,87,292
2006,Rural,Assam,Crime Against Children,Child Abuse,Male,31-45,8736,7206,1530,7374,1362
2009,Urban,West Bengal,Crime Against Children,Kidnapping,Male,0-12,6610,5811,799,5813,797
2010,Urban,Kerala,Property Crime,Vandalism,Female,18-30,8749,730,8019,8538,211
2005,Urban,Delhi,Other Crimes,Cyber Crime,Male,46-60,9709,5496,4213,7185,2524
2002,Urban,Kerala,Crime Against Men,Assault,Male,0-12,7360,18,7342,1060,6300
2008,Rural,Kerala,Crime Against Men,Assault,Female,46-60,8221,5030,3191,5860,2361
2009,Rural,Nagaland,Property Crime,Theft,Male,13-17,7736,2927,4809,3002,4734
2005,Urban,Rajasthan,Crime Against Children,Trafficking,Female,60+,9708,274,9434,2532,7176
2009,Urban,Chhattisgarh,Crime Against Women,Rape,Female,60+,469,93,376,216,253
2005,Urban,Andhra Pradesh,Crime Against Children,Child Labor,Female,60+,9479,6635,2844,9142,337
2005,Rural,Tamil Nadu,Crime Against Men,Assault,Female,46-60,5112,100,5012,1988,3124
2006,Urban,Uttarakhand,Property Crime,Theft,Female,0-12,1276,527,749,1230,46
2009,Rural,Odisha,Crime Against Men,Murder,Male,18-30,2927,1648,1279,2225,702
2002,Rural,Sikkim,Property Crime,Vandalism,Male,13-17,5989,2816,3173,4733,1256
2003,Rural,Sikkim,Other Crimes,Corruption,Male,31-45,4030,2414,1616,3580,450
2008,Urban,Meghalaya,Crime Against Men,Murder,Male,46-60,2675,1281,1394,2487,188
2006,Urban,Rajasthan,Crime Against Women,Dowry Deaths,Female,46-60,4045,1862,2183,3028,1017
2007,Urban,Manipur,Other Crimes,Fraud,Female,60+,821,676,145,771,50
2001,Urban,Meghalaya,Crime Against Children,Child Abuse,Female,18-30,7569,1041,6528,1218,6351
2007,Urban,Gujarat,Crime Against Children,Kidnapping,Male,13-17,1958,1451,507,1545,413
2004,Rural,Meghalaya,Crime Against Men,Murder,Male,46-60,4306,4110,196,4119,187
2002,Rural,Punjab,Crime Against Men,Assault,Female,46-60,9607,1902,7705,3194,6413
2007,Rural,Delhi,Crime Against Women,Domestic Violence,Female,13-17,7738,1285,6453,6928,810
2008,Rural,Odisha,Crime Against Men,Murder,Male,18-30,8455,2398,6057,6840,1615
2003,Rural,West Bengal,Property Crime,Theft,Female,60+,6317,6089,228,6108,209
2002,Rural,Odisha,Property Crime,Vandalism,Female,60+,224,179,45,222,2
2004,Rural,Jharkhand,Other Crimes,Drug Offense,Female,46-60,5785,4384,1401,5493,292
2003,Urban,Bihar,Property Crime,Burglary,Female,18-30,1657,997,660,1419,238
2005,Rural,West Bengal,Crime Against Women,Rape,Male,13-17,7445,2605,4840,4716,2729
2010,Urban,Goa,Property Crime,Burglary,Male,60+,4385,1792,2593,3859,526
2010,Rural,Goa,Property Crime,Vandalism,Female,60+,2823,1114,1709,2418,405
2002,Urban,Arunachal Pradesh,Other Crimes,Cyber Crime,Female,46-60,5983,5882,101,5889,94
2008,Urban,Punjab,Other Crimes,Corruption,Male,46-60,1067,376,691,664,403
2009,Rural,Jharkhand,Crime Against Children,Kidnapping,Female,0-12,7898,81,7817,5210,2688
2003,Urban,Nagaland,Other Crimes,Corruption,Female,46-60,6359,2864,3495,3213,3146
2006,Rural,Uttarakhand,Crime Against Women,Molestation,Male,60+,167,140,27,144,23
2003,Urban,Kerala,Crime Against Children,Child Abuse,Male,13-17,6365,1583,4782,2008,4357
2008,Urban,Sikkim,Other Crimes,Drug Offense,Female,46-60,3423,1137,2286,2407,1016
2002,Rural,Odisha,Crime Against Women,Molestation,Male,31-45,647,371,276,574,73
2001,Urban,Rajasthan,Crime Against Children,Child Abuse,Female,13-17,5733,5108,625,5631,102
2008,Rural,Gujarat,Property Crime,Vandalism,Female,60+,2083,1019,1064,1298,785
2001,Rural,Maharashtra,Property Crime,Burglary,Female,46-60,7833,686,7147,2166,5667
2005,Rural,Rajasthan,Property Crime,Burglary,Male,18-30,836,646,190,742,94
2005,Urban,Chhattisgarh,Crime Against Women,Dowry Deaths,Male,31-45,9495,510,8985,2483,7012
2008,Rural,Sikkim,Property Crime,Theft,Male,31-45,3848,2684,1164,3644,204
2002,Urban,Meghalaya,Property Crime,Theft,Female,0-12,3962,2403,1559,2708,1254
2006,Rural,Punjab,Crime Against Women,Rape,Male,31-45,6988,752,6236,1356,5632
2002,Urban,Haryana,Other Crimes,Fraud,Male,18-30,9489,5891,3598,6638,2851
2009,Urban,West Bengal,Crime Against Children,Child Labor,Female,60+,5720,3688,2032,4584,1136
2006,Urban,Goa,Crime Against Men,Murder,Male,13-17,6554,5586,968,6243,311
2001,Urban,Karnataka,Crime Against Children,Trafficking,Female,0-12,5334,394,4940,3967,1367
2001,Urban,Uttarakhand,Crime Against Women,Molestation,Female,0-12,3740,3241,499,3584,156
2005,Rural,Haryana,Other Crimes,Cyber Crime,Female,0-12,8136,6509,1627,7797,339
2010,Rural,Himachal Pradesh,Crime Against Women,Dowry Deaths,Male,13-17,9697,8476,1221,8777,920
2003,Urban,Manipur,Other Crimes,Cyber Crime,Female,46-60,4296,2570,1726,3483,813
2007,Rural,Manipur,Crime Against Men,Murder,Male,46-60,5766,3543,2223,5541,225
2010,Urban,Meghalaya,Crime Against Men,Murder,Female,18-30,8997,4823,4174,6400,2597
2003,Urban,Assam,Other Crimes,Drug Offense,Male,46-60,5263,4001,1262,4848,415
2008,Urban,Karnataka,Property Crime,Vandalism,Male,31-45,6831,24,6807,5651,1180
2004,Urban,Andhra Pradesh,Crime Against Children,Kidnapping,Female,13-17,8796,7868,928,8012,784
2007,Urban,Telangana,Crime Against Women,Domestic Violence,Female,31-45,3233,1033,2200,2996,237
2007,Urban,Jharkhand,Property Crime,Arson,Male,46-60,367,55,312,285,82
2006,Rural,Delhi,Crime Against Men,Extortion,Male,31-45,5868,1940,3928,4535,1333
2009,Urban,Delhi,Crime Against Women,Dowry Deaths,Female,18-30,6137,5565,572,5797,340
2002,Urban,Mizoram,Crime Against Men,Assault,Male,60+,511,436,75,459,52
2008,Urban,Andhra Pradesh,Other Crimes,Corruption,Male,13-17,4567,3931,636,4516,51
2001,Urban,Mizoram,Crime Against Children,Kidnapping,Male,46-60,3550,2591,959,2916,634
2007,Urban,Chhattisgarh,Crime Against Men,Assault,Female,46-60,2230,1055,1175,2197,33
2004,Urban,Nagaland,Other Crimes,Drug Offense,Male,60+,5806,2258,3548,2416,3390
2004,Rural,Chhattisgarh,Crime Against Women,Rape,Female,13-17,2563,101,2462,2112,451
2002,Urban,Delhi,Crime Against Women,Rape,Female,0-12,4586,3578,1008,4177,409
2006,Urban,Goa,Property Crime,Burglary,Female,0-12,5409,1555,3854,4738,671
2010,Urban,Jammu & Kashmir,Crime Against Men,Murder,Male,13-17,6076,546,5530,2798,3278
2006,Rural,Jammu & Kashmir,Crime Against Men,Robbery,Female,18-30,9298,3906,5392,4044,5254
2005,Urban,Karnataka,Crime Against Children,Child Abuse,Female,13-17,6015,5344,671,5950,65
2004,Urban,West Bengal,Property Crime,Burglary,Female,46-60,5758,2967,2791,3798,1960
2001,Urban,Assam,Crime Against Children,Trafficking,Male,0-12,4906,3499,1407,4471,435
2003,Rural,Tamil Nadu,Other Crimes,Cyber Crime,Male,0-12,9986,9578,408,9759,227
2003,Urban,Gujarat,Other Crimes,Fraud,Male,13-17,2401,997,1404,1139,1262
2010,Urban,Odisha,Crime Against Men,Assault,Male,31-45,3455,1423,2032,2175,1280
2003,Rural,Assam,Other Crimes,Cyber Crime,Male,18-30,8864,7678,1186,8360,504
2002,Urban,Tripura,Property Crime,Vandalism,Female,13-17,5865,4739,1126,4834,1031
2002,Urban,Andhra Pradesh,Crime Against Children,Trafficking,Female,13-17,7413,2866,4547,3117,4296
2010,Rural,Jharkhand,Crime Against Women,Dowry Deaths,Male,18-30,956,736,220,893,63
2004,Rural,Uttarakhand,Other Crimes,Fraud,Male,31-45,2706,990,1716,2240,466
2008,Rural,Sikkim,Other Crimes,Cyber Crime,Male,31-45,4167,4155,12,4163,4
2010,Rural,Delhi,Crime Against Children,Trafficking,Male,13-17,3696,9,3687,1129,2567
2003,Rural,Goa,Crime Against Men,Assault,Male,60+,3938,3096,842,3735,203
2003,Rural,Odisha,Crime Against Women,Rape,Female,60+,4487,600,3887,2589,1898
2009,Urban,Assam,Crime Against Children,Kidnapping,Female,46-60,5484,1714,3770,5032,452
2001,Urban,Kerala,Crime Against Children,Child Abuse,Female,0-12,6959,1673,5286,3997,2962
2007,Urban,Sikkim,Crime Against Men,Murder,Female,18-30,9434,2956,6478,8179,1255
2009,Rural,Meghalaya,Other Crimes,Drug Offense,Male,31-45,1329,577,752,1266,63
2005,Rural,Arunachal Pradesh,Crime Against Men,Robbery,Female,31-45,3981,2566,1415,3059,922
2002,Rural,Mizoram,Crime Against Men,Murder,Female,0-12,4636,3828,808,4418,218
2007,Urban,Telangana,Crime Against Women,Dowry Deaths,Male,13-17,8724,153,8571,247,8477
2006,Rural,Delhi,Crime Against Children,Kidnapping,Female,31-45,859,182,677,610,249
2004,Urban,Gujarat,Crime Against Men,Extortion,Female,31-45,6063,3838,2225,4240,1823
2003,Urban,Uttar Pradesh,Other Crimes,Corruption,Female,60+,466,311,155,406,60
2005,Urban,Sikkim,Property Crime,Vandalism,Male,46-60,9561,5487,4074,5798,3763
2004,Rural,Odisha,Crime Against Men,Extortion,Female,60+,3177,2711,466,3049,128
2002,Rural,Tamil Nadu,Property Crime,Arson,Female,18-30,4902,3003,1899,3955,947
2005,Urban,Rajasthan,Property Crime,Vandalism,Male,60+,8075,1758,6317,2706,5369
2007,Urban,Tripura,Property Crime,Burglary,Male,31-45,8949,89,8860,3289,5660
2001,Urban,Jammu & Kashmir,Crime Against Men,Robbery,Female,13-17,5861,481,5380,3140,2721
2009,Rural,Odisha,Property Crime,Arson,Male,13-17,2329,953,1376,1713,616
2005,Urban,Uttar Pradesh,Other Crimes,Cyber Crime,Male,13-17,8371,7102,1269,7899,472
2002,Rural,Assam,Crime Against Women,Molestation,Male,18-30,250,109,141,131,119
2005,Urban,Jharkhand,Crime Against Men,Robbery,Male,18-30,3429,924,2505,2111,1318
2001,Urban,Gujarat,Crime Against Children,Kidnapping,Male,46-60,7826,3732,4094,4112,3714
2006,Urban,Tamil Nadu,Crime Against Children,Child Labor,Female,0-12,5824,3733,2091,5153,671
2008,Rural,Gujarat,Crime Against Children,Trafficking,Male,60+,2127,246,1881,1889,238
2008,Urban,Meghalaya,Other Crimes,Fraud,Male,46-60,635,583,52,632,3
2002,Rural,Jammu & Kashmir,Other Crimes,Cyber Crime,Female,31-45,3910,3061,849,3887,23
2005,Rural,Rajasthan,Other Crimes,Fraud,Male,18-30,2356,534,1822,853,1503
2003,Urban,Kerala,Crime Against Men,Assault,Male,0-12,8993,1744,7249,2460,6533
2002,Rural,Chhattisgarh,Crime Against Men,Assault,Female,13-17,4422,3782,640,4396,26
2001,Urban,Nagaland,Crime Against Women,Dowry Deaths,Male,60+,4620,4142,478,4456,164
2005,Urban,Haryana,Property Crime,Theft,Male,0-12,788,556,232,678,110
2006,Urban,Telangana,Crime Against Men,Assault,Male,60+,4471,168,4303,2212,2259
2003,Rural,Uttar Pradesh,Other Crimes,Fraud,Male,13-17,591,194,397,330,261
2009,Urban,Nagaland,Crime Against Men,Murder,Male,60+,9360,493,8867,7489,1871
2005,Rural,Goa,Crime Against Men,Murder,Male,31-45,2230,1926,304,2184,46
2001,Rural,Sikkim,Property Crime,Vandalism,Male,46-60,9841,3032,6809,4363,5478
2004,Urban,Odisha,Other Crimes,Corruption,Female,0-12,8911,7970,941,8618,293
2004,Rural,Tamil Nadu,Crime Against Children,Child Labor,Female,0-12,9618,6500,3118,6656,2962
2003,Urban,Sikkim,Crime Against Men,Assault,Female,46-60,7637,1567,6070,2912,4725
2009,Urban,Delhi,Crime Against Women,Dowry Deaths,Female,0-12,2753,1752,1001,1878,875
2008,Rural,Chhattisgarh,Crime Against Women,Domestic Violence,Female,60+,8492,879,7613,6721,1771
2006,Urban,Bihar,Crime Against Children,Child Labor,Male,13-17,7610,1230,6380,4877,2733
2008,Urban,Haryana,Other Crimes,Fraud,Male,0-12,6393,2686,3707,5061,1332
2004,Urban,Punjab,Crime Against Women,Rape,Female,0-12,5086,2900,2186,4396,690
2004,Urban,Delhi,Crime Against Women,Domestic Violence,Male,13-17,1895,383,1512,537,1358
2002,Rural,Gujarat,Property Crime,Theft,Male,60+,8698,1303,7395,4783,3915
2001,Urban,West Bengal,Property Crime,Vandalism,Female,0-12,8043,7300,743,7651,392
2005,Rural,Karnataka,Other Crimes,Fraud,Female,18-30,8800,6136,2664,8413,387
2005,Urban,Assam,Property Crime,Theft,Female,18-30,5420,181,5239,2182,3238
2002,Urban,Punjab,Crime Against Women,Dowry Deaths,Female,0-12,3828,3580,248,3611,217
2007,Urban,Jammu & Kashmir,Property Crime,Burglary,Female,0-12,1256,1008,248,1029,227
2004,Urban,Tamil Nadu,Property Crime,Arson,Female,0-12,3333,1780,1553,2207,1126
2002,Urban,Mizoram,Other Crimes,Fraud,Female,0-12,926,665,261,770,156
2009,Urban,Gujarat,Other Crimes,Cyber Crime,Male,0-12,6204,3060,3144,4703,1501
2009,Rural,Meghalaya,Property Crime,Arson,Female,31-45,8016,4548,3468,7939,77
2009,Urban,Maharashtra,Other Crimes,Fraud,Male,13-17,7293,3309,3984,4863,2430
2008,Rural,Jammu & Kashmir,Property Crime,Theft,Female,46-60,557,457,100,489,68
2002,Urban,Meghalaya,Crime Against Children,Child Abuse,Male,13-17,1298,1212,86,1232,66
2005,Rural,Gujarat,Crime Against Men,Robbery,Male,60+,2604,779,1825,2278,326
2006,Urban,Delhi,Crime Against Women,Domestic Violence,Male,18-30,7952,3378,4574,3752,4200
2008,Rural,Odisha,Crime Against Men,Murder,Female,13-17,4162,1747,2415,3771,391
2008,Urban,Manipur,Crime Against Women,Molestation,Female,18-30,7819,1867,5952,2949,4870
2008,Rural,Maharashtra,Other Crimes,Drug Offense,Female,60+,7796,5658,2138,6354,1442
2001,Rural,Arunachal Pradesh,Crime Against Women,Rape,Female,31-45,747,84,663,134,613
2009,Rural,Nagaland,Other Crimes,Corruption,Male,46-60,5850,3685,2165,4517,1333
2002,Rural,Uttar Pradesh,Crime Against Men,Murder,Male,13-17,7383,1453,5930,2124,5259
2009,Rural,Delhi,Crime Against Men,Assault,Male,18-30,4751,2350,2401,3929,822
2008,Rural,Madhya Pradesh,Property Crime,Vandalism,Female,0-12,5459,2468,2991,4286,1173
2007,Urban,Jharkhand,Crime Against Children,Kidnapping,Female,13-17,3961,2557,1404,2647,1314
2009,Rural,Rajasthan,Crime Against Women,Dowry Deaths,Male,18-30,7582,1442,6140,3594,3988
2002,Urban,Gujarat,Property Crime,Vandalism,Female,46-60,605,36,569,260,345
2009,Urban,Nagaland,Other Crimes,Cyber Crime,Female,18-30,7591,6359,1232,7057,534
2002,Rural,Odisha,Crime Against Women,Rape,Female,31-45,641,342,299,528,113
2001,Urban,Maharashtra,Property Crime,Theft,Female,60+,9928,9738,190,9762,166
2006,Urban,Jharkhand,Crime Against Children,Trafficking,Female,60+,5233,4577,656,4791,442
2009,Rural,Uttarakhand,Crime Against Men,Murder,Male,13-17,1665,463,1202,545,1120
2001,Rural,Mizoram,Property Crime,Arson,Male,46-60,1350,671,679,1128,222
2002,Urban,Himachal Pradesh,Crime Against Women,Rape,Female,60+,9757,6199,3558,7216,2541
2008,Urban,Telangana,Property Crime,Vandalism,Male,13-17,2251,2038,213,2075,176
2001,Urban,Madhya Pradesh,Crime Against Children,Kidnapping,Female,13-17,1431,109,1322,227,1204
2003,Rural,Punjab,Property Crime,Theft,Female,18-30,3158,944,2214,1051,2107
2008,Urban,Tamil Nadu,Other Crimes,Corruption,Female,18-30,2972,1075,1897,1177,1795
2007,Rural,Manipur,Other Crimes,Cyber Crime,Female,31-45,2313,1510,803,2056,257
2004,Urban,Tamil Nadu,Crime Against Men,Assault,Female,18-30,2335,1685,650,2033,302
2009,Rural,Uttarakhand,Property Crime,Theft,Male,31-45,8976,5693,3283,8097,879
2002,Urban,Rajasthan,Property Crime,Theft,Female,18-30,8588,6699,1889,6770,1818
2007,Rural,Gujarat,Crime Against Women,Rape,Male,0-12,1277,135,1142,309,968
2008,Rural,Jharkhand,Crime Against Men,Murder,Female,18-30,7915,2223,5692,4762,3153
2009,Urban,Tamil Nadu,Crime Against Children,Child Abuse,Male,31-45,6326,2994,3332,6219,107
2009,Rural,Sikkim,Crime Against Children,Kidnapping,Female,18-30,1384,581,803,1274,110
2007,Urban,Maharashtra,Crime Against Women,Molestation,Female,46-60,7501,2392,5109,5220,2281
2001,Rural,Odisha,Crime Against Children,Child Labor,Male,18-30,1810,1505,305,1613,197
2010,Rural,Manipur,Property Crime,Vandalism,Male,31-45,7690,2767,4923,2907,4783
2007,Rural,Karnataka,Property Crime,Arson,Female,46-60,3703,85,3618,3224,479
2010,Rural,Himachal Pradesh,Crime Against Women,Molestation,Female,46-60,8896,6338,2558,8076,820
2005,Rural,Telangana,Crime Against Children,Trafficking,Male,0-12,6331,602,5729,3519,2812
2002,Rural,Uttarakhand,Crime Against Children,Kidnapping,Male,60+,3730,1762,1968,3127,603
2005,Urban,Tamil Nadu,Crime Against Children,Child Labor,Female,60+,2911,2694,217,2893,18
2007,Urban,Tripura,Property Crime,Vandalism,Female,18-30,9481,3005,6476,9461,20
2002,Rural,Rajasthan,Crime Against Children,Kidnapping,Male,46-60,5751,1166,4585,3642,2109
2003,Urban,Gujarat,Crime Against Women,Molestation,Male,13-17,6178,4810,1368,5799,379
2003,Rural,Punjab,Crime Against Children,Kidnapping,Male,0-12,4968,922,4046,2037,2931
2009,Urban,Uttarakhand,Crime Against Children,Child Abuse,Female,18-30,3166,132,3034,575,2591
2004,Rural,Sikkim,Crime Against Men,Murder,Male,31-45,749,414,335,560,189
2001,Urban,Delhi,Crime Against Children,Child Abuse,Female,0-12,9658,6685,2973,7439,2219
2006,Urban,Meghalaya,Crime Against Children,Kidnapping,Female,31-45,9958,3948,6010,5558,4400
2008,Rural,Delhi,Crime Against Men,Robbery,Male,0-12,708,654,54,690,18
2008,Rural,Uttarakhand,Other Crimes,Corruption,Male,13-17,7520,6156,1364,7146,374
2005,Rural,Uttarakhand,Crime Against Children,Kidnapping,Female,18-30,6819,5336,1483,5675,1144
2006,Rural,Madhya Pradesh,Crime Against Men,Extortion,Male,0-12,9524,2135,7389,5220,4304
2007,Rural,Andhra Pradesh,Crime Against Children,Trafficking,Male,0-12,5842,5432,410,5524,318
2007,Rural,Haryana,Other Crimes,Corruption,Female,46-60,6332,4062,2270,5421,911
2007,Rural,Nagaland,Crime Against Women,Rape,Male,0-12,3276,1691,1585,2463,813
2004,Urban,Nagaland,Crime Against Women,Molestation,Female,60+,9048,5951,3097,6397,2651
2006,Rural,Tamil Nadu,Crime Against Women,Domestic Violence,Male,0-12,2755,1717,1038,2203,552
2009,Urban,Himachal Pradesh,Crime Against Men,Robbery,Male,60+,8401,3206,5195,3956,4445
2006,Rural,Delhi,Crime Against Men,Extortion,Male,60+,7769,7075,694,7598,171
2001,Urban,Arunachal Pradesh,Crime Against Women,Molestation,Female,13-17,5900,3271,2629,3907,1993
2010,Rural,Jharkhand,Property Crime,Arson,Male,13-17,3259,1898,1361,2241,1018
2003,Rural,Himachal Pradesh,Other Crimes,Fraud,Male,0-12,3562,547,3015,3215,347
2001,Urban,Haryana,Crime Against Men,Extortion,Male,0-12,3368,781,2587,2254,1114
2005,Urban,Kerala,Crime Against Women,Rape,Male,60+,3736,712,3024,2340,1396
2010,Rural,Telangana,Crime Against Women,Rape,Female,0-12,9391,203,9188,603,8788
2008,Rural,Tripura,Property Crime,Burglary,Male,60+,2468,607,1861,1175,1293
2008,Rural,Kerala,Crime Against Men,Murder,Male,0-12,8832,4022,4810,4059,4773
2001,Rural,Kerala,Property Crime,Theft,Male,18-30,4028,2742,1286,3474,554
2006,Urban,Himachal Pradesh,Crime Against Women,Rape,Male,60+,2523,141,2382,1944,579
2005,Urban,Uttar Pradesh,Crime Against Women,Dowry Deaths,Male,46-60,6219,5114,1105,6199,20
2005,Urban,Nagaland,Property Crime,Vandalism,Male,46-60,4175,3130,1045,3312,863
2010,Rural,Jharkhand,Other Crimes,Corruption,Male,31-45,5018,4603,415,4890,128
2010,Urban,Chhattisgarh,Crime Against Children,Child Labor,Female,46-60,5629,1304,4325,2129,3500
2004,Rural,Himachal Pradesh,Crime Against Children,Kidnapping,Male,0-12,3037,2690,347,2958,79
2007,Rural,Andhra Pradesh,Crime Against Men,Murder,Female,60+,5015,2344,2671,2479,2536
2006,Urban,Chhattisgarh,Crime Against Women,Molestation,Male,0-12,3934,184,3750,1095,2839
2007,Rural,Chhattisgarh,Crime Against Children,Child Abuse,Male,31-45,204,82,122,88,116
2004,Rural,Kerala,Crime Against Men,Assault,Female,13-17,5028,2147,2881,3934,1094
2005,Rural,Mizoram,Crime Against Children,Kidnapping,Female,60+,6354,5093,1261,5994,360
2010,Rural,Delhi,Property Crime,Theft,Male,31-45,404,26,378,103,301
2002,Urban,West Bengal,Other Crimes,Corruption,Female,0-12,8798,8525,273,8779,19
2010,Rural,Maharashtra,Crime Against Men,Murder,Male,60+,6022,5920,102,5969,53
2004,Urban,Tamil Nadu,Property Crime,Burglary,Male,0-12,5008,3033,1975,4835,173
2005,Rural,Delhi,Crime Against Children,Trafficking,Male,31-45,8613,3881,4732,4490,4123
2007,Urban,Gujarat,Other Crimes,Fraud,Female,31-45,6127,2135,3992,2991,3136
2009,Rural,Maharashtra,Crime Against Men,Extortion,Female,31-45,6554,4752,1802,6119,435
2005,Rural,Jammu & Kashmir,Crime Against Children,Trafficking,Female,18-30,1331,936,395,1014,317
2001,Rural,West Bengal,Other Crimes,Drug Offense,Female,46-60,9530,1532,7998,3274,6256
2003,Urban,Gujarat,Property Crime,Burglary,Female,0-12,4780,378,4402,4226,554
2009,Rural,Tamil Nadu,Crime Against Women,Molestation,Female,60+,3106,193,2913,2731,375
2008,Urban,Tripura,Crime Against Women,Domestic Violence,Female,31-45,6523,5308,1215,5743,780
2002,Urban,Goa,Crime Against Men,Murder,Female,0-12,1898,765,1133,1705,193
2008,Rural,Manipur,Property Crime,Arson,Male,60+,3681,2663,1018,3656,25
2008,Urban,Manipur,Other Crimes,Corruption,Female,18-30,3848,424,3424,1767,2081
2004,Urban,Bihar,Property Crime,Arson,Male,0-12,3123,1611,1512,1926,1197
2007,Urban,Punjab,Crime Against Children,Kidnapping,Male,0-12,2649,1109,1540,1594,1055
2002,Urban,Meghalaya,Crime Against Women,Rape,Male,46-60,793,553,240,757,36
2007,Urban,Madhya Pradesh,Crime Against Men,Extortion,Male,18-30,4180,30,4150,2243,1937
2007,Rural,Assam,Crime Against Men,Murder,Male,31-45,1986,1003,983,1881,105
2006,Rural,Kerala,Property Crime,Arson,Female,60+,3327,347,2980,1024,2303
2010,Urban,Rajasthan,Property Crime,Arson,Female,18-30,5436,3638,1798,4601,835
2009,Rural,Madhya Pradesh,Crime Against Children,Child Abuse,Male,0-12,9969,7027,2942,9206,763
2007,Urban,Haryana,Crime Against Children,Trafficking,Female,0-12,9602,886,8716,5843,3759
2001,Rural,Punjab,Crime Against Men,Assault,Female,18-30,2857,564,2293,895,1962
2003,Urban,Arunachal Pradesh,Other Crimes,Fraud,Male,60+,8298,5878,2420,7463,835
2006,Urban,Maharashtra,Property Crime,Theft,Female,31-45,2835,2684,151,2823,12
2005,Rural,Maharashtra,Property Crime,Burglary,Male,31-45,3110,2302,808,2734,376
2009,Urban,Gujarat,Crime Against Women,Rape,Male,60+,7770,4053,3717,5459,2311
2010,Urban,Chhattisgarh,Crime Against Children,Child Labor,Male,46-60,1658,1204,454,1265,393
2002,Urban,West Bengal,Crime Against Men,Assault,Male,18-30,4068,3448,620,3484,584
2001,Rural,Jammu & Kashmir,Crime Against Children,Kidnapping,Male,60+,3561,386,3175,1548,2013
2009,Rural,Mizoram,Crime Against Children,Trafficking,Female,60+,94,5,89,9,85
2010,Urban,Haryana,Crime Against Men,Robbery,Female,46-60,9660,492,9168,6859,2801
2006,Rural,Delhi,Property Crime,Burglary,Female,13-17,6916,1238,5678,2588,4328
2008,Rural,Nagaland,Other Crimes,Cyber Crime,Female,60+,6145,4705,1440,5573,572
2003,Urban,Arunachal Pradesh,Property Crime,Arson,Female,31-45,5903,4374,1529,4794,1109
2006,Urban,Nagaland,Crime Against Men,Robbery,Female,0-12,3293,959,2334,2840,453
2004,Urban,Meghalaya,Crime Against Men,Extortion,Female,18-30,3604,2676,928,2986,618
2003,Rural,Haryana,Crime Against Children,Trafficking,Female,46-60,4813,322,4491,3484,1329
2003,Urban,Madhya Pradesh,Crime Against Women,Molestation,Female,60+,5109,4148,961,4355,754
2005,Rural,West Bengal,Crime Against Men,Robbery,Male,13-17,7219,1793,5426,2872,4347
2010,Urban,Uttar Pradesh,Crime Against Men,Extortion,Male,60+,4808,2320,2488,2467,2341
2007,Rural,Odisha,Crime Against Women,Molestation,Female,0-12,6447,911,5536,4136,2311
2002,Urban,Manipur,Crime Against Children,Kidnapping,Male,60+,5859,4432,1427,4470,1389
2003,Urban,Uttar Pradesh,Property Crime,Arson,Female,31-45,1755,87,1668,922,833
2009,Rural,Manipur,Crime Against Men,Assault,Male,31-45,1321,949,372,1285,36
2004,Rural,Rajasthan,Other Crimes,Corruption,Male,46-60,5472,483,4989,3689,1783
2010,Urban,Delhi,Other Crimes,Drug Offense,Female,46-60,225,222,3,225,0
2001,Rural,Tamil Nadu,Crime Against Women,Domestic Violence,Female,31-45,9465,3930,5535,4698,4767
2007,Urban,Odisha,Crime Against Men,Robbery,Male,18-30,1346,910,436,1261,85
2005,Urban,Manipur,Other Crimes,Drug Offense,Female,60+,9470,4193,5277,8304,1166
2002,Urban,Meghalaya,Property Crime,Vandalism,Male,60+,4036,2376,1660,2925,1111
2005,Rural,Arunachal Pradesh,Property Crime,Vandalism,Female,31-45,824,720,104,737,87
2004,Rural,Arunachal Pradesh,Crime Against Children,Kidnapping,Male,0-12,1522,615,907,940,582
2001,Rural,Meghalaya,Crime Against Women,Dowry Deaths,Female,0-12,2804,2008,796,2610,194
2010,Urban,Maharashtra,Property Crime,Burglary,Female,31-45,4955,1352,3603,4369,586
2005,Urban,Goa,Crime Against Men,Extortion,Female,60+,4730,2721,2009,3545,1185
2009,Rural,Punjab,Crime Against Women,Molestation,Male,31-45,5979,1201,4778,2836,3143
2002,Rural,Arunachal Pradesh,Crime Against Men,Assault,Female,13-17,4100,1862,2238,2963,1137
2004,Rural,Sikkim,Crime Against Men,Extortion,Female,13-17,2587,82,2505,717,1870
2010,Rural,Gujarat,Crime Against Men,Murder,Male,13-17,6227,3623,2604,5558,669
2008,Urban,Nagaland,Other Crimes,Fraud,Female,18-30,1195,1047,148,1064,131
2001,Urban,Meghalaya,Crime Against Children,Trafficking,Male,31-45,1115,1081,34,1092,23
2006,Rural,Rajasthan,Crime Against Children,Child Labor,Male,60+,1007,833,174,948,59
2009,Urban,Tamil Nadu,Other Crimes,Drug Offense,Male,31-45,8638,7135,1503,7696,942
2010,Rural,Gujarat,Crime Against Men,Robbery,Male,18-30,5188,2330,2858,4343,845
2009,Rural,Odisha,Other Crimes,Corruption,Female,60+,3208,1687,1521,2837,371
2001,Rural,Arunachal Pradesh,Other Crimes,Corruption,Female,60+,5729,971,4758,4181,1548
2008,Urban,Nagaland,Crime Against Children,Trafficking,Male,60+,1218,326,892,596,622
2002,Urban,Mizoram,Property Crime,Theft,Female,60+,9588,700,8888,7579,2009
2007,Urban,Telangana,Other Crimes,Drug Offense,Female,18-30,5061,693,4368,4865,196
2009,Rural,Haryana,Crime Against Men,Extortion,Male,46-60,6044,5072,972,5550,494
2006,Rural,Jharkhand,Other Crimes,Cyber Crime,Male,0-12,6961,6196,765,6803,158
2009,Rural,Tamil Nadu,Crime Against Women,Rape,Male,60+,4207,3933,274,4202,5
2003,Urban,Sikkim,Crime Against Men,Assault,Male,13-17,1118,188,930,945,173
2009,Rural,West Bengal,Other Crimes,Fraud,Female,18-30,2997,2085,912,2203,794
2003,Rural,Sikkim,Crime Against Women,Rape,Female,0-12,2581,2414,167,2567,14
2002,Urban,Kerala,Property Crime,Arson,Female,13-17,7177,1605,5572,1826,5351
2001,Urban,Assam,Crime Against Children,Child Abuse,Male,46-60,9436,7679,1757,8386,1050
2006,Urban,Rajasthan,Other Crimes,Corruption,Male,0-12,6596,1646,4950,3289,3307
2007,Rural,Bihar,Property Crime,Theft,Male,18-30,986,630,356,644,342
2002,Urban,Jharkhand,Other Crimes,Cyber Crime,Female,13-17,679,47,632,438,241
2008,Rural,Delhi,Property Crime,Vandalism,Female,60+,4686,2031,2655,4358,328
2004,Rural,Maharashtra,Crime Against Children,Trafficking,Female,18-30,6729,6468,261,6629,100
2006,Rural,West Bengal,Other Crimes,Fraud,Female,18-30,7118,1450,5668,3676,3442
2010,Urban,Tamil Nadu,Other Crimes,Corruption,Male,46-60,4044,2633,1411,3194,850
2002,Urban,Tamil Nadu,Crime Against Women,Dowry Deaths,Male,18-30,3381,1150,2231,2306,1075
2009,Urban,Jammu & Kashmir,Crime Against Men,Extortion,Female,46-60,5382,3092,2290,3948,1434
2005,Rural,Rajasthan,Crime Against Children,Child Abuse,Female,31-45,6968,3402,3566,6955,13
2009,Rural,Delhi,Crime Against Men,Extortion,Female,13-17,2276,1734,542,2118,158
2005,Rural,West Bengal,Crime Against Children,Child Abuse,Male,46-60,2947,318,2629,1919,1028
2001,Rural,West Bengal,Property Crime,Burglary,Male,60+,9725,7067,2658,9266,459
2009,Rural,Manipur,Property Crime,Arson,Female,18-30,8410,3358,5052,4620,3790
2003,Rural,Andhra Pradesh,Other Crimes,Fraud,Male,46-60,9633,1090,8543,7308,2325
2009,Rural,Odisha,Property Crime,Theft,Female,60+,350,242,108,254,96
2001,Urban,Delhi,Crime Against Women,Rape,Male,0-12,8259,5448,2811,7394,865
2007,Rural,Sikkim,Crime Against Children,Trafficking,Male,46-60,2332,1801,531,1823,509
2007,Rural,Himachal Pradesh,Other Crimes,Corruption,Male,13-17,4305,2055,2250,3504,801
2010,Urban,Sikkim,Other Crimes,Fraud,Male,13-17,425,190,235,229,196
2005,Rural,Nagaland,Crime Against Men,Robbery,Male,60+,6085,148,5937,5417,668
2010,Rural,Uttarakhand,Property Crime,Burglary,Female,46-60,2874,1936,938,2623,251
2007,Urban,Meghalaya,Property Crime,Theft,Female,31-45,3414,2827,587,3176,238
2007,Rural,Delhi,Crime Against Men,Extortion,Male,31-45,9018,2291,6727,8658,360
2002,Rural,Assam,Crime Against Children,Child Abuse,Female,0-12,4644,1169,3475,3141,1503
2002,Urban,Chhattisgarh,Crime Against Children,Child Abuse,Female,18-30,9865,6642,3223,6829,3036
2009,Urban,Telangana,Crime Against Children,Kidnapping,Male,46-60,747,575,172,648,99
2005,Rural,Tripura,Crime Against Men,Assault,Male,31-45,8094,7156,938,7263,831
2007,Rural,Odisha,Crime Against Women,Molestation,Female,46-60,3053,2549,504,2799,254
2002,Rural,Rajasthan,Property Crime,Arson,Male,18-30,4317,1336,2981,3658,659
2010,Urban,Rajasthan,Crime Against Women,Molestation,Female,31-45,4132,1368,2764,3045,1087
2005,Rural,Jammu & Kashmir,Other Crimes,Corruption,Female,0-12,6261,3895,2366,6213,48
2007,Urban,Assam,Crime Against Men,Murder,Male,18-30,646,444,202,622,24
2001,Urban,Punjab,Property Crime,Theft,Male,13-17,399,226,173,228,171
2006,Urban,Himachal Pradesh,Property Crime,Arson,Female,60+,1695,1381,314,1658,37
2002,Urban,Jharkhand,Crime Against Men,Murder,Female,60+,7644,5756,1888,6798,846
2010,Urban,Assam,Property Crime,Arson,Female,13-17,6239,1145,5094,1870,4369
2007,Rural,Sikkim,Crime Against Women,Rape,Male,60+,9361,6487,2874,8486,875
2002,Urban,Karnataka,Crime Against Men,Extortion,Female,0-12,1507,1030,477,1460,47
2002,Urban,Rajasthan,Crime Against Men,Extortion,Male,0-12,5419,1941,3478,4672,747
2009,Urban,Jammu & Kashmir,Other Crimes,Drug Offense,Male,18-30,8706,6010,2696,6524,2182
2002,Urban,Rajasthan,Crime Against Women,Rape,Female,13-17,9509,265,9244,3722,5787
2004,Urban,Jharkhand,Property Crime,Theft,Female,60+,4891,3212,1679,4509,382
2006,Urban,Karnataka,Crime Against Women,Domestic Violence,Male,46-60,2757,1271,1486,2237,520
2005,Urban,Rajasthan,Crime Against Women,Molestation,Male,31-45,1610,536,1074,1380,230
2003,Urban,Maharashtra,Property Crime,Vandalism,Female,0-12,5139,3747,1392,4223,916
2002,Rural,Rajasthan,Crime Against Men,Robbery,Female,13-17,1591,1172,419,1483,108
2009,Rural,Maharashtra,Crime Against Children,Child Abuse,Male,31-45,931,73,858,144,787
2001,Rural,Gujarat,Crime Against Children,Trafficking,Female,31-45,9100,1851,7249,5398,3702
2003,Rural,Sikkim,Other Crimes,Fraud,Male,31-45,1372,20,1352,635,737
2003,Rural,Haryana,Crime Against Children,Kidnapping,Female,31-45,8295,5910,2385,7184,1111
2004,Rural,Maharashtra,Other Crimes,Drug Offense,Female,13-17,7779,5273,2506,5439,2340
2006,Urban,Chhattisgarh,Crime Against Men,Robbery,Male,46-60,9212,3160,6052,9048,164
2009,Rural,Rajasthan,Property Crime,Burglary,Male,18-30,8488,1245,7243,3819,4669
2006,Rural,Chhattisgarh,Crime Against Women,Rape,Female,13-17,5544,4148,1396,4204,1340
2006,Rural,Assam,Property Crime,Arson,Male,0-12,7084,358,6726,3124,3960
2009,Urban,Karnataka,Property Crime,Burglary,Female,0-12,1243,437,806,474,769
2010,Urban,Tripura,Property Crime,Theft,Female,0-12,4491,340,4151,2028,2463
2010,Urban,Uttar Pradesh,Other Crimes,Corruption,Female,18-30,8693,8467,226,8532,161
2005,Rural,Nagaland,Crime Against Women,Domestic Violence,Female,13-17,3541,341,3200,1192,2349
2005,Urban,Meghalaya,Crime Against Men,Assault,Female,0-12,2516,1983,533,2069,447
2004,Rural,Rajasthan,Property Crime,Burglary,Female,18-30,1998,397,1601,1067,931
2008,Rural,Meghalaya,Other Crimes,Drug Offense,Female,60+,3998,449,3549,3473,525
2008,Urban,Tripura,Property Crime,Theft,Male,0-12,2368,1624,744,1838,530
2002,Urban,Uttar Pradesh,Other Crimes,Drug Offense,Male,13-17,6514,6312,202,6435,79
2003,Urban,West Bengal,Crime Against Men,Assault,Male,60+,6821,4401,2420,6717,104
2007,Urban,Delhi,Crime Against Men,Assault,Male,0-12,7539,3383,4156,3922,3617
2009,Rural,Bihar,Crime Against Women,Rape,Male,13-17,9908,5202,4706,6585,3323
2001,Rural,Telangana,Property Crime,Theft,Female,31-45,6325,3994,2331,4690,1635
2002,Rural,Nagaland,Crime Against Children,Child Abuse,Male,60+,2966,108,2858,2770,196
2003,Rural,Sikkim,Crime Against Women,Dowry Deaths,Male,18-30,7502,4871,2631,6558,944
2002,Rural,Haryana,Property Crime,Burglary,Female,46-60,9916,1257,8659,4369,5547
2001,Rural,Uttar Pradesh,Crime Against Women,Dowry Deaths,Female,18-30,916,69,847,317,599
2008,Urban,Jharkhand,Other Crimes,Cyber Crime,Female,0-12,9652,1171,8481,7922,1730
2001,Rural,West Bengal,Crime Against Children,Child Abuse,Male,18-30,1599,477,1122,1014,585
2004,Urban,Odisha,Crime Against Children,Kidnapping,Male,13-17,7373,4254,3119,6775,598
2007,Urban,Delhi,Crime Against Children,Child Abuse,Male,18-30,637,377,260,492,145
2001,Urban,Uttarakhand,Crime Against Women,Domestic Violence,Female,0-12,9795,3692,6103,5917,3878
2003,Urban,Punjab,Crime Against Children,Child Labor,Male,0-12,2849,167,2682,2849,0
2002,Rural,Manipur,Crime Against Women,Rape,Male,18-30,5882,4045,1837,4792,1090
2001,Urban,West Bengal,Property Crime,Theft,Female,0-12,7750,3460,4290,7670,80
2007,Rural,Uttarakhand,Property Crime,Vandalism,Male,46-60,7295,5411,1884,5497,1798
2003,Rural,Maharashtra,Property Crime,Arson,Male,13-17,6477,5508,969,5944,533
2004,Rural,Maharashtra,Crime Against Children,Trafficking,Male,31-45,4165,2630,1535,3725,440
2005,Rural,Madhya Pradesh,Other Crimes,Fraud,Male,0-12,7210,199,7011,2432,4778
2002,Rural,Madhya Pradesh,Crime Against Men,Assault,Male,18-30,5085,1921,3164,3985,1100
2009,Rural,Meghalaya,Other Crimes,Drug Offense,Female,31-45,767,600,167,748,19
2006,Rural,Karnataka,Crime Against Women,Molestation,Female,31-45,9937,9129,808,9238,699
2003,Urban,Haryana,Crime Against Children,Trafficking,Male,18-30,1944,1890,54,1944,0
2008,Urban,Punjab,Crime Against Children,Child Abuse,Female,46-60,605,183,422,208,397
2008,Urban,Meghalaya,Crime Against Women,Domestic Violence,Male,60+,8135,6192,1943,7688,447
2008,Urban,Assam,Crime Against Men,Extortion,Female,13-17,373,144,229,316,57
2005,Urban,Arunachal Pradesh,Other Crimes,Fraud,Male,13-17,2005,1212,793,1572,433
2004,Urban,Uttar Pradesh,Crime Against Children,Child Labor,Male,13-17,1861,1190,671,1809,52
2006,Urban,Goa,Crime Against Women,Domestic Violence,Male,31-45,2427,1661,766,2140,287
2009,Rural,Goa,Crime Against Women,Molestation,Male,0-12,9330,4793,4537,9292,38
2003,Urban,Haryana,Other Crimes,Drug Offense,Female,13-17,446,415,31,443,3
2002,Urban,Karnataka,Property Crime,Theft,Male,31-45,9639,55,9584,6103,3536
2003,Rural,Uttar Pradesh,Property Crime,Arson,Male,60+,580,335,245,382,198
2004,Rural,Gujarat,Crime Against Children,Child Labor,Female,0-12,2820,2573,247,2731,89
2002,Urban,Madhya Pradesh,Crime Against Women,Dowry Deaths,Male,31-45,2177,413,1764,1301,876
2006,Rural,Assam,Property Crime,Burglary,Male,60+,8351,1830,6521,6006,2345
2005,Rural,Maharashtra,Other Crimes,Fraud,Male,60+,6059,2373,3686,2677,3382
2002,Rural,Goa,Crime Against Women,Domestic Violence,Female,0-12,892,501,391,783,109
2005,Rural,Madhya Pradesh,Property Crime,Theft,Female,0-12,5725,2256,3469,2838,2887
2007,Rural,Odisha,Crime Against Children,Child Abuse,Male,31-45,3962,3891,71,3892,70
2008,Urban,Telangana,Property Crime,Burglary,Female,0-12,8240,807,7433,3500,4740
2009,Rural,Punjab,Crime Against Men,Murder,Male,46-60,5898,4591,1307,5874,24
2009,Rural,Madhya Pradesh,Crime Against Children,Trafficking,Male,31-45,325,252,73,257,68
2004,Urban,Assam,Property Crime,Arson,Male,0-12,6249,1478,4771,3197,3052
2010,Urban,Odisha,Crime Against Men,Extortion,Female,60+,8277,1079,7198,5295,2982
2005,Rural,Sikkim,Crime Against Women,Dowry Deaths,Female,18-30,1768,1750,18,1763,5
2007,Rural,Jammu & Kashmir,Crime Against Men,Robbery,Male,0-12,5986,575,5411,3567,2419
2004,Rural,Meghalaya,Crime Against Men,Assault,Male,46-60,3514,1572,1942,1994,1520
2004,Urban,Assam,Crime Against Women,Domestic Violence,Female,46-60,8900,6030,2870,8362,538
2004,Urban,Delhi,Other Crimes,Fraud,Female,13-17,6693,5501,1192,6546,147
2002,Urban,Haryana,Crime Against Men,Robbery,Male,13-17,7926,4781,3145,5541,2385
2006,Urban,Uttarakhand,Crime Against Men,Extortion,Female,18-30,5592,2250,3342,4468,1124
2010,Urban,Manipur,Crime Against Children,Child Abuse,Female,0-12,6335,2023,4312,2521,3814
2001,Rural,Manipur,Crime Against Children,Child Abuse,Female,18-30,4492,1076,3416,1333,3159
2001,Rural,Tamil Nadu,Other Crimes,Corruption,Female,18-30,6145,5318,827,5368,777
2007,Rural,West Bengal,Other Crimes,Fraud,Female,13-17,9091,4093,4998,7061,2030
2008,Urban,Telangana,Crime Against Men,Murder,Female,31-45,4406,1094,3312,3448,958
2009,Urban,Himachal Pradesh,Crime Against Women,Rape,Female,18-30,2323,2310,13,2311,12
2006,Urban,Rajasthan,Crime Against Men,Murder,Female,31-45,5397,1514,3883,3066,2331
2002,Urban,Bihar,Crime Against Men,Robbery,Female,0-12,958,715,243,942,16
2006,Urban,Assam,Crime Against Women,Domestic Violence,Female,18-30,3121,3043,78,3061,60
2003,Urban,Jammu & Kashmir,Property Crime,Theft,Female,13-17,9883,7692,2191,8674,1209
2008,Urban,Odisha,Other Crimes,Fraud,Female,13-17,1778,1425,353,1776,2
2009,Rural,Telangana,Crime Against Men,Robbery,Male,13-17,989,82,907,439,550
2002,Urban,Kerala,Crime Against Children,Child Abuse,Female,18-30,5211,2633,2578,5117,94
2003,Rural,Punjab,Property Crime,Vandalism,Male,0-12,7617,802,6815,3493,4124
2005,Rural,Haryana,Crime Against Men,Assault,Male,0-12,2439,329,2110,1843,596
2005,Urban,West Bengal,Property Crime,Vandalism,Male,0-12,9654,2867,6787,6503,3151
2002,Urban,Tamil Nadu,Property Crime,Arson,Male,0-12,9098,6091,3007,7457,1641
2006,Urban,Assam,Crime Against Men,Robbery,Male,60+,6544,5055,1489,6052,492
2003,Rural,Telangana,Crime Against Men,Assault,Female,31-45,7461,5674,1787,7221,240
2004,Urban,Kerala,Crime Against Men,Murder,Female,0-12,1162,667,495,940,222
2009,Rural,Telangana,Crime Against Men,Extortion,Male,18-30,5898,4047,1851,4216,1682
2003,Rural,Madhya Pradesh,Crime Against Women,Rape,Male,0-12,4364,1357,3007,2351,2013
2010,Urban,Manipur,Crime Against Men,Extortion,Female,46-60,4986,862,4124,4865,121
2006,Rural,Uttarakhand,Property Crime,Burglary,Male,31-45,3692,3623,69,3675,17
2009,Urban,Assam,Crime Against Children,Kidnapping,Male,60+,839,164,675,332,507
2007,Urban,Chhattisgarh,Crime Against Women,Molestation,Female,0-12,9105,6204,2901,9039,66
2006,Rural,Kerala,Crime Against Women,Dowry Deaths,Female,31-45,6314,2599,3715,4879,1435
2002,Rural,Haryana,Crime Against Men,Extortion,Male,60+,3669,2955,714,3540,129
2004,Rural,Manipur,Crime Against Men,Extortion,Male,46-60,190,190,0,190,0
2001,Rural,Madhya Pradesh,Crime Against Children,Child Labor,Female,13-17,8659,6081,2578,8541,118
2005,Urban,Gujarat,Property Crime,Vandalism,Male,46-60,3632,1084,2548,1718,1914
2005,Urban,Assam,Crime Against Women,Dowry Deaths,Male,0-12,1885,1302,583,1396,489
2008,Rural,Delhi,Crime Against Men,Extortion,Male,0-12,5268,2329,2939,3929,1339
2003,Rural,Punjab,Other Crimes,Drug Offense,Female,31-45,4263,3674,589,4087,176
2003,Urban,Manipur,Crime Against Women,Dowry Deaths,Male,0-12,2643,878,1765,1814,829
2006,Rural,Haryana,Crime Against Children,Child Labor,Female,18-30,6266,1424,4842,5233,1033
2003,Urban,Jharkhand,Property Crime,Arson,Male,13-17,5063,1232,3831,1480,3583
2002,Urban,Kerala,Property Crime,Arson,Female,13-17,50,1,49,36,14
2002,Rural,Gujarat,Crime Against Men,Assault,Male,0-12,574,318,256,433,141
2006,Urban,Punjab,Other Crimes,Drug Offense,Male,46-60,3398,1231,2167,2691,707
2004,Rural,Goa,Property Crime,Burglary,Male,31-45,446,391,55,393,53
2002,Urban,Odisha,Crime Against Women,Rape,Male,31-45,3150,2518,632,2831,319
2001,Rural,Jammu & Kashmir,Other Crimes,Drug Offense,Male,13-17,9476,1489,7987,5406,4070
2007,Urban,Jammu & Kashmir,Crime Against Women,Molestation,Female,31-45,9318,2764,6554,3100,6218
2008,Urban,Uttarakhand,Crime Against Men,Extortion,Male,0-12,811,494,317,629,182
2001,Rural,Meghalaya,Other Crimes,Drug Offense,Male,18-30,5165,2529,2636,5121,44
2001,Rural,Assam,Crime Against Men,Murder,Female,18-30,4446,274,4172,2096,2350
2008,Rural,Telangana,Crime Against Children,Child Abuse,Female,31-45,8177,1924,6253,2639,5538
2009,Urban,Tamil Nadu,Property Crime,Burglary,Female,46-60,4656,763,3893,1704,2952
2007,Rural,Chhattisgarh,Other Crimes,Cyber Crime,Female,46-60,8819,4704,4115,6146,2673
2010,Urban,Himachal Pradesh,Other Crimes,Corruption,Female,60+,9839,8414,1425,8828,1011
2010,Urban,Chhattisgarh,Crime Against Children,Trafficking,Female,18-30,9254,3238,6016,6853,2401
2009,Urban,Mizoram,Other Crimes,Corruption,Male,60+,5036,3026,2010,4733,303
2010,Urban,Tamil Nadu,Other Crimes,Cyber Crime,Male,18-30,6455,422,6033,852,5603
2006,Urban,West Bengal,Crime Against Children,Kidnapping,Male,0-12,3307,2329,978,3171,136
2005,Rural,Uttar Pradesh,Crime Against Men,Extortion,Male,46-60,7586,3312,4274,6953,633
2006,Rural,Gujarat,Crime Against Men,Murder,Female,46-60,1164,212,952,698,466
2010,Rural,Mizoram,Crime Against Men,Extortion,Male,31-45,3037,773,2264,1510,1527
2003,Rural,Tripura,Crime Against Men,Murder,Male,31-45,6345,5787,558,6330,15
2010,Urban,Bihar,Crime Against Children,Child Abuse,Male,31-45,9813,7474,2339,8342,1471
2006,Rural,Karnataka,Crime Against Women,Dowry Deaths,Male,60+,1512,62,1450,1511,1
2003,Urban,Assam,Crime Against Children,Kidnapping,Female,13-17,713,278,435,696,17
2001,Rural,Kerala,Crime Against Men,Robbery,Male,31-45,5534,1384,4150,3781,1753
2001,Rural,Rajasthan,Other Crimes,Drug Offense,Female,18-30,6833,1402,5431,3994,2839
2005,Rural,Odisha,Property Crime,Burglary,Female,13-17,7344,3040,4304,4173,3171
2001,Urban,Punjab,Other Crimes,Corruption,Male,60+,8160,7141,1019,7779,381
2008,Rural,Telangana,Property Crime,Arson,Male,31-45,8808,6181,2627,8607,201
2008,Urban,Kerala,Crime Against Children,Child Abuse,Male,60+,8532,8159,373,8442,90
2002,Urban,Meghalaya,Crime Against Men,Murder,Male,13-17,906,101,805,746,160
2007,Rural,Tamil Nadu,Other Crimes,Corruption,Male,60+,1343,831,512,1258,85
2006,Rural,Andhra Pradesh,Crime Against Women,Domestic Violence,Male,46-60,5322,4411,911,5253,69
2008,Urban,Kerala,Other Crimes,Drug Offense,Male,18-30,5821,4186,1635,5792,29
2005,Rural,Jammu & Kashmir,Property Crime,Theft,Female,60+,2584,73,2511,2138,446
2008,Rural,Maharashtra,Crime Against Women,Dowry Deaths,Male,13-17,3939,3800,139,3843,96
2005,Urban,Delhi,Crime Against Children,Child Abuse,Female,46-60,5571,944,4627,5208,363
2008,Urban,Sikkim,Crime Against Women,Molestation,Male,46-60,4852,1340,3512,2296,2556
2004,Urban,Haryana,Crime Against Children,Trafficking,Female,0-12,6854,2164,4690,2166,4688
2005,Rural,Arunachal Pradesh,Crime Against Children,Child Labor,Male,31-45,359,351,8,355,4
2010,Rural,Andhra Pradesh,Property Crime,Theft,Male,46-60,546,429,117,475,71
2005,Urban,Maharashtra,Crime Against Women,Dowry Deaths,Female,31-45,8051,2899,5152,3184,4867
2008,Rural,Madhya Pradesh,Crime Against Children,Kidnapping,Female,31-45,5160,1943,3217,2672,2488
2003,Urban,Nagaland,Crime Against Women,Rape,Male,31-45,4654,2946,1708,3295,1359
2006,Urban,Arunachal Pradesh,Other Crimes,Drug Offense,Female,0-12,5105,1978,3127,4066,1039
2004,Urban,Goa,Other Crimes,Drug Offense,Female,46-60,3287,1140,2147,1859,1428
2002,Urban,Punjab,Property Crime,Theft,Female,13-17,995,873,122,955,40
2005,Rural,Uttarakhand,Property Crime,Arson,Male,60+,7746,6627,1119,7079,667
2001,Urban,Kerala,Other Crimes,Fraud,Female,0-12,5569,36,5533,4722,847
2008,Rural,Manipur,Crime Against Women,Molestation,Female,46-60,3456,576,2880,873,2583
2007,Rural,Maharashtra,Crime Against Children,Kidnapping,Female,31-45,6911,4547,2364,6370,541
2001,Rural,Jharkhand,Property Crime,Arson,Male,13-17,9974,1110,8864,4948,5026
2003,Urban,Gujarat,Crime Against Children,Kidnapping,Male,60+,6702,867,5835,4253,2449
2004,Urban,Nagaland,Crime Against Women,Molestation,Female,13-17,9460,8915,545,9017,443
2010,Urban,Goa,Crime Against Children,Child Abuse,Female,31-45,213,165,48,174,39
2003,Rural,Maharashtra,Crime Against Children,Trafficking,Female,13-17,6884,1115,5769,1291,5593
2005,Rural,Kerala,Property Crime,Vandalism,Female,0-12,6101,5934,167,5937,164
2003,Urban,Andhra Pradesh,Crime Against Men,Robbery,Male,0-12,2585,285,2300,1660,925
2009,Rural,Karnataka,Crime Against Children,Child Labor,Female,13-17,5772,2540,3232,4619,1153
2004,Rural,Uttar Pradesh,Crime Against Men,Extortion,Female,31-45,3966,2626,1340,3749,217
2003,Urban,Andhra Pradesh,Crime Against Children,Trafficking,Male,18-30,9483,8397,1086,9111,372
2006,Rural,Maharashtra,Other Crimes,Drug Offense,Male,46-60,586,547,39,573,13
2003,Urban,Telangana,Crime Against Men,Robbery,Female,0-12,9033,4278,4755,4355,4678
2010,Urban,Andhra Pradesh,Crime Against Men,Assault,Male,13-17,6555,752,5803,1124,5431
2010,Urban,Manipur,Property Crime,Arson,Female,18-30,5629,2577,3052,5076,553
2003,Rural,Manipur,Crime Against Women,Molestation,Female,60+,5191,3166,2025,4079,1112
2001,Rural,Uttar Pradesh,Crime Against Men,Extortion,Male,0-12,9199,5571,3628,7520,1679
2001,Rural,Jammu & Kashmir,Crime Against Children,Trafficking,Male,0-12,9720,1797,7923,9387,333
2008,Rural,Andhra Pradesh,Crime Against Women,Rape,Female,18-30,9425,6479,2946,6718,2707
2004,Rural,Maharashtra,Crime Against Women,Dowry Deaths,Male,0-12,7985,2608,5377,3037,4948
2004,Urban,Telangana,Other Crimes,Fraud,Male,13-17,7785,4540,3245,5771,2014
2003,Urban,Mizoram,Crime Against Men,Assault,Male,13-17,9529,8296,1233,8975,554
2003,Rural,Assam,Crime Against Children,Kidnapping,Male,0-12,2513,1216,1297,1404,1109
2006,Urban,Telangana,Crime Against Children,Trafficking,Female,18-30,3233,3102,131,3231,2
2004,Urban,Haryana,Crime Against Women,Dowry Deaths,Male,18-30,459,390,69,434,25
2002,Urban,Uttarakhand,Property Crime,Burglary,Female,60+,2606,1439,1167,1800,806
2010,Rural,Maharashtra,Crime Against Women,Rape,Female,31-45,5424,4115,1309,4144,1280
2006,Rural,Jammu & Kashmir,Property Crime,Burglary,Male,46-60,3511,1611,1900,1998,1513
2002,Urban,Maharashtra,Other Crimes,Drug Offense,Male,46-60,7271,4456,2815,4863,2408
2001,Urban,Assam,Crime Against Women,Dowry Deaths,Female,31-45,1967,857,1110,976,991
2003,Rural,Rajasthan,Property Crime,Vandalism,Female,46-60,1467,235,1232,1122,345
2007,Rural,Bihar,Other Crimes,Cyber Crime,Male,0-12,6266,4903,1363,5665,601
2008,Urban,Himachal Pradesh,Property Crime,Burglary,Female,31-45,9059,6181,2878,9043,16
2006,Urban,Manipur,Other Crimes,Drug Offense,Female,0-12,3720,819,2901,1111,2609
2007,Urban,Delhi,Crime Against Women,Molestation,Female,60+,3368,569,2799,1108,2260
2007,Urban,Odisha,Crime Against Women,Dowry Deaths,Female,31-45,8245,4599,3646,5145,3100
2004,Urban,Karnataka,Crime Against Children,Child Abuse,Female,31-45,1610,376,1234,1412,198
2005,Urban,Mizoram,Other Crimes,Corruption,Female,60+,7940,654,7286,4231,3709
2003,Rural,Nagaland,Crime Against Children,Child Labor,Female,18-30,7928,6583,1345,7832,96
2003,Rural,Sikkim,Crime Against Women,Molestation,Female,46-60,6629,4217,2412,5147,1482
2010,Rural,Nagaland,Crime Against Children,Child Labor,Female,31-45,2683,2609,74,2653,30
2004,Rural,Delhi,Property Crime,Arson,Male,60+,8912,3107,5805,4072,4840
2004,Urban,Madhya Pradesh,Crime Against Women,Dowry Deaths,Female,31-45,3582,1180,2402,1217,2365
2005,Rural,Tripura,Property Crime,Burglary,Male,0-12,9526,6809,2717,7181,2345
2001,Urban,Tamil Nadu,Crime Against Children,Kidnapping,Male,46-60,1079,137,942,553,526
2005,Urban,Gujarat,Crime Against Women,Domestic Violence,Female,18-30,7520,5438,2082,5850,1670
2005,Urban,Rajasthan,Crime Against Children,Trafficking,Female,60+,8608,4535,4073,7542,1066
2006,Rural,Delhi,Crime Against Women,Dowry Deaths,Female,31-45,4880,3065,1815,4338,542
2008,Rural,Madhya Pradesh,Crime Against Children,Child Labor,Male,13-17,9906,4891,5015,9691,215
2009,Rural,Jammu & Kashmir,Crime Against Children,Child Labor,Female,18-30,6398,3849,2549,4179,2219
2003,Urban,Jammu & Kashmir,Crime Against Men,Assault,Male,31-45,4580,3814,766,3833,747
2005,Urban,Uttarakhand,Property Crime,Theft,Male,13-17,4927,4035,892,4300,627
2005,Rural,Telangana,Other Crimes,Drug Offense,Female,13-17,8132,1882,6250,2144,5988
2008,Urban,Tripura,Property Crime,Theft,Female,18-30,6186,2774,3412,5901,285
2010,Urban,Telangana,Crime Against Children,Kidnapping,Female,18-30,8703,7726,977,8228,475
2010,Urban,Gujarat,Other Crimes,Fraud,Female,31-45,4413,403,4010,2433,1980
2010,Rural,Himachal Pradesh,Other Crimes,Cyber Crime,Male,0-12,8137,499,7638,626,7511
2002,Urban,Jammu & Kashmir,Crime Against Children,Trafficking,Male,60+,3379,1807,1572,2943,436
2006,Urban,Assam,Property Crime,Theft,Male,13-17,5223,1899,3324,3440,1783
2006,Urban,Delhi,Property Crime,Theft,Female,18-30,5087,3085,2002,4945,142
2003,Rural,Rajasthan,Other Crimes,Drug Offense,Male,60+,7793,4346,3447,6362,1431
2006,Rural,Karnataka,Crime Against Women,Rape,Male,13-17,6489,3882,2607,4477,2012
2002,Urban,Kerala,Crime Against Children,Trafficking,Male,0-12,3044,1050,1994,2914,130
2009,Urban,Tamil Nadu,Crime Against Women,Domestic Violence,Female,18-30,4551,556,3995,3515,1036
2009,Urban,Kerala,Crime Against Women,Rape,Male,31-45,2086,1325,761,1786,300
2008,Urban,Uttar Pradesh,Crime Against Women,Rape,Female,0-12,9482,3228,6254,5037,4445
2003,Rural,Rajasthan,Crime Against Children,Child Abuse,Female,13-17,112,79,33,94,18
2003,Rural,Kerala,Crime Against Children,Trafficking,Female,13-17,6948,1897,5051,6676,272
2008,Rural,Sikkim,Property Crime,Arson,Female,18-30,7922,3233,4689,5589,2333
2001,Urban,Jammu & Kashmir,Crime Against Children,Trafficking,Female,46-60,4177,1772,2405,3244,933
2010,Rural,Bihar,Crime Against Men,Murder,Female,0-12,7515,430,7085,6142,1373
2006,Urban,West Bengal,Property Crime,Vandalism,Female,0-12,7142,3638,3504,4751,2391
2006,Urban,Andhra Pradesh,Crime Against Men,Extortion,Male,18-30,5273,1463,3810,2765,2508
2002,Urban,Haryana,Crime Against Women,Rape,Male,13-17,6932,3159,3773,4122,2810
2001,Rural,Goa,Crime Against Men,Assault,Male,13-17,8776,5189,3587,7550,1226
2006,Rural,Bihar,Crime Against Men,Murder,Female,46-60,5536,1466,4070,3509,2027
2003,Rural,Kerala,Crime Against Men,Robbery,Female,60+,9229,7276,1953,7603,1626
2003,Rural,West Bengal,Crime Against Children,Child Abuse,Female,31-45,6091,654,5437,3938,2153
2001,Rural,West Bengal,Crime Against Women,Dowry Deaths,Female,0-12,9822,3746,6076,5380,4442
2008,Rural,Rajasthan,Crime Against Women,Domestic Violence,Male,18-30,846,41,805,162,684
2009,Urban,Madhya Pradesh,Other Crimes,Corruption,Male,60+,494,207,287,348,146
2009,Urban,Telangana,Crime Against Women,Dowry Deaths,Male,31-45,4252,931,3321,1683,2569
2004,Rural,Tripura,Other Crimes,Corruption,Male,60+,4994,2936,2058,3912,1082
2002,Rural,Delhi,Crime Against Men,Extortion,Male,13-17,9049,4212,4837,7548,1501
2003,Rural,Madhya Pradesh,Crime Against Women,Rape,Female,13-17,4114,143,3971,1185,2929
2007,Urban,Uttar Pradesh,Crime Against Men,Extortion,Male,60+,3049,2793,256,2916,133
2007,Urban,Bihar,Crime Against Children,Child Labor,Male,31-45,5421,1352,4069,2814,2607
2008,Urban,Gujarat,Property Crime,Burglary,Male,46-60,8162,5718,2444,7927,235
2006,Rural,Tripura,Crime Against Children,Child Abuse,Female,0-12,942,169,773,447,495
2008,Urban,Delhi,Crime Against Men,Assault,Male,60+,5862,2829,3033,3785,2077
2007,Rural,Uttarakhand,Crime Against Men,Extortion,Male,0-12,1686,737,949,830,856
2003,Urban,Karnataka,Other Crimes,Cyber Crime,Male,13-17,7487,2516,4971,5816,1671
2010,Rural,Uttar Pradesh,Crime Against Children,Child Labor,Female,60+,6985,4657,2328,5892,1093
2003,Urban,Mizoram,Other Crimes,Fraud,Male,13-17,2723,2090,633,2690,33
2010,Rural,Assam,Other Crimes,Drug Offense,Male,18-30,685,14,671,622,63
2003,Rural,Uttarakhand,Crime Against Men,Extortion,Female,31-45,4970,2663,2307,4775,195
2008,Urban,Odisha,Crime Against Women,Domestic Violence,Female,13-17,1063,217,846,852,211
2006,Urban,Mizoram,Other Crimes,Corruption,Male,13-17,1980,109,1871,1966,14
2005,Urban,Jammu & Kashmir,Crime Against Children,Trafficking,Female,0-12,6137,4479,1658,4563,1574
2007,Urban,Assam,Crime Against Children,Trafficking,Male,13-17,704,562,142,652,52
2008,Rural,Chhattisgarh,Other Crimes,Cyber Crime,Male,0-12,1298,776,522,1170,128
2004,Urban,Nagaland,Crime Against Women,Dowry Deaths,Male,31-45,158,29,129,61,97
2010,Urban,West Bengal,Crime Against Men,Robbery,Female,13-17,6981,3056,3925,5608,1373
2002,Urban,Maharashtra,Crime Against Men,Murder,Female,0-12,1481,407,1074,846,635
2006,Urban,Rajasthan,Property Crime,Arson,Male,13-17,1737,589,1148,1410,327
2002,Urban,Goa,Crime Against Women,Dowry Deaths,Male,60+,5233,3403,1830,4633,600
2004,Urban,Arunachal Pradesh,Other Crimes,Drug Offense,Male,46-60,3347,1464,1883,1705,1642
2009,Urban,Uttar Pradesh,Crime Against Men,Extortion,Female,13-17,78,57,21,60,18
2010,Urban,Uttarakhand,Property Crime,Burglary,Female,0-12,1843,765,1078,1551,292
2006,Rural,Punjab,Property Crime,Arson,Female,0-12,1496,681,815,1364,132
2001,Rural,Sikkim,Crime Against Women,Dowry Deaths,Female,31-45,9918,2742,7176,4568,5350
2004,Urban,Uttarakhand,Property Crime,Theft,Male,31-45,5652,3570,2082,3580,2072
2007,Rural,Jharkhand,Other Crimes,Drug Offense,Male,60+,2021,1303,718,1964,57
2004,Rural,Andhra Pradesh,Crime Against Children,Trafficking,Female,18-30,6013,5348,665,5513,500
2009,Urban,Gujarat,Crime Against Women,Dowry Deaths,Male,60+,8963,6632,2331,7889,1074
2007,Rural,Sikkim,Crime Against Women,Rape,Male,46-60,5229,807,4422,2173,3056
2004,Urban,Haryana,Property Crime,Vandalism,Female,0-12,3358,2025,1333,2323,1035
2002,Urban,Jharkhand,Crime Against Women,Dowry Deaths,Female,60+,2723,2577,146,2589,134
2004,Rural,Uttar Pradesh,Crime Against Men,Assault,Female,13-17,4071,2287,1784,3317,754
2007,Rural,Maharashtra,Crime Against Men,Murder,Female,0-12,487,359,128,434,53
2003,Rural,Rajasthan,Crime Against Men,Murder,Male,13-17,804,110,694,195,609
2002,Rural,Uttar Pradesh,Crime Against Men,Robbery,Female,46-60,5804,4509,1295,4640,1164
2001,Rural,Mizoram,Crime Against Children,Trafficking,Female,31-45,1171,908,263,953,218
2004,Rural,Bihar,Crime Against Women,Molestation,Female,18-30,4617,2826,1791,3724,893
2002,Urban,Jharkhand,Crime Against Children,Child Labor,Female,0-12,6934,6135,799,6582,352
2007,Rural,Uttar Pradesh,Crime Against Men,Murder,Female,46-60,2556,572,1984,2341,215
2002,Rural,Meghalaya,Property Crime,Arson,Male,0-12,109,3,106,51,58
2004,Urban,Maharashtra,Crime Against Women,Rape,Male,31-45,2600,333,2267,1080,1520
2006,Rural,Jharkhand,Property Crime,Vandalism,Female,31-45,6764,4777,1987,5609,1155
2007,Urban,Bihar,Crime Against Children,Child Labor,Male,31-45,2806,1003,1803,1766,1040
2006,Urban,Uttar Pradesh,Crime Against Children,Trafficking,Female,0-12,1588,1256,332,1326,262
2009,Urban,Madhya Pradesh,Other Crimes,Corruption,Male,46-60,1341,275,1066,610,731
2007,Rural,Assam,Crime Against Children,Child Abuse,Female,60+,5383,2752,2631,4321,1062
2008,Urban,Odisha,Other Crimes,Cyber Crime,Male,13-17,1057,420,637,573,484
2005,Urban,Rajasthan,Crime Against Children,Trafficking,Female,13-17,2691,304,2387,901,1790
2002,Rural,Tripura,Crime Against Men,Murder,Female,13-17,2007,940,1067,1552,455
2004,Urban,Uttar Pradesh,Crime Against Men,Murder,Male,0-12,4000,1611,2389,3077,923
2003,Urban,Tamil Nadu,Crime Against Women,Domestic Violence,Female,0-12,8887,7710,1177,8237,650
2004,Urban,Arunachal Pradesh,Crime Against Men,Robbery,Male,60+,4038,1063,2975,3555,483
2006,Urban,Andhra Pradesh,Crime Against Men,Murder,Female,18-30,1223,1081,142,1201,22
2001,Urban,Andhra Pradesh,Crime Against Women,Dowry Deaths,Female,18-30,5379,3429,1950,4210,1169
2007,Urban,Uttarakhand,Other Crimes,Corruption,Male,31-45,4526,1995,2531,2658,1868
2010,Rural,Delhi,Other Crimes,Fraud,Male,13-17,4174,3520,654,3876,298
2010,Urban,Sikkim,Crime Against Women,Molestation,Male,60+,5643,744,4899,1680,3963
2002,Urban,Haryana,Other Crimes,Corruption,Male,18-30,4840,4440,400,4777,63
2002,Rural,Delhi,Crime Against Men,Assault,Male,31-45,8197,7027,1170,7496,701
2010,Rural,Tamil Nadu,Crime Against Children,Child Abuse,Male,31-45,7089,6591,498,6641,448
2009,Urban,Gujarat,Other Crimes,Fraud,Female,0-12,676,384,292,435,241
2005,Urban,Arunachal Pradesh,Crime Against Women,Domestic Violence,Female,46-60,4968,3424,1544,3729,1239
2006,Urban,Rajasthan,Crime Against Children,Kidnapping,Male,60+,1353,799,554,1138,215
2004,Rural,Sikkim,Other Crimes,Corruption,Male,60+,6053,4337,1716,5409,644
2008,Rural,Uttarakhand,Crime Against Men,Murder,Male,18-30,4012,2381,1631,2471,1541
2010,Urban,Jharkhand,Crime Against Men,Robbery,Male,31-45,3423,2349,1074,2356,1067
2010,Rural,Assam,Crime Against Children,Child Labor,Female,13-17,7629,1591,6038,2900,4729
2007,Urban,Kerala,Crime Against Men,Assault,Female,46-60,3598,2525,1073,2589,1009
2008,Urban,Himachal Pradesh,Crime Against Men,Robbery,Male,13-17,2444,1773,671,2251,193
2010,Rural,Sikkim,Other Crimes,Cyber Crime,Male,31-45,3129,694,2435,1247,1882
2005,Rural,Haryana,Crime Against Men,Murder,Male,31-45,9538,3964,5574,4265,5273
2003,Urban,West Bengal,Crime Against Women,Domestic Violence,Female,31-45,7396,5743,1653,5941,1455
2004,Rural,Uttarakhand,Crime Against Men,Murder,Male,0-12,6546,1984,4562,5432,1114
2002,Urban,Goa,Property Crime,Vandalism,Female,0-12,6490,6004,486,6439,51
2010,Urban,Haryana,Crime Against Men,Assault,Female,0-12,2468,1913,555,2059,409
2009,Urban,Mizoram,Crime Against Children,Child Labor,Male,0-12,324,221,103,249,75
2004,Urban,Madhya Pradesh,Other Crimes,Cyber Crime,Male,0-12,2544,2325,219,2366,178
2009,Urban,Punjab,Other Crimes,Cyber Crime,Female,13-17,519,318,201,346,173
2008,Rural,Tripura,Crime Against Women,Dowry Deaths,Female,18-30,2615,2204,411,2340,275
2003,Rural,Gujarat,Crime Against Children,Child Labor,Female,13-17,6450,5659,791,5733,717
2001,Rural,Manipur,Crime Against Children,Kidnapping,Female,46-60,5945,1502,4443,4373,1572
2005,Rural,Goa,Crime Against Children,Kidnapping,Female,60+,9404,2380,7024,7353,2051
2003,Rural,Punjab,Property Crime,Vandalism,Male,31-45,6456,1465,4991,1589,4867
2003,Rural,Arunachal Pradesh,Property Crime,Arson,Female,18-30,7897,7588,309,7785,112
2003,Rural,Arunachal Pradesh,Crime Against Children,Kidnapping,Male,0-12,6758,103,6655,4124,2634
2007,Urban,Delhi,Crime Against Children,Kidnapping,Male,18-30,286,51,235,225,61
2007,Urban,Assam,Other Crimes,Fraud,Male,60+,7079,3424,3655,3796,3283
2002,Urban,Rajasthan,Crime Against Women,Dowry Deaths,Male,46-60,9624,3363,6261,4537,5087
2010,Rural,Manipur,Crime Against Children,Child Abuse,Male,13-17,2256,1350,906,1427,829
2005,Urban,Nagaland,Crime Against Children,Child Abuse,Female,0-12,2704,560,2144,991,1713
2004,Urban,Haryana,Crime Against Women,Domestic Violence,Female,46-60,7642,2109,5533,7483,159
2004,Urban,Punjab,Crime Against Men,Extortion,Male,31-45,6441,176,6265,4782,1659
2001,Urban,Uttar Pradesh,Crime Against Men,Murder,Female,0-12,4482,2870,1612,2877,1605
2007,Urban,Haryana,Crime Against Women,Molestation,Male,60+,8020,1737,6283,7946,74
2009,Rural,Bihar,Crime Against Men,Murder,Male,46-60,5320,3221,2099,4387,933
2004,Rural,Delhi,Crime Against Children,Child Abuse,Female,13-17,1196,436,760,1039,157
2009,Rural,Telangana,Crime Against Men,Robbery,Male,60+,1197,217,980,708,489
2004,Urban,Uttar Pradesh,Crime Against Men,Robbery,Male,18-30,246,164,82,197,49
2005,Rural,Punjab,Other Crimes,Corruption,Female,18-30,7481,5499,1982,7123,358
2003,Rural,Haryana,Property Crime,Arson,Female,13-17,8388,3621,4767,8370,18
2008,Rural,Jharkhand,Property Crime,Arson,Female,60+,2501,2,2499,752,1749
2010,Rural,Sikkim,Crime Against Women,Rape,Male,13-17,6660,1290,5370,2698,3962
2010,Rural,Goa,Other Crimes,Corruption,Male,60+,2052,1641,411,1652,400
2009,Urban,Madhya Pradesh,Crime Against Children,Kidnapping,Male,13-17,7096,2627,4469,6305,791
2001,Rural,Mizoram,Crime Against Children,Trafficking,Female,31-45,2083,1713,370,2050,33
2003,Rural,Andhra Pradesh,Crime Against Women,Domestic Violence,Male,18-30,3128,98,3030,419,2709
2006,Rural,Andhra Pradesh,Crime Against Men,Robbery,Female,60+,9393,4150,5243,7538,1855
2008,Rural,Uttarakhand,Crime Against Women,Domestic Violence,Female,18-30,1320,771,549,791,529
2007,Rural,Gujarat,Crime Against Men,Robbery,Female,31-45,9777,5376,4401,6098,3679
2005,Urban,Haryana,Property Crime,Theft,Female,60+,7425,4068,3357,5291,2134
2005,Rural,Telangana,Other Crimes,Corruption,Male,0-12,1553,532,1021,1302,251
2010,Urban,Himachal Pradesh,Crime Against Children,Child Abuse,Female,0-12,4595,56,4539,1229,3366
2001,Urban,Jharkhand,Crime Against Men,Assault,Female,31-45,2460,705,1755,896,1564
2007,Rural,Maharashtra,Crime Against Women,Molestation,Female,31-45,5627,3669,1958,4233,1394
2005,Urban,Karnataka,Crime Against Children,Child Labor,Male,31-45,4263,4016,247,4177,86
2007,Urban,Delhi,Crime Against Men,Extortion,Female,31-45,4726,4428,298,4477,249
2002,Urban,Arunachal Pradesh,Other Crimes,Drug Offense,Female,18-30,1542,474,1068,1018,524
2008,Urban,Punjab,Crime Against Men,Murder,Male,0-12,5544,599,4945,660,4884
2010,Urban,Meghalaya,Crime Against Men,Extortion,Male,13-17,8020,6469,1551,7862,158
2004,Urban,Gujarat,Crime Against Children,Child Labor,Male,0-12,7318,2111,5207,6016,1302
2010,Rural,Haryana,Crime Against Children,Kidnapping,Female,13-17,4527,2731,1796,2781,1746
2004,Urban,Rajasthan,Crime Against Women,Domestic Violence,Male,13-17,749,395,354,729,20
2009,Urban,Bihar,Crime Against Children,Child Abuse,Female,13-17,5266,1084,4182,1839,3427
2003,Urban,Punjab,Other Crimes,Cyber Crime,Male,13-17,5592,149,5443,3936,1656
2007,Rural,Uttarakhand,Crime Against Men,Murder,Female,0-12,514,11,503,340,174
2008,Urban,Kerala,Crime Against Men,Extortion,Female,31-45,5577,2352,3225,3258,2319
2010,Urban,Karnataka,Property Crime,Theft,Male,60+,2479,1893,586,1954,525
2010,Rural,Jharkhand,Crime Against Women,Dowry Deaths,Female,13-17,9510,7991,1519,8858,652
2003,Rural,Karnataka,Crime Against Women,Domestic Violence,Female,31-45,1669,820,849,953,716
2010,Urban,Karnataka,Crime Against Women,Rape,Male,46-60,4092,3395,697,3718,374
2010,Rural,Himachal Pradesh,Other Crimes,Fraud,Female,18-30,1058,63,995,825,233
2010,Rural,Punjab,Other Crimes,Cyber Crime,Female,18-30,1503,704,799,716,787
2005,Rural,Jammu & Kashmir,Crime Against Men,Extortion,Male,31-45,9224,1665,7559,3500,5724
2007,Urban,Goa,Property Crime,Arson,Male,46-60,3999,2248,1751,3543,456
2004,Rural,Meghalaya,Crime Against Men,Assault,Male,0-12,7533,3838,3695,5580,1953
2009,Rural,Nagaland,Crime Against Men,Assault,Female,60+,3896,759,3137,1302,2594
2004,Rural,Rajasthan,Property Crime,Vandalism,Male,46-60,314,299,15,300,14
2001,Urban,Manipur,Other Crimes,Fraud,Female,13-17,3435,3007,428,3028,407
2001,Rural,Assam,Other Crimes,Drug Offense,Female,31-45,1348,1328,20,1331,17
2005,Urban,Haryana,Crime Against Children,Child Labor,Male,60+,6258,4566,1692,5795,463
2010,Rural,West Bengal,Property Crime,Vandalism,Female,60+,6248,1490,4758,5259,989
2003,Rural,Rajasthan,Property Crime,Theft,Male,13-17,6365,1117,5248,4078,2287
2007,Rural,Nagaland,Crime Against Men,Robbery,Female,18-30,1549,352,1197,718,831
2006,Urban,Punjab,Crime Against Men,Extortion,Female,60+,530,75,455,159,371
2009,Urban,Assam,Crime Against Children,Kidnapping,Male,60+,3254,2399,855,2913,341
2002,Urban,Meghalaya,Crime Against Children,Child Abuse,Female,60+,418,187,231,263,155
2008,Urban,Andhra Pradesh,Crime Against Children,Kidnapping,Female,60+,934,641,293,900,34
2010,Rural,Jammu & Kashmir,Property Crime,Vandalism,Male,31-45,5337,2264,3073,3197,2140
2005,Rural,Tamil Nadu,Crime Against Men,Robbery,Male,31-45,5212,1516,3696,4046,1166
2002,Rural,Madhya Pradesh,Other Crimes,Fraud,Female,18-30,8414,2186,6228,3552,4862
2006,Urban,Himachal Pradesh,Other Crimes,Drug Offense,Male,13-17,3961,3802,159,3894,67
2006,Urban,Chhattisgarh,Other Crimes,Drug Offense,Female,46-60,3261,1940,1321,1966,1295
2007,Urban,Uttarakhand,Crime Against Men,Extortion,Female,46-60,4924,1085,3839,2623,2301
2006,Rural,Odisha,Other Crimes,Cyber Crime,Male,46-60,3017,611,2406,709,2308
2009,Rural,Assam,Property Crime,Arson,Male,0-12,3908,2029,1879,3353,555
2001,Rural,Nagaland,Other Crimes,Fraud,Male,0-12,3347,543,2804,952,2395
2009,Rural,Jammu & Kashmir,Property Crime,Theft,Female,13-17,6593,5904,689,6303,290
2006,Rural,Delhi,Other Crimes,Corruption,Female,18-30,7736,4054,3682,5296,2440
2007,Urban,Uttar Pradesh,Crime Against Women,Dowry Deaths,Male,60+,9655,9228,427,9650,5
2004,Rural,West Bengal,Crime Against Men,Assault,Male,0-12,2520,1369,1151,1692,828
2002,Rural,West Bengal,Crime Against Children,Kidnapping,Male,0-12,5259,2815,2444,3958,1301
2008,Rural,Jammu & Kashmir,Crime Against Men,Robbery,Female,31-45,5999,4027,1972,4980,1019
2007,Urban,Rajasthan,Other Crimes,Corruption,Female,18-30,7356,1648,5708,2852,4504
2007,Rural,Mizoram,Crime Against Children,Trafficking,Female,0-12,8710,7300,1410,8455,255
2004,Rural,Andhra Pradesh,Crime Against Children,Child Labor,Female,0-12,8911,68,8843,4359,4552
2005,Rural,West Bengal,Crime Against Children,Child Labor,Male,31-45,3054,156,2898,1056,1998
2006,Rural,Jammu & Kashmir,Crime Against Children,Child Labor,Female,13-17,6098,1920,4178,3351,2747
2004,Rural,Jharkhand,Crime Against Children,Kidnapping,Female,18-30,1813,1704,109,1800,13
2009,Urban,Manipur,Property Crime,Theft,Male,60+,8307,3336,4971,6577,1730
2004,Rural,Telangana,Crime Against Women,Rape,Female,18-30,8347,6965,1382,8128,219
2010,Rural,Himachal Pradesh,Crime Against Men,Assault,Male,31-45,2631,768,1863,1014,1617
2002,Urban,Delhi,Crime Against Children,Child Abuse,Male,31-45,8001,358,7643,5326,2675
2006,Urban,Andhra Pradesh,Crime Against Children,Child Labor,Male,13-17,9350,9016,334,9224,126
2010,Rural,Maharashtra,Other Crimes,Fraud,Female,0-12,8183,2226,5957,2423,5760
2007,Rural,Jharkhand,Other Crimes,Drug Offense,Male,13-17,3727,1024,2703,2655,1072
2009,Urban,Meghalaya,Other Crimes,Cyber Crime,Male,60+,5088,3621,1467,4895,193
2003,Urban,Himachal Pradesh,Other Crimes,Fraud,Male,31-45,6095,37,6058,2374,3721
2008,Rural,Karnataka,Crime Against Men,Murder,Female,18-30,498,475,23,475,23
2006,Rural,Sikkim,Crime Against Children,Child Labor,Female,46-60,6310,6118,192,6254,56
2006,Urban,Uttar Pradesh,Other Crimes,Drug Offense,Male,46-60,9541,3570,5971,7899,1642
2007,Urban,Mizoram,Crime Against Men,Assault,Female,46-60,3301,1822,1479,1836,1465
2006,Rural,Assam,Other Crimes,Cyber Crime,Male,60+,7161,5132,2029,5668,1493
2004,Rural,Mizoram,Crime Against Women,Dowry Deaths,Male,60+,3340,3023,317,3289,51
2010,Rural,Haryana,Property Crime,Arson,Male,0-12,5230,2514,2716,3463,1767
2007,Rural,Gujarat,Crime Against Children,Kidnapping,Female,46-60,1211,205,1006,1092,119
2003,Rural,Karnataka,Property Crime,Theft,Female,0-12,5480,4973,507,5014,466
2004,Urban,Andhra Pradesh,Crime Against Children,Kidnapping,Male,60+,6289,74,6215,4011,2278
2002,Urban,Haryana,Crime Against Women,Rape,Female,18-30,7081,435,6646,4743,2338
2001,Urban,Arunachal Pradesh,Other Crimes,Corruption,Male,18-30,7550,2751,4799,7512,38
2007,Urban,Assam,Crime Against Children,Trafficking,Female,18-30,4439,1947,2492,4378,61
2006,Rural,Odisha,Other Crimes,Fraud,Female,18-30,413,268,145,380,33
2009,Rural,Himachal Pradesh,Crime Against Children,Kidnapping,Male,60+,2724,616,2108,1403,1321
2003,Urban,Karnataka,Property Crime,Arson,Male,13-17,7000,6944,56,6964,36
2004,Urban,Kerala,Other Crimes,Corruption,Male,18-30,6283,5936,347,6159,124
2009,Rural,Assam,Property Crime,Theft,Female,18-30,536,120,416,434,102
2005,Urban,Uttarakhand,Crime Against Women,Molestation,Female,46-60,7551,4198,3353,5803,1748
2001,Rural,Odisha,Crime Against Children,Child Abuse,Female,46-60,6280,1650,4630,4171,2109
2001,Rural,Assam,Other Crimes,Drug Offense,Female,0-12,2476,2160,316,2162,314
2001,Urban,Uttarakhand,Crime Against Women,Dowry Deaths,Female,46-60,8062,806,7256,1420,6642
2002,Urban,Tripura,Property Crime,Vandalism,Male,31-45,4361,3613,748,4048,313
2005,Rural,Rajasthan,Other Crimes,Drug Offense,Male,13-17,1402,36,1366,821,581
2001,Urban,Manipur,Other Crimes,Corruption,Male,0-12,1414,360,1054,586,828
2001,Rural,Telangana,Property Crime,Burglary,Male,13-17,8220,5085,3135,5816,2404
2007,Urban,Jammu & Kashmir,Other Crimes,Fraud,Male,46-60,675,320,355,451,224
2005,Rural,Manipur,Other Crimes,Cyber Crime,Male,60+,7217,2114,5103,2609,4608
2003,Urban,Nagaland,Other Crimes,Cyber Crime,Male,46-60,9721,9615,106,9640,81
2008,Rural,Himachal Pradesh,Other Crimes,Corruption,Male,18-30,7964,5464,2500,5861,2103
2003,Rural,Uttar Pradesh,Crime Against Women,Rape,Female,46-60,4636,1782,2854,2806,1830
2002,Rural,Sikkim,Other Crimes,Fraud,Male,60+,1991,1000,991,1906,85
2009,Rural,Madhya Pradesh,Other Crimes,Fraud,Male,46-60,8888,3253,5635,4978,3910
2009,Rural,Uttarakhand,Crime Against Women,Rape,Male,31-45,3400,2181,1219,3175,225
2009,Urban,Assam,Crime Against Women,Molestation,Male,18-30,2664,2652,12,2658,6
2005,Urban,Arunachal Pradesh,Crime Against Women,Rape,Female,18-30,8268,2552,5716,5675,2593
2002,Rural,Punjab,Crime Against Men,Assault,Male,0-12,1585,621,964,1085,500
2003,Rural,West Bengal,Crime Against Children,Child Abuse,Male,18-30,4767,2475,2292,4725,42
2009,Rural,Arunachal Pradesh,Crime Against Women,Rape,Female,0-12,7908,2499,5409,4369,3539
2002,Rural,Mizoram,Crime Against Women,Rape,Female,31-45,2692,1069,1623,1682,1010
2008,Rural,Uttarakhand,Property Crime,Theft,Female,18-30,8827,2588,6239,8024,803
2007,Rural,Assam,Crime Against Men,Assault,Female,60+,589,5,584,318,271
2008,Urban,Chhattisgarh,Crime Against Children,Child Labor,Male,13-17,6697,4652,2045,5899,798
2007,Urban,Tamil Nadu,Crime Against Men,Murder,Male,31-45,989,370,619,418,571
2008,Rural,West Bengal,Crime Against Children,Trafficking,Male,60+,4226,3055,1171,3755,471
2006,Urban,Chhattisgarh,Other Crimes,Cyber Crime,Female,31-45,4726,262,4464,731,3995
2010,Urban,Mizoram,Other Crimes,Cyber Crime,Male,13-17,7712,5150,2562,7338,374
2003,Urban,Chhattisgarh,Crime Against Children,Child Labor,Female,18-30,918,912,6,918,0
2001,Rural,Gujarat,Crime Against Women,Rape,Female,60+,4025,2315,1710,2699,1326
2010,Urban,Nagaland,Crime Against Women,Rape,Male,31-45,9399,6124,3275,7413,1986
2010,Rural,Karnataka,Crime Against Men,Murder,Female,60+,7421,6964,457,7276,145
2009,Rural,Telangana,Crime Against Children,Kidnapping,Male,18-30,4792,727,4065,4630,162
2002,Rural,Meghalaya,Property Crime,Vandalism,Male,18-30,2269,1036,1233,1536,733
2010,Urban,Manipur,Crime Against Children,Trafficking,Female,13-17,3126,1522,1604,2624,502
2002,Rural,Mizoram,Crime Against Women,Dowry Deaths,Male,18-30,534,318,216,397,137
2008,Rural,Odisha,Crime Against Children,Kidnapping,Male,31-45,2854,452,2402,1879,975
2008,Rural,Uttarakhand,Other Crimes,Drug Offense,Female,60+,3663,2965,698,3570,93
2006,Rural,Haryana,Crime Against Men,Robbery,Female,46-60,5956,1463,4493,4210,1746
2003,Urban,Delhi,Crime Against Men,Robbery,Female,18-30,6053,2318,3735,5026,1027
2003,Urban,Jammu & Kashmir,Other Crimes,Fraud,Male,60+,4169,2688,1481,4110,59
2008,Rural,Punjab,Crime Against Men,Murder,Female,46-60,8964,6233,2731,6701,2263
2005,Urban,Maharashtra,Other Crimes,Corruption,Female,0-12,5874,5438,436,5459,415
2005,Rural,Haryana,Property Crime,Theft,Male,46-60,7472,1036,6436,5730,1742
2007,Urban,Andhra Pradesh,Crime Against Men,Extortion,Male,60+,2834,2156,678,2320,514
2009,Urban,West Bengal,Crime Against Women,Dowry Deaths,Male,13-17,3011,1945,1066,2702,309
2006,Rural,Gujarat,Property Crime,Vandalism,Male,18-30,9718,9101,617,9406,312
2006,Urban,Rajasthan,Crime Against Men,Murder,Female,31-45,6836,2480,4356,3090,3746
2003,Rural,Gujarat,Crime Against Men,Assault,Female,18-30,9208,5385,3823,9084,124
2001,Urban,Telangana,Other Crimes,Fraud,Male,13-17,5386,3205,2181,4934,452
2010,Rural,Kerala,Crime Against Children,Child Abuse,Female,31-45,8344,3702,4642,4120,4224
2006,Rural,West Bengal,Other Crimes,Corruption,Male,31-45,1057,18,1039,707,350
2001,Rural,Madhya Pradesh,Crime Against Women,Molestation,Male,13-17,8864,1057,7807,7065,1799
2009,Rural,West Bengal,Property Crime,Burglary,Female,31-45,6741,4239,2502,4576,2165
2009,Rural,Nagaland,Crime Against Children,Trafficking,Male,60+,1499,1216,283,1400,99
2005,Urban,Assam,Crime Against Men,Assault,Male,60+,7752,668,7084,2045,5707
2010,Rural,Bihar,Property Crime,Vandalism,Female,31-45,7678,1497,6181,7390,288
2001,Urban,Punjab,Crime Against Women,Domestic Violence,Male,0-12,5602,5483,119,5544,58
2008,Rural,Odisha,Crime Against Men,Murder,Female,46-60,3779,1367,2412,1445,2334
2004,Urban,Andhra Pradesh,Crime Against Children,Kidnapping,Female,31-45,7230,3760,3470,3821,3409
2009,Rural,Bihar,Crime Against Women,Molestation,Female,60+,1622,1201,421,1412,210
2005,Rural,Maharashtra,Crime Against Children,Child Labor,Male,31-45,971,889,82,908,63
2007,Rural,Rajasthan,Other Crimes,Fraud,Male,18-30,3665,158,3507,3441,224
2002,Urban,Karnataka,Crime Against Women,Domestic Violence,Male,18-30,8596,6690,1906,8030,566
2003,Rural,Himachal Pradesh,Property Crime,Burglary,Female,46-60,6811,1000,5811,3372,3439
2003,Rural,Manipur,Crime Against Women,Domestic Violence,Male,13-17,523,302,221,451,72
2008,Urban,Maharashtra,Property Crime,Theft,Male,18-30,2999,512,2487,2647,352
2006,Rural,Tamil Nadu,Crime Against Men,Robbery,Female,18-30,2406,1526,880,2191,215
2009,Urban,Sikkim,Crime Against Children,Trafficking,Female,18-30,7496,523,6973,597,6899
2007,Rural,Tamil Nadu,Other Crimes,Drug Offense,Female,13-17,7971,4342,3629,7967,4
2006,Rural,Meghalaya,Property Crime,Arson,Male,46-60,9270,2897,6373,5550,3720
2002,Rural,Meghalaya,Crime Against Children,Kidnapping,Female,60+,3622,2200,1422,2741,881
2009,Urban,Uttarakhand,Crime Against Women,Domestic Violence,Male,31-45,7348,455,6893,4349,2999
2003,Urban,Nagaland,Crime Against Women,Molestation,Female,31-45,9953,423,9530,451,9502
2004,Urban,Jharkhand,Crime Against Children,Child Abuse,Male,31-45,4373,2104,2269,2996,1377
2004,Urban,Jharkhand,Crime Against Women,Molestation,Female,18-30,1864,648,1216,1218,646
2004,Rural,Manipur,Property Crime,Arson,Female,46-60,6585,2250,4335,3357,3228
2007,Rural,Andhra Pradesh,Crime Against Children,Child Labor,Male,13-17,1720,484,1236,1364,356
2005,Rural,Tripura,Crime Against Men,Extortion,Female,13-17,8825,7594,1231,8706,119
2008,Urban,Kerala,Property Crime,Arson,Male,60+,1856,1725,131,1834,22
2010,Urban,Sikkim,Crime Against Women,Rape,Female,46-60,8071,4485,3586,5004,3067
2002,Rural,Karnataka,Property Crime,Burglary,Female,13-17,5247,2022,3225,3844,1403
2010,Rural,Tripura,Crime Against Children,Child Abuse,Female,18-30,9314,4577,4737,4942,4372
2004,Urban,Punjab,Property Crime,Arson,Female,60+,5252,307,4945,5110,142
2005,Urban,Maharashtra,Crime Against Women,Domestic Violence,Male,0-12,5638,937,4701,1650,3988
2009,Rural,Madhya Pradesh,Other Crimes,Corruption,Female,46-60,7172,5189,1983,6805,367
2007,Urban,Jammu & Kashmir,Property Crime,Burglary,Male,13-17,3157,1134,2023,2410,747
2004,Urban,Nagaland,Other Crimes,Drug Offense,Female,31-45,3424,1948,1476,2903,521
2004,Urban,Bihar,Crime Against Children,Trafficking,Female,0-12,6314,263,6051,3749,2565
2007,Rural,Odisha,Crime Against Children,Trafficking,Male,46-60,1544,1227,317,1351,193
2001,Urban,Maharashtra,Crime Against Children,Child Abuse,Female,13-17,9483,2337,7146,5480,4003
2009,Urban,Assam,Property Crime,Arson,Male,60+,3940,916,3024,1596,2344
2005,Urban,Kerala,Crime Against Men,Murder,Female,13-17,4342,2612,1730,3172,1170
2006,Urban,Tripura,Crime Against Men,Extortion,Female,0-12,9628,5658,3970,8969,659
2002,Urban,Uttar Pradesh,Crime Against Women,Rape,Female,60+,5412,4690,722,4867,545
2005,Rural,Karnataka,Crime Against Men,Extortion,Male,46-60,3283,705,2578,1566,1717
2010,Urban,West Bengal,Crime Against Men,Robbery,Female,13-17,6886,4321,2565,4632,2254
2004,Rural,Chhattisgarh,Crime Against Women,Molestation,Female,46-60,3319,2258,1061,3272,47
2010,Urban,Kerala,Crime Against Children,Kidnapping,Female,31-45,8769,629,8140,4008,4761
2006,Rural,Maharashtra,Property Crime,Theft,Female,31-45,512,434,78,480,32
2005,Urban,Delhi,Property Crime,Burglary,Male,60+,147,79,68,139,8
2004,Rural,Tamil Nadu,Crime Against Men,Extortion,Female,13-17,491,79,412,207,284
2003,Rural,Sikkim,Crime Against Men,Murder,Male,0-12,1263,587,676,966,297
2005,Urban,Assam,Crime Against Women,Rape,Male,60+,2822,1400,1422,1464,1358
2009,Rural,West Bengal,Crime Against Men,Robbery,Male,0-12,5078,3157,1921,3836,1242
2001,Urban,Tamil Nadu,Crime Against Women,Dowry Deaths,Male,60+,8975,7406,1569,7489,1486
2010,Urban,Arunachal Pradesh,Property Crime,Burglary,Female,60+,4125,189,3936,1889,2236
2002,Rural,Gujarat,Crime Against Men,Extortion,Male,18-30,7201,5376,1825,6651,550
2005,Rural,Andhra Pradesh,Crime Against Men,Assault,Female,0-12,7594,1669,5925,4709,2885
2010,Urban,Uttarakhand,Crime Against Men,Assault,Male,46-60,4337,3170,1167,3808,529
2005,Urban,Tripura,Crime Against Children,Child Abuse,Female,46-60,3283,1736,1547,1843,1440
2010,Rural,Andhra Pradesh,Crime Against Women,Domestic Violence,Male,13-17,857,505,352,569,288
2008,Urban,Uttarakhand,Other Crimes,Corruption,Female,13-17,951,596,355,673,278
2008,Urban,Tamil Nadu,Crime Against Men,Murder,Female,0-12,9715,8675,1040,8946,769
2009,Rural,Chhattisgarh,Crime Against Men,Assault,Female,60+,5015,4664,351,4987,28
2005,Rural,Delhi,Crime Against Men,Robbery,Female,0-12,5253,3973,1280,5151,102
2003,Rural,Meghalaya,Property Crime,Arson,Female,60+,4927,3768,1159,4843,84
2009,Urban,Punjab,Crime Against Children,Trafficking,Male,31-45,5634,4871,763,4877,757
2008,Rural,Chhattisgarh,Crime Against Children,Trafficking,Male,46-60,536,447,89,525,11
2002,Urban,Sikkim,Crime Against Men,Robbery,Female,0-12,2162,647,1515,1052,1110
2007,Urban,Madhya Pradesh,Property Crime,Vandalism,Female,18-30,7975,1517,6458,5646,2329
2006,Rural,Haryana,Crime Against Men,Robbery,Male,0-12,6643,4650,1993,6248,395
2009,Urban,Manipur,Crime Against Children,Child Abuse,Female,31-45,3797,3035,762,3711,86
2007,Rural,Delhi,Crime Against Women,Dowry Deaths,Female,60+,1629,946,683,1419,210
2010,Rural,Tamil Nadu,Property Crime,Burglary,Female,60+,349,246,103,256,93
2003,Urban,Haryana,Crime Against Women,Domestic Violence,Female,31-45,8592,4756,3836,7248,1344
2005,Rural,Rajasthan,Other Crimes,Corruption,Male,0-12,1883,1544,339,1773,110
2006,Rural,Himachal Pradesh,Other Crimes,Fraud,Male,60+,5934,291,5643,2215,3719
2004,Rural,Haryana,Crime Against Children,Trafficking,Male,46-60,1600,767,833,1595,5
2003,Rural,Karnataka,Other Crimes,Cyber Crime,Female,0-12,2077,560,1517,1817,260
2005,Urban,Mizoram,Crime Against Women,Molestation,Male,31-45,3597,3078,519,3595,2
2001,Urban,Uttarakhand,Other Crimes,Cyber Crime,Male,13-17,1816,1092,724,1416,400
2010,Urban,Manipur,Crime Against Women,Rape,Female,0-12,6665,5653,1012,6186,479
2008,Urban,Telangana,Crime Against Men,Assault,Male,46-60,5389,5243,146,5294,95
2006,Urban,Haryana,Property Crime,Theft,Female,18-30,4725,3268,1457,3947,778
2008,Urban,Arunachal Pradesh,Other Crimes,Drug Offense,Male,46-60,4220,1374,2846,2358,1862
2006,Urban,Chhattisgarh,Crime Against Children,Child Labor,Male,31-45,781,479,302,674,107
2007,Urban,Nagaland,Crime Against Men,Extortion,Female,0-12,2953,2161,792,2483,470
2001,Rural,Tamil Nadu,Property Crime,Vandalism,Female,0-12,4254,2625,1629,3205,1049
2005,Urban,Uttar Pradesh,Crime Against Men,Murder,Female,46-60,2497,1111,1386,2375,122
2004,Urban,Odisha,Crime Against Children,Child Abuse,Male,18-30,8691,5873,2818,5997,2694
2005,Urban,Sikkim,Crime Against Men,Assault,Male,13-17,8949,5391,3558,5540,3409
2004,Urban,Manipur,Crime Against Men,Murder,Female,18-30,9754,5213,4541,9118,636
2002,Rural,Delhi,Other Crimes,Drug Offense,Male,60+,529,43,486,86,443
2004,Rural,Tripura,Crime Against Men,Murder,Male,46-60,5074,1101,3973,4628,446
2002,Urban,Gujarat,Crime Against Women,Rape,Female,60+,2874,2727,147,2768,106
2008,Rural,Himachal Pradesh,Crime Against Women,Molestation,Male,46-60,5662,5034,628,5534,128
2002,Rural,Kerala,Crime Against Women,Dowry Deaths,Female,46-60,3800,847,2953,2832,968
2006,Urban,Uttarakhand,Crime Against Women,Molestation,Male,13-17,5207,2211,2996,3484,1723
2003,Urban,Uttarakhand,Crime Against Children,Child Labor,Female,18-30,993,904,89,967,26
2007,Urban,Nagaland,Property Crime,Theft,Male,18-30,3643,933,2710,1956,1687
2005,Urban,Sikkim,Other Crimes,Cyber Crime,Male,0-12,3366,2724,642,2891,475
2005,Rural,Karnataka,Property Crime,Theft,Male,0-12,1731,814,917,1076,655
2010,Rural,Sikkim,Other Crimes,Drug Offense,Female,0-12,3994,218,3776,408,3586
2003,Rural,Bihar,Crime Against Men,Assault,Male,46-60,4778,905,3873,1111,3667
2010,Rural,Arunachal Pradesh,Property Crime,Theft,Female,13-17,6883,4437,2446,6396,487
2005,Rural,Tripura,Property Crime,Burglary,Female,31-45,3533,1138,2395,3520,13
2001,Rural,Odisha,Other Crimes,Fraud,Male,13-17,7176,4365,2811,5297,1879
2001,Urban,Himachal Pradesh,Other Crimes,Corruption,Female,46-60,1788,1092,696,1503,285
2005,Urban,Nagaland,Crime Against Men,Assault,Female,31-45,7891,3925,3966,5377,2514
2005,Urban,Karnataka,Crime Against Children,Child Labor,Female,0-12,1424,1042,382,1358,66
2005,Rural,Sikkim,Other Crimes,Cyber Crime,Female,60+,626,46,580,131,495
2006,Rural,Assam,Crime Against Women,Dowry Deaths,Male,18-30,162,96,66,106,56
2010,Urban,Jammu & Kashmir,Crime Against Men,Murder,Male,18-30,2658,1883,775,2641,17
2007,Rural,Haryana,Crime Against Women,Molestation,Female,18-30,3421,3055,366,3237,184
2005,Urban,Himachal Pradesh,Crime Against Children,Child Labor,Male,31-45,3832,2892,940,3677,155
2003,Urban,Andhra Pradesh,Crime Against Children,Child Labor,Male,13-17,4869,3725,1144,3872,997
2003,Urban,Himachal Pradesh,Other Crimes,Drug Offense,Female,0-12,73,1,72,41,32
2005,Urban,Madhya Pradesh,Other Crimes,Corruption,Female,60+,7348,3064,4284,3363,3985
2001,Rural,Bihar,Crime Against Women,Rape,Male,13-17,1231,464,767,782,449
2004,Rural,Gujarat,Crime Against Women,Domestic Violence,Male,60+,7846,6532,1314,6834,1012
2002,Urban,Telangana,Property Crime,Burglary,Male,13-17,9762,8857,905,9365,397
2006,Urban,Madhya Pradesh,Crime Against Women,Dowry Deaths,Male,60+,249,184,65,202,47
2007,Urban,Tripura,Property Crime,Arson,Male,31-45,7534,5034,2500,7049,485
2001,Rural,Meghalaya,Crime Against Women,Molestation,Female,13-17,1819,981,838,1411,408
2004,Rural,Himachal Pradesh,Crime Against Children,Child Abuse,Male,46-60,3524,1423,2101,1858,1666
2007,Rural,Delhi,Crime Against Men,Extortion,Male,60+,1834,1224,610,1296,538
2005,Urban,Haryana,Crime Against Men,Assault,Female,46-60,9972,9176,796,9479,493
2006,Urban,Odisha,Crime Against Children,Trafficking,Female,60+,1481,1207,274,1382,99
2005,Rural,Telangana,Property Crime,Burglary,Female,60+,1841,86,1755,786,1055
2002,Rural,Manipur,Other Crimes,Corruption,Female,18-30,7388,6826,562,6984,404
2003,Rural,Assam,Property Crime,Theft,Female,18-30,3299,777,2522,2746,553
2005,Rural,Odisha,Crime Against Men,Assault,Female,31-45,8123,4237,3886,7228,895
2003,Rural,Odisha,Crime Against Women,Dowry Deaths,Male,18-30,5055,2961,2094,3735,1320
2008,Urban,Sikkim,Crime Against Children,Trafficking,Female,46-60,4639,778,3861,1799,2840
2004,Urban,Kerala,Property Crime,Theft,Female,31-45,8884,2344,6540,4214,4670
2002,Urban,Himachal Pradesh,Crime Against Men,Robbery,Male,0-12,3995,1648,2347,2327,1668
2001,Rural,Uttar Pradesh,Crime Against Children,Kidnapping,Female,31-45,9564,7511,2053,8702,862
2006,Urban,Manipur,Crime Against Children,Trafficking,Female,0-12,8559,6125,2434,7678,881
2003,Rural,Tripura,Crime Against Women,Dowry Deaths,Female,60+,7815,1932,5883,7374,441
2007,Rural,Uttarakhand,Property Crime,Arson,Female,18-30,5438,652,4786,2180,3258
2001,Rural,Sikkim,Property Crime,Theft,Male,0-12,6219,5471,748,5683,536
2002,Urban,Bihar,Property Crime,Vandalism,Male,31-45,1860,552,1308,1733,127
2002,Urban,Maharashtra,Crime Against Men,Robbery,Female,60+,7560,6372,1188,6808,752
2002,Urban,Rajasthan,Crime Against Men,Assault,Female,13-17,7964,300,7664,6099,1865
2005,Urban,Maharashtra,Crime Against Children,Trafficking,Male,18-30,6531,3786,2745,6392,139
2009,Rural,Bihar,Crime Against Men,Murder,Male,31-45,1284,1010,274,1116,168
2004,Urban,Gujarat,Crime Against Children,Kidnapping,Male,31-45,4577,2927,1650,3835,742
2004,Rural,Himachal Pradesh,Crime Against Women,Domestic Violence,Female,0-12,5572,5449,123,5484,88
2003,Urban,Chhattisgarh,Crime Against Women,Rape,Male,0-12,838,41,797,597,241
2008,Urban,Gujarat,Property Crime,Theft,Male,13-17,2266,2067,199,2116,150
2003,Rural,Gujarat,Crime Against Children,Kidnapping,Male,13-17,1552,1029,523,1250,302
2008,Urban,Uttar Pradesh,Crime Against Children,Trafficking,Male,60+,6762,6493,269,6709,53
2001,Rural,Gujarat,Crime Against Women,Domestic Violence,Female,46-60,7856,3261,4595,3863,3993
2007,Urban,Uttar Pradesh,Other Crimes,Fraud,Female,46-60,5945,2967,2978,4123,1822
2010,Urban,West Bengal,Crime Against Women,Molestation,Male,46-60,8580,6231,2349,8336,244
2010,Urban,Chhattisgarh,Crime Against Men,Extortion,Female,60+,6241,6195,46,6229,12
2006,Urban,Andhra Pradesh,Other Crimes,Corruption,Male,60+,7739,5742,1997,5941,1798
2002,Urban,Arunachal Pradesh,Other Crimes,Cyber Crime,Male,0-12,8806,4689,4117,5385,3421
2006,Rural,Manipur,Crime Against Children,Trafficking,Female,13-17,1923,548,1375,925,998
2001,Rural,Chhattisgarh,Crime Against Children,Kidnapping,Female,31-45,183,70,113,164,19
2004,Urban,Mizoram,Crime Against Women,Domestic Violence,Female,31-45,8320,4537,3783,5173,3147
2001,Urban,Tamil Nadu,Crime Against Children,Child Labor,Male,18-30,4363,3293,1070,3300,1063
2010,Rural,Manipur,Crime Against Children,Kidnapping,Female,18-30,4513,2420,2093,3649,864
2005,Rural,Telangana,Crime Against Women,Domestic Violence,Female,0-12,4438,831,3607,4237,201
2007,Rural,Bihar,Other Crimes,Cyber Crime,Male,13-17,7922,4670,3252,6898,1024
2008,Urban,Meghalaya,Crime Against Children,Child Abuse,Male,60+,356,166,190,297,59
2007,Urban,Punjab,Crime Against Children,Kidnapping,Male,60+,7152,5129,2023,6983,169
2004,Rural,Jharkhand,Other Crimes,Cyber Crime,Female,31-45,8878,4444,4434,5964,2914
2008,Urban,Telangana,Property Crime,Theft,Male,60+,5456,3036,2420,5247,209
2008,Rural,Uttar Pradesh,Property Crime,Arson,Male,31-45,2217,53,2164,1146,1071
2001,Urban,Maharashtra,Crime Against Children,Child Abuse,Male,46-60,9258,3346,5912,6077,3181
2007,Rural,Odisha,Other Crimes,Corruption,Male,31-45,9299,4811,4488,8266,1033
2004,Urban,Chhattisgarh,Other Crimes,Corruption,Female,60+,2840,2130,710,2327,513
2003,Rural,Gujarat,Crime Against Children,Trafficking,Male,60+,4377,1514,2863,2353,2024
2003,Urban,Andhra Pradesh,Other Crimes,Fraud,Female,18-30,4009,3195,814,3227,782
2002,Rural,Punjab,Crime Against Men,Extortion,Female,0-12,9973,4527,5446,6332,3641
2003,Rural,Sikkim,Crime Against Men,Assault,Female,13-17,8569,8017,552,8401,168
2009,Rural,Jharkhand,Other Crimes,Corruption,Female,0-12,3667,2579,1088,2659,1008
2009,Urban,Jammu & Kashmir,Other Crimes,Drug Offense,Male,60+,1839,329,1510,392,1447
2007,Urban,Punjab,Crime Against Women,Dowry Deaths,Male,60+,4686,1474,3212,2152,2534
2002,Rural,Delhi,Crime Against Women,Molestation,Male,31-45,5230,1183,4047,3817,1413
2007,Urban,Madhya Pradesh,Crime Against Men,Murder,Male,31-45,9266,3693,5573,7799,1467
2009,Urban,Tamil Nadu,Other Crimes,Drug Offense,Male,31-45,4074,852,3222,3684,390
2002,Urban,Goa,Property Crime,Theft,Male,13-17,6757,607,6150,2998,3759
2008,Rural,Himachal Pradesh,Property Crime,Theft,Male,60+,1697,450,1247,1373,324
2001,Rural,Jharkhand,Property Crime,Vandalism,Male,46-60,1165,506,659,720,445
2004,Urban,Himachal Pradesh,Other Crimes,Corruption,Female,60+,775,278,497,675,100
2001,Rural,Mizoram,Crime Against Children,Child Labor,Female,18-30,8518,8175,343,8343,175
2007,Rural,Odisha,Other Crimes,Cyber Crime,Female,46-60,9717,7966,1751,9568,149
2001,Urban,Rajasthan,Property Crime,Arson,Female,0-12,723,112,611,607,116
2005,Urban,Goa,Crime Against Men,Robbery,Male,18-30,5231,2890,2341,3577,1654
2003,Rural,Haryana,Crime Against Children,Child Abuse,Female,46-60,4967,804,4163,3918,1049
2005,Rural,Sikkim,Property Crime,Arson,Female,31-45,4131,1149,2982,2565,1566
2008,Urban,Gujarat,Crime Against Children,Kidnapping,Male,31-45,6419,3860,2559,5987,432
2006,Rural,Madhya Pradesh,Crime Against Children,Child Labor,Male,60+,1219,452,767,1014,205
2002,Urban,Bihar,Property Crime,Arson,Male,46-60,2200,1023,1177,2005,195
2004,Urban,Tamil Nadu,Other Crimes,Cyber Crime,Male,60+,1893,752,1141,1617,276
2008,Rural,Himachal Pradesh,Other Crimes,Fraud,Male,60+,1299,339,960,1163,136
2008,Rural,Maharashtra,Other Crimes,Cyber Crime,Male,0-12,3654,2904,750,3508,146
2008,Urban,Kerala,Crime Against Women,Domestic Violence,Male,60+,5687,952,4735,5357,330
2004,Urban,Madhya Pradesh,Other Crimes,Fraud,Female,31-45,3405,2110,1295,2874,531
2005,Urban,Rajasthan,Crime Against Women,Rape,Male,46-60,2291,2047,244,2236,55
2005,Rural,Punjab,Crime Against Children,Kidnapping,Female,18-30,6422,6313,109,6315,107
2004,Urban,Manipur,Crime Against Men,Robbery,Female,0-12,5587,2388,3199,4277,1310
2003,Rural,Tamil Nadu,Crime Against Children,Trafficking,Female,18-30,1060,988,72,1043,17
2002,Rural,Himachal Pradesh,Property Crime,Theft,Male,60+,5120,1199,3921,4273,847
2008,Rural,Assam,Property Crime,Vandalism,Male,60+,3567,364,3203,3426,141
2004,Rural,Assam,Crime Against Men,Extortion,Male,60+,2335,418,1917,1709,626
2008,Urban,Meghalaya,Property Crime,Arson,Male,46-60,9246,8714,532,9235,11
2002,Urban,Odisha,Property Crime,Burglary,Female,0-12,3641,1866,1775,2677,964
2003,Urban,Arunachal Pradesh,Crime Against Men,Robbery,Male,60+,7519,2120,5399,3451,4068
2007,Rural,Telangana,Property Crime,Theft,Male,0-12,7057,499,6558,2935,4122
2007,Urban,Rajasthan,Crime Against Women,Rape,Male,60+,4003,3642,361,3741,262
2002,Rural,Uttar Pradesh,Property Crime,Arson,Male,18-30,9805,5219,4586,8642,1163
2004,Rural,Nagaland,Crime Against Children,Trafficking,Female,46-60,5361,2866,2495,4717,644
2001,Rural,Sikkim,Crime Against Men,Extortion,Male,31-45,5120,2582,2538,4541,579
2006,Urban,Arunachal Pradesh,Crime Against Children,Child Labor,Female,13-17,4561,4381,180,4410,151
2007,Urban,Jharkhand,Crime Against Children,Child Labor,Female,46-60,825,539,286,782,43
2003,Urban,Uttarakhand,Crime Against Children,Trafficking,Male,46-60,3078,1517,1561,2971,107
2001,Urban,Tamil Nadu,Crime Against Children,Kidnapping,Female,46-60,5033,369,4664,876,4157
2003,Urban,Assam,Crime Against Women,Dowry Deaths,Male,46-60,9094,8892,202,9058,36
2010,Urban,Chhattisgarh,Crime Against Men,Robbery,Female,18-30,5297,4148,1149,5178,119
2003,Rural,Kerala,Crime Against Children,Child Abuse,Female,46-60,6702,4323,2379,4359,2343
2010,Rural,Madhya Pradesh,Property Crime,Vandalism,Male,60+,8234,6785,1449,8075,159
2004,Rural,Telangana,Crime Against Men,Murder,Male,0-12,3414,2758,656,3141,273
2003,Rural,Haryana,Crime Against Women,Domestic Violence,Female,0-12,7950,3100,4850,6078,1872
2007,Rural,Maharashtra,Crime Against Women,Domestic Violence,Male,60+,8291,540,7751,6330,1961
2010,Urban,Uttar Pradesh,Crime Against Women,Molestation,Female,31-45,4842,568,4274,1486,3356
2008,Urban,Bihar,Crime Against Men,Extortion,Male,18-30,1355,1280,75,1306,49
2002,Urban,Delhi,Crime Against Children,Kidnapping,Male,46-60,8684,618,8066,8117,567
2007,Rural,Nagaland,Crime Against Women,Rape,Male,18-30,793,471,322,587,206
2009,Urban,Chhattisgarh,Crime Against Women,Molestation,Male,46-60,530,198,332,317,213
2003,Rural,Madhya Pradesh,Crime Against Women,Rape,Female,13-17,3590,736,2854,2761,829
2004,Rural,Bihar,Crime Against Children,Trafficking,Male,31-45,325,305,20,309,16
2009,Urban,Maharashtra,Crime Against Children,Child Abuse,Female,60+,4421,3180,1241,3651,770
2008,Urban,Mizoram,Crime Against Children,Trafficking,Female,46-60,7784,1367,6417,3357,4427
2009,Urban,West Bengal,Other Crimes,Fraud,Female,46-60,4278,174,4104,2644,1634
2007,Urban,Tamil Nadu,Crime Against Women,Molestation,Male,13-17,3790,3789,1,3789,1
2007,Urban,Andhra Pradesh,Other Crimes,Drug Offense,Female,13-17,7127,1673,5454,6291,836
2004,Rural,Nagaland,Crime Against Women,Molestation,Male,60+,7739,3237,4502,3683,4056
2001,Urban,Uttar Pradesh,Other Crimes,Corruption,Female,31-45,5561,2822,2739,5200,361
2004,Rural,Uttarakhand,Property Crime,Vandalism,Female,0-12,9444,7574,1870,9309,135
2005,Urban,Uttarakhand,Property Crime,Arson,Female,0-12,3311,2544,767,3070,241
2009,Rural,Jammu & Kashmir,Property Crime,Vandalism,Male,46-60,5031,4583,448,4958,73
2004,Urban,Jammu & Kashmir,Crime Against Children,Trafficking,Female,60+,2721,1720,1001,1966,755
2004,Urban,Sikkim,Other Crimes,Corruption,Female,0-12,531,159,372,186,345
2009,Rural,Jharkhand,Other Crimes,Corruption,Female,13-17,6883,5406,1477,6069,814
2010,Rural,Chhattisgarh,Property Crime,Burglary,Male,46-60,3633,1430,2203,1653,1980
2001,Urban,Odisha,Crime Against Men,Extortion,Male,31-45,868,354,514,747,121
2005,Urban,Bihar,Crime Against Children,Trafficking,Female,31-45,8615,3303,5312,8562,53
2004,Rural,Kerala,Crime Against Men,Murder,Female,60+,8617,5734,2883,6245,2372
2001,Rural,Delhi,Other Crimes,Drug Offense,Female,13-17,6697,1985,4712,2790,3907
2005,Urban,Bihar,Other Crimes,Corruption,Female,46-60,1056,1050,6,1053,3
2008,Rural,Nagaland,Property Crime,Arson,Female,13-17,9596,5217,4379,6088,3508
2008,Urban,Mizoram,Crime Against Women,Molestation,Female,13-17,6670,2704,3966,4451,2219
2001,Rural,Jharkhand,Property Crime,Vandalism,Male,60+,5946,2645,3301,3310,2636
2007,Rural,Chhattisgarh,Other Crimes,Cyber Crime,Male,18-30,7077,1017,6060,2019,5058
2009,Urban,Uttar Pradesh,Other Crimes,Corruption,Female,60+,5819,4481,1338,5701,118
2009,Urban,Tamil Nadu,Crime Against Women,Dowry Deaths,Female,31-45,6105,3679,2426,3948,2157
2006,Rural,Goa,Other Crimes,Fraud,Male,18-30,7633,7231,402,7333,300
2002,Rural,Jharkhand,Property Crime,Theft,Female,0-12,5734,1378,4356,4145,1589
2004,Urban,Tripura,Crime Against Women,Domestic Violence,Female,46-60,5128,1085,4043,3922,1206
2006,Rural,Manipur,Crime Against Women,Dowry Deaths,Male,60+,3756,2810,946,2969,787
2001,Urban,Andhra Pradesh,Crime Against Women,Domestic Violence,Male,31-45,5650,156,5494,4830,820
2001,Urban,Rajasthan,Property Crime,Burglary,Female,0-12,8752,987,7765,3216,5536
2006,Urban,Rajasthan,Crime Against Men,Extortion,Male,31-45,272,28,244,183,89
2003,Urban,Manipur,Crime Against Women,Dowry Deaths,Male,60+,4308,1539,2769,2609,1699
2005,Rural,Arunachal Pradesh,Other Crimes,Drug Offense,Female,46-60,4118,1306,2812,3883,235
2007,Urban,Goa,Other Crimes,Cyber Crime,Male,18-30,9661,7454,2207,8758,903
2008,Urban,Madhya Pradesh,Crime Against Women,Domestic Violence,Female,60+,5085,279,4806,1686,3399
2005,Rural,Mizoram,Crime Against Women,Domestic Violence,Female,46-60,814,496,318,558,256
2001,Urban,Mizoram,Crime Against Women,Rape,Female,46-60,1315,1262,53,1295,20
2009,Rural,Haryana,Crime Against Men,Extortion,Female,0-12,4574,1758,2816,3900,674
2005,Rural,Odisha,Crime Against Men,Murder,Female,46-60,1562,599,963,990,572
2002,Rural,Punjab,Crime Against Men,Robbery,Female,60+,64,62,2,64,0
2008,Rural,Manipur,Property Crime,Theft,Male,31-45,7225,790,6435,2523,4702
2001,Rural,Himachal Pradesh,Property Crime,Burglary,Female,0-12,8030,3569,4461,5157,2873
2003,Rural,Rajasthan,Crime Against Men,Robbery,Female,18-30,8072,5525,2547,6060,2012
2004,Rural,Tamil Nadu,Crime Against Men,Robbery,Female,31-45,1238,386,852,546,692
2007,Urban,Tripura,Crime Against Men,Extortion,Male,13-17,1448,819,629,1339,109
2009,Urban,Madhya Pradesh,Other Crimes,Cyber Crime,Female,60+,2220,1494,726,1621,599
2010,Rural,Meghalaya,Crime Against Women,Molestation,Female,46-60,3916,2396,1520,3327,589
2003,Urban,Maharashtra,Other Crimes,Cyber Crime,Male,60+,1212,371,841,501,711
2007,Urban,Jammu & Kashmir,Other Crimes,Drug Offense,Female,18-30,3638,512,3126,1799,1839
2004,Urban,Telangana,Crime Against Children,Child Labor,Male,0-12,162,126,36,150,12
2004,Urban,Odisha,Property Crime,Burglary,Male,18-30,8552,2826,5726,4087,4465
2004,Rural,Meghalaya,Other Crimes,Fraud,Male,46-60,7587,6142,1445,6449,1138
2003,Urban,Telangana,Other Crimes,Fraud,Female,13-17,4176,2034,2142,3846,330
2001,Urban,Punjab,Other Crimes,Cyber Crime,Male,60+,938,733,205,764,174
2006,Urban,Bihar,Crime Against Children,Child Labor,Female,18-30,6145,5962,183,6083,62
2008,Urban,Tripura,Crime Against Men,Robbery,Female,0-12,4555,1893,2662,3729,826
2010,Urban,Meghalaya,Property Crime,Vandalism,Female,0-12,3543,1996,1547,2167,1376
2009,Urban,Kerala,Other Crimes,Cyber Crime,Female,13-17,1494,607,887,1057,437
2008,Urban,Tamil Nadu,Other Crimes,Cyber Crime,Male,18-30,9422,4283,5139,8892,530
2009,Rural,Gujarat,Crime Against Children,Trafficking,Male,46-60,6679,2758,3921,4464,2215
2006,Rural,Maharashtra,Crime Against Children,Child Labor,Male,0-12,2194,1580,614,2030,164
2005,Urban,Haryana,Crime Against Men,Assault,Female,46-60,1432,527,905,798,634
2010,Urban,Andhra Pradesh,Crime Against Women,Dowry Deaths,Female,18-30,9923,5430,4493,6677,3246
2001,Urban,Uttarakhand,Crime Against Children,Trafficking,Female,0-12,5533,1545,3988,2380,3153
2008,Urban,Madhya Pradesh,Crime Against Children,Kidnapping,Male,0-12,1073,557,516,635,438
2010,Urban,Uttarakhand,Crime Against Women,Domestic Violence,Male,31-45,2953,958,1995,1403,1550
2001,Rural,Kerala,Crime Against Men,Murder,Female,0-12,6072,4676,1396,5945,127
2005,Rural,Goa,Other Crimes,Fraud,Male,18-30,1239,994,245,1079,160
2002,Urban,Chhattisgarh,Property Crime,Arson,Male,0-12,1647,1437,210,1630,17
2007,Urban,West Bengal,Crime Against Children,Trafficking,Female,18-30,2086,201,1885,1658,428
2003,Urban,Maharashtra,Crime Against Men,Extortion,Female,31-45,6574,3547,3027,4897,1677
2007,Urban,Tripura,Crime Against Women,Molestation,Female,31-45,2513,1946,567,2151,362
2007,Urban,Rajasthan,Crime Against Children,Child Labor,Male,46-60,2412,2114,298,2296,116
2004,Urban,Karnataka,Other Crimes,Cyber Crime,Female,31-45,5460,1151,4309,3702,1758
2007,Rural,Gujarat,Other Crimes,Cyber Crime,Male,0-12,7358,3111,4247,3567,3791
2006,Urban,Haryana,Property Crime,Theft,Male,60+,9689,1748,7941,3850,5839
2003,Rural,Uttarakhand,Crime Against Women,Domestic Violence,Male,46-60,4523,185,4338,925,3598
2003,Urban,Jharkhand,Crime Against Men,Extortion,Male,46-60,1255,616,639,725,530
2001,Rural,Jammu & Kashmir,Other Crimes,Corruption,Female,13-17,396,271,125,391,5
2002,Rural,Kerala,Crime Against Men,Murder,Male,46-60,8489,3250,5239,5618,2871
2006,Urban,Meghalaya,Other Crimes,Corruption,Male,18-30,7925,2730,5195,5477,2448
2009,Rural,Jammu & Kashmir,Other Crimes,Corruption,Female,31-45,9070,4273,4797,4503,4567
2009,Rural,Sikkim,Property Crime,Theft,Male,46-60,4344,4241,103,4306,38
2002,Urban,Andhra Pradesh,Other Crimes,Corruption,Female,60+,887,197,690,377,510
2002,Rural,Kerala,Other Crimes,Corruption,Male,13-17,1921,292,1629,1764,157
2003,Rural,Jharkhand,Other Crimes,Fraud,Female,31-45,8220,4973,3247,8051,169
2003,Urban,Kerala,Crime Against Women,Rape,Male,31-45,8682,6026,2656,6811,1871
2005,Rural,Manipur,Property Crime,Vandalism,Female,60+,8221,157,8064,1561,6660
2005,Urban,Telangana,Crime Against Children,Child Labor,Male,13-17,3955,3537,418,3864,91
2006,Rural,Sikkim,Other Crimes,Corruption,Male,46-60,1142,2,1140,734,408
2009,Rural,Andhra Pradesh,Other Crimes,Cyber Crime,Female,31-45,9928,3837,6091,5515,4413
2006,Rural,Mizoram,Crime Against Women,Domestic Violence,Female,46-60,2876,1988,888,2138,738
2008,Rural,Odisha,Crime Against Women,Rape,Male,60+,3386,1004,2382,1540,1846
2002,Rural,Assam,Crime Against Women,Dowry Deaths,Female,60+,2244,2104,140,2180,64
2005,Rural,Delhi,Crime Against Women,Dowry Deaths,Male,31-45,5238,927,4311,2818,2420
2003,Urban,Maharashtra,Crime Against Women,Molestation,Male,13-17,6847,588,6259,5636,1211
2008,Urban,Tamil Nadu,Property Crime,Vandalism,Male,18-30,3120,1445,1675,2024,1096
2009,Rural,Tripura,Property Crime,Theft,Female,60+,9561,7605,1956,8885,676
2005,Rural,Goa,Property Crime,Burglary,Female,13-17,8348,6868,1480,7946,402
2010,Urban,Gujarat,Property Crime,Burglary,Male,0-12,9597,6274,3323,9478,119
2009,Rural,Jharkhand,Crime Against Women,Dowry Deaths,Female,46-60,1937,580,1357,1045,892
2002,Rural,West Bengal,Property Crime,Theft,Male,31-45,9120,2787,6333,8407,713
2005,Urban,Nagaland,Crime Against Women,Domestic Violence,Female,18-30,9992,213,9779,6715,3277
2004,Urban,Assam,Other Crimes,Fraud,Female,13-17,9175,1952,7223,8135,1040
2006,Rural,Punjab,Crime Against Men,Extortion,Female,46-60,2096,1764,332,1868,228
2010,Urban,Punjab,Property Crime,Theft,Female,46-60,8796,223,8573,3796,5000
2006,Urban,Punjab,Crime Against Women,Dowry Deaths,Male,46-60,675,117,558,319,356
2008,Urban,Rajasthan,Other Crimes,Drug Offense,Male,13-17,4305,407,3898,3027,1278
2002,Urban,Jammu & Kashmir,Crime Against Men,Assault,Male,18-30,1239,198,1041,613,626
2006,Rural,Gujarat,Crime Against Women,Molestation,Female,60+,7146,854,6292,5364,1782
2008,Urban,Uttarakhand,Crime Against Women,Domestic Violence,Female,46-60,8132,6896,1236,7263,869
2007,Rural,Haryana,Crime Against Men,Extortion,Female,18-30,8120,7360,760,7783,337
2004,Urban,Uttar Pradesh,Crime Against Children,Trafficking,Male,46-60,954,343,611,516,438
2001,Rural,Tripura,Crime Against Women,Rape,Female,13-17,1520,391,1129,635,885
2007,Urban,Meghalaya,Property Crime,Burglary,Male,13-17,7464,4932,2532,7363,101
2002,Urban,Telangana,Other Crimes,Corruption,Male,46-60,2506,493,2013,2239,267
2010,Rural,Jharkhand,Property Crime,Vandalism,Female,13-17,1048,388,660,1038,10
2010,Rural,Uttar Pradesh,Other Crimes,Drug Offense,Female,13-17,9482,1507,7975,4444,5038
2002,Urban,Odisha,Other Crimes,Cyber Crime,Male,46-60,215,66,149,103,112
2004,Rural,Odisha,Crime Against Women,Dowry Deaths,Male,13-17,8693,6710,1983,7069,1624
2006,Urban,Tamil Nadu,Other Crimes,Fraud,Female,0-12,208,66,142,203,5
2003,Rural,Assam,Crime Against Men,Assault,Male,13-17,5246,2419,2827,4113,1133
2007,Rural,Punjab,Crime Against Men,Murder,Male,18-30,5565,1360,4205,1533,4032
2005,Urban,Telangana,Crime Against Men,Extortion,Male,13-17,287,270,17,276,11
2002,Urban,Chhattisgarh,Property Crime,Arson,Female,31-45,3569,706,2863,994,2575
2001,Urban,Kerala,Crime Against Women,Dowry Deaths,Male,0-12,8631,4601,4030,7648,983
2005,Rural,Assam,Property Crime,Arson,Female,46-60,4591,395,4196,4470,121
2006,Urban,Telangana,Other Crimes,Cyber Crime,Female,0-12,7997,2983,5014,4823,3174
2002,Rural,Chhattisgarh,Crime Against Children,Child Labor,Male,31-45,1466,1250,216,1260,206
2010,Urban,Jharkhand,Other Crimes,Drug Offense,Female,13-17,1981,1765,216,1911,70
2002,Urban,Sikkim,Crime Against Women,Domestic Violence,Female,0-12,1306,345,961,350,956
2006,Rural,Meghalaya,Crime Against Children,Child Labor,Female,46-60,2541,1920,621,2250,291
2005,Rural,West Bengal,Other Crimes,Drug Offense,Female,18-30,7698,1467,6231,6369,1329
2004,Rural,Mizoram,Property Crime,Vandalism,Female,31-45,5514,1730,3784,5402,112
2006,Urban,Goa,Crime Against Women,Domestic Violence,Female,18-30,1037,32,1005,682,355
2009,Urban,Arunachal Pradesh,Crime Against Children,Child Abuse,Female,13-17,7389,6846,543,6901,488
2010,Urban,Haryana,Property Crime,Theft,Male,60+,2326,1174,1152,1346,980
2008,Rural,Kerala,Crime Against Women,Molestation,Male,0-12,3791,702,3089,812,2979
2002,Urban,Haryana,Property Crime,Arson,Female,13-17,5202,3191,2011,4453,749
2004,Rural,Himachal Pradesh,Crime Against Men,Robbery,Female,18-30,8994,606,8388,1709,7285
2009,Rural,Manipur,Crime Against Women,Dowry Deaths,Male,0-12,5057,4386,671,4901,156
2007,Rural,Meghalaya,Other Crimes,Fraud,Female,0-12,2527,1081,1446,1911,616
2005,Urban,West Bengal,Crime Against Women,Rape,Male,31-45,7691,6432,1259,6785,906
2010,Rural,Tripura,Crime Against Women,Molestation,Male,60+,6921,783,6138,5950,971
2010,Urban,Telangana,Crime Against Women,Domestic Violence,Male,31-45,5864,4215,1649,4399,1465
2009,Rural,Uttarakhand,Other Crimes,Corruption,Female,60+,9234,9060,174,9084,150
2003,Urban,Sikkim,Crime Against Women,Domestic Violence,Male,0-12,575,472,103,481,94
2008,Urban,West Bengal,Crime Against Women,Dowry Deaths,Male,60+,5652,711,4941,2081,3571
2002,Rural,Mizoram,Property Crime,Arson,Female,18-30,4475,1721,2754,3954,521
2008,Urban,Tamil Nadu,Property Crime,Theft,Female,60+,7216,6384,832,6858,358
2003,Urban,Uttarakhand,Property Crime,Arson,Male,18-30,9614,118,9496,4481,5133
2002,Rural,Andhra Pradesh,Property Crime,Arson,Male,60+,6110,1297,4813,1855,4255
2005,Urban,Bihar,Property Crime,Arson,Female,46-60,2446,2187,259,2404,42
2010,Rural,Manipur,Property Crime,Burglary,Male,18-30,6020,2264,3756,5905,115
2008,Rural,Bihar,Property Crime,Arson,Female,18-30,6514,3343,3171,5505,1009
2005,Rural,Assam,Property Crime,Vandalism,Female,18-30,3412,2224,1188,2255,1157
2008,Rural,Sikkim,Crime Against Women,Domestic Violence,Female,0-12,9650,2698,6952,9203,447
2001,Rural,Tamil Nadu,Crime Against Children,Kidnapping,Female,13-17,1931,187,1744,746,1185
2008,Urban,Madhya Pradesh,Other Crimes,Drug Offense,Female,0-12,6079,3083,2996,3913,2166
2009,Rural,Manipur,Property Crime,Vandalism,Male,0-12,184,19,165,97,87
2002,Urban,Andhra Pradesh,Crime Against Men,Robbery,Female,0-12,9297,3598,5699,9242,55
2003,Urban,Delhi,Other Crimes,Fraud,Female,0-12,121,40,81,48,73
2005,Urban,Sikkim,Crime Against Children,Child Labor,Female,13-17,8095,6802,1293,7474,621
2007,Urban,Jharkhand,Crime Against Men,Robbery,Male,18-30,6612,227,6385,2963,3649
2003,Urban,Uttarakhand,Crime Against Children,Trafficking,Female,0-12,6130,2360,3770,3447,2683
2007,Rural,Manipur,Other Crimes,Corruption,Male,46-60,8911,483,8428,3584,5327
2010,Rural,Andhra Pradesh,Property Crime,Theft,Female,13-17,2533,1471,1062,1819,714
2008,Urban,Tamil Nadu,Crime Against Children,Child Labor,Male,13-17,7296,6812,484,6956,340
2010,Rural,Tamil Nadu,Other Crimes,Corruption,Male,13-17,3526,1909,1617,2667,859
2007,Urban,Jammu & Kashmir,Crime Against Women,Dowry Deaths,Male,46-60,9852,1901,7951,9066,786
2002,Urban,Kerala,Crime Against Women,Molestation,Male,13-17,3969,3760,209,3920,49
2009,Urban,Jammu & Kashmir,Other Crimes,Drug Offense,Male,31-45,6873,4321,2552,6398,475
2005,Rural,Manipur,Other Crimes,Corruption,Male,13-17,5230,3724,1506,4938,292
2005,Urban,Uttar Pradesh,Other Crimes,Corruption,Female,13-17,6570,3474,3096,3913,2657
2004,Urban,Meghalaya,Property Crime,Theft,Female,46-60,4171,1552,2619,3004,1167
2001,Urban,Manipur,Other Crimes,Corruption,Female,18-30,9064,6611,2453,8887,177
2002,Rural,Telangana,Other Crimes,Drug Offense,Male,60+,6939,730,6209,3591,3348
2005,Rural,Jammu & Kashmir,Crime Against Children,Kidnapping,Female,31-45,4518,674,3844,2770,1748
2008,Rural,Jharkhand,Other Crimes,Drug Offense,Male,60+,6860,5246,1614,6258,602
2001,Rural,Mizoram,Other Crimes,Cyber Crime,Female,46-60,8650,3458,5192,8203,447
2005,Urban,Kerala,Property Crime,Burglary,Female,60+,9449,7957,1492,8917,532
2004,Urban,West Bengal,Crime Against Children,Trafficking,Female,0-12,1106,921,185,1070,36
2007,Urban,Assam,Crime Against Women,Dowry Deaths,Female,46-60,2489,1125,1364,2227,262
2010,Rural,Delhi,Crime Against Women,Molestation,Female,60+,5917,2935,2982,3512,2405
2010,Rural,Andhra Pradesh,Crime Against Women,Dowry Deaths,Female,13-17,5997,32,5965,3683,2314
2005,Urban,Jammu & Kashmir,Crime Against Women,Rape,Male,60+,232,96,136,221,11
2003,Urban,Arunachal Pradesh,Crime Against Children,Trafficking,Female,60+,5019,3373,1646,4003,1016
2001,Rural,Meghalaya,Crime Against Women,Dowry Deaths,Female,13-17,3631,3457,174,3541,90
2007,Rural,Goa,Crime Against Women,Dowry Deaths,Female,31-45,1196,768,428,1053,143
2007,Rural,Uttarakhand,Crime Against Women,Domestic Violence,Female,46-60,7370,349,7021,5329,2041
2009,Urban,Haryana,Crime Against Men,Assault,Female,46-60,6292,889,5403,2209,4083
2007,Rural,Mizoram,Crime Against Children,Kidnapping,Male,60+,8490,5235,3255,6810,1680
2005,Urban,Kerala,Crime Against Children,Child Labor,Female,13-17,3139,791,2348,1015,2124
2002,Rural,Karnataka,Property Crime,Arson,Male,60+,7026,362,6664,2555,4471
2001,Rural,Arunachal Pradesh,Crime Against Women,Dowry Deaths,Female,18-30,1068,110,958,460,608
2002,Rural,Rajasthan,Crime Against Men,Robbery,Male,31-45,3549,71,3478,863,2686
2005,Rural,Rajasthan,Crime Against Men,Extortion,Male,60+,874,56,818,556,318
2009,Rural,Telangana,Crime Against Children,Trafficking,Female,18-30,4071,3764,307,4037,34
2004,Rural,Kerala,Crime Against Men,Assault,Male,31-45,8826,2111,6715,6998,1828
2002,Urban,Odisha,Crime Against Men,Murder,Female,0-12,3611,2771,840,3067,544
2006,Rural,Goa,Crime Against Women,Domestic Violence,Male,13-17,9790,3420,6370,6306,3484
2004,Urban,Bihar,Property Crime,Burglary,Male,60+,1714,586,1128,1083,631
2003,Urban,West Bengal,Crime Against Children,Kidnapping,Male,60+,4957,2138,2819,2481,2476
2005,Urban,Delhi,Crime Against Women,Molestation,Male,46-60,7335,2932,4403,3223,4112
2004,Urban,Nagaland,Other Crimes,Drug Offense,Male,13-17,2850,2539,311,2616,234
2001,Urban,Odisha,Crime Against Men,Extortion,Female,60+,1816,1758,58,1768,48
2009,Urban,Himachal Pradesh,Property Crime,Vandalism,Male,13-17,2667,755,1912,1440,1227
2003,Urban,Odisha,Other Crimes,Fraud,Male,46-60,4088,2122,1966,3087,1001
2008,Rural,Madhya Pradesh,Crime Against Men,Robbery,Male,31-45,3865,3640,225,3839,26
2004,Urban,Punjab,Crime Against Children,Child Labor,Female,31-45,310,113,197,289,21
2003,Rural,Madhya Pradesh,Crime Against Children,Child Abuse,Female,46-60,5060,1101,3959,4767,293
2010,Rural,Odisha,Crime Against Men,Murder,Female,18-30,4098,2823,1275,3414,684
2006,Urban,Tamil Nadu,Crime Against Men,Robbery,Female,46-60,9742,450,9292,4911,4831
2003,Urban,Jammu & Kashmir,Crime Against Children,Trafficking,Female,31-45,565,552,13,555,10
2007,Rural,Gujarat,Property Crime,Burglary,Female,46-60,131,112,19,128,3
2001,Rural,Sikkim,Property Crime,Burglary,Male,60+,7634,6164,1470,7394,240
2003,Urban,Chhattisgarh,Other Crimes,Fraud,Female,18-30,2950,1972,978,2267,683
2003,Urban,Himachal Pradesh,Property Crime,Theft,Female,0-12,7757,3758,3999,4205,3552
2004,Urban,Mizoram,Other Crimes,Fraud,Male,46-60,494,396,98,464,30
2007,Rural,Chhattisgarh,Other Crimes,Corruption,Male,18-30,4297,2717,1580,3572,725
2007,Urban,Odisha,Crime Against Men,Assault,Male,46-60,5037,1299,3738,4016,1021
2005,Urban,Delhi,Other Crimes,Fraud,Female,60+,9096,3498,5598,5623,3473
2001,Rural,Manipur,Crime Against Men,Extortion,Female,46-60,1563,6,1557,445,1118
2003,Rural,Punjab,Crime Against Children,Child Abuse,Male,0-12,7901,1810,6091,4284,3617
2005,Rural,Gujarat,Crime Against Men,Extortion,Female,31-45,4899,3167,1732,3545,1354
2004,Rural,Rajasthan,Crime Against Men,Robbery,Male,46-60,5894,4288,1606,4649,1245
2010,Urban,Uttarakhand,Other Crimes,Cyber Crime,Male,18-30,8383,1204,7179,3509,4874
2003,Rural,Rajasthan,Crime Against Children,Trafficking,Female,13-17,3686,379,3307,536,3150
2008,Urban,Kerala,Other Crimes,Drug Offense,Female,0-12,1689,859,830,1055,634
2007,Urban,Uttarakhand,Crime Against Men,Robbery,Male,60+,9884,7958,1926,8554,1330
2005,Rural,Goa,Crime Against Men,Murder,Female,13-17,4414,2081,2333,2092,2322
2002,Urban,Goa,Property Crime,Vandalism,Male,31-45,6859,2230,4629,3803,3056
2010,Rural,Odisha,Other Crimes,Corruption,Female,31-45,383,190,193,239,144
2002,Rural,Jharkhand,Crime Against Women,Rape,Female,0-12,1747,1477,270,1524,223
2001,Urban,Jharkhand,Crime Against Children,Child Labor,Male,0-12,6469,137,6332,2488,3981
2008,Urban,Maharashtra,Crime Against Women,Rape,Female,18-30,6576,2609,3967,4680,1896
2004,Rural,Andhra Pradesh,Property Crime,Burglary,Female,13-17,9277,3561,5716,6856,2421
2007,Rural,Gujarat,Property Crime,Arson,Male,60+,9569,1400,8169,9464,105
2001,Rural,Madhya Pradesh,Crime Against Children,Kidnapping,Male,13-17,2493,264,2229,499,1994
2006,Rural,Assam,Crime Against Men,Assault,Female,18-30,4527,614,3913,3080,1447
2004,Urban,Madhya Pradesh,Crime Against Men,Robbery,Male,31-45,6408,5296,1112,5948,460
2002,Rural,Delhi,Other Crimes,Drug Offense,Female,60+,6248,1616,4632,2685,3563
2004,Urban,Delhi,Crime Against Children,Child Labor,Female,13-17,59,13,46,19,40
2005,Urban,Karnataka,Other Crimes,Drug Offense,Male,31-45,4363,1715,2648,2623,1740
2004,Urban,Telangana,Property Crime,Vandalism,Female,31-45,6078,357,5721,1494,4584
2009,Urban,Rajasthan,Crime Against Men,Robbery,Female,0-12,5345,3598,1747,4971,374
2009,Urban,Arunachal Pradesh,Crime Against Children,Kidnapping,Male,31-45,8805,3169,5636,3344,5461
2006,Urban,Karnataka,Crime Against Children,Trafficking,Male,46-60,899,94,805,604,295
2007,Urban,Maharashtra,Crime Against Children,Child Abuse,Female,31-45,218,162,56,191,27
2010,Urban,Himachal Pradesh,Crime Against Men,Robbery,Female,46-60,6234,1333,4901,2469,3765
2002,Urban,Gujarat,Other Crimes,Corruption,Female,31-45,6365,4066,2299,5797,568
2002,Urban,Goa,Property Crime,Arson,Female,31-45,2017,248,1769,1105,912
2006,Rural,Goa,Other Crimes,Cyber Crime,Female,60+,3607,483,3124,1181,2426
2010,Urban,Odisha,Property Crime,Burglary,Male,13-17,3633,2884,749,3521,112
2002,Urban,Goa,Other Crimes,Cyber Crime,Male,18-30,6026,5680,346,5777,249
2001,Urban,Uttarakhand,Other Crimes,Drug Offense,Male,13-17,6580,292,6288,1677,4903
2009,Rural,Uttar Pradesh,Crime Against Children,Child Labor,Female,31-45,5323,4837,486,5015,308
2003,Rural,Nagaland,Crime Against Men,Murder,Female,31-45,8632,4177,4455,7269,1363
2005,Urban,Chhattisgarh,Crime Against Men,Murder,Male,0-12,3329,9,3320,794,2535
2004,Rural,Delhi,Crime Against Children,Child Labor,Male,0-12,2314,1139,1175,1344,970
2008,Urban,Haryana,Other Crimes,Drug Offense,Male,13-17,761,581,180,671,90
2002,Rural,Jammu & Kashmir,Other Crimes,Fraud,Male,0-12,6661,4958,1703,5895,766
2010,Rural,Telangana,Crime Against Children,Child Abuse,Male,60+,8604,8242,362,8530,74
2009,Rural,Uttarakhand,Crime Against Men,Robbery,Female,31-45,5437,186,5251,1486,3951
2007,Rural,Delhi,Crime Against Children,Child Labor,Male,0-12,205,182,23,186,19
2001,Rural,Madhya Pradesh,Other Crimes,Corruption,Female,60+,7376,4739,2637,7136,240
2003,Rural,West Bengal,Crime Against Women,Rape,Female,0-12,5829,5610,219,5766,63
2004,Rural,Telangana,Other Crimes,Drug Offense,Female,60+,8668,4104,4564,4906,3762
2007,Urban,Sikkim,Other Crimes,Corruption,Female,31-45,2196,2085,111,2124,72
2004,Urban,Sikkim,Crime Against Children,Child Labor,Male,60+,8476,3217,5259,7564,912
2006,Urban,Maharashtra,Crime Against Children,Kidnapping,Male,0-12,3638,844,2794,3376,262
2007,Urban,Kerala,Crime Against Men,Robbery,Female,0-12,526,47,479,261,265
2009,Rural,Odisha,Crime Against Children,Child Labor,Female,18-30,1441,810,631,911,530
2004,Urban,Gujarat,Crime Against Children,Child Labor,Male,31-45,329,211,118,312,17
2005,Rural,Manipur,Crime Against Men,Assault,Male,13-17,844,82,762,260,584
2004,Rural,Haryana,Crime Against Women,Rape,Female,31-45,3753,3193,560,3216,537
2006,Rural,Jammu & Kashmir,Crime Against Women,Domestic Violence,Male,31-45,3550,5,3545,666,2884
2002,Rural,Punjab,Crime Against Women,Dowry Deaths,Female,18-30,7044,2758,4286,6327,717
2010,Rural,Karnataka,Crime Against Women,Dowry Deaths,Male,46-60,1711,1315,396,1454,257
2007,Rural,Kerala,Other Crimes,Drug Offense,Male,18-30,391,378,13,383,8
2010,Rural,Uttar Pradesh,Other Crimes,Drug Offense,Male,13-17,8034,5224,2810,5638,2396
2008,Rural,Delhi,Crime Against Women,Domestic Violence,Male,46-60,9506,7656,1850,9252,254
2001,Rural,Meghalaya,Crime Against Children,Trafficking,Male,60+,2510,296,2214,1969,541
2006,Rural,Manipur,Crime Against Men,Murder,Female,18-30,9693,5561,4132,8729,964
2002,Urban,West Bengal,Crime Against Men,Murder,Female,13-17,7233,6414,819,6994,239
2002,Urban,Assam,Other Crimes,Fraud,Male,46-60,8813,4819,3994,7485,1328
2004,Urban,Tripura,Crime Against Men,Assault,Male,31-45,7705,1183,6522,6179,1526
2010,Rural,Assam,Other Crimes,Drug Offense,Male,46-60,6416,6205,211,6294,122
2009,Urban,Rajasthan,Crime Against Women,Rape,Female,18-30,9149,8975,174,9009,140
2001,Urban,Goa,Property Crime,Arson,Female,13-17,2474,72,2402,2398,76
2001,Rural,Gujarat,Crime Against Women,Molestation,Male,18-30,504,145,359,281,223
2005,Rural,Punjab,Property Crime,Burglary,Male,13-17,5326,4729,597,4783,543
2008,Urban,Punjab,Property Crime,Burglary,Female,31-45,7189,6501,688,6601,588
2008,Rural,Delhi,Crime Against Children,Trafficking,Male,0-12,6558,2417,4141,3881,2677
2006,Urban,Punjab,Crime Against Children,Child Labor,Male,46-60,3816,3253,563,3727,89
2004,Urban,Madhya Pradesh,Other Crimes,Cyber Crime,Female,18-30,9958,3824,6134,4415,5543
2005,Urban,Rajasthan,Crime Against Women,Molestation,Male,18-30,8107,1370,6737,5261,2846
2004,Rural,Himachal Pradesh,Crime Against Children,Child Abuse,Female,13-17,2133,2058,75,2080,53
2001,Rural,Gujarat,Crime Against Women,Molestation,Female,60+,8627,6079,2548,6357,2270
2006,Rural,Bihar,Other Crimes,Cyber Crime,Male,46-60,7767,4662,3105,5689,2078
2001,Urban,Delhi,Property Crime,Burglary,Female,60+,4105,1765,2340,3854,251
2003,Rural,Odisha,Property Crime,Vandalism,Male,0-12,5371,3693,1678,4669,702
2006,Urban,Madhya Pradesh,Crime Against Women,Domestic Violence,Female,60+,8673,1614,7059,7567,1106
2002,Rural,Uttarakhand,Crime Against Women,Dowry Deaths,Female,60+,6476,3340,3136,3408,3068
2006,Urban,Telangana,Crime Against Children,Trafficking,Female,18-30,401,180,221,185,216
2008,Rural,Kerala,Other Crimes,Cyber Crime,Female,46-60,2325,698,1627,2051,274
2007,Rural,Karnataka,Other Crimes,Fraud,Female,0-12,9533,2934,6599,5277,4256
2004,Rural,Bihar,Other Crimes,Cyber Crime,Male,46-60,5027,974,4053,1373,3654
2006,Rural,Meghalaya,Crime Against Men,Extortion,Female,60+,3721,3084,637,3304,417
2005,Rural,Uttar Pradesh,Crime Against Men,Murder,Male,18-30,7551,183,7368,2219,5332
2002,Rural,Uttar Pradesh,Crime Against Men,Murder,Female,0-12,9730,7693,2037,9085,645
2008,Rural,Telangana,Crime Against Women,Domestic Violence,Female,31-45,7768,591,7177,6921,847
2006,Urban,Meghalaya,Crime Against Women,Dowry Deaths,Female,60+,5436,5002,434,5093,343
2008,Urban,Tamil Nadu,Property Crime,Vandalism,Female,0-12,3200,425,2775,1621,1579
2002,Rural,Punjab,Other Crimes,Drug Offense,Male,31-45,8065,3350,4715,5915,2150
2010,Urban,Telangana,Other Crimes,Drug Offense,Female,13-17,9291,3630,5661,8193,1098
2007,Rural,Chhattisgarh,Crime Against Men,Assault,Female,31-45,6988,4068,2920,5629,1359
2001,Urban,Himachal Pradesh,Property Crime,Vandalism,Female,46-60,5513,3543,1970,4907,606
2006,Rural,Uttarakhand,Crime Against Children,Child Abuse,Female,0-12,4714,2314,2400,4138,576
2001,Urban,Odisha,Crime Against Women,Rape,Female,46-60,8920,8001,919,8817,103
2008,Urban,Madhya Pradesh,Crime Against Men,Murder,Female,0-12,1443,1197,246,1395,48
2005,Urban,Telangana,Crime Against Women,Rape,Female,18-30,7067,6603,464,6743,324
2001,Urban,Andhra Pradesh,Crime Against Women,Dowry Deaths,Male,18-30,998,135,863,631,367
2002,Rural,Rajasthan,Crime Against Children,Child Abuse,Female,60+,9989,9378,611,9566,423
2008,Rural,Assam,Crime Against Children,Child Labor,Female,0-12,3671,1071,2600,2775,896
2003,Urban,Uttarakhand,Crime Against Men,Murder,Male,60+,7968,1748,6220,6046,1922
2005,Rural,Uttarakhand,Crime Against Men,Extortion,Male,0-12,6350,829,5521,2067,4283
2001,Urban,Punjab,Property Crime,Arson,Female,13-17,4074,3329,745,4008,66
2007,Urban,Himachal Pradesh,Crime Against Men,Murder,Female,13-17,417,358,59,388,29
2005,Rural,West Bengal,Other Crimes,Drug Offense,Female,18-30,650,179,471,428,222
2003,Urban,Maharashtra,Crime Against Women,Molestation,Male,13-17,6220,903,5317,1594,4626
2002,Urban,Himachal Pradesh,Crime Against Men,Murder,Female,60+,6952,1220,5732,4826,2126
2010,Urban,Telangana,Crime Against Men,Robbery,Male,13-17,3895,555,3340,847,3048
2003,Urban,Bihar,Crime Against Women,Domestic Violence,Female,46-60,7223,4284,2939,6007,1216
2008,Rural,Arunachal Pradesh,Property Crime,Burglary,Male,0-12,7085,889,6196,4379,2706
2001,Urban,Madhya Pradesh,Property Crime,Vandalism,Male,46-60,8557,7640,917,8499,58
2010,Rural,Uttarakhand,Other Crimes,Corruption,Male,46-60,1055,669,386,821,234
2006,Rural,Bihar,Property Crime,Burglary,Female,18-30,5842,249,5593,5028,814
2001,Rural,Arunachal Pradesh,Property Crime,Arson,Male,31-45,5308,3794,1514,3802,1506
2009,Urban,Goa,Property Crime,Vandalism,Male,13-17,7574,7361,213,7455,119
2001,Urban,Gujarat,Crime Against Children,Kidnapping,Female,60+,2548,116,2432,1333,1215
2009,Rural,Karnataka,Crime Against Men,Robbery,Male,13-17,8180,5332,2848,6092,2088
2002,Urban,Chhattisgarh,Crime Against Women,Domestic Violence,Female,0-12,3518,2680,838,3202,316
2001,Rural,Chhattisgarh,Crime Against Men,Assault,Male,31-45,7568,2517,5051,4689,2879
2007,Urban,Haryana,Crime Against Women,Domestic Violence,Male,60+,4519,2119,2400,3024,1495
2008,Urban,Tamil Nadu,Crime Against Women,Molestation,Female,18-30,7193,2429,4764,4324,2869
2006,Rural,Goa,Crime Against Children,Trafficking,Male,31-45,3427,436,2991,3268,159
2001,Rural,Goa,Crime Against Women,Molestation,Female,18-30,1920,1075,845,1094,826
2010,Rural,Gujarat,Crime Against Children,Trafficking,Male,31-45,7352,1410,5942,3810,3542
2006,Rural,Kerala,Crime Against Children,Child Labor,Female,46-60,3906,2634,1272,3870,36
2005,Urban,Meghalaya,Property Crime,Theft,Male,46-60,1184,1039,145,1077,107
2007,Rural,Odisha,Crime Against Men,Robbery,Female,31-45,1586,760,826,1403,183
2005,Urban,Rajasthan,Other Crimes,Cyber Crime,Female,46-60,6441,139,6302,729,5712
2007,Urban,Jammu & Kashmir,Crime Against Children,Trafficking,Female,60+,5423,3989,1434,5034,389
2007,Rural,Delhi,Crime Against Women,Dowry Deaths,Female,60+,4934,2434,2500,4116,818
2001,Urban,Maharashtra,Property Crime,Arson,Male,31-45,9774,7572,2202,8961,813
2005,Rural,Assam,Crime Against Children,Kidnapping,Male,46-60,3226,2573,653,2958,268
2008,Rural,Delhi,Crime Against Women,Dowry Deaths,Female,18-30,2674,2359,315,2635,39
2006,Urban,Uttarakhand,Crime Against Children,Trafficking,Female,31-45,5004,4801,203,4995,9
2002,Rural,Maharashtra,Property Crime,Arson,Male,0-12,4912,2293,2619,4114,798
2004,Urban,Gujarat,Crime Against Women,Molestation,Male,46-60,6205,4051,2154,4104,2101
2008,Rural,Tamil Nadu,Crime Against Women,Domestic Violence,Male,31-45,5318,4454,864,4678,640
2004,Rural,Bihar,Other Crimes,Corruption,Female,46-60,5748,4855,893,5278,470
2005,Rural,Assam,Crime Against Men,Murder,Female,46-60,2236,1569,667,2104,132
2006,Urban,Sikkim,Property Crime,Burglary,Female,60+,1845,1498,347,1764,81
2008,Rural,Madhya Pradesh,Crime Against Children,Trafficking,Male,13-17,2886,510,2376,1836,1050
2008,Urban,Punjab,Crime Against Men,Extortion,Female,0-12,6580,2362,4218,4375,2205
2006,Rural,Mizoram,Property Crime,Burglary,Male,0-12,7520,1769,5751,3958,3562
2007,Rural,Uttar Pradesh,Other Crimes,Fraud,Male,18-30,1315,260,1055,576,739
2006,Urban,Telangana,Crime Against Children,Child Abuse,Male,60+,6369,3438,2931,5384,985
2006,Urban,Arunachal Pradesh,Crime Against Men,Extortion,Male,46-60,8432,3139,5293,5594,2838
2004,Rural,Rajasthan,Other Crimes,Fraud,Female,13-17,4042,3999,43,4003,39
2009,Urban,Mizoram,Crime Against Men,Robbery,Female,18-30,5360,1840,3520,5002,358
2002,Rural,West Bengal,Other Crimes,Drug Offense,Male,46-60,5189,1258,3931,2995,2194
2008,Urban,Goa,Crime Against Men,Murder,Male,13-17,8964,2498,6466,8485,479
2007,Urban,Tripura,Other Crimes,Drug Offense,Female,13-17,9240,3432,5808,4320,4920
2009,Rural,Telangana,Crime Against Children,Kidnapping,Female,31-45,8073,4105,3968,7786,287
2009,Rural,Tripura,Crime Against Children,Child Abuse,Female,60+,943,79,864,754,189
2001,Rural,West Bengal,Crime Against Women,Rape,Male,0-12,1698,1044,654,1192,506
2009,Rural,Andhra Pradesh,Other Crimes,Fraud,Female,13-17,2099,121,1978,647,1452
2010,Rural,Kerala,Crime Against Children,Child Abuse,Female,13-17,6356,4917,1439,5468,888
2005,Urban,Assam,Crime Against Women,Dowry Deaths,Female,18-30,5701,165,5536,3919,1782
2009,Urban,Meghalaya,Crime Against Children,Kidnapping,Male,31-45,9106,7191,1915,7885,1221
2007,Urban,Odisha,Crime Against Children,Kidnapping,Female,60+,7076,6304,772,6370,706
2005,Urban,Bihar,Other Crimes,Fraud,Female,13-17,4359,2620,1739,2643,1716
2006,Rural,Uttar Pradesh,Property Crime,Burglary,Male,13-17,416,165,251,363,53
2002,Urban,Arunachal Pradesh,Crime Against Men,Robbery,Female,18-30,5281,145,5136,3560,1721
2001,Rural,Chhattisgarh,Crime Against Women,Molestation,Male,60+,3250,1127,2123,2185,1065
2004,Rural,Rajasthan,Crime Against Men,Extortion,Female,60+,1821,1150,671,1154,667
2008,Rural,Manipur,Property Crime,Vandalism,Female,31-45,5738,3197,2541,3779,1959
2005,Urban,Uttarakhand,Crime Against Women,Domestic Violence,Female,31-45,8453,2187,6266,8365,88
2002,Urban,Delhi,Property Crime,Theft,Female,31-45,4242,1424,2818,2576,1666
2003,Rural,Telangana,Crime Against Women,Molestation,Male,0-12,611,15,596,559,52
2006,Urban,Jharkhand,Other Crimes,Fraud,Male,60+,874,655,219,724,150
2005,Urban,Meghalaya,Crime Against Men,Murder,Male,18-30,1730,1115,615,1337,393
2008,Rural,Goa,Crime Against Men,Extortion,Female,13-17,5220,1082,4138,5167,53
2004,Urban,Haryana,Property Crime,Arson,Male,18-30,4855,2310,2545,2607,2248
2004,Rural,Tripura,Crime Against Women,Molestation,Female,13-17,2715,1091,1624,1164,1551
2003,Rural,Nagaland,Crime Against Women,Molestation,Female,46-60,5393,1515,3878,5200,193
2007,Rural,Andhra Pradesh,Other Crimes,Drug Offense,Female,60+,732,444,288,717,15
2004,Rural,Jharkhand,Crime Against Children,Trafficking,Female,13-17,1961,353,1608,1909,52
2006,Urban,Bihar,Crime Against Children,Child Abuse,Male,0-12,2196,1323,873,1543,653
2006,Rural,Uttarakhand,Crime Against Women,Rape,Male,46-60,3137,1948,1189,2859,278
2009,Rural,Himachal Pradesh,Other Crimes,Fraud,Female,60+,9138,5212,3926,5212,3926
2001,Urban,Sikkim,Crime Against Men,Murder,Female,31-45,6196,2229,3967,2576,3620
2007,Urban,Odisha,Property Crime,Burglary,Male,13-17,7402,2275,5127,4493,2909
2004,Urban,Chhattisgarh,Property Crime,Arson,Female,46-60,2452,994,1458,2352,100
2001,Urban,Tripura,Crime Against Children,Kidnapping,Male,18-30,1731,382,1349,820,911
2009,Urban,Assam,Crime Against Children,Child Labor,Male,13-17,4100,3261,839,3270,830
2009,Rural,Chhattisgarh,Crime Against Children,Child Abuse,Female,46-60,5485,5409,76,5466,19
2003,Urban,Karnataka,Crime Against Men,Murder,Female,0-12,9614,4564,5050,9538,76
2003,Urban,Delhi,Crime Against Men,Robbery,Female,18-30,5547,5245,302,5371,176
2008,Urban,Sikkim,Other Crimes,Drug Offense,Female,18-30,8795,3233,5562,7789,1006
2009,Urban,Kerala,Other Crimes,Corruption,Male,60+,7227,996,6231,4873,2354
2002,Urban,Sikkim,Crime Against Children,Child Abuse,Male,18-30,6765,4329,2436,4616,2149
2001,Urban,Goa,Crime Against Women,Rape,Female,46-60,5359,1040,4319,2842,2517
2008,Rural,Uttarakhand,Other Crimes,Corruption,Female,13-17,4337,3286,1051,4073,264
2001,Rural,Nagaland,Crime Against Children,Child Abuse,Female,0-12,6535,6351,184,6446,89
2007,Rural,Nagaland,Crime Against Children,Kidnapping,Male,0-12,8265,6713,1552,7967,298
2010,Rural,Manipur,Crime Against Children,Child Abuse,Male,0-12,3539,2499,1040,2890,649
2003,Rural,Telangana,Other Crimes,Drug Offense,Male,31-45,617,475,142,587,30
2006,Rural,Haryana,Crime Against Children,Child Labor,Female,60+,387,273,114,375,12
2006,Rural,Jharkhand,Crime Against Women,Rape,Female,18-30,9970,2485,7485,8552,1418
2009,Rural,Goa,Crime Against Children,Kidnapping,Male,0-12,8489,1306,7183,4307,4182
2009,Rural,Mizoram,Other Crimes,Corruption,Female,18-30,4627,2933,1694,4562,65
2003,Rural,West Bengal,Crime Against Children,Child Abuse,Male,46-60,5568,1953,3615,2383,3185
2001,Rural,Goa,Crime Against Women,Molestation,Male,46-60,4301,2859,1442,4106,195
2009,Urban,Maharashtra,Property Crime,Theft,Female,60+,5213,3947,1266,5014,199
2004,Urban,Andhra Pradesh,Property Crime,Vandalism,Male,13-17,8026,1813,6213,7794,232
2001,Urban,Mizoram,Crime Against Women,Domestic Violence,Male,18-30,7494,4081,3413,6414,1080
2007,Rural,Delhi,Property Crime,Burglary,Male,31-45,2336,646,1690,660,1676
2005,Urban,Goa,Property Crime,Theft,Male,18-30,7563,4705,2858,5481,2082
2007,Urban,Jharkhand,Property Crime,Vandalism,Female,60+,4225,559,3666,621,3604
2009,Rural,Andhra Pradesh,Other Crimes,Fraud,Male,18-30,9520,6749,2771,8383,1137
2010,Rural,Himachal Pradesh,Crime Against Men,Murder,Male,46-60,8536,748,7788,8143,393
2005,Urban,Chhattisgarh,Crime Against Children,Kidnapping,Female,0-12,6576,123,6453,2731,3845
2007,Urban,Rajasthan,Crime Against Children,Child Abuse,Female,60+,3640,3631,9,3631,9
2006,Urban,Telangana,Crime Against Children,Child Labor,Male,60+,4494,4014,480,4017,477
2010,Rural,Odisha,Other Crimes,Drug Offense,Male,31-45,6065,3907,2158,4838,1227
2004,Rural,Himachal Pradesh,Other Crimes,Corruption,Female,18-30,2880,2868,12,2878,2
2007,Urban,Telangana,Property Crime,Arson,Female,46-60,8457,3261,5196,6563,1894
2010,Rural,Meghalaya,Crime Against Children,Child Abuse,Female,13-17,220,105,115,180,40
2007,Rural,Punjab,Crime Against Women,Rape,Male,60+,1740,1604,136,1649,91
2001,Rural,Telangana,Crime Against Children,Child Labor,Female,46-60,8465,170,8295,4863,3602
2010,Urban,West Bengal,Crime Against Children,Kidnapping,Female,31-45,5476,344,5132,4720,756
2002,Urban,West Bengal,Crime Against Children,Trafficking,Female,60+,4233,3211,1022,3295,938
2003,Urban,Assam,Crime Against Men,Murder,Male,13-17,5432,3587,1845,3867,1565
2005,Rural,Delhi,Other Crimes,Drug Offense,Male,0-12,516,132,384,471,45
2006,Urban,Kerala,Property Crime,Theft,Female,60+,4763,2248,2515,2368,2395
2008,Urban,Karnataka,Crime Against Children,Trafficking,Male,31-45,78,3,75,32,46
2008,Urban,Gujarat,Crime Against Women,Dowry Deaths,Male,31-45,3324,3236,88,3257,67
2010,Rural,Meghalaya,Crime Against Children,Kidnapping,Male,0-12,7604,3,7601,5179,2425
2003,Urban,Chhattisgarh,Crime Against Women,Domestic Violence,Female,46-60,3386,1306,2080,2543,843
2006,Urban,Jharkhand,Crime Against Women,Domestic Violence,Female,46-60,6808,5136,1672,5911,897
2009,Urban,Meghalaya,Crime Against Women,Rape,Female,18-30,7482,4021,3461,4478,3004
2010,Rural,Kerala,Property Crime,Burglary,Male,31-45,8170,1202,6968,4538,3632
2004,Rural,Odisha,Crime Against Men,Robbery,Male,31-45,9261,1112,8149,2746,6515
2003,Urban,Himachal Pradesh,Crime Against Children,Child Abuse,Male,0-12,9648,8118,1530,8852,796
2009,Urban,Uttarakhand,Property Crime,Theft,Male,31-45,4920,3687,1233,3730,1190
2002,Urban,Nagaland,Crime Against Women,Rape,Male,18-30,8183,5009,3174,6280,1903
2008,Rural,West Bengal,Property Crime,Theft,Male,18-30,6831,6712,119,6753,78
2005,Rural,Goa,Crime Against Men,Murder,Male,60+,9466,9110,356,9265,201
2003,Urban,Manipur,Crime Against Men,Robbery,Male,31-45,8729,271,8458,1002,7727
2008,Rural,Tripura,Crime Against Children,Child Labor,Male,18-30,9896,982,8914,1377,8519
2009,Rural,Jammu & Kashmir,Property Crime,Theft,Female,18-30,7686,153,7533,5123,2563
2005,Urban,Gujarat,Crime Against Children,Trafficking,Male,31-45,3635,177,3458,1260,2375
2009,Urban,Arunachal Pradesh,Other Crimes,Cyber Crime,Male,31-45,8600,3245,5355,4656,3944
2009,Urban,Chhattisgarh,Crime Against Children,Trafficking,Male,60+,3062,1396,1666,2797,265
2005,Rural,Haryana,Other Crimes,Fraud,Female,60+,6786,3231,3555,3662,3124
2001,Rural,Punjab,Crime Against Men,Assault,Female,0-12,67,9,58,53,14
2005,Urban,Rajasthan,Property Crime,Vandalism,Female,0-12,3867,1858,2009,3332,535
2008,Urban,Maharashtra,Property Crime,Burglary,Female,46-60,3853,337,3516,2287,1566
2004,Urban,Telangana,Crime Against Women,Molestation,Female,60+,6114,979,5135,4113,2001
2006,Urban,Nagaland,Other Crimes,Cyber Crime,Male,60+,3184,1806,1378,2962,222
2002,Urban,Arunachal Pradesh,Crime Against Women,Dowry Deaths,Male,46-60,4102,982,3120,1882,2220
2010,Urban,Chhattisgarh,Crime Against Children,Child Labor,Female,13-17,5073,2940,2133,5064,9
2007,Urban,Madhya Pradesh,Crime Against Men,Murder,Male,18-30,2518,2224,294,2398,120
2005,Urban,Telangana,Other Crimes,Cyber Crime,Male,0-12,5254,1229,4025,3155,2099
2005,Rural,Haryana,Property Crime,Burglary,Male,13-17,6309,6201,108,6202,107
2005,Rural,Punjab,Crime Against Children,Child Labor,Male,13-17,9635,6685,2950,8045,1590
2007,Urban,Nagaland,Crime Against Children,Child Abuse,Female,18-30,6619,2438,4181,5147,1472
2002,Rural,Goa,Crime Against Women,Domestic Violence,Male,60+,299,120,179,262,37
2001,Urban,Jharkhand,Crime Against Children,Trafficking,Male,18-30,5898,2987,2911,3151,2747
2005,Rural,Punjab,Crime Against Children,Kidnapping,Female,31-45,137,118,19,134,3
2007,Rural,Bihar,Other Crimes,Drug Offense,Male,18-30,772,316,456,616,156
2009,Rural,Assam,Crime Against Women,Molestation,Female,60+,9563,4932,4631,7254,2309
2008,Urban,Madhya Pradesh,Crime Against Women,Dowry Deaths,Male,46-60,5912,1464,4448,3710,2202
2002,Urban,Rajasthan,Other Crimes,Fraud,Female,18-30,1921,1058,863,1350,571
2004,Rural,West Bengal,Crime Against Children,Child Abuse,Male,31-45,5421,4757,664,5117,304
2007,Rural,Delhi,Crime Against Men,Extortion,Female,18-30,8978,6181,2797,8911,67
2004,Rural,Maharashtra,Crime Against Men,Murder,Female,0-12,2563,1647,916,1673,890
2007,Urban,Uttar Pradesh,Crime Against Children,Child Abuse,Female,60+,5020,1676,3344,2794,2226
2001,Rural,Goa,Crime Against Children,Kidnapping,Male,46-60,3782,164,3618,776,3006
2009,Rural,Tamil Nadu,Crime Against Children,Trafficking,Female,13-17,5744,557,5187,1858,3886
2001,Urban,Assam,Property Crime,Arson,Male,18-30,9354,3750,5604,8672,682
2006,Rural,Maharashtra,Crime Against Children,Child Labor,Female,13-17,7897,5566,2331,6220,1677
2003,Rural,Tripura,Property Crime,Arson,Male,60+,9210,3086,6124,4122,5088
2004,Rural,Delhi,Property Crime,Vandalism,Female,13-17,7332,5337,1995,6951,381
2008,Rural,Madhya Pradesh,Crime Against Children,Kidnapping,Male,60+,1715,1222,493,1567,148
2006,Urban,Uttarakhand,Property Crime,Theft,Male,60+,7598,4792,2806,5715,1883
2007,Rural,Arunachal Pradesh,Crime Against Women,Rape,Female,46-60,3636,2510,1126,3370,266
2010,Urban,Telangana,Crime Against Men,Assault,Female,13-17,8504,7465,1039,8028,476
2005,Rural,Chhattisgarh,Crime Against Children,Child Labor,Male,60+,4066,684,3382,1063,3003
2004,Urban,Meghalaya,Property Crime,Burglary,Female,46-60,7307,6207,1100,6876,431
2006,Rural,Delhi,Crime Against Children,Child Labor,Female,46-60,1921,637,1284,876,1045
2007,Rural,Sikkim,Crime Against Women,Rape,Female,60+,1230,441,789,1212,18
2007,Urban,Nagaland,Crime Against Children,Kidnapping,Male,18-30,2576,1536,1040,2492,84
2002,Rural,Karnataka,Crime Against Children,Child Abuse,Male,13-17,5122,3522,1600,4209,913
2010,Urban,Telangana,Other Crimes,Cyber Crime,Female,60+,9362,3199,6163,4746,4616
2008,Urban,Jharkhand,Crime Against Children,Child Abuse,Female,18-30,717,717,0,717,0
2010,Rural,Rajasthan,Property Crime,Vandalism,Male,60+,8329,3315,5014,3551,4778
2002,Rural,Telangana,Property Crime,Arson,Female,0-12,6358,1768,4590,3500,2858
2009,Urban,Himachal Pradesh,Crime Against Children,Trafficking,Male,18-30,2107,48,2059,915,1192
2007,Rural,Telangana,Property Crime,Theft,Female,18-30,1297,654,643,725,572
2002,Rural,Madhya Pradesh,Other Crimes,Fraud,Male,31-45,4347,4125,222,4225,122
2009,Rural,Assam,Crime Against Women,Rape,Female,13-17,9407,450,8957,2713,6694
2006,Urban,Goa,Crime Against Men,Robbery,Female,46-60,5309,1453,3856,2326,2983
2004,Urban,Haryana,Crime Against Children,Child Labor,Male,31-45,1788,935,853,1353,435
2004,Urban,Mizoram,Crime Against Men,Extortion,Male,31-45,3613,3084,529,3319,294
2005,Rural,Telangana,Crime Against Women,Dowry Deaths,Male,31-45,7629,3777,3852,4858,2771
2008,Urban,Delhi,Crime Against Men,Extortion,Female,13-17,8614,5246,3368,5439,3175
2005,Urban,Uttar Pradesh,Crime Against Men,Murder,Male,46-60,3090,749,2341,2479,611
2001,Rural,Goa,Crime Against Children,Child Labor,Female,46-60,4809,4122,687,4526,283
2003,Urban,Telangana,Other Crimes,Corruption,Male,18-30,4185,2663,1522,3033,1152
2006,Urban,Andhra Pradesh,Crime Against Men,Assault,Male,18-30,7801,5020,2781,7445,356
2002,Urban,Rajasthan,Crime Against Children,Kidnapping,Female,31-45,1985,1330,655,1649,336
2008,Urban,Odisha,Crime Against Children,Kidnapping,Female,13-17,8252,388,7864,2711,5541
2006,Rural,Uttarakhand,Crime Against Women,Dowry Deaths,Female,46-60,6718,959,5759,2673,4045
2003,Urban,Telangana,Crime Against Children,Kidnapping,Male,0-12,3687,1566,2121,3295,392
2002,Urban,Gujarat,Property Crime,Theft,Female,13-17,158,3,155,106,52
2010,Rural,Uttar Pradesh,Crime Against Men,Robbery,Male,13-17,505,73,432,505,0
2006,Urban,Arunachal Pradesh,Property Crime,Arson,Female,60+,3666,310,3356,2972,694
2008,Urban,Bihar,Property Crime,Vandalism,Male,31-45,6498,2299,4199,4341,2157
2003,Rural,Meghalaya,Other Crimes,Drug Offense,Female,46-60,2614,2054,560,2577,37
2008,Rural,Uttarakhand,Other Crimes,Cyber Crime,Female,0-12,5528,1920,3608,4623,905
2008,Urban,Maharashtra,Other Crimes,Corruption,Female,46-60,6040,1174,4866,4500,1540
2004,Rural,Odisha,Crime Against Children,Trafficking,Female,31-45,2408,1865,543,1915,493
2001,Rural,Gujarat,Crime Against Women,Rape,Male,31-45,6980,6153,827,6413,567
2006,Rural,Gujarat,Crime Against Men,Assault,Male,46-60,7665,16,7649,3258,4407
2001,Rural,Karnataka,Crime Against Women,Molestation,Male,18-30,4054,3405,649,3659,395
2008,Urban,Kerala,Crime Against Men,Assault,Male,13-17,5399,500,4899,1701,3698
2007,Urban,Uttar Pradesh,Crime Against Women,Domestic Violence,Male,31-45,2368,1900,468,2280,88
2002,Rural,Tamil Nadu,Other Crimes,Drug Offense,Female,18-30,2028,169,1859,659,1369
2003,Urban,Tamil Nadu,Crime Against Men,Assault,Female,31-45,8835,7994,841,8182,653
2005,Urban,Delhi,Crime Against Children,Child Labor,Female,46-60,2730,244,2486,1148,1582
2007,Urban,Odisha,Property Crime,Vandalism,Female,18-30,4547,1288,3259,4018,529
2001,Rural,Gujarat,Crime Against Men,Robbery,Male,0-12,5264,1858,3406,3217,2047
2006,Urban,Telangana,Crime Against Women,Dowry Deaths,Male,46-60,1643,1457,186,1592,51
2007,Rural,Uttarakhand,Crime Against Women,Molestation,Male,46-60,8645,3982,4663,7979,666
2009,Urban,Bihar,Property Crime,Vandalism,Male,31-45,8484,2258,6226,6379,2105
2008,Rural,Jammu & Kashmir,Crime Against Women,Molestation,Male,60+,5888,3688,2200,3945,1943
2010,Urban,Arunachal Pradesh,Other Crimes,Cyber Crime,Male,46-60,249,28,221,53,196
2008,Rural,Andhra Pradesh,Crime Against Men,Robbery,Female,18-30,7352,4618,2734,5936,1416
2007,Urban,Gujarat,Crime Against Children,Kidnapping,Female,0-12,6351,4596,1755,5969,382
2010,Rural,Telangana,Property Crime,Theft,Female,0-12,8788,5951,2837,8372,416
2006,Urban,Goa,Property Crime,Theft,Female,13-17,6160,1947,4213,5323,837
2001,Urban,Himachal Pradesh,Other Crimes,Fraud,Female,31-45,6343,1413,4930,6176,167
2008,Urban,Tamil Nadu,Property Crime,Burglary,Female,0-12,2950,2234,716,2788,162
2004,Urban,Jharkhand,Crime Against Women,Dowry Deaths,Female,0-12,2845,2520,325,2616,229
2002,Rural,Madhya Pradesh,Crime Against Men,Murder,Female,18-30,2069,796,1273,1104,965
2004,Urban,Sikkim,Crime Against Men,Robbery,Female,13-17,6780,2376,4404,5707,1073
2002,Urban,Chhattisgarh,Property Crime,Burglary,Male,60+,6480,5674,806,6257,223
2009,Rural,Meghalaya,Property Crime,Arson,Male,0-12,3175,2081,1094,2712,463
2008,Urban,Kerala,Crime Against Children,Trafficking,Male,18-30,8370,315,8055,408,7962
2007,Urban,Manipur,Crime Against Men,Extortion,Male,31-45,7126,5160,1966,7020,106
2006,Rural,Maharashtra,Property Crime,Burglary,Male,31-45,5951,2684,3267,4774,1177
2006,Urban,Assam,Crime Against Men,Murder,Male,46-60,2459,300,2159,1143,1316
2006,Rural,Sikkim,Other Crimes,Cyber Crime,Female,13-17,8502,5677,2825,7882,620
2006,Urban,Madhya Pradesh,Crime Against Women,Molestation,Female,46-60,3160,2605,555,3120,40
2006,Rural,Mizoram,Other Crimes,Corruption,Female,18-30,6297,5375,922,6173,124
2010,Urban,Sikkim,Crime Against Men,Assault,Female,18-30,3993,3683,310,3942,51
2004,Rural,Uttarakhand,Crime Against Women,Molestation,Male,0-12,4116,1962,2154,2118,1998
2008,Rural,Gujarat,Crime Against Men,Murder,Female,31-45,4121,1186,2935,2794,1327
2005,Urban,Haryana,Crime Against Children,Kidnapping,Female,60+,2084,673,1411,787,1297
2010,Rural,Gujarat,Property Crime,Vandalism,Male,0-12,8681,3276,5405,7827,854
2002,Rural,Kerala,Other Crimes,Cyber Crime,Male,60+,4360,491,3869,2914,1446
2001,Urban,Himachal Pradesh,Property Crime,Theft,Female,13-17,1320,1276,44,1295,25
2002,Rural,Madhya Pradesh,Crime Against Men,Murder,Female,18-30,1678,1322,356,1434,244
2006,Rural,Telangana,Property Crime,Arson,Female,0-12,5469,136,5333,1859,3610
2008,Rural,Delhi,Crime Against Children,Child Labor,Female,18-30,9555,3328,6227,9345,210
2010,Urban,Sikkim,Other Crimes,Corruption,Male,60+,5482,2653,2829,3905,1577
2001,Rural,Mizoram,Other Crimes,Cyber Crime,Male,60+,2467,343,2124,402,2065
2005,Rural,Uttar Pradesh,Crime Against Women,Rape,Male,0-12,2649,36,2613,2181,468
2003,Rural,Andhra Pradesh,Crime Against Women,Molestation,Female,18-30,5857,4542,1315,4705,1152
2006,Rural,Telangana,Crime Against Women,Domestic Violence,Male,0-12,1316,1171,145,1175,141
2001,Rural,Madhya Pradesh,Property Crime,Vandalism,Male,18-30,8253,3151,5102,5146,3107
2005,Urban,Haryana,Crime Against Men,Extortion,Male,13-17,5315,908,4407,4211,1104
2006,Rural,Manipur,Crime Against Men,Murder,Female,31-45,8379,3854,4525,7283,1096
2008,Urban,Kerala,Other Crimes,Fraud,Male,31-45,9070,5820,3250,7659,1411
2009,Urban,Uttarakhand,Crime Against Children,Child Labor,Female,31-45,293,8,285,129,164
2007,Rural,Himachal Pradesh,Crime Against Children,Kidnapping,Female,31-45,9328,3287,6041,7358,1970
2010,Urban,Kerala,Property Crime,Vandalism,Female,60+,6496,1168,5328,3216,3280
2010,Rural,Haryana,Crime Against Children,Kidnapping,Male,31-45,1266,210,1056,1067,199
2004,Urban,Rajasthan,Other Crimes,Drug Offense,Female,18-30,8156,1306,6850,3942,4214
2006,Rural,Telangana,Other Crimes,Drug Offense,Male,18-30,3894,556,3338,710,3184
2001,Rural,Punjab,Crime Against Women,Molestation,Male,31-45,5332,3952,1380,4433,899
2001,Rural,Kerala,Property Crime,Theft,Female,31-45,4296,1582,2714,2759,1537
2002,Rural,Meghalaya,Property Crime,Theft,Female,60+,3586,466,3120,2982,604
2005,Urban,Mizoram,Crime Against Women,Dowry Deaths,Male,13-17,1327,75,1252,1154,173
2007,Rural,Delhi,Crime Against Women,Rape,Female,60+,687,448,239,448,239
2008,Rural,Karnataka,Other Crimes,Drug Offense,Female,18-30,2351,2343,8,2347,4
2001,Rural,West Bengal,Property Crime,Vandalism,Female,31-45,4768,261,4507,3012,1756
2006,Rural,Tamil Nadu,Crime Against Women,Molestation,Male,60+,5991,1056,4935,5476,515
2003,Rural,Odisha,Other Crimes,Fraud,Male,31-45,1564,580,984,580,984
2008,Rural,Odisha,Crime Against Women,Molestation,Female,46-60,4063,3574,489,3763,300
2008,Rural,Meghalaya,Property Crime,Burglary,Female,46-60,6326,4558,1768,5118,1208
2004,Rural,Uttarakhand,Crime Against Men,Murder,Female,18-30,1227,433,794,581,646
2009,Urban,Punjab,Crime Against Children,Trafficking,Male,46-60,1742,438,1304,762,980
2002,Urban,Gujarat,Other Crimes,Cyber Crime,Female,0-12,7853,3674,4179,3761,4092
2007,Rural,Bihar,Property Crime,Vandalism,Male,18-30,3655,835,2820,2941,714
2009,Rural,Karnataka,Crime Against Men,Extortion,Female,13-17,5608,3899,1709,5525,83
2003,Urban,Himachal Pradesh,Other Crimes,Drug Offense,Male,0-12,1904,1066,838,1813,91
2010,Urban,Uttar Pradesh,Crime Against Children,Child Labor,Female,46-60,7865,2233,5632,5908,1957
2008,Rural,Madhya Pradesh,Property Crime,Arson,Male,31-45,1779,1122,657,1183,596
2001,Rural,Delhi,Crime Against Children,Child Abuse,Female,60+,4700,332,4368,1271,3429
2001,Urban,Chhattisgarh,Crime Against Men,Assault,Male,0-12,6483,1775,4708,1790,4693
2004,Urban,Tripura,Crime Against Women,Molestation,Female,13-17,1217,818,399,1153,64
2005,Rural,Chhattisgarh,Crime Against Men,Robbery,Male,13-17,2955,525,2430,1282,1673
2007,Rural,Goa,Crime Against Women,Rape,Female,18-30,3824,2427,1397,3007,817
2003,Urban,West Bengal,Crime Against Children,Child Labor,Male,60+,549,392,157,504,45
2008,Rural,Telangana,Crime Against Children,Kidnapping,Male,60+,8428,3443,4985,4354,4074
2002,Rural,Goa,Crime Against Men,Murder,Male,60+,6845,500,6345,3081,3764
2008,Urban,Uttar Pradesh,Other Crimes,Fraud,Male,46-60,2661,2652,9,2661,0
2008,Urban,Punjab,Crime Against Children,Kidnapping,Female,18-30,2316,234,2082,2116,200
2009,Rural,Nagaland,Crime Against Women,Dowry Deaths,Female,13-17,8657,2283,6374,7563,1094
2007,Urban,Goa,Property Crime,Vandalism,Female,0-12,2893,2624,269,2742,151
2009,Rural,Telangana,Crime Against Children,Kidnapping,Female,31-45,2347,2054,293,2125,222
2006,Urban,Odisha,Other Crimes,Fraud,Male,18-30,6930,4570,2360,5681,1249
2001,Urban,Gujarat,Crime Against Women,Dowry Deaths,Male,46-60,3531,2727,804,3363,168
2001,Rural,Punjab,Property Crime,Burglary,Male,60+,1724,555,1169,1458,266
2002,Rural,Tamil Nadu,Other Crimes,Fraud,Female,18-30,2497,946,1551,2019,478
2007,Rural,Himachal Pradesh,Crime Against Women,Molestation,Male,18-30,7899,4047,3852,4345,3554
2006,Urban,Madhya Pradesh,Crime Against Children,Kidnapping,Female,46-60,7244,6498,746,6958,286
2003,Rural,Odisha,Crime Against Children,Child Abuse,Female,13-17,3944,2341,1603,2640,1304
2002,Rural,Madhya Pradesh,Other Crimes,Drug Offense,Male,31-45,861,342,519,358,503
2009,Rural,Punjab,Crime Against Women,Molestation,Female,0-12,7113,4798,2315,6390,723
2007,Rural,Kerala,Crime Against Men,Murder,Female,18-30,1474,1023,451,1469,5
2007,Urban,Haryana,Crime Against Children,Child Abuse,Male,46-60,4122,1446,2676,2232,1890
2008,Urban,Mizoram,Crime Against Children,Kidnapping,Female,60+,8353,403,7950,2024,6329
2009,Rural,Assam,Crime Against Children,Kidnapping,Male,31-45,5294,1088,4206,4312,982
2002,Urban,Gujarat,Crime Against Children,Kidnapping,Male,18-30,6540,1765,4775,6150,390
2006,Urban,Rajasthan,Crime Against Women,Molestation,Male,60+,4025,3179,846,3305,720
2005,Rural,Gujarat,Crime Against Women,Dowry Deaths,Female,31-45,2988,2456,532,2938,50
2010,Urban,Assam,Crime Against Women,Domestic Violence,Female,31-45,434,257,177,411,23
2006,Rural,Delhi,Crime Against Women,Domestic Violence,Female,13-17,5483,3100,2383,3303,2180
2005,Rural,Manipur,Crime Against Children,Child Labor,Male,0-12,2500,1874,626,2296,204
2007,Rural,Jharkhand,Crime Against Men,Murder,Female,18-30,427,150,277,234,193
2003,Urban,Tripura,Crime Against Children,Child Abuse,Female,13-17,9572,1148,8424,7843,1729
2009,Rural,Mizoram,Crime Against Men,Assault,Female,18-30,5042,3535,1507,3777,1265
2007,Rural,Rajasthan,Property Crime,Vandalism,Female,18-30,6935,5110,1825,6460,475
2003,Urban,Andhra Pradesh,Other Crimes,Fraud,Female,18-30,2992,58,2934,1108,1884
2001,Rural,Rajasthan,Property Crime,Burglary,Female,46-60,8951,2754,6197,3962,4989
2007,Rural,Gujarat,Crime Against Men,Robbery,Female,18-30,8332,6041,2291,6895,1437
2002,Rural,West Bengal,Crime Against Men,Assault,Male,60+,3003,846,2157,2693,310
2008,Urban,Uttarakhand,Property Crime,Arson,Female,60+,2967,2256,711,2629,338
2010,Urban,Assam,Property Crime,Vandalism,Male,18-30,5889,445,5444,1541,4348
2005,Urban,Manipur,Other Crimes,Drug Offense,Male,46-60,7028,6365,663,6856,172
2001,Urban,Bihar,Crime Against Women,Domestic Violence,Female,60+,2883,2806,77,2825,58
2007,Rural,Tamil Nadu,Crime Against Women,Domestic Violence,Male,31-45,6565,4098,2467,5201,1364
2007,Urban,Delhi,Crime Against Women,Rape,Female,60+,9750,6235,3515,9184,566
2008,Urban,Tripura,Property Crime,Arson,Male,60+,3064,2615,449,2778,286
2003,Urban,Assam,Property Crime,Theft,Female,0-12,9949,7956,1993,8036,1913
2009,Rural,Jammu & Kashmir,Crime Against Children,Trafficking,Male,18-30,4145,1721,2424,3766,379
2006,Rural,Odisha,Crime Against Women,Molestation,Male,60+,5458,282,5176,2602,2856
2007,Rural,Tamil Nadu,Crime Against Women,Rape,Male,60+,4837,1608,3229,2843,1994
2007,Urban,Odisha,Other Crimes,Cyber Crime,Female,31-45,1194,951,243,1072,122
2005,Rural,Delhi,Crime Against Men,Assault,Female,13-17,5904,4663,1241,5558,346
2010,Urban,Goa,Crime Against Children,Child Abuse,Male,18-30,5624,2596,3028,4909,715
2005,Rural,Karnataka,Crime Against Children,Kidnapping,Male,31-45,3322,677,2645,2032,1290
2006,Rural,Kerala,Crime Against Children,Child Labor,Female,18-30,1450,555,895,710,740
2010,Urban,Odisha,Other Crimes,Cyber Crime,Male,0-12,9779,4937,4842,9619,160
2009,Urban,Telangana,Crime Against Children,Child Labor,Male,31-45,6681,2315,4366,2883,3798
2001,Urban,Mizoram,Property Crime,Vandalism,Female,46-60,5553,710,4843,3493,2060
2002,Urban,Uttarakhand,Crime Against Men,Murder,Male,60+,8695,5767,2928,6126,2569
2009,Rural,Telangana,Property Crime,Theft,Male,18-30,5716,5161,555,5564,152
2002,Rural,Mizoram,Property Crime,Arson,Female,18-30,4781,1468,3313,4589,192
2003,Rural,Telangana,Crime Against Children,Child Abuse,Female,31-45,6126,1941,4185,3833,2293
2005,Rural,Punjab,Property Crime,Arson,Male,60+,8282,3200,5082,7195,1087
2005,Urban,Rajasthan,Crime Against Children,Child Abuse,Female,13-17,115,51,64,101,14
2009,Urban,Madhya Pradesh,Crime Against Men,Robbery,Male,46-60,9618,7453,2165,8226,1392
2006,Urban,Andhra Pradesh,Property Crime,Vandalism,Male,60+,7115,6839,276,6996,119
2007,Urban,Punjab,Other Crimes,Cyber Crime,Female,13-17,3088,1243,1845,1773,1315
2008,Rural,Sikkim,Crime Against Children,Child Abuse,Male,31-45,457,63,394,178,279
2007,Urban,Jharkhand,Other Crimes,Cyber Crime,Male,60+,1930,1279,651,1375,555
2005,Rural,Chhattisgarh,Property Crime,Theft,Female,31-45,5567,3814,1753,5028,539
2007,Urban,Goa,Crime Against Men,Assault,Male,31-45,9465,230,9235,3516,5949
2003,Rural,Gujarat,Property Crime,Vandalism,Male,18-30,5914,3986,1928,4171,1743
2005,Urban,Himachal Pradesh,Property Crime,Theft,Male,46-60,3115,1040,2075,2942,173
2005,Urban,Madhya Pradesh,Crime Against Children,Trafficking,Male,31-45,6579,265,6314,1969,4610
2007,Urban,Karnataka,Crime Against Women,Dowry Deaths,Male,31-45,8394,1734,6660,7935,459
2009,Rural,Maharashtra,Other Crimes,Corruption,Female,0-12,1928,1798,130,1853,75
2006,Rural,Bihar,Property Crime,Burglary,Male,13-17,5525,1251,4274,4103,1422
2004,Rural,Himachal Pradesh,Crime Against Men,Assault,Female,0-12,6680,6432,248,6480,200
2002,Rural,Jharkhand,Crime Against Women,Dowry Deaths,Male,18-30,6841,6779,62,6819,22
2003,Rural,Sikkim,Crime Against Women,Rape,Female,18-30,5162,3845,1317,3980,1182
2006,Urban,Nagaland,Other Crimes,Fraud,Male,13-17,1258,487,771,732,526
2009,Urban,Arunachal Pradesh,Other Crimes,Drug Offense,Male,46-60,449,16,433,163,286
2003,Rural,Tamil Nadu,Crime Against Women,Domestic Violence,Male,0-12,639,559,80,625,14
2006,Rural,Gujarat,Crime Against Men,Assault,Female,31-45,3040,2982,58,2985,55
2004,Urban,Gujarat,Crime Against Children,Child Labor,Female,18-30,6223,1795,4428,5020,1203
2002,Rural,Madhya Pradesh,Crime Against Men,Extortion,Female,31-45,9889,1782,8107,6714,3175
2007,Urban,Tripura,Crime Against Women,Rape,Female,60+,2303,1945,358,2192,111
2004,Urban,Uttarakhand,Crime Against Children,Child Labor,Female,60+,880,864,16,864,16
2004,Rural,Odisha,Crime Against Children,Child Abuse,Male,18-30,1750,1538,212,1574,176
2009,Rural,Rajasthan,Crime Against Children,Trafficking,Male,13-17,3021,1494,1527,1854,1167
2003,Urban,West Bengal,Other Crimes,Drug Offense,Female,46-60,1042,275,767,653,389
2005,Rural,Arunachal Pradesh,Crime Against Men,Murder,Female,13-17,1885,882,1003,1720,165
2010,Rural,Jammu & Kashmir,Other Crimes,Cyber Crime,Female,13-17,4842,2830,2012,3009,1833
2007,Urban,Arunachal Pradesh,Property Crime,Arson,Male,46-60,6214,4781,1433,5099,1115
2008,Urban,Gujarat,Crime Against Men,Murder,Male,0-12,9383,8834,549,9204,179
2002,Urban,Meghalaya,Crime Against Men,Assault,Female,0-12,7100,3671,3429,6294,806
2008,Urban,Kerala,Crime Against Women,Molestation,Female,31-45,9607,5085,4522,6119,3488
2010,Urban,Tripura,Crime Against Children,Kidnapping,Male,46-60,6255,5602,653,6245,10
2009,Urban,Telangana,Crime Against Men,Robbery,Male,31-45,3009,1370,1639,2947,62
2006,Rural,Telangana,Crime Against Children,Child Abuse,Female,31-45,6555,4575,1980,6266,289
2009,Rural,Uttar Pradesh,Property Crime,Burglary,Female,13-17,5800,2111,3689,2833,2967
2009,Urban,Sikkim,Other Crimes,Corruption,Female,46-60,1026,77,949,758,268
2010,Urban,Telangana,Crime Against Women,Domestic Violence,Female,31-45,9355,2281,7074,4844,4511
2001,Rural,Odisha,Crime Against Men,Robbery,Male,13-17,7128,6227,901,7032,96
2001,Rural,Tripura,Crime Against Women,Rape,Male,13-17,4965,3164,1801,3773,1192
2010,Urban,Telangana,Other Crimes,Corruption,Female,0-12,1182,877,305,956,226
2007,Urban,Uttarakhand,Crime Against Children,Child Abuse,Male,31-45,4408,3210,1198,3918,490
2007,Urban,Arunachal Pradesh,Other Crimes,Fraud,Female,31-45,785,343,442,612,173
2003,Urban,Maharashtra,Other Crimes,Corruption,Female,46-60,706,166,540,380,326
2006,Urban,Uttar Pradesh,Crime Against Women,Dowry Deaths,Male,60+,57,47,10,49,8
2001,Rural,Nagaland,Property Crime,Arson,Male,60+,2596,172,2424,1797,799
2010,Rural,Delhi,Crime Against Men,Robbery,Female,13-17,9115,7674,1441,8067,1048
2003,Urban,Andhra Pradesh,Property Crime,Arson,Female,46-60,7678,178,7500,3958,3720
2002,Rural,Maharashtra,Other Crimes,Cyber Crime,Male,46-60,4523,3612,911,4305,218
2010,Urban,Haryana,Property Crime,Theft,Female,31-45,1492,425,1067,462,1030
2010,Urban,Karnataka,Property Crime,Theft,Male,60+,3746,892,2854,2920,826
2008,Rural,Andhra Pradesh,Crime Against Children,Kidnapping,Female,18-30,9121,6606,2515,7073,2048
2007,Rural,Tamil Nadu,Crime Against Men,Assault,Male,13-17,190,168,22,187,3
2002,Rural,Odisha,Crime Against Men,Assault,Female,0-12,8499,3632,4867,8028,471
2001,Rural,Jammu & Kashmir,Crime Against Men,Assault,Male,0-12,8818,6171,2647,6847,1971
2010,Urban,Goa,Crime Against Children,Child Labor,Male,13-17,910,757,153,886,24
2004,Urban,Andhra Pradesh,Crime Against Women,Rape,Male,13-17,6214,5742,472,6154,60
2004,Rural,Uttar Pradesh,Property Crime,Theft,Male,60+,6732,6185,547,6362,370
2002,Urban,Arunachal Pradesh,Crime Against Men,Murder,Female,0-12,3989,3911,78,3918,71
2009,Urban,Jharkhand,Crime Against Women,Domestic Violence,Female,0-12,305,109,196,278,27
2003,Urban,Arunachal Pradesh,Property Crime,Theft,Female,0-12,7483,5481,2002,7310,173
2002,Rural,Maharashtra,Crime Against Women,Molestation,Male,18-30,6658,4770,1888,6150,508
2010,Urban,Himachal Pradesh,Other Crimes,Cyber Crime,Male,31-45,8962,4778,4184,5641,3321
2005,Rural,Mizoram,Property Crime,Burglary,Male,0-12,1046,849,197,921,125
2002,Urban,Sikkim,Crime Against Women,Dowry Deaths,Male,31-45,5318,579,4739,1875,3443
2004,Urban,Delhi,Property Crime,Theft,Male,60+,5415,4855,560,5380,35
2005,Rural,Telangana,Other Crimes,Cyber Crime,Female,18-30,8015,5677,2338,6183,1832
2005,Urban,Telangana,Crime Against Children,Kidnapping,Female,0-12,5850,2093,3757,2771,3079
2009,Urban,Nagaland,Other Crimes,Fraud,Male,18-30,9777,9388,389,9402,375
2006,Urban,Gujarat,Other Crimes,Corruption,Male,13-17,9826,7670,2156,9144,682
2009,Urban,Manipur,Crime Against Men,Murder,Male,13-17,8513,8092,421,8390,123
2010,Rural,Tamil Nadu,Crime Against Children,Trafficking,Female,60+,9240,8266,974,8270,970
2005,Urban,West Bengal,Property Crime,Burglary,Male,31-45,2569,1344,1225,2104,465
2006,Urban,Tamil Nadu,Crime Against Women,Molestation,Male,31-45,2521,2292,229,2521,0
2001,Rural,Jammu & Kashmir,Crime Against Men,Extortion,Female,13-17,7443,2346,5097,2743,4700
2003,Urban,Meghalaya,Crime Against Men,Robbery,Male,31-45,1072,66,1006,155,917
2009,Rural,Bihar,Property Crime,Theft,Male,13-17,9710,6010,3700,7835,1875
2004,Urban,Jharkhand,Other Crimes,Corruption,Female,18-30,7882,4573,3309,6975,907
2003,Rural,Madhya Pradesh,Crime Against Women,Domestic Violence,Female,60+,2071,794,1277,1121,950
2010,Urban,Maharashtra,Property Crime,Theft,Female,0-12,3491,3068,423,3073,418
2001,Urban,Uttar Pradesh,Crime Against Men,Murder,Female,46-60,2633,1087,1546,2565,68
2003,Rural,Himachal Pradesh,Crime Against Children,Kidnapping,Female,46-60,850,847,3,850,0
2004,Rural,Haryana,Crime Against Men,Robbery,Male,31-45,1801,803,998,1096,705
2004,Rural,Maharashtra,Crime Against Children,Trafficking,Male,0-12,4167,1717,2450,3060,1107
2009,Rural,Tamil Nadu,Crime Against Men,Murder,Male,31-45,7710,2964,4746,5193,2517
2003,Urban,Uttarakhand,Property Crime,Vandalism,Male,46-60,5813,2822,2991,3228,2585
2009,Urban,Sikkim,Crime Against Women,Rape,Male,60+,4894,3693,1201,4507,387
2001,Rural,Telangana,Other Crimes,Drug Offense,Male,18-30,8374,2569,5805,8340,34
2003,Urban,Haryana,Crime Against Children,Child Labor,Female,0-12,3529,532,2997,2283,1246
2009,Urban,Meghalaya,Crime Against Men,Assault,Female,0-12,8570,2515,6055,6351,2219
2003,Rural,Uttar Pradesh,Crime Against Women,Rape,Female,13-17,434,177,257,213,221
2001,Rural,Karnataka,Crime Against Women,Domestic Violence,Female,0-12,1050,927,123,1035,15
2005,Urban,Goa,Crime Against Women,Rape,Female,13-17,1924,141,1783,1721,203
2008,Urban,Odisha,Crime Against Women,Domestic Violence,Female,18-30,4866,4090,776,4649,217
2008,Urban,Uttarakhand,Crime Against Men,Assault,Male,31-45,7280,1483,5797,3424,3856
2005,Rural,Karnataka,Crime Against Women,Dowry Deaths,Female,13-17,4161,3393,768,3783,378
2004,Urban,Delhi,Crime Against Women,Domestic Violence,Male,0-12,9854,9828,26,9842,12
2009,Rural,Arunachal Pradesh,Crime Against Children,Child Labor,Male,13-17,5291,1318,3973,4054,1237
2003,Rural,Uttar Pradesh,Crime Against Men,Robbery,Female,46-60,6501,2023,4478,4696,1805
2001,Rural,Goa,Other Crimes,Corruption,Male,31-45,2211,362,1849,1379,832
2004,Urban,Kerala,Property Crime,Arson,Female,13-17,4521,825,3696,1088,3433
2007,Rural,Madhya Pradesh,Crime Against Children,Child Labor,Female,60+,9587,5315,4272,7435,2152
2009,Urban,Chhattisgarh,Other Crimes,Corruption,Female,46-60,317,222,95,315,2
2002,Rural,Jammu & Kashmir,Other Crimes,Cyber Crime,Male,0-12,2324,531,1793,2201,123
2003,Rural,Bihar,Crime Against Men,Murder,Female,0-12,5008,1588,3420,4820,188
2001,Urban,West Bengal,Crime Against Men,Assault,Female,0-12,1415,144,1271,973,442
2001,Urban,Uttar Pradesh,Crime Against Children,Child Abuse,Male,46-60,8885,7790,1095,8674,211
2006,Rural,Chhattisgarh,Property Crime,Theft,Male,31-45,8720,3272,5448,5622,3098
2004,Rural,Bihar,Other Crimes,Cyber Crime,Female,60+,2718,141,2577,2139,579
2001,Urban,Arunachal Pradesh,Crime Against Children,Child Abuse,Female,18-30,8464,3645,4819,6346,2118
2006,Urban,Sikkim,Crime Against Children,Child Labor,Female,13-17,6485,260,6225,2382,4103
2009,Rural,Sikkim,Crime Against Children,Child Labor,Female,60+,5073,4941,132,4967,106
2005,Rural,Arunachal Pradesh,Property Crime,Theft,Female,60+,2420,185,2235,460,1960
2008,Urban,Punjab,Crime Against Women,Rape,Female,60+,8165,5117,3048,5525,2640
2008,Urban,Odisha,Property Crime,Burglary,Male,13-17,473,365,108,406,67
2009,Rural,Punjab,Crime Against Women,Molestation,Male,13-17,8299,7611,688,8267,32
2004,Rural,Jammu & Kashmir,Other Crimes,Fraud,Female,46-60,508,441,67,505,3
2010,Urban,Andhra Pradesh,Crime Against Women,Rape,Female,31-45,3241,229,3012,897,2344
2001,Urban,Uttar Pradesh,Crime Against Men,Murder,Male,31-45,6823,131,6692,3155,3668
2010,Rural,Mizoram,Other Crimes,Fraud,Female,13-17,8509,3267,5242,4412,4097
2008,Rural,Delhi,Other Crimes,Drug Offense,Male,60+,2480,1954,526,2387,93
2008,Urban,Chhattisgarh,Property Crime,Arson,Male,18-30,5314,4017,1297,4428,886
2007,Rural,Goa,Crime Against Children,Child Abuse,Female,46-60,6751,3296,3455,4590,2161
2001,Rural,Punjab,Other Crimes,Drug Offense,Male,46-60,9107,8357,750,9092,15
2010,Rural,Jharkhand,Property Crime,Burglary,Female,60+,5832,4733,1099,5022,810
2010,Rural,Assam,Crime Against Children,Child Labor,Male,46-60,1173,918,255,931,242
2002,Rural,Chhattisgarh,Property Crime,Vandalism,Male,46-60,4093,2160,1933,2708,1385
2001,Urban,Jammu & Kashmir,Other Crimes,Cyber Crime,Female,60+,1429,1175,254,1381,48
2008,Urban,Tamil Nadu,Crime Against Men,Murder,Male,60+,2510,734,1776,1843,667
2005,Rural,Gujarat,Crime Against Children,Child Abuse,Male,13-17,6109,3694,2415,4434,1675
2010,Rural,Karnataka,Crime Against Children,Child Labor,Female,46-60,5816,1991,3825,2530,3286
2004,Urban,Tamil Nadu,Crime Against Children,Kidnapping,Male,31-45,7775,2701,5074,2966,4809
2009,Rural,Assam,Property Crime,Burglary,Female,60+,3367,1416,1951,3235,132
2003,Rural,Himachal Pradesh,Crime Against Children,Child Labor,Female,31-45,6819,3801,3018,5544,1275
2009,Urban,Tripura,Property Crime,Burglary,Female,46-60,3774,2557,1217,2581,1193
2009,Urban,West Bengal,Crime Against Children,Kidnapping,Female,60+,9790,6758,3032,8844,946
2010,Rural,Telangana,Crime Against Children,Kidnapping,Female,60+,3368,2393,975,3332,36
2005,Urban,Delhi,Crime Against Women,Molestation,Male,18-30,3216,1070,2146,2795,421
2010,Urban,Tripura,Crime Against Men,Robbery,Male,0-12,3276,3183,93,3228,48
2008,Urban,Odisha,Crime Against Men,Assault,Male,31-45,2617,1502,1115,1557,1060
2002,Urban,West Bengal,Crime Against Children,Child Abuse,Male,60+,4364,1873,2491,4249,115
2005,Rural,Haryana,Crime Against Men,Assault,Female,13-17,5490,3988,1502,4554,936
2005,Urban,Nagaland,Crime Against Children,Trafficking,Male,0-12,2040,179,1861,272,1768
2003,Urban,Mizoram,Other Crimes,Drug Offense,Male,31-45,2891,1620,1271,1930,961
2007,Rural,Assam,Crime Against Men,Robbery,Female,13-17,8323,7339,984,7395,928
2005,Urban,Bihar,Crime Against Women,Dowry Deaths,Female,60+,6270,518,5752,4573,1697
2005,Urban,Punjab,Crime Against Men,Extortion,Female,18-30,6750,5792,958,6723,27
2007,Urban,Uttarakhand,Crime Against Women,Molestation,Male,18-30,9736,6637,3099,7191,2545
2009,Rural,Delhi,Crime Against Women,Dowry Deaths,Female,46-60,6881,5230,1651,6527,354
2007,Rural,Sikkim,Crime Against Men,Extortion,Male,0-12,7164,1122,6042,6113,1051
2002,Rural,Jharkhand,Crime Against Children,Child Abuse,Male,13-17,1293,455,838,1137,156
2007,Urban,Telangana,Property Crime,Theft,Male,18-30,3385,1872,1513,2616,769
2003,Rural,Uttar Pradesh,Other Crimes,Fraud,Female,31-45,7253,4127,3126,7057,196
2002,Urban,Manipur,Other Crimes,Cyber Crime,Female,31-45,1420,1222,198,1310,110
2001,Urban,Rajasthan,Crime Against Children,Trafficking,Female,46-60,7766,7136,630,7154,612
2008,Rural,Uttarakhand,Crime Against Men,Extortion,Male,46-60,3112,2681,431,3112,0
2003,Urban,Manipur,Crime Against Women,Rape,Female,60+,8569,8025,544,8488,81
2002,Rural,Jharkhand,Crime Against Women,Dowry Deaths,Male,60+,4774,541,4233,1914,2860
2008,Urban,Himachal Pradesh,Crime Against Children,Trafficking,Female,13-17,7090,3074,4016,6206,884
2004,Rural,Delhi,Crime Against Women,Rape,Male,13-17,4571,1327,3244,3729,842
2005,Rural,Assam,Crime Against Men,Extortion,Male,0-12,3837,2690,1147,2975,862
2008,Urban,Jammu & Kashmir,Crime Against Men,Murder,Male,0-12,7539,7136,403,7279,260
2001,Rural,Jharkhand,Crime Against Women,Domestic Violence,Female,18-30,7153,4650,2503,7051,102
2004,Rural,Manipur,Crime Against Women,Molestation,Female,0-12,6052,5127,925,5337,715
2007,Urban,Goa,Crime Against Children,Kidnapping,Female,18-30,2469,794,1675,1472,997
2010,Rural,Goa,Other Crimes,Drug Offense,Male,46-60,1622,806,816,1003,619
2002,Urban,Manipur,Crime Against Children,Child Labor,Male,46-60,2229,1727,502,1942,287
2002,Rural,Uttarakhand,Crime Against Men,Robbery,Female,13-17,6388,924,5464,1660,4728
2007,Rural,Maharashtra,Property Crime,Theft,Male,13-17,4184,3325,859,3772,412
2002,Urban,Bihar,Property Crime,Theft,Female,0-12,1340,926,414,972,368
2001,Urban,Uttarakhand,Crime Against Men,Assault,Male,18-30,6024,2915,3109,5138,886
2001,Urban,Haryana,Crime Against Children,Trafficking,Male,31-45,1425,297,1128,686,739
2006,Urban,Uttar Pradesh,Property Crime,Vandalism,Male,60+,6320,1958,4362,2648,3672
2002,Urban,Mizoram,Property Crime,Burglary,Female,46-60,6239,3529,2710,4117,2122
2002,Urban,Gujarat,Other Crimes,Fraud,Male,31-45,4383,3307,1076,3979,404
2001,Urban,Kerala,Crime Against Men,Extortion,Female,0-12,2012,1032,980,1291,721
2010,Urban,Chhattisgarh,Crime Against Children,Child Labor,Female,13-17,4312,2827,1485,3068,1244
2009,Urban,Madhya Pradesh,Property Crime,Burglary,Male,46-60,9519,5243,4276,8212,1307
2010,Rural,Goa,Crime Against Men,Robbery,Female,60+,9368,5663,3705,6146,3222
2005,Rural,Kerala,Crime Against Children,Child Abuse,Female,13-17,5875,631,5244,3407,2468
2002,Rural,Nagaland,Crime Against Children,Trafficking,Female,46-60,6822,6081,741,6095,727
2006,Rural,Gujarat,Other Crimes,Cyber Crime,Male,13-17,4955,3103,1852,3653,1302
2003,Rural,Tamil Nadu,Other Crimes,Fraud,Male,46-60,2279,1471,808,1559,720
2003,Urban,Mizoram,Crime Against Women,Dowry Deaths,Male,60+,8484,8177,307,8331,153
2005,Rural,Bihar,Crime Against Children,Trafficking,Male,18-30,9619,2341,7278,6145,3474
2004,Rural,Nagaland,Other Crimes,Corruption,Male,0-12,877,249,628,804,73
2002,Urban,Gujarat,Crime Against Children,Trafficking,Female,18-30,4303,3541,762,3868,435
2008,Urban,Maharashtra,Crime Against Women,Molestation,Male,18-30,5099,2465,2634,3348,1751
2005,Rural,Odisha,Crime Against Men,Extortion,Male,46-60,5996,198,5798,4789,1207
2004,Rural,Gujarat,Crime Against Women,Molestation,Male,60+,6453,4575,1878,5777,676
2009,Urban,Kerala,Crime Against Men,Extortion,Male,31-45,1452,385,1067,1228,224
2007,Urban,Karnataka,Other Crimes,Fraud,Male,18-30,6173,5864,309,5926,247
2006,Rural,Uttarakhand,Crime Against Women,Dowry Deaths,Female,18-30,6796,2734,4062,5698,1098
2008,Urban,Punjab,Crime Against Men,Assault,Female,31-45,4639,2921,1718,3304,1335
2005,Rural,Maharashtra,Other Crimes,Cyber Crime,Female,18-30,1492,634,858,1372,120
2006,Rural,Maharashtra,Crime Against Women,Domestic Violence,Female,60+,5290,717,4573,3731,1559
2008,Rural,Assam,Other Crimes,Drug Offense,Male,13-17,7112,5797,1315,6234,878
2001,Rural,Manipur,Crime Against Women,Rape,Male,31-45,6493,414,6079,3435,3058
2006,Urban,Bihar,Crime Against Women,Domestic Violence,Male,46-60,3224,3137,87,3141,83
2008,Urban,Andhra Pradesh,Crime Against Children,Child Abuse,Male,13-17,2493,797,1696,805,1688
2010,Urban,Nagaland,Crime Against Men,Robbery,Female,46-60,7520,4834,2686,6821,699
2010,Rural,Andhra Pradesh,Crime Against Women,Domestic Violence,Male,0-12,2374,1107,1267,1746,628
2005,Urban,Madhya Pradesh,Crime Against Men,Assault,Female,13-17,2074,1584,490,1629,445
2001,Urban,Himachal Pradesh,Property Crime,Vandalism,Female,60+,2776,1201,1575,1924,852
2004,Urban,Punjab,Property Crime,Vandalism,Male,46-60,9980,7425,2555,9917,63
2005,Urban,Meghalaya,Crime Against Women,Dowry Deaths,Male,18-30,6236,4415,1821,4969,1267
2009,Urban,Rajasthan,Crime Against Women,Domestic Violence,Male,18-30,2628,868,1760,2373,255
2001,Urban,Mizoram,Other Crimes,Drug Offense,Male,0-12,5077,1565,3512,3052,2025
2007,Urban,Manipur,Crime Against Women,Molestation,Female,46-60,4067,3646,421,3822,245
2009,Rural,Meghalaya,Other Crimes,Drug Offense,Male,18-30,7881,1452,6429,1975,5906
2005,Rural,Nagaland,Property Crime,Theft,Female,31-45,7559,2355,5204,7437,122
2010,Rural,Manipur,Crime Against Women,Rape,Male,46-60,2650,834,1816,2243,407
2003,Rural,Assam,Crime Against Children,Child Labor,Male,46-60,7111,5482,1629,6085,1026
2009,Rural,West Bengal,Crime Against Men,Robbery,Male,18-30,5345,367,4978,3754,1591
2005,Rural,Tamil Nadu,Property Crime,Burglary,Female,60+,7985,587,7398,1835,6150
2004,Urban,Karnataka,Crime Against Men,Robbery,Female,0-12,5081,910,4171,2382,2699
2001,Rural,Arunachal Pradesh,Crime Against Children,Kidnapping,Female,60+,3682,1380,2302,3567,115
2005,Urban,Chhattisgarh,Property Crime,Vandalism,Female,0-12,7095,4442,2653,6331,764
2003,Urban,Kerala,Property Crime,Burglary,Male,0-12,5166,4870,296,5042,124
2002,Urban,Telangana,Property Crime,Vandalism,Female,18-30,6892,6310,582,6604,288
2004,Rural,Jammu & Kashmir,Property Crime,Arson,Female,46-60,1671,1526,145,1635,36
2006,Rural,Jharkhand,Crime Against Children,Child Abuse,Male,46-60,155,17,138,120,35
2008,Urban,Telangana,Property Crime,Arson,Male,18-30,2113,163,1950,651,1462
2002,Rural,Tamil Nadu,Crime Against Children,Child Labor,Male,46-60,4139,2522,1617,4111,28
2005,Rural,Uttar Pradesh,Property Crime,Burglary,Female,13-17,1901,1113,788,1697,204
2005,Rural,Jammu & Kashmir,Crime Against Men,Extortion,Female,31-45,5675,1451,4224,3468,2207
2006,Rural,Goa,Other Crimes,Corruption,Male,0-12,6127,5197,930,5997,130
2003,Urban,Nagaland,Crime Against Children,Kidnapping,Female,18-30,515,466,49,510,5
2007,Urban,Kerala,Crime Against Men,Robbery,Female,18-30,3217,1299,1918,3055,162
2010,Rural,Haryana,Crime Against Women,Molestation,Female,0-12,5169,4176,993,4334,835
2002,Rural,Tripura,Property Crime,Vandalism,Female,46-60,5622,5620,2,5621,1
2008,Rural,Uttar Pradesh,Crime Against Children,Child Labor,Female,18-30,8849,4792,4057,5172,3677
2008,Rural,Tripura,Crime Against Women,Domestic Violence,Male,46-60,62,35,27,52,10
2006,Rural,Tripura,Crime Against Women,Dowry Deaths,Male,0-12,3291,2915,376,3179,112
2002,Urban,Himachal Pradesh,Property Crime,Vandalism,Female,0-12,8592,6399,2193,6818,1774
2008,Urban,Madhya Pradesh,Crime Against Women,Rape,Female,0-12,689,433,256,578,111
2009,Rural,Assam,Crime Against Children,Child Labor,Female,31-45,9687,9200,487,9407,280
2003,Rural,Karnataka,Crime Against Men,Extortion,Female,18-30,5534,4872,662,5299,235
2003,Rural,Haryana,Other Crimes,Corruption,Male,46-60,426,167,259,399,27
2006,Urban,Jharkhand,Property Crime,Burglary,Female,60+,2167,1825,342,2160,7
2009,Urban,Maharashtra,Other Crimes,Fraud,Male,31-45,3640,830,2810,2526,1114
2004,Urban,Odisha,Crime Against Children,Trafficking,Male,31-45,4446,3228,1218,4146,300
2002,Rural,Telangana,Property Crime,Theft,Female,13-17,8002,2448,5554,4194,3808
2009,Urban,Tamil Nadu,Property Crime,Vandalism,Male,18-30,8502,3429,5073,7192,1310
2008,Urban,West Bengal,Crime Against Children,Trafficking,Male,31-45,6364,2116,4248,6058,306
2009,Urban,Chhattisgarh,Crime Against Men,Murder,Male,46-60,633,187,446,209,424
2006,Rural,Jharkhand,Crime Against Men,Murder,Female,60+,6440,850,5590,5730,710
2010,Urban,Karnataka,Property Crime,Arson,Female,46-60,6022,4927,1095,5006,1016
2004,Rural,Madhya Pradesh,Crime Against Men,Murder,Male,46-60,6037,3979,2058,5980,57
2009,Urban,Tripura,Crime Against Men,Assault,Female,0-12,8968,2508,6460,8685,283
2007,Urban,Nagaland,Crime Against Men,Murder,Female,46-60,2646,1975,671,2170,476
2003,Rural,Tripura,Crime Against Women,Rape,Female,0-12,9139,8517,622,8818,321
2006,Urban,Uttar Pradesh,Property Crime,Arson,Male,46-60,3396,2480,916,3063,333
2003,Urban,Punjab,Property Crime,Theft,Male,13-17,1466,1402,64,1403,63
2007,Rural,Tripura,Crime Against Children,Child Labor,Female,46-60,3961,2946,1015,3824,137
2009,Urban,Uttarakhand,Crime Against Women,Molestation,Male,13-17,2996,805,2191,2644,352
2008,Urban,Sikkim,Property Crime,Vandalism,Female,0-12,2128,388,1740,618,1510
2008,Urban,Kerala,Crime Against Children,Child Abuse,Male,60+,6815,6627,188,6705,110
2003,Urban,Tamil Nadu,Property Crime,Theft,Male,60+,1276,638,638,1082,194
2005,Urban,Odisha,Other Crimes,Fraud,Female,0-12,7314,3392,3922,4193,3121
2008,Rural,Rajasthan,Property Crime,Arson,Male,60+,2001,1320,681,1748,253
2009,Urban,Manipur,Crime Against Women,Rape,Male,0-12,3102,1594,1508,2025,1077
2007,Urban,Karnataka,Crime Against Children,Child Abuse,Female,31-45,9187,5628,3559,6561,2626
2008,Rural,Tamil Nadu,Other Crimes,Cyber Crime,Male,0-12,8718,5069,3649,7651,1067
2006,Urban,Delhi,Crime Against Men,Murder,Female,60+,9864,1667,8197,6107,3757
2009,Urban,Gujarat,Crime Against Men,Robbery,Female,60+,8271,320,7951,5377,2894
2006,Urban,Sikkim,Crime Against Children,Child Abuse,Female,31-45,9216,715,8501,7815,1401
2001,Urban,Rajasthan,Crime Against Children,Trafficking,Female,0-12,4178,2909,1269,3786,392
2006,Rural,Jammu & Kashmir,Other Crimes,Corruption,Male,60+,1487,186,1301,885,602
2005,Urban,Meghalaya,Property Crime,Theft,Female,13-17,9658,1646,8012,7843,1815
2006,Urban,Maharashtra,Other Crimes,Cyber Crime,Female,18-30,2157,771,1386,1645,512
2007,Urban,Goa,Crime Against Children,Child Abuse,Female,0-12,6060,2107,3953,5518,542
2003,Urban,Sikkim,Crime Against Children,Kidnapping,Male,60+,4135,1548,2587,2718,1417
2006,Urban,Punjab,Property Crime,Arson,Female,13-17,2812,2318,494,2530,282
2002,Urban,Himachal Pradesh,Property Crime,Theft,Male,46-60,8675,5554,3121,8551,124
2002,Urban,Jammu & Kashmir,Other Crimes,Fraud,Male,46-60,1663,803,860,1568,95
2009,Urban,Odisha,Property Crime,Arson,Male,13-17,5557,341,5216,720,4837
2001,Rural,Andhra Pradesh,Property Crime,Burglary,Male,60+,1642,74,1568,1115,527
2003,Rural,Gujarat,Crime Against Men,Assault,Male,46-60,4584,1662,2922,2634,1950
2010,Rural,Manipur,Crime Against Men,Murder,Female,31-45,9134,3347,5787,5125,4009
2002,Urban,Madhya Pradesh,Crime Against Men,Robbery,Female,13-17,9283,5034,4249,8246,1037
2003,Rural,Maharashtra,Crime Against Men,Extortion,Male,0-12,1770,1753,17,1768,2
2005,Rural,Tamil Nadu,Other Crimes,Cyber Crime,Female,31-45,8217,4597,3620,6246,1971
2007,Urban,Punjab,Crime Against Men,Assault,Male,0-12,6115,687,5428,3986,2129
2008,Urban,Manipur,Other Crimes,Cyber Crime,Male,31-45,189,79,110,113,76
2003,Rural,Arunachal Pradesh,Property Crime,Theft,Male,60+,9249,4790,4459,8643,606
2006,Rural,Rajasthan,Crime Against Children,Trafficking,Male,31-45,6063,368,5695,4897,1166
2001,Urban,West Bengal,Crime Against Men,Murder,Female,31-45,2725,1061,1664,1802,923
2005,Rural,Tamil Nadu,Property Crime,Vandalism,Male,0-12,5071,1149,3922,1546,3525
2004,Urban,Nagaland,Crime Against Children,Trafficking,Female,0-12,7340,4117,3223,4431,2909
2002,Urban,Mizoram,Crime Against Women,Domestic Violence,Female,31-45,2162,2069,93,2075,87
2006,Rural,Telangana,Crime Against Children,Kidnapping,Male,60+,6633,2772,3861,6317,316
2001,Rural,Sikkim,Other Crimes,Cyber Crime,Female,46-60,515,136,379,395,120
2006,Urban,Chhattisgarh,Crime Against Children,Trafficking,Male,18-30,9153,6424,2729,9009,144
2001,Urban,West Bengal,Crime Against Women,Rape,Female,46-60,6280,3750,2530,5960,320
2006,Urban,Arunachal Pradesh,Crime Against Women,Molestation,Male,31-45,4718,3060,1658,3201,1517
2009,Rural,Arunachal Pradesh,Property Crime,Theft,Female,31-45,1687,1024,663,1558,129
2006,Urban,Tamil Nadu,Property Crime,Arson,Male,31-45,5190,3911,1279,5177,13
2001,Urban,Odisha,Crime Against Children,Kidnapping,Female,60+,9686,4608,5078,8077,1609
2004,Urban,Karnataka,Other Crimes,Cyber Crime,Female,0-12,7965,3233,4732,3542,4423
2008,Rural,Bihar,Crime Against Men,Robbery,Male,60+,7472,768,6704,4645,2827
2007,Urban,Gujarat,Crime Against Children,Kidnapping,Female,18-30,1697,1668,29,1692,5
2001,Urban,Nagaland,Crime Against Children,Kidnapping,Male,13-17,5818,4500,1318,5544,274
2003,Urban,Assam,Property Crime,Arson,Male,13-17,6412,374,6038,1079,5333
2009,Rural,Jammu & Kashmir,Crime Against Men,Murder,Male,31-45,5199,2649,2550,2970,2229
2004,Urban,Odisha,Crime Against Men,Assault,Male,13-17,5235,1325,3910,2671,2564
2002,Urban,Uttarakhand,Other Crimes,Corruption,Female,46-60,4247,1883,2364,2625,1622
2003,Rural,Madhya Pradesh,Crime Against Men,Robbery,Male,46-60,4748,1546,3202,3600,1148
2004,Rural,Jharkhand,Crime Against Men,Extortion,Female,31-45,1836,746,1090,1638,198
2008,Rural,Tamil Nadu,Other Crimes,Fraud,Male,31-45,6727,4148,2579,6200,527
2009,Rural,Himachal Pradesh,Crime Against Children,Kidnapping,Female,18-30,4873,2723,2150,4825,48
2004,Urban,Maharashtra,Crime Against Men,Extortion,Male,0-12,8166,6870,1296,7652,514
2009,Urban,Tamil Nadu,Property Crime,Theft,Female,0-12,4406,1586,2820,1906,2500
2007,Urban,Jharkhand,Crime Against Men,Assault,Male,18-30,1888,1650,238,1759,129
2009,Rural,West Bengal,Crime Against Women,Molestation,Male,60+,9035,3321,5714,5364,3671
2010,Urban,Uttar Pradesh,Crime Against Women,Rape,Male,60+,9146,9115,31,9125,21
2004,Urban,Nagaland,Other Crimes,Fraud,Female,0-12,4269,1662,2607,4245,24
2004,Urban,Himachal Pradesh,Crime Against Men,Robbery,Male,46-60,3104,153,2951,2867,237
2001,Urban,Odisha,Crime Against Children,Kidnapping,Male,46-60,2985,1098,1887,1524,1461
2007,Urban,Karnataka,Other Crimes,Corruption,Female,60+,9897,24,9873,1765,8132
2001,Urban,Kerala,Crime Against Children,Child Abuse,Male,13-17,3948,3342,606,3700,248
2001,Rural,Arunachal Pradesh,Crime Against Women,Molestation,Male,0-12,1704,1612,92,1682,22
2004,Urban,Uttar Pradesh,Other Crimes,Corruption,Male,18-30,8795,493,8302,3164,5631
2009,Rural,Tripura,Crime Against Children,Kidnapping,Male,46-60,4911,3061,1850,4165,746
2005,Urban,Rajasthan,Crime Against Women,Dowry Deaths,Male,60+,9736,4750,4986,5948,3788
2010,Urban,West Bengal,Property Crime,Burglary,Male,13-17,2791,204,2587,2643,148
2002,Urban,Himachal Pradesh,Crime Against Women,Dowry Deaths,Male,0-12,3572,2724,848,2891,681
2003,Rural,Madhya Pradesh,Crime Against Men,Murder,Female,0-12,5550,3771,1779,5321,229
2009,Rural,Uttar Pradesh,Crime Against Women,Domestic Violence,Female,31-45,9529,5850,3679,7988,1541
2008,Urban,Punjab,Crime Against Women,Molestation,Male,0-12,4597,3079,1518,4209,388
2003,Urban,Nagaland,Crime Against Women,Dowry Deaths,Female,0-12,9699,2630,7069,7988,1711
2010,Rural,Meghalaya,Crime Against Men,Assault,Male,18-30,9318,7749,1569,9104,214
2009,Urban,Nagaland,Other Crimes,Fraud,Male,46-60,6951,4982,1969,5281,1670
2009,Urban,Punjab,Crime Against Men,Murder,Female,0-12,9230,8745,485,9038,192
2006,Rural,Telangana,Crime Against Women,Domestic Violence,Male,46-60,5448,302,5146,607,4841
2006,Urban,Rajasthan,Crime Against Children,Child Labor,Female,0-12,7793,4971,2822,7151,642
2008,Rural,Jharkhand,Property Crime,Burglary,Male,60+,2444,112,2332,2013,431
2009,Rural,Gujarat,Crime Against Children,Child Labor,Female,0-12,6988,4232,2756,6762,226
2001,Urban,Kerala,Crime Against Men,Murder,Female,31-45,9981,844,9137,3836,6145
2010,Rural,Jammu & Kashmir,Crime Against Women,Rape,Female,31-45,4097,1965,2132,2416,1681
2009,Urban,Kerala,Crime Against Women,Rape,Male,46-60,399,398,1,399,0
2006,Rural,Chhattisgarh,Property Crime,Vandalism,Male,13-17,7674,519,7155,2053,5621
2009,Rural,Kerala,Other Crimes,Cyber Crime,Female,18-30,9864,8647,1217,9496,368
2004,Rural,Madhya Pradesh,Crime Against Men,Extortion,Female,13-17,2453,966,1487,1733,720
2006,Urban,Telangana,Property Crime,Burglary,Male,31-45,789,121,668,775,14
2010,Rural,Tamil Nadu,Other Crimes,Cyber Crime,Female,60+,2095,469,1626,1585,510
2004,Rural,Sikkim,Crime Against Children,Trafficking,Female,0-12,6441,3508,2933,5797,644
2009,Urban,Arunachal Pradesh,Crime Against Men,Robbery,Female,31-45,3496,395,3101,3295,201
2005,Urban,Odisha,Property Crime,Arson,Female,18-30,580,551,29,563,17
2008,Urban,Odisha,Crime Against Men,Murder,Female,18-30,632,575,57,579,53
2004,Rural,Meghalaya,Crime Against Men,Extortion,Female,60+,75,6,69,11,64
2010,Urban,Mizoram,Crime Against Women,Molestation,Male,60+,4982,4918,64,4919,63
2001,Urban,Uttar Pradesh,Crime Against Women,Molestation,Female,0-12,5464,2386,3078,3182,2282
2004,Rural,Mizoram,Property Crime,Arson,Male,31-45,837,524,313,802,35
2005,Urban,Mizoram,Property Crime,Vandalism,Male,13-17,6487,4268,2219,5159,1328
2008,Urban,Assam,Crime Against Children,Child Abuse,Male,0-12,1939,1164,775,1438,501
2006,Rural,Rajasthan,Crime Against Women,Rape,Female,31-45,2834,1403,1431,2217,617
2009,Rural,Manipur,Crime Against Children,Child Abuse,Female,60+,8857,5239,3618,5575,3282
2005,Urban,Madhya Pradesh,Other Crimes,Drug Offense,Male,13-17,1262,576,686,956,306
2004,Urban,Mizoram,Other Crimes,Drug Offense,Male,0-12,1836,333,1503,394,1442
2007,Urban,Tripura,Property Crime,Vandalism,Male,60+,6182,1963,4219,5827,355
2009,Urban,Nagaland,Crime Against Men,Assault,Female,31-45,9653,1528,8125,5143,4510
2001,Rural,Jammu & Kashmir,Crime Against Men,Murder,Male,18-30,776,305,471,578,198
2006,Urban,Tripura,Other Crimes,Fraud,Male,60+,4318,452,3866,3875,443
2007,Urban,Jammu & Kashmir,Crime Against Women,Dowry Deaths,Male,18-30,7124,4382,2742,6647,477
2001,Urban,West Bengal,Crime Against Men,Murder,Male,13-17,9146,4073,5073,5437,3709
2010,Rural,Mizoram,Property Crime,Theft,Male,0-12,2310,1946,364,2194,116
2004,Urban,Himachal Pradesh,Crime Against Children,Child Labor,Male,60+,4608,3765,843,4166,442
2006,Rural,Odisha,Property Crime,Vandalism,Female,46-60,9221,7274,1947,7441,1780
2007,Rural,West Bengal,Crime Against Women,Domestic Violence,Male,31-45,3502,1877,1625,2784,718
2010,Urban,Tripura,Crime Against Women,Domestic Violence,Female,60+,3216,1989,1227,3043,173
2007,Rural,Nagaland,Crime Against Men,Robbery,Male,31-45,7186,3212,3974,4396,2790
2004,Rural,Delhi,Crime Against Women,Domestic Violence,Female,0-12,6111,319,5792,978,5133
2002,Rural,Telangana,Crime Against Men,Robbery,Male,13-17,3285,1078,2207,1622,1663
2009,Rural,Gujarat,Crime Against Men,Murder,Male,46-60,592,6,586,180,412
2002,Urban,Odisha,Crime Against Men,Murder,Male,18-30,3724,16,3708,2409,1315
2003,Urban,Rajasthan,Other Crimes,Drug Offense,Male,60+,844,193,651,617,227
2010,Urban,Andhra Pradesh,Crime Against Men,Extortion,Female,31-45,7545,4298,3247,4409,3136
2008,Urban,Arunachal Pradesh,Other Crimes,Cyber Crime,Female,13-17,8615,5121,3494,5388,3227
2009,Rural,Mizoram,Other Crimes,Cyber Crime,Male,0-12,6981,956,6025,2833,4148
2004,Rural,Delhi,Other Crimes,Cyber Crime,Female,60+,8505,7211,1294,8368,137
2002,Rural,Jharkhand,Crime Against Women,Molestation,Female,31-45,9554,8687,867,9306,248
2002,Rural,Meghalaya,Crime Against Women,Rape,Male,0-12,6458,731,5727,5135,1323
2001,Rural,Karnataka,Property Crime,Burglary,Female,13-17,4780,1475,3305,4270,510
2008,Rural,Bihar,Property Crime,Vandalism,Male,46-60,9954,5058,4896,7432,2522
2002,Urban,Arunachal Pradesh,Crime Against Children,Child Labor,Male,13-17,5372,3586,1786,3808,1564
2005,Urban,Jammu & Kashmir,Crime Against Men,Robbery,Female,0-12,9432,2263,7169,4786,4646
2006,Urban,Himachal Pradesh,Crime Against Women,Molestation,Female,60+,3149,834,2315,2555,594
2004,Urban,Maharashtra,Property Crime,Burglary,Male,18-30,5933,4596,1337,5148,785
2009,Urban,Punjab,Property Crime,Arson,Female,60+,8723,355,8368,4558,4165
2004,Rural,Rajasthan,Property Crime,Arson,Female,60+,7335,1881,5454,3744,3591
2005,Rural,Karnataka,Crime Against Men,Assault,Male,18-30,4235,673,3562,2045,2190
2009,Rural,Mizoram,Property Crime,Burglary,Female,60+,6118,5864,254,5944,174
2009,Rural,Mizoram,Other Crimes,Cyber Crime,Male,46-60,356,80,276,313,43
2004,Rural,Mizoram,Crime Against Children,Kidnapping,Female,60+,7048,2132,4916,6045,1003
2001,Rural,Goa,Crime Against Women,Molestation,Male,13-17,3594,1551,2043,3020,574
2010,Urban,Rajasthan,Crime Against Children,Child Abuse,Female,60+,2528,1858,670,2050,478
2008,Rural,Himachal Pradesh,Property Crime,Burglary,Female,13-17,2285,452,1833,583,1702
2002,Urban,Haryana,Crime Against Men,Assault,Female,60+,3842,2674,1168,3440,402
2010,Rural,Goa,Crime Against Men,Assault,Female,18-30,7821,4460,3361,7371,450
2002,Urban,Haryana,Crime Against Men,Murder,Male,13-17,7905,3886,4019,4236,3669
2004,Urban,Uttar Pradesh,Crime Against Women,Domestic Violence,Male,13-17,4344,633,3711,2969,1375
2008,Rural,Jammu & Kashmir,Crime Against Children,Child Labor,Male,60+,3329,2512,817,3000,329
2010,Urban,Manipur,Property Crime,Vandalism,Female,31-45,2506,1404,1102,2119,387
2005,Urban,Odisha,Crime Against Men,Extortion,Female,18-30,7944,6798,1146,7250,694
2001,Rural,Tamil Nadu,Crime Against Men,Robbery,Female,0-12,4887,781,4106,2674,2213
2006,Urban,Meghalaya,Property Crime,Theft,Female,31-45,5289,90,5199,3369,1920
2008,Urban,Uttar Pradesh,Crime Against Men,Robbery,Male,60+,7857,4606,3251,7210,647
2001,Urban,Andhra Pradesh,Crime Against Children,Child Labor,Male,60+,3816,3742,74,3781,35
2010,Rural,Uttarakhand,Crime Against Men,Robbery,Female,0-12,3074,725,2349,955,2119
2008,Urban,West Bengal,Crime Against Women,Domestic Violence,Female,13-17,6359,1133,5226,4277,2082
2010,Rural,Tripura,Crime Against Men,Extortion,Male,18-30,6423,565,5858,5077,1346
2009,Urban,Sikkim,Other Crimes,Fraud,Male,31-45,8075,1922,6153,2180,5895
2007,Rural,Odisha,Other Crimes,Cyber Crime,Male,13-17,6005,1665,4340,5297,708
2005,Urban,Nagaland,Crime Against Women,Molestation,Male,18-30,2225,842,1383,1718,507
2004,Rural,Sikkim,Crime Against Children,Child Labor,Female,13-17,5132,1030,4102,3347,1785
2001,Rural,Himachal Pradesh,Crime Against Men,Assault,Female,46-60,7078,5610,1468,7008,70
2010,Rural,Gujarat,Crime Against Men,Murder,Male,13-17,1152,373,779,703,449
2010,Rural,Goa,Crime Against Children,Kidnapping,Female,18-30,8448,3449,4999,6145,2303
2001,Urban,Odisha,Crime Against Men,Extortion,Male,18-30,7045,1703,5342,4830,2215
2009,Urban,Assam,Crime Against Children,Child Labor,Male,31-45,4817,2119,2698,2228,2589
2006,Urban,Meghalaya,Property Crime,Burglary,Female,0-12,2292,1853,439,1890,402
2010,Rural,Jammu & Kashmir,Crime Against Children,Kidnapping,Male,18-30,6592,5886,706,6031,561
2002,Urban,Maharashtra,Other Crimes,Cyber Crime,Male,60+,5349,4891,458,4988,361
2001,Rural,Punjab,Crime Against Women,Domestic Violence,Male,46-60,9651,1674,7977,3409,6242
2009,Urban,Bihar,Crime Against Women,Rape,Female,0-12,2248,732,1516,1384,864
2008,Urban,Meghalaya,Crime Against Men,Robbery,Male,31-45,6892,2522,4370,6659,233
2009,Rural,Nagaland,Crime Against Children,Child Abuse,Male,0-12,1711,572,1139,740,971
2002,Rural,Tamil Nadu,Property Crime,Burglary,Male,13-17,393,360,33,360,33
2009,Rural,Sikkim,Property Crime,Arson,Male,60+,3856,1909,1947,2834,1022
2003,Rural,Uttar Pradesh,Crime Against Women,Molestation,Female,46-60,7292,1651,5641,6888,404
2006,Urban,Goa,Crime Against Men,Assault,Male,0-12,5035,3047,1988,3954,1081
2001,Rural,Haryana,Property Crime,Arson,Male,46-60,1002,834,168,849,153
2010,Rural,Tripura,Crime Against Men,Murder,Male,46-60,1590,1095,495,1111,479
2004,Rural,Manipur,Property Crime,Burglary,Male,0-12,7732,810,6922,2319,5413
2005,Urban,Uttarakhand,Property Crime,Arson,Female,13-17,8922,2156,6766,2847,6075
2008,Rural,Mizoram,Crime Against Children,Child Abuse,Female,13-17,7284,584,6700,4548,2736
2002,Urban,Kerala,Property Crime,Arson,Female,46-60,4139,3484,655,3648,491
2004,Urban,Maharashtra,Other Crimes,Drug Offense,Male,18-30,752,722,30,750,2
2009,Rural,Himachal Pradesh,Crime Against Women,Molestation,Female,60+,5170,2310,2860,4276,894
2003,Urban,Tripura,Crime Against Children,Trafficking,Female,60+,5857,3088,2769,3874,1983
2006,Urban,Goa,Crime Against Women,Domestic Violence,Female,31-45,9099,8589,510,8689,410
2001,Urban,Kerala,Property Crime,Arson,Male,46-60,3819,3228,591,3262,557
2001,Urban,Arunachal Pradesh,Other Crimes,Fraud,Male,13-17,4808,614,4194,1335,3473
2008,Rural,Haryana,Crime Against Children,Child Labor,Male,13-17,5977,5902,75,5958,19
2010,Rural,Punjab,Crime Against Children,Trafficking,Female,46-60,782,577,205,589,193
2006,Urban,Bihar,Other Crimes,Corruption,Female,0-12,2199,461,1738,806,1393
2010,Urban,Odisha,Property Crime,Vandalism,Male,31-45,7895,4303,3592,7581,314
2004,Urban,Jharkhand,Crime Against Men,Assault,Female,18-30,1083,437,646,598,485
2002,Rural,Gujarat,Other Crimes,Fraud,Male,0-12,7841,2746,5095,6872,969
2002,Urban,Andhra Pradesh,Other Crimes,Fraud,Female,13-17,9807,6614,3193,6812,2995
2006,Urban,Goa,Other Crimes,Corruption,Male,13-17,3433,110,3323,2067,1366
2007,Urban,Delhi,Other Crimes,Cyber Crime,Male,18-30,5408,3206,2202,3223,2185
2006,Urban,Haryana,Crime Against Men,Extortion,Female,0-12,9744,5617,4127,9666,78
2010,Rural,Punjab,Property Crime,Burglary,Male,31-45,2021,334,1687,1008,1013
2007,Rural,Delhi,Property Crime,Theft,Male,60+,1785,814,971,1036,749
2007,Urban,Rajasthan,Other Crimes,Cyber Crime,Female,13-17,8250,1653,6597,3463,4787
2003,Rural,Odisha,Crime Against Men,Robbery,Female,13-17,8359,887,7472,7086,1273
2005,Rural,Meghalaya,Crime Against Women,Domestic Violence,Female,0-12,4796,3321,1475,4020,776
2002,Rural,Himachal Pradesh,Crime Against Men,Extortion,Female,0-12,8097,5483,2614,7092,1005
2001,Rural,Arunachal Pradesh,Crime Against Children,Child Abuse,Male,46-60,2284,445,1839,1703,581
2002,Urban,Karnataka,Property Crime,Theft,Female,13-17,798,382,416,648,150
2006,Urban,Manipur,Crime Against Children,Child Labor,Male,60+,4600,1613,2987,4398,202
2001,Urban,Gujarat,Other Crimes,Corruption,Male,60+,7685,3885,3800,5895,1790
2003,Urban,Kerala,Crime Against Women,Domestic Violence,Male,31-45,7194,1528,5666,4746,2448
2007,Rural,Manipur,Crime Against Children,Child Labor,Female,60+,9189,4437,4752,5347,3842
2001,Rural,Mizoram,Crime Against Women,Rape,Male,18-30,9727,8359,1368,9141,586
2001,Urban,Odisha,Property Crime,Vandalism,Male,18-30,8328,874,7454,1448,6880
2008,Rural,Meghalaya,Other Crimes,Cyber Crime,Female,0-12,2197,178,2019,1830,367
2001,Rural,Arunachal Pradesh,Crime Against Women,Molestation,Female,0-12,5046,1130,3916,3706,1340
2008,Rural,Goa,Other Crimes,Corruption,Female,13-17,7302,7027,275,7072,230
2002,Urban,Gujarat,Property Crime,Theft,Female,31-45,9413,778,8635,4174,5239
2008,Urban,Arunachal Pradesh,Crime Against Women,Molestation,Male,60+,7109,2449,4660,5417,1692
2006,Rural,Arunachal Pradesh,Other Crimes,Cyber Crime,Male,31-45,5813,5496,317,5678,135
2002,Rural,Uttarakhand,Crime Against Women,Rape,Female,60+,7787,4572,3215,7429,358
2003,Rural,Delhi,Crime Against Women,Dowry Deaths,Male,46-60,703,600,103,603,100
2007,Urban,Haryana,Property Crime,Arson,Female,0-12,8051,5232,2819,6487,1564
2004,Rural,Delhi,Crime Against Women,Domestic Violence,Male,13-17,6528,2871,3657,5243,1285
2001,Urban,Haryana,Crime Against Women,Rape,Female,60+,9137,2241,6896,3871,5266
2004,Rural,Manipur,Crime Against Children,Trafficking,Male,18-30,4905,3237,1668,3699,1206
2006,Urban,Andhra Pradesh,Crime Against Children,Trafficking,Male,31-45,2853,1769,1084,2565,288
2001,Urban,Punjab,Crime Against Children,Child Abuse,Male,0-12,2876,1822,1054,1892,984
2007,Urban,Tripura,Crime Against Women,Domestic Violence,Male,46-60,9744,7357,2387,8200,1544
2005,Urban,Uttarakhand,Other Crimes,Cyber Crime,Male,31-45,6063,901,5162,2414,3649
2001,Rural,Jharkhand,Other Crimes,Cyber Crime,Male,0-12,3650,392,3258,2242,1408
2002,Rural,Arunachal Pradesh,Crime Against Women,Rape,Female,31-45,6339,4691,1648,5329,1010
2005,Rural,Himachal Pradesh,Other Crimes,Drug Offense,Female,13-17,239,142,97,176,63
2004,Rural,Odisha,Crime Against Children,Child Labor,Male,31-45,6506,960,5546,2447,4059
2003,Urban,Madhya Pradesh,Property Crime,Burglary,Female,60+,6966,3470,3496,5710,1256
2005,Urban,Kerala,Other Crimes,Fraud,Female,46-60,661,652,9,652,9
2005,Urban,Karnataka,Crime Against Men,Assault,Male,46-60,8677,7472,1205,8025,652
2008,Urban,Jammu & Kashmir,Other Crimes,Corruption,Female,13-17,3519,48,3471,3458,61
2009,Rural,Maharashtra,Crime Against Men,Assault,Male,60+,1580,952,628,1405,175
2009,Urban,Rajasthan,Crime Against Women,Dowry Deaths,Female,31-45,6684,5239,1445,5534,1150
2008,Urban,Uttar Pradesh,Crime Against Men,Assault,Female,31-45,5847,2555,3292,5347,500
2006,Rural,Goa,Crime Against Children,Kidnapping,Male,13-17,3881,2375,1506,3770,111
2005,Rural,Uttarakhand,Property Crime,Arson,Female,60+,1343,450,893,765,578
2008,Rural,Tripura,Property Crime,Theft,Male,0-12,7038,1092,5946,3248,3790
2010,Rural,Goa,Crime Against Women,Rape,Female,18-30,5666,4098,1568,5659,7
2002,Rural,Bihar,Crime Against Children,Trafficking,Female,13-17,4028,3610,418,3633,395
2005,Rural,Madhya Pradesh,Crime Against Men,Murder,Female,0-12,5244,2657,2587,3830,1414
2003,Urban,Kerala,Crime Against Men,Assault,Female,0-12,8348,5221,3127,8130,218
2009,Rural,Jammu & Kashmir,Crime Against Women,Rape,Female,60+,8923,6858,2065,7485,1438
2003,Rural,West Bengal,Other Crimes,Corruption,Male,31-45,514,286,228,428,86
2005,Rural,Uttar Pradesh,Crime Against Women,Molestation,Female,46-60,1320,625,695,888,432
2007,Rural,Mizoram,Crime Against Women,Molestation,Male,0-12,5885,4935,950,5606,279
2008,Rural,West Bengal,Property Crime,Theft,Female,0-12,5293,4168,1125,4630,663
2005,Rural,Gujarat,Other Crimes,Fraud,Female,46-60,5493,3047,2446,3686,1807
2004,Rural,Chhattisgarh,Crime Against Children,Child Abuse,Male,13-17,824,13,811,58,766
2008,Urban,Meghalaya,Property Crime,Burglary,Female,46-60,2817,228,2589,303,2514
2009,Rural,Andhra Pradesh,Crime Against Men,Extortion,Male,13-17,9652,6009,3643,8127,1525
2007,Rural,Tamil Nadu,Crime Against Women,Dowry Deaths,Male,0-12,175,136,39,174,1
2003,Rural,West Bengal,Crime Against Children,Kidnapping,Female,31-45,4724,2053,2671,2461,2263
2002,Rural,Uttarakhand,Property Crime,Arson,Male,18-30,8776,6953,1823,8725,51
2001,Rural,Uttarakhand,Crime Against Women,Molestation,Female,18-30,2095,353,1742,879,1216
2008,Rural,Andhra Pradesh,Crime Against Children,Trafficking,Male,31-45,5252,78,5174,5052,200
2010,Rural,Andhra Pradesh,Other Crimes,Cyber Crime,Male,0-12,507,173,334,282,225
2002,Rural,Telangana,Crime Against Men,Assault,Female,13-17,7461,4024,3437,7362,99
2010,Rural,Jharkhand,Crime Against Men,Extortion,Male,46-60,5092,2752,2340,4064,1028
2007,Rural,Nagaland,Crime Against Men,Assault,Male,0-12,361,100,261,280,81
2006,Rural,Nagaland,Crime Against Women,Dowry Deaths,Male,31-45,4598,222,4376,1795,2803
2002,Rural,Mizoram,Crime Against Children,Trafficking,Male,18-30,6236,5663,573,5976,260
2009,Rural,Manipur,Property Crime,Vandalism,Male,46-60,7379,1438,5941,2732,4647
2002,Urban,Uttarakhand,Crime Against Children,Trafficking,Female,31-45,679,623,56,636,43
2003,Urban,Jharkhand,Other Crimes,Cyber Crime,Male,18-30,6577,4356,2221,5798,779
2002,Urban,Assam,Crime Against Women,Domestic Violence,Female,31-45,5396,1919,3477,5239,157
2001,Urban,Jharkhand,Crime Against Children,Trafficking,Male,18-30,1210,343,867,740,470
2010,Rural,Goa,Crime Against Children,Kidnapping,Male,13-17,2072,1913,159,1950,122
2003,Rural,Mizoram,Crime Against Men,Extortion,Male,0-12,4347,3322,1025,3982,365
2009,Rural,Maharashtra,Crime Against Men,Robbery,Female,0-12,4541,4306,235,4387,154
2007,Urban,Tripura,Crime Against Children,Kidnapping,Female,0-12,8950,7109,1841,8760,190
2010,Urban,Punjab,Crime Against Children,Child Abuse,Male,18-30,6274,3004,3270,5076,1198
2004,Urban,Jharkhand,Crime Against Men,Robbery,Male,18-30,360,247,113,351,9
2005,Urban,Chhattisgarh,Crime Against Children,Trafficking,Male,60+,1956,554,1402,1790,166
2004,Urban,Nagaland,Crime Against Children,Child Labor,Male,60+,7241,4547,2694,5379,1862
2004,Rural,Karnataka,Crime Against Children,Trafficking,Female,0-12,8425,596,7829,1140,7285
2007,Urban,Uttar Pradesh,Crime Against Children,Trafficking,Male,46-60,5477,1841,3636,3057,2420
2010,Rural,Madhya Pradesh,Crime Against Women,Domestic Violence,Male,13-17,1507,285,1222,404,1103
2002,Rural,Arunachal Pradesh,Other Crimes,Fraud,Male,13-17,5637,647,4990,1230,4407
2007,Urban,Haryana,Crime Against Children,Child Abuse,Male,31-45,1660,527,1133,1177,483
2010,Rural,Karnataka,Crime Against Women,Molestation,Male,46-60,8848,2742,6106,7267,1581
2003,Rural,Karnataka,Crime Against Women,Domestic Violence,Female,60+,1354,1187,167,1349,5
2006,Urban,Meghalaya,Crime Against Men,Murder,Male,60+,8281,5553,2728,6392,1889
2002,Urban,Mizoram,Crime Against Children,Child Labor,Male,18-30,4103,849,3254,2755,1348
2010,Urban,Nagaland,Crime Against Women,Domestic Violence,Male,18-30,1376,960,416,1215,161
2004,Rural,Odisha,Property Crime,Arson,Male,60+,8207,1690,6517,7150,1057
2005,Urban,West Bengal,Crime Against Men,Murder,Female,0-12,4942,633,4309,2304,2638
2003,Rural,Nagaland,Crime Against Women,Dowry Deaths,Female,0-12,1989,1524,465,1529,460
2004,Rural,Bihar,Crime Against Children,Trafficking,Male,46-60,4637,348,4289,2233,2404
2009,Urban,Madhya Pradesh,Crime Against Men,Assault,Female,46-60,9120,570,8550,1030,8090
2002,Urban,Madhya Pradesh,Crime Against Women,Molestation,Male,0-12,6433,4675,1758,6051,382
2002,Rural,Manipur,Property Crime,Theft,Female,13-17,9325,3467,5858,4143,5182
2005,Rural,Goa,Property Crime,Burglary,Female,18-30,9570,7015,2555,9474,96
2008,Rural,Maharashtra,Crime Against Women,Rape,Female,18-30,9886,7441,2445,9283,603
2009,Rural,Bihar,Property Crime,Theft,Female,46-60,4467,1791,2676,2384,2083
2004,Urban,Meghalaya,Other Crimes,Drug Offense,Female,31-45,2478,856,1622,1787,691
2005,Rural,Telangana,Crime Against Men,Extortion,Male,13-17,5281,469,4812,1580,3701
2007,Rural,Chhattisgarh,Other Crimes,Drug Offense,Female,46-60,4819,2420,2399,3437,1382
2001,Rural,Tamil Nadu,Crime Against Men,Extortion,Male,13-17,2143,1149,994,1984,159
2009,Urban,West Bengal,Other Crimes,Corruption,Female,13-17,3664,1337,2327,2492,1172
2009,Rural,Jammu & Kashmir,Crime Against Men,Extortion,Female,0-12,9748,7143,2605,8390,1358
2010,Rural,Andhra Pradesh,Other Crimes,Fraud,Male,60+,1666,601,1065,1370,296
2010,Rural,Tamil Nadu,Other Crimes,Drug Offense,Male,13-17,2304,1051,1253,2171,133
2009,Urban,Tamil Nadu,Property Crime,Burglary,Male,31-45,7720,3602,4118,5181,2539
2010,Rural,Telangana,Property Crime,Arson,Female,18-30,1693,755,938,1524,169
2001,Urban,Mizoram,Crime Against Children,Trafficking,Female,13-17,256,208,48,233,23
2003,Urban,Madhya Pradesh,Crime Against Men,Assault,Male,0-12,1041,965,76,988,53
2001,Urban,Manipur,Crime Against Women,Domestic Violence,Female,31-45,8491,1480,7011,3847,4644
2010,Rural,Goa,Crime Against Children,Kidnapping,Male,60+,706,648,58,697,9
2004,Urban,Jammu & Kashmir,Property Crime,Theft,Male,0-12,283,70,213,253,30
2009,Rural,Jharkhand,Crime Against Men,Assault,Male,31-45,3733,1272,2461,2767,966
2006,Urban,Jharkhand,Crime Against Children,Child Abuse,Female,18-30,1191,900,291,1005,186
2001,Urban,Punjab,Other Crimes,Drug Offense,Male,18-30,1928,563,1365,1287,641
2003,Urban,Kerala,Crime Against Women,Rape,Female,46-60,9911,7387,2524,8324,1587
2002,Rural,Delhi,Property Crime,Arson,Female,13-17,7913,7515,398,7643,270
2010,Urban,Haryana,Crime Against Children,Kidnapping,Female,0-12,6549,3262,3287,3275,3274
2008,Rural,Mizoram,Property Crime,Burglary,Female,13-17,7224,730,6494,2790,4434
2004,Urban,Jharkhand,Property Crime,Burglary,Female,18-30,3319,2047,1272,3000,319
2007,Urban,Bihar,Property Crime,Arson,Male,46-60,4486,3774,712,3839,647
2005,Rural,Odisha,Crime Against Children,Child Abuse,Male,18-30,1293,75,1218,865,428
2001,Urban,Tamil Nadu,Other Crimes,Corruption,Female,13-17,3910,60,3850,222,3688
2004,Urban,Himachal Pradesh,Crime Against Children,Kidnapping,Male,31-45,7547,933,6614,5172,2375
2001,Urban,Assam,Crime Against Children,Trafficking,Male,0-12,7441,2652,4789,6931,510
2002,Rural,Assam,Crime Against Men,Murder,Female,60+,533,492,41,507,26
2005,Urban,Andhra Pradesh,Crime Against Women,Dowry Deaths,Male,46-60,8820,5337,3483,7840,980
2005,Urban,Haryana,Crime Against Men,Robbery,Female,13-17,400,382,18,389,11
2010,Urban,Jammu & Kashmir,Property Crime,Arson,Male,31-45,6771,6515,256,6742,29
2004,Urban,Rajasthan,Crime Against Women,Rape,Male,18-30,2188,1327,861,2180,8
2008,Rural,Goa,Crime Against Men,Assault,Male,0-12,937,557,380,917,20
2004,Rural,Chhattisgarh,Other Crimes,Corruption,Male,31-45,6695,3405,3290,4245,2450
2010,Rural,Haryana,Crime Against Women,Domestic Violence,Female,46-60,8177,2147,6030,7653,524
2006,Urban,Nagaland,Crime Against Women,Molestation,Male,13-17,9097,3293,5804,6274,2823
2009,Urban,Himachal Pradesh,Crime Against Children,Kidnapping,Female,18-30,4500,4396,104,4500,0
2010,Urban,Chhattisgarh,Other Crimes,Drug Offense,Female,60+,2618,1892,726,2138,480
2007,Urban,Uttarakhand,Other Crimes,Fraud,Female,0-12,4678,987,3691,1188,3490
2006,Urban,Maharashtra,Crime Against Children,Child Abuse,Male,31-45,4574,31,4543,4009,565
2007,Rural,Tripura,Crime Against Children,Child Labor,Female,46-60,5752,983,4769,3459,2293
2003,Urban,Gujarat,Crime Against Men,Murder,Female,18-30,6217,3772,2445,6172,45
2010,Rural,Himachal Pradesh,Crime Against Men,Murder,Male,31-45,5553,3231,2322,3296,2257
2008,Rural,Nagaland,Other Crimes,Drug Offense,Male,60+,5948,3278,2670,4796,1152
2009,Urban,Tripura,Property Crime,Theft,Male,46-60,6920,5487,1433,6893,27
2010,Rural,Rajasthan,Property Crime,Theft,Female,31-45,2971,863,2108,2637,334
2006,Urban,Mizoram,Crime Against Women,Domestic Violence,Female,46-60,1394,1324,70,1392,2
2001,Rural,Tamil Nadu,Crime Against Women,Molestation,Female,60+,8770,2501,6269,8213,557
2003,Urban,Mizoram,Crime Against Children,Child Abuse,Male,46-60,5027,2653,2374,3511,1516
2010,Rural,Andhra Pradesh,Property Crime,Theft,Male,46-60,8898,68,8830,7228,1670
2009,Urban,Jammu & Kashmir,Property Crime,Vandalism,Female,60+,6564,1928,4636,5703,861
2003,Rural,Himachal Pradesh,Property Crime,Theft,Male,13-17,4973,1147,3826,1530,3443
2001,Urban,Karnataka,Crime Against Men,Robbery,Female,31-45,1660,1397,263,1503,157
2006,Urban,Tamil Nadu,Crime Against Men,Murder,Male,18-30,1865,1432,433,1656,209
2007,Rural,Bihar,Other Crimes,Fraud,Male,18-30,7531,394,7137,1223,6308
2003,Urban,Jharkhand,Other Crimes,Drug Offense,Female,60+,2993,2283,710,2666,327
2008,Rural,Bihar,Property Crime,Arson,Male,60+,3977,1273,2704,2899,1078
2003,Urban,Himachal Pradesh,Crime Against Children,Trafficking,Female,18-30,8884,1022,7862,1386,7498
2002,Urban,Bihar,Property Crime,Vandalism,Male,60+,5123,1627,3496,1686,3437
2005,Urban,Delhi,Property Crime,Theft,Male,60+,1193,705,488,1191,2
2002,Rural,Maharashtra,Other Crimes,Fraud,Male,31-45,6718,6417,301,6543,175
2004,Urban,Odisha,Property Crime,Vandalism,Female,13-17,273,173,100,196,77
2003,Urban,Karnataka,Property Crime,Vandalism,Female,31-45,3307,3030,277,3258,49
2010,Rural,Meghalaya,Other Crimes,Corruption,Male,60+,1917,1123,794,1883,34
2005,Rural,Gujarat,Other Crimes,Corruption,Male,18-30,5347,5034,313,5328,19
2002,Urban,Punjab,Crime Against Women,Rape,Male,46-60,4002,1695,2307,3551,451
2001,Rural,Uttar Pradesh,Crime Against Women,Domestic Violence,Female,31-45,7539,867,6672,6614,925
2005,Urban,Jammu & Kashmir,Crime Against Women,Rape,Male,60+,5597,2718,2879,4224,1373
2002,Urban,Karnataka,Crime Against Men,Assault,Female,18-30,1289,95,1194,786,503
2010,Urban,Sikkim,Other Crimes,Fraud,Female,0-12,269,118,151,262,7
2010,Rural,Andhra Pradesh,Property Crime,Vandalism,Male,60+,6352,2775,3577,5060,1292
2010,Rural,Uttarakhand,Crime Against Women,Rape,Male,13-17,7909,6956,953,7455,454
2003,Urban,Gujarat,Crime Against Women,Dowry Deaths,Male,0-12,2233,472,1761,1370,863
2002,Urban,Haryana,Crime Against Women,Dowry Deaths,Female,13-17,7616,5282,2334,6167,1449
2006,Urban,Delhi,Property Crime,Burglary,Male,0-12,4720,1454,3266,3819,901
2002,Urban,Delhi,Property Crime,Theft,Female,18-30,310,88,222,231,79
2001,Urban,Rajasthan,Crime Against Men,Extortion,Female,18-30,6176,5959,217,6029,147
2008,Urban,Madhya Pradesh,Crime Against Women,Dowry Deaths,Male,0-12,5058,1121,3937,4236,822
2007,Urban,Gujarat,Other Crimes,Corruption,Female,60+,3602,3116,486,3285,317
2006,Rural,Tripura,Crime Against Men,Assault,Female,46-60,1567,891,676,920,647
2006,Rural,Karnataka,Crime Against Children,Child Labor,Female,13-17,8897,2783,6114,6940,1957
2008,Urban,Haryana,Property Crime,Theft,Female,18-30,3414,904,2510,1311,2103
2010,Urban,Bihar,Property Crime,Vandalism,Female,13-17,3196,784,2412,2105,1091
2008,Rural,West Bengal,Crime Against Men,Assault,Male,46-60,761,5,756,324,437
2010,Rural,Tripura,Crime Against Children,Child Abuse,Male,0-12,4652,3985,667,4471,181
2009,Rural,Odisha,Crime Against Men,Murder,Female,60+,8885,8203,682,8368,517
2010,Urban,Goa,Other Crimes,Corruption,Male,18-30,1735,1157,578,1169,566
2007,Urban,Telangana,Crime Against Women,Dowry Deaths,Female,0-12,1002,383,619,878,124
2008,Urban,Jammu & Kashmir,Property Crime,Burglary,Female,31-45,3140,2326,814,2508,632
2008,Rural,Delhi,Crime Against Men,Murder,Female,31-45,3979,3050,929,3842,137
2005,Urban,Uttar Pradesh,Crime Against Children,Child Labor,Female,46-60,2778,2613,165,2707,71
2008,Rural,Goa,Crime Against Men,Murder,Male,46-60,2148,289,1859,1724,424
2006,Urban,Kerala,Crime Against Women,Dowry Deaths,Female,13-17,2402,215,2187,1908,494
2010,Urban,Assam,Crime Against Children,Kidnapping,Male,31-45,9972,3968,6004,5740,4232
2009,Urban,Assam,Property Crime,Arson,Female,31-45,8087,211,7876,4563,3524
2006,Urban,Bihar,Property Crime,Arson,Female,0-12,7871,924,6947,5204,2667
2010,Rural,Uttarakhand,Other Crimes,Cyber Crime,Female,60+,2619,430,2189,1794,825
2009,Rural,Goa,Crime Against Women,Dowry Deaths,Female,46-60,3486,57,3429,1764,1722
2008,Rural,Gujarat,Crime Against Women,Dowry Deaths,Female,0-12,2294,722,1572,1123,1171
2008,Rural,Assam,Crime Against Women,Dowry Deaths,Female,0-12,340,332,8,332,8
2002,Rural,Assam,Crime Against Children,Trafficking,Male,60+,3262,953,2309,1594,1668
2005,Rural,Andhra Pradesh,Crime Against Men,Extortion,Male,31-45,7459,4964,2495,6639,820
2002,Urban,Jharkhand,Crime Against Men,Extortion,Male,13-17,2132,330,1802,1050,1082
2009,Urban,Kerala,Crime Against Children,Child Abuse,Male,46-60,812,729,83,806,6
2001,Rural,Punjab,Crime Against Women,Dowry Deaths,Female,18-30,5803,4196,1607,5287,516
2007,Rural,Rajasthan,Crime Against Women,Molestation,Male,60+,9817,5192,4625,8990,827
2007,Rural,Himachal Pradesh,Crime Against Women,Domestic Violence,Female,31-45,689,654,35,658,31
2004,Urban,Delhi,Crime Against Children,Child Abuse,Male,46-60,4875,4318,557,4641,234
2005,Urban,West Bengal,Property Crime,Burglary,Male,31-45,1508,1420,88,1455,53
2008,Urban,Karnataka,Crime Against Women,Dowry Deaths,Female,13-17,4454,270,4184,1946,2508
2004,Rural,Jammu & Kashmir,Crime Against Men,Extortion,Female,0-12,7490,4753,2737,6859,631
2003,Rural,Jharkhand,Other Crimes,Fraud,Female,60+,4468,3483,985,4070,398
2010,Urban,Sikkim,Crime Against Men,Extortion,Male,0-12,4476,2406,2070,2454,2022
2006,Urban,Kerala,Other Crimes,Fraud,Male,46-60,8379,5667,2712,6323,2056
2001,Urban,Nagaland,Property Crime,Vandalism,Female,31-45,4014,199,3815,2759,1255
2006,Rural,Delhi,Crime Against Women,Dowry Deaths,Female,60+,8222,3150,5072,5930,2292
2006,Rural,Chhattisgarh,Other Crimes,Fraud,Male,18-30,6343,212,6131,1189,5154
2008,Urban,Odisha,Crime Against Men,Robbery,Female,31-45,8827,1970,6857,5190,3637
2003,Rural,Madhya Pradesh,Other Crimes,Cyber Crime,Male,18-30,8654,5783,2871,6812,1842
2004,Urban,Uttar Pradesh,Crime Against Men,Extortion,Male,60+,6540,258,6282,1275,5265
2004,Rural,Meghalaya,Other Crimes,Cyber Crime,Male,13-17,5040,4225,815,4685,355
2008,Rural,Goa,Other Crimes,Drug Offense,Male,60+,4119,829,3290,3699,420
2007,Urban,Odisha,Crime Against Men,Robbery,Female,31-45,8196,3290,4906,5336,2860
2001,Urban,Mizoram,Other Crimes,Corruption,Male,60+,5738,3666,2072,5505,233
2007,Rural,Gujarat,Crime Against Children,Child Labor,Male,60+,9628,723,8905,9122,506
2004,Urban,Punjab,Property Crime,Burglary,Male,18-30,4835,694,4141,4379,456
2008,Urban,Gujarat,Crime Against Men,Assault,Female,31-45,9441,4303,5138,5039,4402
2010,Rural,Nagaland,Other Crimes,Corruption,Male,31-45,4459,1600,2859,2590,1869
2001,Urban,Manipur,Property Crime,Theft,Male,46-60,4288,2751,1537,2836,1452
2003,Rural,Odisha,Other Crimes,Drug Offense,Female,18-30,6527,5278,1249,5489,1038
2008,Rural,Haryana,Other Crimes,Cyber Crime,Male,13-17,3771,152,3619,401,3370
2010,Urban,Assam,Crime Against Women,Domestic Violence,Male,46-60,6963,533,6430,6857,106
2007,Rural,Punjab,Crime Against Men,Assault,Male,60+,3126,681,2445,2415,711
2002,Urban,Jharkhand,Crime Against Children,Kidnapping,Female,13-17,8005,3500,4505,3614,4391
2002,Rural,West Bengal,Crime Against Women,Domestic Violence,Male,60+,6739,4226,2513,6434,305
2005,Urban,Himachal Pradesh,Other Crimes,Cyber Crime,Female,46-60,5724,3389,2335,4165,1559
2004,Rural,Tripura,Crime Against Children,Child Abuse,Female,46-60,3982,94,3888,333,3649
2008,Urban,Bihar,Other Crimes,Corruption,Male,46-60,1696,1410,286,1478,218
2008,Urban,Himachal Pradesh,Crime Against Children,Child Labor,Female,60+,9201,6211,2990,9197,4
2009,Urban,Tamil Nadu,Crime Against Women,Dowry Deaths,Female,60+,8249,3757,4492,3955,4294
2010,Urban,Haryana,Crime Against Men,Assault,Male,60+,183,6,177,115,68
2006,Rural,Assam,Crime Against Men,Assault,Female,18-30,8805,8380,425,8803,2
2005,Urban,Karnataka,Crime Against Men,Robbery,Female,13-17,9600,2030,7570,7410,2190
2009,Rural,Uttar Pradesh,Property Crime,Vandalism,Male,0-12,8974,6477,2497,7131,1843
2009,Urban,Sikkim,Crime Against Men,Assault,Male,13-17,7961,2858,5103,3752,4209
2005,Rural,Bihar,Crime Against Children,Child Abuse,Male,31-45,7708,3487,4221,4471,3237
2006,Urban,Nagaland,Other Crimes,Drug Offense,Male,13-17,7117,6756,361,6967,150
2001,Rural,Manipur,Other Crimes,Cyber Crime,Female,31-45,6007,1110,4897,3226,2781
2007,Rural,Uttarakhand,Crime Against Children,Child Labor,Female,0-12,3105,2699,406,2757,348
2003,Rural,Karnataka,Other Crimes,Drug Offense,Female,31-45,2401,607,1794,2353,48
2003,Urban,Punjab,Crime Against Children,Child Labor,Male,18-30,5330,702,4628,4945,385
2008,Urban,Madhya Pradesh,Property Crime,Arson,Female,46-60,6602,776,5826,1520,5082
2006,Urban,Jammu & Kashmir,Property Crime,Theft,Male,46-60,1222,764,458,910,312
2005,Rural,Kerala,Property Crime,Burglary,Female,31-45,8012,2255,5757,3348,4664
2008,Rural,Uttarakhand,Crime Against Children,Child Labor,Female,18-30,55,27,28,27,28
2008,Urban,Arunachal Pradesh,Property Crime,Theft,Female,60+,1227,139,1088,1021,206
2002,Urban,Goa,Crime Against Women,Dowry Deaths,Male,31-45,2989,2067,922,2323,666
2001,Urban,Goa,Other Crimes,Drug Offense,Male,18-30,3944,1899,2045,3471,473
2008,Rural,Rajasthan,Other Crimes,Drug Offense,Male,60+,4844,1848,2996,3796,1048
2001,Rural,Kerala,Property Crime,Vandalism,Male,18-30,175,21,154,159,16
2006,Rural,Kerala,Crime Against Children,Kidnapping,Female,31-45,2565,1692,873,2389,176
2003,Urban,Mizoram,Crime Against Children,Trafficking,Female,31-45,9715,406,9309,4911,4804
2005,Rural,Odisha,Crime Against Children,Kidnapping,Female,60+,7314,1570,5744,4769,2545
2003,Rural,Nagaland,Property Crime,Theft,Female,31-45,3256,2387,869,2912,344
2003,Rural,Haryana,Property Crime,Arson,Male,0-12,364,355,9,357,7
2006,Rural,Chhattisgarh,Other Crimes,Cyber Crime,Female,60+,9359,5970,3389,7848,1511
2006,Rural,Andhra Pradesh,Other Crimes,Corruption,Female,13-17,7246,3732,3514,5648,1598
2006,Rural,Madhya Pradesh,Crime Against Women,Rape,Female,18-30,990,216,774,443,547
2001,Rural,Mizoram,Crime Against Men,Extortion,Female,31-45,6788,644,6144,6380,408
2002,Rural,Maharashtra,Other Crimes,Cyber Crime,Male,31-45,4157,3824,333,3919,238
2006,Rural,Arunachal Pradesh,Property Crime,Arson,Female,13-17,2342,1384,958,2057,285
2009,Urban,West Bengal,Crime Against Women,Rape,Female,13-17,5573,45,5528,4208,1365
2007,Rural,Arunachal Pradesh,Other Crimes,Drug Offense,Male,13-17,8931,748,8183,2062,6869
2002,Rural,Tripura,Crime Against Men,Murder,Male,13-17,2607,1817,790,2423,184
2009,Urban,Maharashtra,Property Crime,Vandalism,Female,0-12,2675,1050,1625,1835,840
2006,Rural,Assam,Other Crimes,Drug Offense,Male,46-60,9409,4007,5402,4757,4652
2004,Rural,Madhya Pradesh,Crime Against Women,Dowry Deaths,Male,31-45,6567,2340,4227,6412,155
2003,Urban,Delhi,Crime Against Men,Robbery,Male,60+,6459,1148,5311,4655,1804
2007,Rural,Meghalaya,Crime Against Children,Child Abuse,Male,31-45,9515,6531,2984,7442,2073
2006,Rural,Sikkim,Crime Against Children,Kidnapping,Female,13-17,9198,1183,8015,4788,4410
2003,Rural,Delhi,Crime Against Children,Child Labor,Female,0-12,8712,6228,2484,8097,615
2001,Rural,Andhra Pradesh,Crime Against Women,Domestic Violence,Female,46-60,1131,274,857,287,844
2005,Rural,Gujarat,Crime Against Men,Assault,Female,31-45,6674,36,6638,5046,1628
2008,Rural,Jammu & Kashmir,Property Crime,Vandalism,Female,46-60,428,295,133,410,18
2004,Urban,Delhi,Crime Against Men,Extortion,Female,46-60,2155,518,1637,1320,835
2009,Urban,Gujarat,Crime Against Women,Molestation,Male,31-45,2916,2835,81,2911,5
2005,Rural,Tamil Nadu,Crime Against Men,Robbery,Female,13-17,4689,1837,2852,2247,2442
2010,Rural,Andhra Pradesh,Crime Against Women,Domestic Violence,Male,0-12,3843,1110,2733,3724,119
2010,Rural,Jammu & Kashmir,Other Crimes,Drug Offense,Male,0-12,7813,5422,2391,7003,810
2007,Urban,Gujarat,Crime Against Women,Dowry Deaths,Male,31-45,4540,3157,1383,4175,365
2002,Rural,Sikkim,Crime Against Men,Extortion,Male,31-45,2406,2228,178,2367,39
2001,Urban,Telangana,Crime Against Men,Murder,Female,13-17,8684,4890,3794,7619,1065
2007,Urban,Bihar,Crime Against Men,Extortion,Male,18-30,4760,1630,3130,3619,1141
2007,Urban,Andhra Pradesh,Other Crimes,Drug Offense,Female,13-17,1280,1194,86,1198,82
2006,Urban,Haryana,Crime Against Children,Trafficking,Female,60+,2499,2020,479,2490,9
2003,Urban,Himachal Pradesh,Property Crime,Vandalism,Male,13-17,3030,1594,1436,2018,1012
2001,Urban,Assam,Crime Against Men,Assault,Male,13-17,8305,2028,6277,6646,1659
2004,Rural,Karnataka,Crime Against Children,Child Abuse,Male,60+,4121,318,3803,3996,125
2008,Rural,Chhattisgarh,Other Crimes,Corruption,Female,0-12,9278,480,8798,1312,7966
2002,Urban,Odisha,Crime Against Children,Child Abuse,Male,31-45,995,404,591,821,174
2006,Rural,Uttar Pradesh,Crime Against Children,Kidnapping,Female,31-45,1901,1872,29,1896,5
2003,Rural,Gujarat,Crime Against Men,Robbery,Female,31-45,6111,145,5966,1691,4420
2008,Urban,Gujarat,Crime Against Children,Trafficking,Male,31-45,8359,3581,4778,7587,772
2004,Urban,Delhi,Crime Against Children,Trafficking,Male,18-30,5850,1374,4476,1906,3944
2007,Rural,Andhra Pradesh,Other Crimes,Cyber Crime,Male,13-17,6527,5446,1081,6057,470
2010,Urban,Bihar,Crime Against Women,Molestation,Female,13-17,3429,1536,1893,3166,263
2001,Urban,Meghalaya,Crime Against Women,Molestation,Male,13-17,1763,99,1664,514,1249
2010,Rural,Kerala,Other Crimes,Fraud,Female,0-12,9451,3707,5744,8185,1266
2002,Urban,Tamil Nadu,Crime Against Women,Domestic Violence,Male,18-30,2273,2094,179,2217,56
2010,Urban,Uttar Pradesh,Crime Against Men,Murder,Female,46-60,8789,245,8544,8557,232
2008,Rural,Madhya Pradesh,Crime Against Men,Robbery,Female,18-30,9718,2308,7410,3754,5964
2009,Urban,Haryana,Other Crimes,Corruption,Female,0-12,7102,3697,3405,6404,698
2005,Urban,Jharkhand,Crime Against Children,Trafficking,Male,46-60,2467,183,2284,2225,242
2002,Urban,Tripura,Property Crime,Theft,Female,18-30,7437,5938,1499,7081,356
2003,Urban,Arunachal Pradesh,Other Crimes,Fraud,Female,60+,8135,5093,3042,6632,1503
2005,Urban,Jharkhand,Crime Against Men,Assault,Male,0-12,8659,1238,7421,6830,1829
2010,Urban,Jharkhand,Crime Against Men,Extortion,Female,13-17,1971,540,1431,1635,336
2002,Rural,West Bengal,Crime Against Children,Kidnapping,Male,18-30,1476,1332,144,1366,110
2007,Rural,West Bengal,Crime Against Men,Robbery,Male,60+,9152,3083,6069,3488,5664
2009,Rural,Bihar,Other Crimes,Cyber Crime,Male,18-30,2415,237,2178,1342,1073
2010,Rural,Arunachal Pradesh,Crime Against Children,Child Abuse,Male,46-60,4419,2958,1461,3978,441
2001,Urban,Manipur,Other Crimes,Corruption,Female,13-17,718,582,136,710,8
2003,Rural,Jammu & Kashmir,Crime Against Women,Rape,Male,60+,2737,1923,814,2634,103
2010,Urban,Tamil Nadu,Other Crimes,Cyber Crime,Female,60+,7663,1605,6058,5585,2078
2005,Urban,Maharashtra,Other Crimes,Drug Offense,Female,0-12,2145,1168,977,1222,923
2010,Urban,Tripura,Crime Against Women,Rape,Female,60+,3592,2748,844,3171,421
2001,Urban,Tripura,Crime Against Men,Extortion,Female,0-12,9373,3721,5652,6179,3194
2007,Rural,Odisha,Other Crimes,Drug Offense,Male,31-45,3868,1130,2738,2722,1146
2007,Rural,Jharkhand,Crime Against Women,Domestic Violence,Female,31-45,7374,2894,4480,2917,4457
2003,Rural,Haryana,Property Crime,Theft,Male,60+,6828,4045,2783,5363,1465
2007,Urban,Uttarakhand,Crime Against Children,Trafficking,Female,31-45,4610,1283,3327,4187,423
2007,Rural,West Bengal,Property Crime,Theft,Female,31-45,5461,4197,1264,5138,323
2009,Urban,Assam,Crime Against Women,Domestic Violence,Female,60+,8336,3099,5237,7719,617
2005,Urban,Jammu & Kashmir,Property Crime,Burglary,Female,31-45,7886,1335,6551,4458,3428
2009,Urban,Sikkim,Crime Against Children,Trafficking,Male,60+,2562,328,2234,2264,298
2009,Rural,Mizoram,Crime Against Children,Trafficking,Male,60+,8648,6624,2024,8372,276
2004,Urban,Kerala,Crime Against Women,Dowry Deaths,Female,60+,2072,222,1850,372,1700
2006,Urban,Sikkim,Crime Against Children,Child Abuse,Male,18-30,6059,4048,2011,4427,1632
2002,Rural,Uttarakhand,Crime Against Women,Molestation,Female,18-30,1073,29,1044,399,674
2010,Rural,Sikkim,Crime Against Children,Kidnapping,Female,60+,6349,2572,3777,2879,3470
2004,Rural,Andhra Pradesh,Other Crimes,Fraud,Male,46-60,5193,334,4859,2356,2837
2007,Rural,Kerala,Crime Against Women,Rape,Male,31-45,7088,2616,4472,6425,663
2006,Urban,Kerala,Crime Against Children,Kidnapping,Male,31-45,1583,620,963,904,679
2009,Urban,Goa,Property Crime,Burglary,Male,18-30,1125,724,401,1101,24
2006,Rural,West Bengal,Crime Against Children,Child Abuse,Female,0-12,2836,28,2808,2780,56
2008,Rural,Mizoram,Property Crime,Burglary,Female,60+,5029,3303,1726,4719,310
2009,Urban,Haryana,Other Crimes,Fraud,Female,60+,1279,927,352,1112,167
2010,Urban,Sikkim,Other Crimes,Cyber Crime,Male,13-17,1732,1674,58,1719,13
2009,Urban,Nagaland,Crime Against Children,Trafficking,Female,31-45,9097,4462,4635,5841,3256
2005,Urban,Uttar Pradesh,Crime Against Women,Rape,Female,60+,2606,1926,680,2553,53
2006,Rural,Assam,Crime Against Children,Kidnapping,Male,60+,5964,2251,3713,4875,1089
2005,Urban,Tripura,Property Crime,Arson,Male,46-60,2764,47,2717,2589,175
2009,Urban,Uttarakhand,Property Crime,Vandalism,Female,0-12,8590,2336,6254,4455,4135
2010,Rural,Mizoram,Crime Against Men,Assault,Female,31-45,7708,2094,5614,7438,270
2001,Urban,Manipur,Crime Against Men,Assault,Male,0-12,5704,589,5115,4786,918
2009,Rural,Manipur,Crime Against Children,Child Abuse,Male,46-60,9001,961,8040,5806,3195
2008,Urban,Maharashtra,Crime Against Women,Dowry Deaths,Female,13-17,2252,1347,905,1530,722
2005,Rural,Mizoram,Crime Against Women,Domestic Violence,Male,46-60,6668,1009,5659,2786,3882
2001,Rural,Gujarat,Other Crimes,Cyber Crime,Female,18-30,3177,202,2975,1897,1280
2008,Urban,Maharashtra,Other Crimes,Cyber Crime,Male,31-45,1748,1363,385,1613,135
2005,Rural,Himachal Pradesh,Other Crimes,Cyber Crime,Female,31-45,2816,2569,247,2661,155
2006,Rural,Manipur,Crime Against Women,Molestation,Male,60+,9930,3206,6724,4583,5347
2009,Urban,Maharashtra,Crime Against Women,Domestic Violence,Female,13-17,1728,1585,143,1686,42
2004,Urban,Nagaland,Crime Against Women,Domestic Violence,Male,13-17,2600,1628,972,2221,379
2007,Urban,Himachal Pradesh,Property Crime,Vandalism,Male,13-17,9107,7645,1462,8079,1028
2005,Urban,Bihar,Crime Against Women,Dowry Deaths,Female,46-60,8985,1909,7076,7202,1783
2001,Urban,Jammu & Kashmir,Property Crime,Burglary,Female,46-60,6701,3767,2934,6291,410
2008,Urban,Goa,Crime Against Men,Assault,Male,0-12,7509,3451,4058,7045,464
2008,Rural,Madhya Pradesh,Crime Against Children,Child Labor,Male,18-30,3523,1552,1971,3301,222
2001,Urban,Madhya Pradesh,Crime Against Children,Child Abuse,Female,31-45,7004,2605,4399,5175,1829
2010,Urban,Uttarakhand,Crime Against Children,Trafficking,Male,0-12,2891,305,2586,2418,473
2001,Rural,Telangana,Crime Against Children,Child Abuse,Male,0-12,3367,2665,702,2854,513
2006,Urban,Arunachal Pradesh,Crime Against Children,Child Abuse,Male,18-30,1786,844,942,1330,456
2004,Rural,Sikkim,Property Crime,Vandalism,Male,18-30,1607,1494,113,1604,3
2006,Urban,Punjab,Other Crimes,Cyber Crime,Female,46-60,6482,4074,2408,4831,1651
2006,Rural,Jammu & Kashmir,Crime Against Men,Extortion,Male,0-12,1675,769,906,1670,5
2010,Rural,Andhra Pradesh,Other Crimes,Fraud,Male,13-17,8213,2827,5386,5961,2252
2005,Rural,Mizoram,Property Crime,Arson,Male,31-45,5247,3810,1437,3888,1359
2003,Urban,Haryana,Property Crime,Burglary,Female,46-60,7566,7273,293,7420,146
2005,Urban,Delhi,Crime Against Men,Assault,Male,13-17,4827,2213,2614,2287,2540
2003,Rural,Andhra Pradesh,Crime Against Men,Extortion,Female,0-12,7175,5935,1240,6834,341
2004,Urban,Gujarat,Other Crimes,Drug Offense,Female,31-45,2693,732,1961,2357,336
2008,Urban,Arunachal Pradesh,Crime Against Men,Extortion,Female,46-60,3948,2980,968,3939,9
2010,Rural,West Bengal,Property Crime,Theft,Male,0-12,4990,487,4503,4938,52
2005,Rural,Chhattisgarh,Crime Against Women,Molestation,Female,18-30,8810,8594,216,8633,177
2001,Rural,Punjab,Crime Against Women,Dowry Deaths,Male,31-45,9566,2017,7549,2537,7029
2003,Rural,Chhattisgarh,Crime Against Men,Assault,Male,18-30,4020,3596,424,3675,345
2005,Rural,Arunachal Pradesh,Other Crimes,Fraud,Male,31-45,1415,918,497,1179,236
2007,Urban,Tripura,Crime Against Children,Child Labor,Female,13-17,2161,158,2003,645,1516
2008,Urban,Assam,Crime Against Men,Extortion,Female,31-45,3350,3021,329,3058,292
2007,Rural,Mizoram,Crime Against Men,Extortion,Female,0-12,9190,4004,5186,5551,3639
2002,Urban,Madhya Pradesh,Crime Against Women,Domestic Violence,Female,13-17,7284,4542,2742,4713,2571
2008,Urban,Uttarakhand,Other Crimes,Drug Offense,Male,13-17,7472,6516,956,6937,535
2004,Urban,Rajasthan,Other Crimes,Drug Offense,Male,13-17,1751,1097,654,1168,583
2009,Rural,Assam,Crime Against Men,Robbery,Female,0-12,6564,2264,4300,4229,2335
2006,Urban,Maharashtra,Property Crime,Burglary,Male,31-45,2736,1745,991,2647,89
2010,Urban,Tripura,Other Crimes,Fraud,Female,46-60,8774,8023,751,8484,290
2001,Urban,Rajasthan,Crime Against Women,Rape,Male,60+,9597,2335,7262,6515,3082
2005,Urban,Sikkim,Crime Against Children,Trafficking,Male,60+,9650,3268,6382,9582,68
2007,Urban,Tamil Nadu,Property Crime,Vandalism,Male,60+,4442,808,3634,1711,2731
2002,Urban,Andhra Pradesh,Property Crime,Theft,Female,13-17,1314,949,365,1291,23
2002,Urban,Himachal Pradesh,Crime Against Women,Molestation,Female,60+,826,50,776,286,540
2001,Rural,Odisha,Crime Against Children,Kidnapping,Female,31-45,90,61,29,86,4
2001,Rural,Tripura,Crime Against Women,Molestation,Male,0-12,8263,798,7465,3980,4283
2009,Urban,Assam,Other Crimes,Corruption,Female,0-12,1859,1157,702,1465,394
2009,Urban,Odisha,Crime Against Men,Extortion,Female,60+,4053,3660,393,3746,307
2009,Rural,Maharashtra,Property Crime,Arson,Male,18-30,8632,5301,3331,7773,859
2009,Urban,Mizoram,Property Crime,Theft,Male,60+,3229,1646,1583,2258,971
2008,Urban,Sikkim,Property Crime,Burglary,Male,60+,5504,1297,4207,3812,1692
2006,Rural,Nagaland,Crime Against Women,Molestation,Female,13-17,7076,152,6924,1089,5987
2010,Rural,West Bengal,Property Crime,Arson,Male,46-60,2468,183,2285,659,1809
2010,Urban,Gujarat,Property Crime,Burglary,Male,0-12,6274,3075,3199,5042,1232
2008,Urban,Chhattisgarh,Other Crimes,Fraud,Male,0-12,116,27,89,34,82
2002,Rural,Chhattisgarh,Crime Against Men,Robbery,Male,60+,8857,7893,964,7989,868
2008,Rural,Karnataka,Crime Against Women,Molestation,Female,31-45,1620,334,1286,1073,547
2003,Urban,Rajasthan,Property Crime,Vandalism,Male,0-12,5942,1076,4866,2497,3445
2008,Rural,Nagaland,Crime Against Children,Child Labor,Female,0-12,9252,772,8480,1052,8200
2007,Rural,Tamil Nadu,Crime Against Women,Dowry Deaths,Male,31-45,9120,8456,664,8952,168
2001,Urban,Delhi,Crime Against Children,Child Labor,Male,60+,2039,1346,693,2037,2
2010,Rural,Meghalaya,Crime Against Men,Murder,Female,0-12,6818,322,6496,4616,2202
2001,Urban,Tripura,Crime Against Children,Child Labor,Female,46-60,6540,1526,5014,3826,2714
2002,Urban,Nagaland,Crime Against Children,Child Abuse,Female,0-12,4983,2686,2297,3180,1803
2006,Urban,Odisha,Crime Against Children,Trafficking,Male,0-12,5995,3171,2824,4629,1366
2002,Rural,Bihar,Other Crimes,Corruption,Female,13-17,6631,3164,3467,5297,1334
2008,Rural,Rajasthan,Property Crime,Vandalism,Female,31-45,8801,2881,5920,4233,4568
2008,Rural,Tripura,Crime Against Women,Domestic Violence,Male,18-30,8175,2653,5522,7764,411
2001,Rural,Jharkhand,Crime Against Men,Assault,Female,0-12,9850,8021,1829,9296,554
2002,Urban,Assam,Crime Against Children,Trafficking,Female,0-12,956,565,391,658,298
2009,Rural,Tripura,Crime Against Children,Kidnapping,Female,46-60,3858,3755,103,3848,10
2006,Urban,Jammu & Kashmir,Other Crimes,Drug Offense,Female,0-12,6780,4878,1902,4986,1794
2004,Rural,Karnataka,Other Crimes,Fraud,Male,13-17,6855,3367,3488,4534,2321
2001,Urban,Tripura,Other Crimes,Drug Offense,Male,46-60,8878,6207,2671,8442,436
2004,Urban,Uttar Pradesh,Crime Against Children,Child Labor,Male,13-17,4498,2714,1784,4348,150
2006,Rural,Uttar Pradesh,Other Crimes,Drug Offense,Male,31-45,4190,3275,915,3780,410
2009,Rural,Meghalaya,Crime Against Children,Child Abuse,Female,0-12,9262,2541,6721,6414,2848
2003,Urban,Telangana,Property Crime,Vandalism,Female,0-12,7261,5106,2155,6835,426
2006,Rural,Delhi,Crime Against Men,Robbery,Male,0-12,709,666,43,678,31
2007,Rural,Manipur,Property Crime,Burglary,Female,46-60,6021,1169,4852,1276,4745
2010,Rural,Karnataka,Crime Against Men,Assault,Female,0-12,526,311,215,404,122
2003,Rural,Sikkim,Crime Against Men,Extortion,Male,18-30,3238,3208,30,3226,12
2003,Rural,Kerala,Property Crime,Burglary,Male,18-30,2239,298,1941,917,1322
2009,Urban,Delhi,Property Crime,Arson,Male,60+,5192,4937,255,5126,66
2010,Urban,Jammu & Kashmir,Crime Against Women,Domestic Violence,Female,13-17,6523,1818,4705,2141,4382
2005,Urban,Arunachal Pradesh,Crime Against Children,Child Abuse,Female,0-12,7325,5117,2208,6120,1205
2005,Rural,Maharashtra,Crime Against Children,Kidnapping,Male,0-12,9253,9115,138,9127,126
2005,Rural,Andhra Pradesh,Property Crime,Vandalism,Female,0-12,9992,1619,8373,6148,3844
2004,Urban,Goa,Crime Against Men,Robbery,Female,60+,767,431,336,489,278
2001,Urban,West Bengal,Crime Against Men,Extortion,Female,13-17,8498,5225,3273,5684,2814
2004,Rural,Karnataka,Crime Against Children,Child Abuse,Male,31-45,7111,641,6470,4539,2572
2003,Rural,Meghalaya,Other Crimes,Corruption,Male,18-30,7751,3218,4533,4459,3292
2005,Urban,Nagaland,Crime Against Children,Trafficking,Female,46-60,9635,8012,1623,8207,1428
2010,Rural,Rajasthan,Property Crime,Theft,Female,31-45,5258,3612,1646,4303,955
2005,Rural,Goa,Property Crime,Arson,Female,60+,915,863,52,897,18
2001,Urban,Tripura,Crime Against Women,Rape,Male,18-30,5806,4870,936,5314,492
2002,Urban,Tripura,Other Crimes,Cyber Crime,Male,46-60,4062,579,3483,3241,821
2007,Urban,Manipur,Other Crimes,Fraud,Male,18-30,4081,1753,2328,2489,1592
2010,Urban,Himachal Pradesh,Crime Against Women,Dowry Deaths,Female,46-60,8612,7570,1042,7632,980
2005,Rural,Nagaland,Crime Against Women,Dowry Deaths,Male,0-12,7377,1296,6081,3323,4054
2005,Urban,Haryana,Crime Against Women,Domestic Violence,Male,18-30,5137,3205,1932,3502,1635
2007,Urban,Chhattisgarh,Property Crime,Burglary,Female,31-45,6162,5732,430,6156,6
2004,Rural,Karnataka,Other Crimes,Cyber Crime,Female,31-45,3462,1274,2188,2375,1087
2009,Urban,Uttarakhand,Other Crimes,Cyber Crime,Male,13-17,1030,253,777,264,766
2001,Rural,Maharashtra,Property Crime,Burglary,Male,18-30,983,340,643,455,528
2005,Urban,Karnataka,Crime Against Women,Domestic Violence,Male,13-17,847,444,403,761,86
2010,Urban,Rajasthan,Crime Against Women,Molestation,Female,31-45,8356,685,7671,2646,5710
2004,Rural,Kerala,Crime Against Men,Extortion,Male,46-60,2296,1255,1041,1371,925
2006,Urban,Arunachal Pradesh,Other Crimes,Drug Offense,Male,31-45,7329,5885,1444,6254,1075
2002,Rural,Himachal Pradesh,Crime Against Children,Kidnapping,Male,0-12,5125,2426,2699,4940,185
2008,Urban,Jharkhand,Property Crime,Burglary,Male,60+,5447,1524,3923,4282,1165
2005,Urban,Tripura,Crime Against Women,Rape,Male,18-30,5856,5637,219,5712,144
2005,Urban,Karnataka,Other Crimes,Fraud,Female,13-17,4204,237,3967,3021,1183
2009,Urban,Punjab,Crime Against Children,Child Abuse,Female,13-17,5728,2298,3430,5074,654
2001,Urban,Kerala,Crime Against Women,Rape,Female,18-30,2153,1368,785,1913,240
2005,Rural,West Bengal,Crime Against Men,Murder,Female,31-45,8317,7051,1266,7770,547
2009,Urban,Delhi,Crime Against Children,Child Labor,Female,31-45,1248,75,1173,355,893
2007,Rural,Haryana,Property Crime,Arson,Female,0-12,4603,3439,1164,3993,610
2005,Urban,Haryana,Crime Against Men,Assault,Male,46-60,3888,3878,10,3885,3
2004,Urban,Nagaland,Other Crimes,Corruption,Female,60+,2804,2487,317,2630,174
2004,Urban,Punjab,Crime Against Men,Assault,Male,46-60,6139,1754,4385,3111,3028
2008,Urban,Manipur,Other Crimes,Corruption,Female,13-17,8245,2844,5401,8160,85
2007,Urban,Punjab,Crime Against Children,Child Labor,Male,31-45,6195,4983,1212,5850,345
2007,Urban,Rajasthan,Property Crime,Theft,Male,31-45,2119,1182,937,1615,504
2009,Urban,Nagaland,Crime Against Women,Domestic Violence,Female,46-60,9621,721,8900,780,8841
2010,Rural,Sikkim,Other Crimes,Fraud,Male,0-12,121,35,86,110,11
2007,Rural,Chhattisgarh,Crime Against Men,Murder,Male,60+,5768,5677,91,5748,20
2009,Urban,Chhattisgarh,Crime Against Men,Robbery,Female,18-30,3747,1044,2703,3423,324
2010,Rural,Goa,Crime Against Women,Molestation,Female,46-60,8932,2922,6010,5077,3855
2005,Rural,Haryana,Other Crimes,Fraud,Male,0-12,6593,3784,2809,6385,208
2004,Rural,Delhi,Other Crimes,Cyber Crime,Female,60+,292,150,142,257,35
2005,Rural,Punjab,Other Crimes,Corruption,Female,13-17,7909,3876,4033,4113,3796
2004,Rural,Rajasthan,Crime Against Men,Murder,Male,31-45,6482,5551,931,5555,927
2005,Urban,Sikkim,Crime Against Children,Child Abuse,Female,0-12,5711,912,4799,2836,2875
2002,Rural,Himachal Pradesh,Property Crime,Vandalism,Male,46-60,8093,6219,1874,7936,157
2005,Urban,Andhra Pradesh,Property Crime,Burglary,Male,13-17,6139,556,5583,5074,1065
2007,Rural,Madhya Pradesh,Crime Against Men,Murder,Female,31-45,7172,1369,5803,6716,456
2005,Rural,Goa,Crime Against Men,Assault,Male,0-12,3969,621,3348,3728,241
2009,Rural,Tripura,Crime Against Children,Child Labor,Female,46-60,1362,1296,66,1339,23
2008,Rural,Karnataka,Property Crime,Arson,Female,0-12,283,176,107,241,42
2002,Rural,Maharashtra,Property Crime,Arson,Male,13-17,4043,1756,2287,2641,1402
2010,Rural,Karnataka,Crime Against Women,Dowry Deaths,Female,31-45,3108,186,2922,427,2681
2006,Rural,Maharashtra,Property Crime,Vandalism,Male,13-17,2551,2377,174,2488,63
2002,Rural,Tamil Nadu,Crime Against Women,Domestic Violence,Male,13-17,8458,2080,6378,7235,1223
2007,Rural,Arunachal Pradesh,Property Crime,Burglary,Male,13-17,932,85,847,319,613
2003,Rural,Assam,Crime Against Women,Dowry Deaths,Female,0-12,2689,1922,767,2425,264
2003,Rural,Meghalaya,Crime Against Men,Assault,Female,13-17,3507,2456,1051,3206,301
2010,Rural,Goa,Other Crimes,Drug Offense,Female,31-45,8916,8050,866,8902,14
2006,Rural,Assam,Other Crimes,Cyber Crime,Female,18-30,6965,2522,4443,3219,3746
2010,Rural,Meghalaya,Crime Against Women,Domestic Violence,Male,60+,5838,5191,647,5422,416
2004,Urban,Manipur,Other Crimes,Fraud,Male,13-17,1589,553,1036,1051,538
2007,Rural,Tripura,Property Crime,Burglary,Female,60+,9335,7678,1657,8412,923
2006,Rural,Sikkim,Crime Against Women,Dowry Deaths,Female,46-60,9395,3830,5565,8889,506
2003,Rural,Himachal Pradesh,Crime Against Women,Dowry Deaths,Female,13-17,9828,3828,6000,8150,1678
2010,Rural,Meghalaya,Property Crime,Theft,Male,0-12,924,537,387,766,158
2002,Rural,Andhra Pradesh,Property Crime,Arson,Male,31-45,7507,6564,943,6569,938
2004,Urban,Punjab,Crime Against Men,Murder,Male,60+,6974,1127,5847,1391,5583
2001,Urban,Haryana,Crime Against Children,Trafficking,Male,31-45,3126,228,2898,2333,793
2004,Rural,Tripura,Other Crimes,Drug Offense,Male,31-45,5068,1705,3363,3310,1758
2004,Urban,Jammu & Kashmir,Crime Against Children,Trafficking,Male,18-30,7013,2439,4574,4980,2033
2009,Rural,Chhattisgarh,Other Crimes,Cyber Crime,Female,46-60,275,201,74,250,25
2005,Urban,Karnataka,Crime Against Women,Dowry Deaths,Male,13-17,1757,1233,524,1494,263
2005,Rural,Kerala,Crime Against Women,Molestation,Female,31-45,8808,4649,4159,5859,2949
2007,Urban,Rajasthan,Other Crimes,Corruption,Female,18-30,3170,2110,1060,2653,517
2006,Urban,Karnataka,Property Crime,Theft,Male,0-12,1371,1097,274,1327,44
2008,Urban,Madhya Pradesh,Property Crime,Theft,Male,13-17,7938,4698,3240,4940,2998
2008,Rural,Jammu & Kashmir,Crime Against Children,Kidnapping,Female,18-30,2336,1678,658,1962,374
2003,Urban,Andhra Pradesh,Property Crime,Burglary,Female,0-12,8683,105,8578,4835,3848
2002,Rural,Manipur,Property Crime,Burglary,Male,13-17,2207,173,2034,450,1757
2001,Urban,Odisha,Crime Against Children,Trafficking,Female,18-30,6763,1021,5742,4691,2072
2003,Rural,West Bengal,Crime Against Women,Molestation,Male,46-60,8496,3215,5281,6368,2128
2003,Rural,Telangana,Crime Against Women,Dowry Deaths,Male,0-12,6434,6374,60,6430,4
2009,Urban,Delhi,Crime Against Women,Rape,Female,46-60,5950,3235,2715,3427,2523
2008,Urban,Haryana,Crime Against Women,Molestation,Female,18-30,8354,4671,3683,5154,3200
2009,Rural,Jammu & Kashmir,Crime Against Women,Rape,Male,60+,1155,1148,7,1155,0
2010,Rural,Assam,Crime Against Children,Trafficking,Male,18-30,4227,252,3975,1171,3056
2002,Rural,Assam,Crime Against Men,Murder,Female,31-45,2463,418,2045,1960,503
2003,Urban,Meghalaya,Property Crime,Vandalism,Male,13-17,6952,6735,217,6877,75
2008,Rural,Chhattisgarh,Property Crime,Arson,Male,31-45,5746,3985,1761,5111,635
2002,Rural,Telangana,Crime Against Women,Molestation,Male,18-30,4894,892,4002,2768,2126
2010,Rural,Himachal Pradesh,Crime Against Women,Molestation,Male,46-60,1529,483,1046,561,968
2008,Urban,Uttarakhand,Crime Against Children,Kidnapping,Male,18-30,5625,3660,1965,5499,126
2001,Urban,Kerala,Crime Against Men,Extortion,Female,0-12,6974,2196,4778,3923,3051
2007,Rural,West Bengal,Other Crimes,Cyber Crime,Male,13-17,9651,6004,3647,6674,2977
2009,Rural,Maharashtra,Crime Against Men,Assault,Male,60+,2226,171,2055,1514,712
2001,Rural,Odisha,Crime Against Men,Extortion,Male,18-30,506,461,45,466,40
2002,Rural,Punjab,Other Crimes,Corruption,Female,13-17,6731,4323,2408,6100,631
2004,Urban,Maharashtra,Crime Against Women,Dowry Deaths,Male,46-60,9526,7702,1824,8039,1487
2001,Rural,Odisha,Property Crime,Vandalism,Male,46-60,9700,5620,4080,9666,34
2003,Rural,Andhra Pradesh,Crime Against Women,Molestation,Male,46-60,8358,2248,6110,4378,3980
2006,Urban,Himachal Pradesh,Property Crime,Arson,Male,60+,5229,4899,330,4972,257
2009,Rural,Haryana,Crime Against Children,Trafficking,Female,60+,3040,2052,988,2457,583
2010,Rural,Delhi,Crime Against Men,Extortion,Female,60+,2139,66,2073,1504,635
2007,Urban,Bihar,Crime Against Men,Assault,Male,31-45,9822,7459,2363,7893,1929
2004,Urban,Mizoram,Crime Against Men,Extortion,Female,60+,422,191,231,278,144
2002,Rural,Chhattisgarh,Crime Against Men,Assault,Female,0-12,9849,4448,5401,9293,556
2006,Rural,Jharkhand,Crime Against Women,Dowry Deaths,Male,60+,9147,2306,6841,5966,3181
2002,Urban,Maharashtra,Crime Against Men,Extortion,Male,18-30,4778,3804,974,4676,102
2001,Urban,Jharkhand,Crime Against Men,Robbery,Female,0-12,4975,101,4874,1797,3178
2001,Rural,Telangana,Crime Against Men,Robbery,Female,31-45,2307,2111,196,2236,71
2007,Rural,Assam,Crime Against Women,Dowry Deaths,Female,18-30,4887,1627,3260,2981,1906
2004,Urban,Andhra Pradesh,Property Crime,Burglary,Female,0-12,2571,364,2207,576,1995
2002,Urban,West Bengal,Other Crimes,Cyber Crime,Female,0-12,412,18,394,198,214
2010,Rural,Maharashtra,Crime Against Children,Trafficking,Male,60+,997,458,539,499,498
2009,Urban,Madhya Pradesh,Crime Against Women,Molestation,Male,46-60,4156,1337,2819,1472,2684
2002,Rural,Delhi,Crime Against Men,Robbery,Female,18-30,8012,6410,1602,7007,1005
2006,Rural,West Bengal,Crime Against Women,Domestic Violence,Male,60+,2894,1342,1552,2501,393
2008,Rural,Uttarakhand,Other Crimes,Drug Offense,Male,60+,8271,3505,4766,8111,160
2010,Rural,Meghalaya,Crime Against Women,Dowry Deaths,Male,18-30,5604,3214,2390,4589,1015
2002,Urban,Punjab,Property Crime,Vandalism,Male,31-45,1101,288,813,524,577
2008,Urban,Delhi,Crime Against Children,Child Abuse,Female,0-12,5246,4988,258,5239,7
2009,Rural,Meghalaya,Property Crime,Arson,Male,18-30,3281,2336,945,2493,788
2002,Rural,Karnataka,Crime Against Men,Murder,Female,18-30,7277,6860,417,7134,143
2007,Rural,Andhra Pradesh,Crime Against Men,Murder,Male,0-12,1403,750,653,1005,398
2001,Rural,Madhya Pradesh,Other Crimes,Cyber Crime,Female,13-17,8509,8423,86,8500,9
2007,Rural,Uttarakhand,Property Crime,Vandalism,Male,60+,2177,711,1466,1448,729
2003,Urban,Goa,Crime Against Women,Rape,Female,18-30,6815,3679,3136,6423,392
2003,Urban,Assam,Crime Against Women,Molestation,Male,13-17,5165,4201,964,4295,870
2001,Urban,Kerala,Property Crime,Burglary,Male,46-60,5288,4879,409,5169,119
2005,Urban,Andhra Pradesh,Crime Against Women,Rape,Female,46-60,7905,4560,3345,6092,1813
2002,Rural,Himachal Pradesh,Property Crime,Burglary,Female,18-30,4643,1272,3371,4621,22
2009,Rural,Meghalaya,Property Crime,Theft,Male,46-60,1841,783,1058,1809,32
2004,Rural,Telangana,Crime Against Women,Molestation,Male,0-12,182,177,5,181,1
2007,Rural,Telangana,Crime Against Women,Dowry Deaths,Male,18-30,6670,5000,1670,5866,804
2006,Rural,Mizoram,Crime Against Children,Child Abuse,Female,31-45,8049,2935,5114,3200,4849
2006,Urban,Odisha,Property Crime,Vandalism,Male,46-60,7295,5929,1366,6629,666
2004,Urban,Jammu & Kashmir,Crime Against Women,Domestic Violence,Female,18-30,2583,111,2472,2434,149
2005,Rural,Tripura,Property Crime,Burglary,Female,31-45,8014,453,7561,6065,1949
2002,Rural,Telangana,Crime Against Men,Extortion,Female,0-12,5614,3987,1627,4704,910
2005,Rural,Gujarat,Crime Against Women,Domestic Violence,Male,60+,3187,972,2215,2776,411
2001,Urban,Rajasthan,Crime Against Men,Assault,Female,46-60,7764,2776,4988,6455,1309
2009,Rural,Madhya Pradesh,Crime Against Children,Trafficking,Male,46-60,6528,1415,5113,4481,2047
2010,Urban,Rajasthan,Crime Against Children,Child Labor,Female,0-12,4082,2863,1219,3429,653
2010,Rural,Arunachal Pradesh,Crime Against Children,Trafficking,Female,60+,1846,1767,79,1798,48
2003,Rural,Odisha,Property Crime,Arson,Male,18-30,3440,654,2786,1627,1813
2010,Rural,Nagaland,Other Crimes,Fraud,Male,18-30,2995,2399,596,2760,235
2004,Rural,Uttar Pradesh,Crime Against Women,Molestation,Male,31-45,5243,2101,3142,2926,2317
2008,Rural,Karnataka,Crime Against Men,Extortion,Female,13-17,1143,144,999,317,826
2008,Rural,Tamil Nadu,Other Crimes,Cyber Crime,Male,46-60,9291,9115,176,9261,30
2001,Rural,Tripura,Crime Against Children,Child Labor,Female,60+,60,19,41,46,14
2007,Rural,Uttar Pradesh,Crime Against Women,Molestation,Female,18-30,1831,553,1278,1336,495
2009,Rural,Haryana,Crime Against Women,Molestation,Male,46-60,1961,1823,138,1852,109
2002,Rural,Nagaland,Crime Against Children,Kidnapping,Male,0-12,2423,352,2071,1728,695
2004,Rural,Tamil Nadu,Crime Against Men,Murder,Male,46-60,7872,256,7616,7243,629
2007,Rural,Gujarat,Crime Against Children,Kidnapping,Female,60+,4618,1593,3025,2118,2500
2001,Urban,Goa,Crime Against Men,Assault,Female,46-60,8916,1666,7250,2116,6800
2003,Rural,Odisha,Crime Against Children,Kidnapping,Male,31-45,6273,3976,2297,5167,1106
2010,Rural,Gujarat,Crime Against Women,Molestation,Male,18-30,7386,512,6874,2475,4911
2006,Rural,Gujarat,Crime Against Women,Domestic Violence,Male,0-12,5969,5440,529,5833,136
2006,Rural,Mizoram,Crime Against Children,Child Labor,Male,46-60,2399,2096,303,2231,168
2004,Urban,Odisha,Other Crimes,Drug Offense,Female,13-17,8722,5686,3036,5921,2801
2005,Rural,Tripura,Property Crime,Theft,Male,46-60,8404,6034,2370,7222,1182
2007,Rural,Manipur,Property Crime,Vandalism,Female,60+,3059,198,2861,2751,308
2010,Rural,Karnataka,Other Crimes,Drug Offense,Male,0-12,6221,4157,2064,5905,316
2004,Urban,Madhya Pradesh,Property Crime,Burglary,Male,60+,2152,396,1756,929,1223
2002,Urban,Odisha,Crime Against Children,Trafficking,Male,31-45,178,178,0,178,0
2010,Rural,Uttarakhand,Crime Against Men,Robbery,Female,0-12,7551,5752,1799,5842,1709
2010,Urban,Mizoram,Crime Against Men,Extortion,Female,18-30,5865,2209,3656,3048,2817
2007,Rural,Maharashtra,Crime Against Men,Extortion,Male,18-30,2498,2235,263,2460,38
2007,Urban,Assam,Other Crimes,Fraud,Male,31-45,9286,6269,3017,7991,1295
2005,Urban,Tripura,Crime Against Men,Extortion,Male,31-45,7712,2053,5659,2465,5247
2002,Urban,Goa,Crime Against Women,Dowry Deaths,Male,13-17,5630,2580,3050,4859,771
2001,Rural,Gujarat,Crime Against Women,Rape,Male,31-45,6123,4673,1450,6112,11
2005,Rural,Gujarat,Crime Against Children,Child Abuse,Male,18-30,203,39,164,46,157
2001,Urban,Jharkhand,Other Crimes,Drug Offense,Male,18-30,2803,1658,1145,2531,272
2001,Rural,Punjab,Other Crimes,Cyber Crime,Male,0-12,843,577,266,598,245
2003,Rural,Jharkhand,Crime Against Children,Trafficking,Female,13-17,7519,3323,4196,4049,3470
2004,Urban,Sikkim,Crime Against Children,Child Labor,Female,31-45,9361,6348,3013,8768,593
2002,Rural,Telangana,Other Crimes,Cyber Crime,Female,18-30,4889,2560,2329,4852,37
2005,Urban,Arunachal Pradesh,Property Crime,Arson,Female,60+,8045,7484,561,8020,25
2009,Urban,Meghalaya,Crime Against Men,Robbery,Female,46-60,8024,714,7310,7249,775
2005,Urban,Telangana,Crime Against Children,Trafficking,Female,18-30,4175,2146,2029,3558,617
2004,Rural,Jharkhand,Other Crimes,Corruption,Male,60+,3677,1227,2450,2162,1515
2003,Rural,Uttarakhand,Crime Against Women,Molestation,Female,46-60,1441,1243,198,1245,196
2003,Urban,Tripura,Crime Against Men,Robbery,Female,31-45,9923,5315,4608,6718,3205
2006,Urban,Nagaland,Crime Against Children,Trafficking,Female,60+,4797,891,3906,2027,2770
2008,Urban,Delhi,Crime Against Women,Rape,Female,60+,760,362,398,715,45
2010,Rural,Punjab,Property Crime,Theft,Female,0-12,7005,3092,3913,6240,765
2004,Urban,Goa,Crime Against Women,Rape,Male,31-45,9467,6846,2621,9243,224
2002,Rural,Kerala,Property Crime,Theft,Male,60+,9703,2974,6729,9037,666
2006,Rural,Uttar Pradesh,Property Crime,Arson,Female,46-60,8718,5089,3629,7646,1072
2009,Urban,Rajasthan,Crime Against Women,Domestic Violence,Male,18-30,4142,2742,1400,2853,1289
2005,Urban,Tripura,Property Crime,Burglary,Female,18-30,5417,3379,2038,4959,458
2008,Rural,Delhi,Crime Against Men,Extortion,Male,31-45,2803,354,2449,779,2024
2008,Urban,Uttar Pradesh,Crime Against Women,Molestation,Female,13-17,5081,2491,2590,3121,1960
2008,Urban,Himachal Pradesh,Crime Against Men,Extortion,Female,0-12,8874,4970,3904,8807,67
2004,Rural,Madhya Pradesh,Crime Against Children,Trafficking,Male,60+,4957,1448,3509,2155,2802
2002,Urban,Assam,Crime Against Children,Child Labor,Male,60+,7690,2203,5487,5018,2672
2004,Rural,Tripura,Other Crimes,Cyber Crime,Female,13-17,8212,5748,2464,5767,2445
2008,Rural,Madhya Pradesh,Crime Against Women,Domestic Violence,Female,18-30,122,96,26,115,7
2004,Rural,Tamil Nadu,Property Crime,Burglary,Female,18-30,237,26,211,236,1
2002,Urban,Sikkim,Other Crimes,Corruption,Male,31-45,9394,1744,7650,5037,4357
2006,Urban,Nagaland,Property Crime,Vandalism,Female,18-30,8459,424,8035,6957,1502
2004,Urban,Gujarat,Crime Against Men,Robbery,Female,46-60,242,6,236,120,122
2007,Urban,Meghalaya,Property Crime,Burglary,Male,31-45,650,168,482,507,143
2003,Rural,Goa,Property Crime,Vandalism,Male,0-12,5488,209,5279,949,4539
2006,Urban,Karnataka,Property Crime,Burglary,Male,60+,7813,4153,3660,7245,568
2010,Urban,Gujarat,Other Crimes,Drug Offense,Male,60+,9828,4630,5198,8032,1796
2010,Rural,Gujarat,Other Crimes,Corruption,Male,46-60,8930,4805,4125,5666,3264
2010,Urban,Tripura,Other Crimes,Corruption,Male,46-60,664,144,520,193,471
2010,Rural,Odisha,Property Crime,Burglary,Male,18-30,4960,3525,1435,3774,1186
2009,Rural,Goa,Crime Against Women,Dowry Deaths,Female,60+,622,213,409,601,21
2008,Urban,Gujarat,Crime Against Men,Extortion,Female,18-30,3378,2853,525,3373,5
2003,Urban,Tamil Nadu,Crime Against Men,Assault,Male,13-17,3158,3108,50,3124,34
2008,Rural,Karnataka,Crime Against Children,Child Labor,Male,0-12,9732,162,9570,7707,2025
2010,Rural,Tripura,Crime Against Men,Robbery,Female,60+,5928,1600,4328,1956,3972
2006,Urban,Chhattisgarh,Crime Against Children,Child Abuse,Male,31-45,9002,6849,2153,7955,1047
2005,Rural,Assam,Crime Against Women,Domestic Violence,Male,31-45,880,186,694,371,509
2009,Rural,Himachal Pradesh,Property Crime,Arson,Female,46-60,7040,1350,5690,2639,4401
2001,Urban,Uttar Pradesh,Crime Against Women,Molestation,Female,46-60,8692,3037,5655,8378,314
2002,Rural,Odisha,Crime Against Men,Extortion,Female,13-17,9631,5936,3695,8842,789
2004,Urban,Karnataka,Property Crime,Burglary,Male,13-17,3301,414,2887,1148,2153
2008,Urban,Bihar,Crime Against Women,Molestation,Male,46-60,6140,6002,138,6071,69
2009,Urban,Tripura,Crime Against Men,Murder,Male,18-30,1170,640,530,955,215
2010,Urban,Meghalaya,Crime Against Children,Child Labor,Male,18-30,5510,3167,2343,5052,458
2002,Urban,Uttarakhand,Other Crimes,Fraud,Male,0-12,1448,370,1078,508,940
2004,Rural,Odisha,Property Crime,Arson,Male,31-45,925,436,489,536,389
2006,Rural,Gujarat,Crime Against Children,Child Labor,Male,46-60,790,666,124,781,9
2010,Urban,Delhi,Crime Against Children,Trafficking,Male,60+,8344,529,7815,7296,1048
2001,Urban,Jammu & Kashmir,Crime Against Women,Molestation,Female,18-30,8640,3960,4680,4119,4521
2004,Rural,Manipur,Other Crimes,Cyber Crime,Male,18-30,4208,3807,401,4100,108
2007,Urban,Tamil Nadu,Property Crime,Arson,Female,18-30,1494,1412,82,1428,66
2002,Urban,Arunachal Pradesh,Crime Against Children,Trafficking,Male,0-12,4672,3343,1329,3629,1043
2005,Urban,Mizoram,Crime Against Children,Child Abuse,Female,46-60,262,25,237,51,211
2010,Rural,Kerala,Crime Against Children,Kidnapping,Male,0-12,6326,2045,4281,5293,1033
2007,Rural,Arunachal Pradesh,Crime Against Men,Extortion,Male,46-60,9207,1807,7400,2079,7128
2009,Urban,Odisha,Property Crime,Arson,Female,18-30,4371,1207,3164,2743,1628
2008,Urban,Bihar,Crime Against Women,Rape,Female,13-17,7644,2203,5441,7332,312
2010,Rural,Chhattisgarh,Crime Against Men,Robbery,Female,0-12,2096,1891,205,2093,3
2003,Urban,Tripura,Crime Against Children,Child Labor,Male,13-17,9740,7320,2420,8773,967
2006,Urban,Bihar,Crime Against Women,Dowry Deaths,Female,60+,6668,4713,1955,5166,1502
2010,Rural,Tamil Nadu,Crime Against Women,Molestation,Male,18-30,9827,3136,6691,7496,2331
2004,Rural,Arunachal Pradesh,Crime Against Children,Trafficking,Male,60+,7329,6322,1007,6748,581
2009,Rural,Arunachal Pradesh,Property Crime,Vandalism,Female,46-60,321,20,301,32,289
2006,Rural,Tamil Nadu,Property Crime,Vandalism,Male,0-12,9751,446,9305,7501,2250
2009,Urban,Mizoram,Other Crimes,Drug Offense,Female,46-60,2275,201,2074,703,1572
2010,Urban,Meghalaya,Crime Against Children,Kidnapping,Male,46-60,2522,2119,403,2298,224
2004,Rural,Himachal Pradesh,Property Crime,Burglary,Male,46-60,3585,1747,1838,3169,416
2008,Rural,Telangana,Crime Against Men,Assault,Female,13-17,4143,597,3546,2881,1262
2009,Rural,Himachal Pradesh,Other Crimes,Fraud,Female,13-17,4872,1028,3844,2716,2156
2003,Urban,Himachal Pradesh,Crime Against Men,Murder,Female,31-45,3497,2889,608,3169,328
2005,Urban,Goa,Crime Against Men,Robbery,Female,13-17,7223,680,6543,5668,1555
2001,Rural,Gujarat,Crime Against Men,Murder,Male,18-30,7128,2405,4723,2701,4427
2002,Rural,Arunachal Pradesh,Crime Against Men,Robbery,Female,31-45,6788,224,6564,6494,294
2007,Rural,Maharashtra,Crime Against Children,Child Abuse,Female,46-60,4190,2033,2157,3844,346
2004,Urban,Andhra Pradesh,Property Crime,Arson,Female,60+,2416,2001,415,2140,276
2004,Rural,Delhi,Crime Against Children,Child Labor,Male,46-60,1115,642,473,701,414
2007,Urban,Himachal Pradesh,Crime Against Children,Kidnapping,Female,60+,3315,1295,2020,1700,1615
2006,Urban,Arunachal Pradesh,Property Crime,Vandalism,Male,0-12,4266,115,4151,1754,2512
2001,Urban,Andhra Pradesh,Other Crimes,Drug Offense,Female,13-17,7267,313,6954,6299,968
2004,Rural,Tamil Nadu,Property Crime,Burglary,Male,0-12,7256,83,7173,4142,3114
2001,Urban,Mizoram,Other Crimes,Fraud,Female,46-60,7512,4937,2575,5164,2348
2009,Urban,Arunachal Pradesh,Crime Against Children,Kidnapping,Male,46-60,696,425,271,510,186
2004,Rural,Jharkhand,Crime Against Women,Domestic Violence,Male,13-17,4294,3465,829,3478,816
2001,Urban,Goa,Property Crime,Theft,Male,31-45,8418,739,7679,2745,5673
2004,Urban,Manipur,Crime Against Children,Trafficking,Female,31-45,2249,250,1999,789,1460
2002,Rural,Chhattisgarh,Crime Against Children,Trafficking,Female,60+,2663,2261,402,2410,253
2007,Rural,Chhattisgarh,Property Crime,Theft,Female,18-30,6107,2451,3656,5501,606
2007,Urban,Bihar,Other Crimes,Fraud,Female,18-30,4121,1860,2261,1871,2250
2004,Rural,West Bengal,Other Crimes,Drug Offense,Male,0-12,2282,232,2050,1717,565
2010,Rural,Goa,Crime Against Men,Robbery,Male,18-30,6027,829,5198,5415,612
2002,Urban,Punjab,Crime Against Women,Molestation,Male,60+,1170,883,287,909,261
2010,Urban,Mizoram,Property Crime,Theft,Female,46-60,6938,4270,2668,4673,2265
2010,Urban,Mizoram,Property Crime,Vandalism,Male,0-12,5340,127,5213,2415,2925
2006,Urban,Arunachal Pradesh,Other Crimes,Drug Offense,Female,18-30,5694,5168,526,5568,126
2006,Rural,Rajasthan,Other Crimes,Corruption,Male,13-17,5434,191,5243,1745,3689
2001,Rural,Chhattisgarh,Crime Against Women,Molestation,Female,0-12,6500,1787,4713,4385,2115
2005,Urban,Tamil Nadu,Crime Against Men,Extortion,Female,60+,4090,3379,711,3848,242
2008,Urban,Telangana,Property Crime,Theft,Female,13-17,8414,3218,5196,4920,3494
2001,Rural,Haryana,Crime Against Children,Kidnapping,Male,18-30,6350,5052,1298,6139,211
2005,Rural,Rajasthan,Crime Against Women,Molestation,Male,18-30,5678,4744,934,5271,407
2003,Urban,Karnataka,Crime Against Children,Trafficking,Male,31-45,7695,247,7448,4528,3167
2009,Rural,Uttarakhand,Crime Against Children,Trafficking,Male,31-45,6208,5815,393,6090,118
2004,Rural,Telangana,Property Crime,Vandalism,Female,46-60,4278,1788,2490,2647,1631
2004,Rural,Andhra Pradesh,Crime Against Men,Assault,Male,13-17,3765,620,3145,1324,2441
2006,Rural,Karnataka,Other Crimes,Drug Offense,Male,46-60,4116,2779,1337,3538,578
2006,Urban,Assam,Crime Against Children,Child Abuse,Female,46-60,2186,53,2133,1525,661
2005,Urban,Gujarat,Crime Against Children,Child Labor,Male,13-17,2577,697,1880,726,1851
2010,Urban,Gujarat,Other Crimes,Cyber Crime,Male,46-60,6610,1538,5072,6174,436
2006,Rural,Arunachal Pradesh,Crime Against Children,Kidnapping,Female,60+,1013,550,463,676,337
2008,Urban,Telangana,Crime Against Men,Murder,Female,31-45,8570,4357,4213,8257,313
2007,Urban,Kerala,Crime Against Children,Trafficking,Female,13-17,4540,642,3898,890,3650
2007,Rural,Meghalaya,Crime Against Children,Child Abuse,Male,60+,4589,375,4214,980,3609
2002,Rural,Jharkhand,Crime Against Men,Robbery,Male,0-12,8240,4896,3344,6907,1333
2010,Urban,Jharkhand,Crime Against Men,Murder,Male,31-45,975,905,70,929,46
2002,Rural,Himachal Pradesh,Crime Against Children,Child Abuse,Male,60+,4012,368,3644,1312,2700
2001,Urban,Odisha,Crime Against Men,Extortion,Male,60+,8932,1201,7731,6503,2429
2005,Urban,Gujarat,Crime Against Children,Child Abuse,Female,13-17,8846,1005,7841,1041,7805
2001,Urban,Tripura,Crime Against Women,Domestic Violence,Female,0-12,9195,3951,5244,6499,2696
2006,Rural,Uttar Pradesh,Crime Against Children,Child Labor,Female,60+,3322,2348,974,2823,499
2005,Rural,Manipur,Crime Against Women,Rape,Male,18-30,1541,1133,408,1239,302
2006,Rural,Nagaland,Crime Against Men,Extortion,Male,18-30,1253,1036,217,1131,122
2005,Urban,Jharkhand,Other Crimes,Fraud,Male,46-60,5555,4294,1261,5482,73
2007,Urban,Mizoram,Crime Against Women,Domestic Violence,Female,31-45,8649,6569,2080,6672,1977
2008,Urban,Rajasthan,Property Crime,Vandalism,Female,0-12,3860,2926,934,3467,393
2001,Rural,West Bengal,Crime Against Women,Domestic Violence,Male,60+,2010,305,1705,710,1300
2005,Rural,Tamil Nadu,Other Crimes,Cyber Crime,Male,46-60,4752,3566,1186,3615,1137
2009,Rural,Punjab,Property Crime,Vandalism,Female,46-60,6469,1581,4888,5871,598
2001,Urban,Tamil Nadu,Property Crime,Theft,Female,31-45,3978,1474,2504,2236,1742
2004,Rural,Delhi,Crime Against Women,Molestation,Male,46-60,6068,3213,2855,3243,2825
2008,Urban,Tamil Nadu,Property Crime,Theft,Female,0-12,8080,5826,2254,7609,471
2008,Urban,Mizoram,Crime Against Women,Dowry Deaths,Female,60+,9346,5017,4329,7424,1922
2007,Urban,Tripura,Crime Against Women,Molestation,Female,18-30,5373,2694,2679,4797,576
2009,Urban,Arunachal Pradesh,Property Crime,Burglary,Male,0-12,9681,8870,811,9272,409
2008,Rural,Odisha,Crime Against Men,Murder,Male,0-12,607,264,343,391,216
2001,Urban,Nagaland,Other Crimes,Fraud,Male,13-17,7797,3582,4215,4522,3275
2007,Rural,Maharashtra,Other Crimes,Cyber Crime,Female,18-30,9894,5684,4210,6219,3675
2003,Urban,Telangana,Crime Against Women,Domestic Violence,Female,0-12,5777,3668,2109,5375,402
2007,Rural,Tripura,Crime Against Women,Molestation,Male,18-30,3889,3712,177,3772,117
2005,Rural,Tamil Nadu,Crime Against Men,Extortion,Male,60+,555,71,484,216,339
2001,Urban,Uttar Pradesh,Crime Against Men,Murder,Male,46-60,4820,2512,2308,3911,909
2001,Rural,Arunachal Pradesh,Crime Against Men,Robbery,Female,18-30,4222,3068,1154,3605,617
2009,Rural,Punjab,Crime Against Women,Rape,Male,60+,8874,1930,6944,3370,5504
2004,Rural,Delhi,Crime Against Men,Assault,Male,18-30,2517,951,1566,1698,819
2007,Rural,Tripura,Other Crimes,Fraud,Female,18-30,3460,3337,123,3405,55
2004,Rural,Nagaland,Property Crime,Vandalism,Female,13-17,2908,1786,1122,1976,932
2003,Rural,Nagaland,Crime Against Women,Dowry Deaths,Male,31-45,7351,6999,352,7148,203
2004,Rural,Mizoram,Property Crime,Arson,Female,46-60,9563,7611,1952,9327,236
2003,Urban,Mizoram,Property Crime,Vandalism,Female,18-30,1885,150,1735,1853,32
2002,Urban,Nagaland,Crime Against Women,Molestation,Female,0-12,1670,411,1259,1455,215
2003,Urban,Karnataka,Other Crimes,Drug Offense,Female,18-30,4236,967,3269,3661,575
2007,Urban,Tamil Nadu,Property Crime,Vandalism,Male,31-45,2633,504,2129,513,2120
2007,Rural,Assam,Property Crime,Theft,Female,31-45,8210,4989,3221,8126,84
2004,Rural,Gujarat,Crime Against Children,Trafficking,Male,31-45,7118,2694,4424,7020,98
2007,Urban,Meghalaya,Crime Against Men,Robbery,Male,60+,2290,1469,821,1938,352
2009,Rural,Chhattisgarh,Crime Against Children,Kidnapping,Female,13-17,7895,6851,1044,6882,1013
2002,Rural,Kerala,Property Crime,Burglary,Male,60+,2407,1808,599,2246,161
2002,Rural,Rajasthan,Property Crime,Arson,Female,60+,9289,6487,2802,7617,1672
2001,Urban,Arunachal Pradesh,Crime Against Men,Murder,Male,18-30,7451,6268,1183,7130,321
2007,Urban,Mizoram,Crime Against Women,Rape,Male,46-60,4828,1830,2998,2712,2116
2001,Urban,Sikkim,Crime Against Children,Child Abuse,Male,60+,8296,4480,3816,7537,759
2009,Urban,Goa,Property Crime,Theft,Female,60+,4305,3612,693,4138,167
2007,Urban,Meghalaya,Crime Against Children,Child Labor,Female,60+,3259,1571,1688,1750,1509
2009,Rural,Arunachal Pradesh,Property Crime,Vandalism,Female,31-45,682,629,53,643,39
2010,Rural,Tripura,Other Crimes,Drug Offense,Male,0-12,116,12,104,66,50
2006,Rural,Mizoram,Property Crime,Vandalism,Female,13-17,4781,1180,3601,2134,2647
2009,Urban,Goa,Other Crimes,Fraud,Male,31-45,3534,1726,1808,2864,670
2008,Rural,Meghalaya,Property Crime,Theft,Female,13-17,5164,4498,666,4506,658
2003,Rural,Kerala,Crime Against Women,Molestation,Female,0-12,2309,1394,915,1475,834
2007,Rural,Uttar Pradesh,Crime Against Children,Child Abuse,Female,46-60,1853,755,1098,898,955
2008,Rural,Kerala,Other Crimes,Cyber Crime,Male,46-60,6684,1696,4988,4939,1745
2008,Rural,Punjab,Crime Against Men,Assault,Male,60+,1064,799,265,873,191
2003,Rural,Uttar Pradesh,Other Crimes,Corruption,Male,13-17,2962,2041,921,2650,312
2008,Urban,Meghalaya,Crime Against Women,Rape,Male,60+,6176,5474,702,5827,349
2003,Urban,Jharkhand,Property Crime,Theft,Female,46-60,6658,2804,3854,4907,1751
2006,Rural,Assam,Crime Against Men,Assault,Female,31-45,7440,6665,775,7440,0
2008,Urban,Manipur,Other Crimes,Drug Offense,Male,31-45,8254,996,7258,6732,1522
2006,Urban,Himachal Pradesh,Property Crime,Burglary,Male,46-60,2929,2889,40,2913,16
2007,Rural,Gujarat,Other Crimes,Cyber Crime,Female,18-30,6052,2048,4004,2249,3803
2001,Urban,Maharashtra,Crime Against Women,Dowry Deaths,Female,31-45,3649,2440,1209,3643,6
2006,Rural,Jammu & Kashmir,Crime Against Children,Trafficking,Female,60+,6506,4452,2054,5924,582
2002,Urban,Madhya Pradesh,Property Crime,Theft,Female,13-17,4847,2186,2661,2615,2232
2008,Rural,Mizoram,Property Crime,Arson,Male,13-17,9150,5036,4114,6812,2338
2008,Urban,Himachal Pradesh,Other Crimes,Fraud,Male,31-45,3800,1714,2086,3755,45
2008,Urban,Himachal Pradesh,Crime Against Women,Molestation,Male,31-45,4548,2143,2405,2856,1692
2009,Urban,Punjab,Crime Against Men,Murder,Female,0-12,8078,7010,1068,7062,1016
2004,Urban,Manipur,Other Crimes,Cyber Crime,Female,60+,3314,1047,2267,3188,126
2009,Rural,Manipur,Property Crime,Arson,Male,46-60,1517,1492,25,1507,10
2009,Urban,Odisha,Crime Against Children,Trafficking,Male,60+,964,768,196,782,182
2008,Urban,Andhra Pradesh,Crime Against Men,Extortion,Female,31-45,7048,6030,1018,6843,205
2008,Urban,Kerala,Crime Against Women,Molestation,Male,46-60,7190,3449,3741,5470,1720
2001,Urban,Maharashtra,Property Crime,Theft,Male,13-17,8296,3166,5130,4040,4256
2006,Urban,Telangana,Property Crime,Burglary,Female,0-12,4497,1068,3429,2669,1828
2006,Urban,Maharashtra,Other Crimes,Drug Offense,Male,13-17,8573,1980,6593,2403,6170
2010,Rural,Andhra Pradesh,Crime Against Men,Murder,Male,13-17,9521,5984,3537,6904,2617
2008,Urban,Himachal Pradesh,Property Crime,Burglary,Male,13-17,4182,2788,1394,4104,78
2004,Urban,Uttar Pradesh,Crime Against Women,Rape,Male,13-17,3892,1851,2041,2706,1186
2010,Urban,Uttar Pradesh,Property Crime,Arson,Female,31-45,2961,1632,1329,2230,731
2010,Rural,Uttar Pradesh,Crime Against Women,Dowry Deaths,Male,0-12,8490,7577,913,7925,565
2005,Urban,Kerala,Crime Against Children,Trafficking,Female,18-30,3395,2749,646,2922,473
2009,Urban,Jammu & Kashmir,Crime Against Women,Domestic Violence,Male,18-30,9241,7067,2174,8538,703
2002,Rural,Telangana,Crime Against Men,Robbery,Female,46-60,9802,7819,1983,9556,246
2002,Urban,Himachal Pradesh,Crime Against Children,Kidnapping,Female,0-12,9186,2397,6789,8150,1036
2010,Rural,Jharkhand,Crime Against Women,Molestation,Male,46-60,615,179,436,251,364
2003,Urban,Chhattisgarh,Crime Against Women,Molestation,Male,0-12,3677,3003,674,3487,190
2002,Rural,West Bengal,Property Crime,Vandalism,Female,0-12,9757,8215,1542,8828,929
2001,Urban,Madhya Pradesh,Crime Against Men,Robbery,Female,18-30,7807,6732,1075,7319,488
2007,Rural,Delhi,Crime Against Men,Robbery,Female,60+,9607,6719,2888,8803,804
2003,Rural,Manipur,Crime Against Women,Rape,Male,18-30,8636,3722,4914,6912,1724
2010,Urban,Haryana,Crime Against Women,Molestation,Female,46-60,4322,2976,1346,4030,292
2009,Rural,Himachal Pradesh,Crime Against Men,Robbery,Female,31-45,9342,4311,5031,8478,864
2003,Urban,Gujarat,Crime Against Women,Dowry Deaths,Female,0-12,9520,4398,5122,5110,4410
2008,Urban,Telangana,Crime Against Children,Kidnapping,Male,31-45,272,112,160,235,37
2010,Urban,Manipur,Property Crime,Theft,Female,18-30,1103,45,1058,863,240
2002,Rural,West Bengal,Crime Against Men,Murder,Male,31-45,6904,5794,1110,6441,463
2005,Rural,Maharashtra,Crime Against Women,Domestic Violence,Female,18-30,4392,2536,1856,3958,434
2007,Urban,Karnataka,Other Crimes,Cyber Crime,Female,13-17,2724,2406,318,2420,304
2002,Urban,Tamil Nadu,Crime Against Men,Extortion,Male,46-60,5982,3016,2966,3229,2753
2006,Urban,West Bengal,Crime Against Women,Dowry Deaths,Male,46-60,7119,6436,683,6908,211
2005,Rural,Karnataka,Crime Against Women,Molestation,Male,18-30,8866,7812,1054,8220,646
2007,Rural,Goa,Crime Against Children,Child Labor,Female,18-30,3884,111,3773,594,3290
2005,Urban,Meghalaya,Crime Against Women,Molestation,Male,46-60,1201,1164,37,1169,32
2009,Urban,Uttar Pradesh,Property Crime,Arson,Male,18-30,7336,7013,323,7066,270
2010,Urban,Arunachal Pradesh,Property Crime,Vandalism,Male,13-17,4111,3520,591,4055,56
2002,Urban,Rajasthan,Other Crimes,Corruption,Female,0-12,7716,1804,5912,6293,1423
2002,Rural,Madhya Pradesh,Crime Against Women,Domestic Violence,Male,0-12,3210,2760,450,3077,133
2010,Rural,Meghalaya,Other Crimes,Cyber Crime,Female,13-17,1569,92,1477,1359,210
2007,Urban,Chhattisgarh,Crime Against Children,Trafficking,Female,46-60,436,7,429,123,313
2003,Urban,Himachal Pradesh,Crime Against Children,Child Labor,Male,0-12,7388,5680,1708,6178,1210
2002,Urban,Tripura,Crime Against Men,Extortion,Female,0-12,783,418,365,724,59
2002,Urban,Kerala,Other Crimes,Fraud,Female,60+,8813,1208,7605,4388,4425
2006,Rural,Meghalaya,Property Crime,Burglary,Female,18-30,162,158,4,161,1
2010,Rural,Sikkim,Property Crime,Arson,Female,18-30,3388,2084,1304,2290,1098
2001,Rural,Karnataka,Crime Against Men,Murder,Male,60+,9505,4373,5132,6984,2521
2008,Rural,Sikkim,Crime Against Men,Robbery,Male,46-60,5514,3655,1859,4997,517
2006,Rural,Rajasthan,Property Crime,Vandalism,Female,0-12,9952,5298,4654,7675,2277
2004,Urban,Gujarat,Crime Against Children,Child Abuse,Male,13-17,280,94,186,241,39
2009,Rural,Nagaland,Crime Against Men,Robbery,Female,60+,2241,213,2028,1557,684
2003,Rural,Tripura,Crime Against Children,Trafficking,Female,60+,953,712,241,805,148
2003,Urban,Mizoram,Property Crime,Theft,Female,18-30,5756,4757,999,5360,396
2008,Rural,Mizoram,Property Crime,Theft,Female,13-17,7511,3762,3749,5063,2448
2008,Rural,Uttar Pradesh,Other Crimes,Corruption,Female,31-45,67,35,32,35,32
2003,Urban,Jammu & Kashmir,Crime Against Men,Murder,Male,60+,7684,7529,155,7677,7
2010,Rural,Tripura,Crime Against Children,Child Abuse,Male,13-17,863,851,12,856,7
2002,Rural,Maharashtra,Property Crime,Arson,Female,46-60,2749,1930,819,2173,576
2002,Urban,Karnataka,Other Crimes,Cyber Crime,Female,0-12,1698,98,1600,605,1093
2007,Urban,Uttar Pradesh,Other Crimes,Fraud,Male,0-12,8343,1575,6768,7080,1263
2002,Urban,Kerala,Crime Against Men,Extortion,Female,18-30,3886,767,3119,2446,1440
2004,Urban,Gujarat,Property Crime,Burglary,Male,18-30,4353,1764,2589,2576,1777
2010,Rural,Meghalaya,Crime Against Women,Molestation,Male,0-12,8499,6236,2263,6652,1847
2005,Rural,Telangana,Crime Against Women,Dowry Deaths,Female,60+,2024,600,1424,1799,225
2010,Urban,Tripura,Crime Against Women,Domestic Violence,Female,46-60,3090,2790,300,2944,146
2007,Rural,Himachal Pradesh,Crime Against Women,Rape,Female,13-17,8512,559,7953,5441,3071
2008,Urban,Sikkim,Property Crime,Arson,Female,0-12,909,787,122,816,93
2005,Urban,Jammu & Kashmir,Crime Against Men,Murder,Female,0-12,5058,428,4630,2499,2559
2004,Rural,Arunachal Pradesh,Property Crime,Arson,Female,0-12,3157,1984,1173,2165,992
2009,Urban,Rajasthan,Crime Against Women,Domestic Violence,Female,46-60,6082,5356,726,5616,466
2010,Rural,Odisha,Crime Against Children,Kidnapping,Male,13-17,359,346,13,348,11
2004,Urban,Jharkhand,Other Crimes,Drug Offense,Male,0-12,6083,2395,3688,5627,456
2008,Urban,Sikkim,Property Crime,Burglary,Female,31-45,4971,1450,3521,4200,771
2002,Urban,Punjab,Crime Against Children,Trafficking,Female,13-17,1514,812,702,1490,24
2009,Rural,Telangana,Other Crimes,Fraud,Female,46-60,6836,4729,2107,6492,344
2007,Rural,Tripura,Crime Against Children,Child Labor,Female,13-17,1982,334,1648,728,1254
2010,Rural,Telangana,Property Crime,Vandalism,Female,60+,7393,2695,4698,6421,972
2001,Rural,Madhya Pradesh,Other Crimes,Fraud,Male,13-17,8505,5875,2630,6634,1871
2010,Urban,Jammu & Kashmir,Other Crimes,Corruption,Male,18-30,5702,1284,4418,2188,3514
2002,Urban,Delhi,Property Crime,Arson,Female,0-12,2272,1761,511,1795,477
2003,Urban,Odisha,Crime Against Children,Child Labor,Male,13-17,5128,2499,2629,2538,2590
2007,Rural,Arunachal Pradesh,Crime Against Women,Dowry Deaths,Male,46-60,5870,5638,232,5714,156
2001,Rural,Andhra Pradesh,Crime Against Men,Assault,Female,18-30,5856,5806,50,5854,2
2001,Urban,Arunachal Pradesh,Property Crime,Vandalism,Male,31-45,1382,524,858,1074,308
2009,Rural,Bihar,Other Crimes,Corruption,Male,60+,4925,3513,1412,3724,1201
2008,Rural,Delhi,Property Crime,Arson,Male,31-45,1284,616,668,1154,130
2001,Rural,Nagaland,Crime Against Women,Molestation,Male,31-45,6743,3831,2912,6473,270
2007,Urban,Delhi,Crime Against Children,Child Abuse,Male,31-45,4112,3700,412,3718,394
2002,Rural,Odisha,Crime Against Men,Assault,Male,60+,6195,1070,5125,5829,366
2003,Urban,Uttarakhand,Crime Against Children,Child Labor,Male,13-17,3469,2803,666,2813,656
2006,Urban,Goa,Crime Against Children,Child Labor,Female,13-17,6778,5981,797,6475,303
2004,Urban,Tamil Nadu,Other Crimes,Corruption,Female,18-30,3623,218,3405,3427,196
2006,Rural,Meghalaya,Crime Against Men,Robbery,Female,46-60,6503,2680,3823,3874,2629
2009,Urban,Odisha,Crime Against Men,Robbery,Female,46-60,4254,1692,2562,3691,563
2004,Rural,Meghalaya,Crime Against Children,Trafficking,Female,0-12,7583,6423,1160,6714,869
2002,Rural,Arunachal Pradesh,Crime Against Women,Molestation,Female,46-60,2777,594,2183,2369,408
2010,Rural,Bihar,Crime Against Men,Robbery,Female,46-60,2337,599,1738,2102,235
2007,Urban,Bihar,Crime Against Children,Child Labor,Male,46-60,5237,2412,2825,2957,2280
2010,Urban,Karnataka,Crime Against Men,Extortion,Female,18-30,7331,3601,3730,5340,1991
2004,Urban,Jammu & Kashmir,Crime Against Children,Trafficking,Male,18-30,5494,5258,236,5394,100
2008,Urban,Maharashtra,Other Crimes,Drug Offense,Female,60+,2332,1956,376,2070,262
2006,Rural,Tamil Nadu,Crime Against Men,Murder,Male,31-45,1227,485,742,624,603
2002,Rural,Madhya Pradesh,Crime Against Children,Child Abuse,Female,18-30,9115,3405,5710,4971,4144
2002,Urban,Meghalaya,Property Crime,Arson,Male,18-30,4108,553,3555,2376,1732
2006,Urban,Sikkim,Crime Against Men,Extortion,Female,18-30,2000,1120,880,1441,559
2008,Rural,Goa,Property Crime,Arson,Male,31-45,9263,8378,885,9010,253
2004,Rural,Jammu & Kashmir,Crime Against Children,Child Abuse,Male,0-12,6394,3809,2585,5927,467
2001,Rural,Bihar,Property Crime,Arson,Male,31-45,4573,602,3971,750,3823
2004,Rural,Mizoram,Property Crime,Burglary,Male,46-60,7298,5285,2013,7245,53
2004,Rural,Manipur,Crime Against Women,Rape,Male,60+,7941,7657,284,7919,22
2001,Urban,Assam,Property Crime,Arson,Male,60+,9995,5151,4844,6528,3467
2009,Urban,Himachal Pradesh,Crime Against Men,Assault,Female,31-45,845,681,164,794,51
2005,Urban,Telangana,Property Crime,Theft,Female,0-12,6279,5444,835,6225,54
2004,Urban,Meghalaya,Property Crime,Theft,Male,60+,7390,1988,5402,4328,3062
2009,Urban,Nagaland,Crime Against Women,Dowry Deaths,Male,13-17,566,298,268,378,188
2002,Urban,Punjab,Crime Against Children,Trafficking,Female,31-45,2516,1853,663,1930,586
2005,Rural,Karnataka,Crime Against Women,Rape,Male,18-30,296,161,135,244,52
2003,Rural,Maharashtra,Crime Against Women,Rape,Female,18-30,2236,462,1774,1776,460
2009,Rural,Madhya Pradesh,Property Crime,Vandalism,Female,46-60,830,779,51,814,16
2001,Urban,Uttar Pradesh,Property Crime,Vandalism,Female,18-30,9071,8700,371,8715,356
2003,Urban,Chhattisgarh,Other Crimes,Corruption,Female,13-17,8344,5482,2862,7586,758
2007,Rural,Kerala,Other Crimes,Drug Offense,Female,46-60,1472,378,1094,1154,318
2008,Rural,Delhi,Other Crimes,Cyber Crime,Male,60+,8835,779,8056,5693,3142
2006,Rural,Manipur,Property Crime,Vandalism,Male,13-17,5899,5137,762,5427,472
2006,Rural,Kerala,Property Crime,Vandalism,Female,31-45,2472,2468,4,2472,0
2006,Rural,Gujarat,Crime Against Children,Child Abuse,Male,18-30,3375,1041,2334,1105,2270
2010,Rural,Karnataka,Property Crime,Arson,Female,60+,361,201,160,205,156
2001,Urban,Haryana,Crime Against Children,Trafficking,Female,13-17,7701,6575,1126,6586,1115
2010,Urban,Punjab,Crime Against Men,Robbery,Female,60+,5006,4146,860,4438,568
2008,Rural,Andhra Pradesh,Property Crime,Vandalism,Female,60+,725,394,331,423,302
2001,Urban,Assam,Other Crimes,Fraud,Female,31-45,3830,2311,1519,3538,292
2001,Rural,Goa,Property Crime,Theft,Female,13-17,2953,1500,1453,2891,62
2001,Rural,Karnataka,Other Crimes,Corruption,Female,46-60,5187,3434,1753,3583,1604
2009,Rural,Assam,Property Crime,Burglary,Male,31-45,8750,3759,4991,7389,1361
2003,Urban,Andhra Pradesh,Property Crime,Arson,Female,46-60,5450,4858,592,4985,465
2007,Urban,Himachal Pradesh,Crime Against Men,Extortion,Male,31-45,4640,2457,2183,3871,769
2005,Rural,Uttarakhand,Crime Against Men,Murder,Male,60+,4224,1737,2487,3298,926
2003,Rural,Sikkim,Property Crime,Arson,Male,18-30,8984,3350,5634,8602,382
2010,Urban,Arunachal Pradesh,Crime Against Women,Molestation,Female,13-17,3280,1426,1854,2155,1125
2004,Rural,Maharashtra,Crime Against Women,Molestation,Female,60+,5936,4972,964,5395,541
2001,Urban,Kerala,Property Crime,Vandalism,Female,18-30,1245,702,543,755,490
2006,Rural,Andhra Pradesh,Other Crimes,Fraud,Male,60+,4288,1267,3021,1895,2393
2008,Rural,Madhya Pradesh,Crime Against Children,Child Labor,Male,18-30,5693,2593,3100,2676,3017
2005,Rural,Andhra Pradesh,Crime Against Children,Child Labor,Female,31-45,2936,1537,1399,2140,796
2007,Rural,Haryana,Crime Against Women,Domestic Violence,Female,0-12,7791,2207,5584,2639,5152
2005,Rural,Uttarakhand,Crime Against Men,Assault,Male,60+,8569,88,8481,1334,7235
2002,Urban,Tamil Nadu,Crime Against Women,Rape,Female,18-30,6841,4304,2537,6276,565
2001,Rural,Telangana,Crime Against Women,Domestic Violence,Male,46-60,6663,2436,4227,3062,3601
2006,Rural,Madhya Pradesh,Other Crimes,Cyber Crime,Female,31-45,3745,536,3209,1474,2271
2006,Rural,Tamil Nadu,Other Crimes,Fraud,Female,31-45,5167,3824,1343,4174,993
2007,Rural,Maharashtra,Crime Against Women,Molestation,Male,13-17,7845,5773,2072,7428,417
2008,Rural,Himachal Pradesh,Crime Against Men,Assault,Male,13-17,2557,1082,1475,1162,1395
2010,Urban,Meghalaya,Crime Against Women,Molestation,Female,18-30,7722,3327,4395,7244,478
2010,Rural,Arunachal Pradesh,Crime Against Men,Assault,Male,0-12,3640,740,2900,2253,1387
2002,Rural,Chhattisgarh,Crime Against Men,Murder,Male,31-45,881,57,824,838,43
2007,Urban,Telangana,Crime Against Children,Kidnapping,Female,46-60,1261,1030,231,1222,39
2004,Rural,Odisha,Property Crime,Arson,Male,13-17,155,139,16,149,6
2004,Rural,Sikkim,Other Crimes,Drug Offense,Male,18-30,1754,761,993,838,916
2008,Urban,Kerala,Crime Against Women,Dowry Deaths,Male,13-17,9271,6748,2523,7267,2004
2003,Rural,West Bengal,Crime Against Children,Trafficking,Female,60+,6892,6330,562,6544,348
2004,Urban,Rajasthan,Property Crime,Vandalism,Female,31-45,6729,6476,253,6542,187
2001,Urban,Himachal Pradesh,Crime Against Children,Child Labor,Male,31-45,7010,3124,3886,6831,179
2003,Rural,Punjab,Crime Against Men,Assault,Female,18-30,4960,3719,1241,4127,833
2007,Rural,Odisha,Property Crime,Vandalism,Male,0-12,2456,1617,839,2242,214
2002,Rural,Assam,Crime Against Children,Child Abuse,Female,0-12,9469,1698,7771,4541,4928
2003,Urban,Himachal Pradesh,Crime Against Children,Child Abuse,Female,31-45,3856,529,3327,601,3255
2007,Urban,Maharashtra,Other Crimes,Corruption,Male,0-12,6820,6510,310,6804,16
2001,Rural,Uttar Pradesh,Crime Against Men,Murder,Male,18-30,1595,366,1229,851,744
2004,Urban,Odisha,Crime Against Women,Rape,Male,13-17,1447,936,511,1321,126
2010,Urban,Assam,Crime Against Men,Robbery,Male,0-12,3324,1638,1686,2716,608
2003,Urban,Gujarat,Property Crime,Vandalism,Female,31-45,2253,1405,848,1529,724
2003,Urban,Bihar,Other Crimes,Cyber Crime,Female,13-17,5822,5593,229,5616,206
2010,Rural,Delhi,Crime Against Women,Rape,Female,0-12,8147,4189,3958,5763,2384
2007,Rural,Punjab,Other Crimes,Fraud,Male,60+,6218,5927,291,6110,108
2001,Urban,Jharkhand,Crime Against Children,Child Labor,Male,18-30,9769,8540,1229,9653,116
2004,Rural,Goa,Crime Against Men,Murder,Female,0-12,3511,1686,1825,1702,1809
2004,Urban,Manipur,Crime Against Women,Dowry Deaths,Female,46-60,9037,4240,4797,6349,2688
2010,Urban,Odisha,Other Crimes,Drug Offense,Female,31-45,329,252,77,264,65
2009,Rural,Madhya Pradesh,Property Crime,Arson,Female,31-45,6124,2312,3812,4715,1409
2004,Urban,Tamil Nadu,Property Crime,Arson,Male,60+,5198,2251,2947,4146,1052
2009,Rural,Tripura,Crime Against Men,Murder,Male,0-12,745,669,76,722,23
2007,Rural,Uttar Pradesh,Crime Against Women,Domestic Violence,Female,0-12,1987,611,1376,1135,852
2008,Urban,Odisha,Crime Against Men,Robbery,Female,18-30,1725,844,881,1416,309
2009,Urban,Delhi,Crime Against Children,Child Labor,Male,18-30,8970,80,8890,2625,6345
2003,Rural,Arunachal Pradesh,Other Crimes,Drug Offense,Female,0-12,9952,5886,4066,8152,1800
2009,Rural,Sikkim,Property Crime,Arson,Male,46-60,9094,5326,3768,8719,375
2009,Rural,Maharashtra,Crime Against Children,Kidnapping,Male,46-60,8736,49,8687,5430,3306
2005,Rural,Telangana,Crime Against Women,Domestic Violence,Female,13-17,8965,5741,3224,6950,2015
2010,Rural,Tamil Nadu,Property Crime,Arson,Male,31-45,1482,1242,240,1413,69
2003,Urban,Tripura,Property Crime,Vandalism,Male,31-45,6314,1659,4655,5492,822
2007,Urban,Karnataka,Crime Against Children,Kidnapping,Male,13-17,6497,2820,3677,3879,2618
2001,Rural,Himachal Pradesh,Crime Against Children,Child Labor,Female,31-45,9508,8088,1420,8688,820
2010,Rural,Maharashtra,Crime Against Men,Assault,Male,60+,3307,1829,1478,1993,1314
2007,Rural,Kerala,Crime Against Children,Kidnapping,Female,18-30,9564,8863,701,9473,91
2010,Urban,Bihar,Crime Against Men,Robbery,Female,18-30,2138,1861,277,1917,221
2001,Rural,Himachal Pradesh,Other Crimes,Fraud,Female,18-30,3262,1357,1905,1887,1375
2010,Urban,Telangana,Crime Against Women,Rape,Male,31-45,6062,5410,652,5765,297
2008,Urban,Andhra Pradesh,Property Crime,Theft,Female,13-17,8699,2305,6394,4209,4490
2002,Urban,Bihar,Crime Against Men,Murder,Female,13-17,4541,1661,2880,4416,125
2003,Urban,Tamil Nadu,Crime Against Men,Robbery,Male,31-45,5569,1931,3638,3678,1891
2003,Urban,Rajasthan,Crime Against Men,Assault,Male,13-17,1288,1101,187,1244,44
2004,Rural,Chhattisgarh,Crime Against Men,Murder,Female,60+,2550,1353,1197,2115,435
2002,Rural,Madhya Pradesh,Other Crimes,Cyber Crime,Male,31-45,5817,3167,2650,4679,1138
2009,Urban,Madhya Pradesh,Crime Against Men,Murder,Female,18-30,4752,530,4222,2195,2557
2007,Urban,Nagaland,Property Crime,Theft,Female,18-30,5126,1454,3672,1612,3514
2008,Urban,Tripura,Crime Against Men,Robbery,Female,60+,8577,3202,5375,6129,2448
2002,Rural,Telangana,Crime Against Children,Kidnapping,Male,46-60,1066,300,766,860,206
2007,Rural,Meghalaya,Crime Against Men,Assault,Female,60+,9517,1902,7615,7737,1780
2001,Rural,Tripura,Crime Against Men,Assault,Female,13-17,145,36,109,70,75
2004,Rural,Odisha,Property Crime,Theft,Female,18-30,8262,7601,661,7895,367
2004,Urban,Jharkhand,Crime Against Men,Robbery,Male,60+,7467,1940,5527,4615,2852
2005,Urban,Nagaland,Other Crimes,Drug Offense,Female,46-60,4838,4625,213,4696,142
2007,Urban,West Bengal,Other Crimes,Cyber Crime,Female,18-30,3059,214,2845,1172,1887
2009,Urban,Assam,Crime Against Men,Assault,Male,13-17,50,25,25,25,25
2008,Rural,Madhya Pradesh,Other Crimes,Drug Offense,Female,0-12,1013,244,769,305,708
2009,Rural,Meghalaya,Property Crime,Burglary,Male,46-60,7672,6362,1310,6469,1203
2009,Urban,Andhra Pradesh,Property Crime,Theft,Male,46-60,505,493,12,504,1
2005,Urban,Maharashtra,Other Crimes,Corruption,Male,60+,7090,6285,805,6463,627
2007,Rural,Meghalaya,Crime Against Women,Molestation,Male,13-17,7769,1629,6140,4779,2990
2010,Rural,Mizoram,Crime Against Men,Assault,Male,46-60,2826,1170,1656,2641,185
2006,Rural,Punjab,Crime Against Women,Molestation,Male,0-12,4864,4736,128,4759,105
2001,Rural,Assam,Property Crime,Theft,Male,46-60,2660,1142,1518,1711,949
2007,Urban,Uttar Pradesh,Crime Against Children,Kidnapping,Male,46-60,7503,1376,6127,5708,1795
2007,Rural,West Bengal,Property Crime,Arson,Male,18-30,2719,1639,1080,1711,1008
2001,Rural,Tamil Nadu,Crime Against Children,Child Labor,Female,60+,7083,5510,1573,5660,1423
2008,Rural,Gujarat,Crime Against Children,Trafficking,Female,18-30,9435,635,8800,7622,1813
2001,Rural,Manipur,Property Crime,Arson,Female,46-60,5647,1206,4441,5449,198
2008,Urban,Sikkim,Crime Against Children,Child Abuse,Female,18-30,1889,232,1657,1670,219
2003,Urban,Delhi,Other Crimes,Corruption,Male,31-45,5830,3190,2640,5305,525
2002,Urban,Karnataka,Crime Against Women,Domestic Violence,Female,13-17,6906,4249,2657,6895,11
2006,Urban,West Bengal,Property Crime,Theft,Male,31-45,9366,3787,5579,8146,1220
2009,Rural,Tripura,Property Crime,Arson,Female,0-12,221,106,115,190,31
2002,Urban,Bihar,Other Crimes,Corruption,Female,0-12,9400,1790,7610,8913,487
2001,Rural,Andhra Pradesh,Crime Against Women,Dowry Deaths,Female,31-45,1172,716,456,893,279
2004,Urban,Andhra Pradesh,Crime Against Men,Murder,Female,46-60,5859,4833,1026,5280,579
2005,Urban,Assam,Other Crimes,Cyber Crime,Male,46-60,4171,2445,1726,3019,1152
2002,Rural,Mizoram,Crime Against Men,Extortion,Male,0-12,8663,6418,2245,6546,2117
2008,Urban,Meghalaya,Crime Against Women,Rape,Female,13-17,1509,200,1309,1069,440
2005,Rural,Jharkhand,Property Crime,Arson,Female,46-60,5064,4541,523,4687,377
2004,Rural,Karnataka,Crime Against Men,Extortion,Male,46-60,3022,334,2688,1215,1807
2009,Urban,Tripura,Other Crimes,Drug Offense,Female,13-17,72,59,13,70,2
2003,Rural,Delhi,Crime Against Children,Kidnapping,Male,31-45,7375,5556,1819,7079,296
2004,Rural,Manipur,Crime Against Men,Assault,Male,60+,7653,339,7314,1912,5741
2001,Rural,Nagaland,Property Crime,Arson,Male,0-12,1996,631,1365,925,1071
2010,Rural,Andhra Pradesh,Crime Against Women,Rape,Male,13-17,5450,1427,4023,5118,332
2008,Urban,Goa,Crime Against Men,Robbery,Male,0-12,63,53,10,57,6
2009,Rural,Jammu & Kashmir,Crime Against Children,Trafficking,Male,18-30,4068,1472,2596,3095,973
2007,Urban,Maharashtra,Crime Against Children,Child Labor,Female,46-60,6627,2991,3636,3044,3583
2005,Rural,Sikkim,Other Crimes,Corruption,Male,0-12,4824,4386,438,4608,216
2010,Rural,Sikkim,Property Crime,Burglary,Male,31-45,693,324,369,413,280
2006,Urban,Chhattisgarh,Crime Against Women,Rape,Male,18-30,75,27,48,73,2
2001,Rural,Chhattisgarh,Crime Against Children,Child Abuse,Female,13-17,632,158,474,573,59
2009,Urban,Odisha,Crime Against Women,Rape,Female,0-12,7895,4075,3820,4849,3046
2007,Urban,Maharashtra,Crime Against Men,Assault,Female,46-60,4262,1335,2927,3583,679
2010,Urban,Uttar Pradesh,Other Crimes,Cyber Crime,Male,13-17,9478,386,9092,7592,1886
2006,Urban,West Bengal,Crime Against Men,Extortion,Female,13-17,5131,2532,2599,4827,304
2002,Urban,Himachal Pradesh,Property Crime,Burglary,Male,46-60,7522,5928,1594,7006,516
2008,Urban,Chhattisgarh,Crime Against Women,Domestic Violence,Female,60+,562,272,290,539,23
2005,Urban,Jharkhand,Crime Against Women,Dowry Deaths,Male,31-45,6488,5887,601,6087,401
2001,Urban,Chhattisgarh,Property Crime,Theft,Male,46-60,9636,7224,2412,8059,1577
2004,Urban,Odisha,Crime Against Men,Murder,Male,31-45,3904,3620,284,3845,59
2005,Rural,Andhra Pradesh,Crime Against Women,Domestic Violence,Male,0-12,776,55,721,726,50
2009,Rural,Arunachal Pradesh,Other Crimes,Drug Offense,Female,31-45,4552,2391,2161,2788,1764
2005,Rural,Maharashtra,Crime Against Children,Child Labor,Male,0-12,4327,592,3735,1720,2607
2009,Urban,Haryana,Property Crime,Burglary,Female,13-17,2043,875,1168,1778,265
2010,Rural,Madhya Pradesh,Crime Against Women,Molestation,Female,18-30,4666,2215,2451,3124,1542
2006,Urban,Odisha,Property Crime,Burglary,Female,0-12,9384,8203,1181,8878,506
2007,Rural,Tripura,Property Crime,Arson,Female,0-12,7082,4529,2553,6979,103
2006,Rural,Delhi,Crime Against Men,Robbery,Female,60+,5614,2834,2780,4915,699
2001,Urban,Uttarakhand,Property Crime,Theft,Male,18-30,4352,2424,1928,3711,641
2008,Urban,Punjab,Crime Against Children,Trafficking,Male,31-45,2633,2258,375,2556,77
2006,Rural,Gujarat,Other Crimes,Corruption,Male,0-12,5338,124,5214,4329,1009
2007,Urban,Jharkhand,Other Crimes,Fraud,Female,46-60,5834,164,5670,3694,2140
2005,Rural,Arunachal Pradesh,Other Crimes,Cyber Crime,Male,60+,4048,3265,783,3333,715
2004,Rural,Himachal Pradesh,Other Crimes,Corruption,Female,18-30,5091,1739,3352,2936,2155
2001,Rural,Gujarat,Other Crimes,Fraud,Male,18-30,2966,1575,1391,2212,754
2004,Urban,Jharkhand,Crime Against Men,Murder,Male,18-30,8584,501,8083,1192,7392
2005,Urban,Maharashtra,Crime Against Men,Assault,Male,13-17,3147,1440,1707,2264,883
2010,Urban,West Bengal,Crime Against Men,Assault,Male,0-12,4799,4013,786,4150,649
2006,Rural,Telangana,Property Crime,Arson,Male,31-45,964,863,101,887,77
2006,Urban,Uttarakhand,Crime Against Men,Assault,Female,13-17,3383,740,2643,832,2551
2002,Rural,Tripura,Crime Against Children,Child Abuse,Male,13-17,4591,1127,3464,3229,1362
2010,Rural,Maharashtra,Crime Against Men,Extortion,Male,60+,4813,1272,3541,1884,2929
2002,Urban,Maharashtra,Crime Against Men,Robbery,Female,0-12,1972,924,1048,1695,277
2001,Urban,Arunachal Pradesh,Crime Against Women,Molestation,Male,46-60,1406,263,1143,520,886
2008,Rural,Delhi,Crime Against Children,Child Abuse,Female,13-17,3792,2184,1608,3698,94
2006,Urban,Punjab,Crime Against Women,Domestic Violence,Male,0-12,5004,2195,2809,4022,982
2001,Urban,Jammu & Kashmir,Crime Against Children,Child Labor,Female,60+,6613,6112,501,6283,330
2007,Urban,Himachal Pradesh,Property Crime,Burglary,Female,46-60,8467,5604,2863,6634,1833
2009,Rural,Odisha,Crime Against Children,Kidnapping,Male,31-45,1619,1415,204,1560,59
2009,Rural,Bihar,Crime Against Men,Extortion,Female,13-17,4329,451,3878,2931,1398
2001,Rural,Jammu & Kashmir,Crime Against Women,Domestic Violence,Female,31-45,7839,6450,1389,7505,334
2006,Rural,Jammu & Kashmir,Other Crimes,Corruption,Female,13-17,105,93,12,95,10
2006,Urban,Arunachal Pradesh,Other Crimes,Cyber Crime,Male,60+,4826,4633,193,4654,172
2007,Urban,Tamil Nadu,Property Crime,Arson,Female,46-60,4031,1995,2036,3200,831
2006,Urban,Telangana,Crime Against Women,Rape,Male,0-12,8191,5979,2212,6927,1264
2008,Rural,Bihar,Crime Against Children,Child Labor,Male,0-12,5254,4345,909,4646,608
2007,Rural,Uttarakhand,Other Crimes,Corruption,Female,18-30,3231,771,2460,2351,880
2006,Urban,Karnataka,Property Crime,Theft,Female,18-30,4297,3831,466,3906,391
2003,Rural,Uttarakhand,Other Crimes,Drug Offense,Female,31-45,3379,3164,215,3278,101
2008,Rural,Kerala,Property Crime,Arson,Female,60+,5416,2954,2462,5186,230
2004,Rural,Meghalaya,Property Crime,Theft,Male,60+,2143,207,1936,1520,623
2007,Rural,Bihar,Property Crime,Theft,Female,18-30,7067,1893,5174,2583,4484
2005,Urban,Manipur,Crime Against Women,Molestation,Male,0-12,8018,3102,4916,4327,3691
2005,Urban,Sikkim,Other Crimes,Corruption,Female,46-60,1660,967,693,1588,72
2009,Rural,Manipur,Crime Against Women,Molestation,Male,31-45,1052,377,675,601,451
2009,Urban,Nagaland,Property Crime,Theft,Male,46-60,9396,8514,882,9146,250
2003,Urban,Uttar Pradesh,Crime Against Children,Child Labor,Male,60+,4528,2813,1715,3894,634
2007,Rural,Jharkhand,Crime Against Women,Rape,Male,46-60,4260,2765,1495,2974,1286
2004,Urban,Punjab,Other Crimes,Cyber Crime,Male,46-60,9851,1333,8518,1375,8476
2010,Rural,Tamil Nadu,Property Crime,Arson,Male,13-17,2266,1481,785,1974,292
2001,Rural,West Bengal,Crime Against Men,Murder,Female,18-30,7279,929,6350,2413,4866
2010,Rural,Manipur,Other Crimes,Corruption,Female,31-45,8789,4909,3880,6877,1912
2005,Urban,Maharashtra,Crime Against Children,Child Abuse,Male,31-45,9588,4285,5303,5083,4505
2003,Rural,Kerala,Crime Against Men,Robbery,Male,0-12,9201,4296,4905,7935,1266
2002,Rural,Jammu & Kashmir,Crime Against Children,Child Abuse,Male,13-17,2053,877,1176,1706,347
2002,Rural,Meghalaya,Crime Against Children,Child Abuse,Female,0-12,4500,1098,3402,2820,1680
2004,Urban,Mizoram,Other Crimes,Drug Offense,Male,0-12,6329,4577,1752,5414,915
2006,Rural,Madhya Pradesh,Crime Against Children,Child Abuse,Male,18-30,3339,2176,1163,2382,957
2001,Urban,Mizoram,Other Crimes,Cyber Crime,Male,0-12,4703,3386,1317,3433,1270
2003,Urban,Goa,Other Crimes,Corruption,Male,18-30,6286,6078,208,6093,193
2005,Urban,Haryana,Crime Against Men,Extortion,Female,0-12,2566,2402,164,2510,56
2002,Urban,Uttarakhand,Property Crime,Theft,Female,31-45,5380,3722,1658,4889,491
2001,Rural,Andhra Pradesh,Property Crime,Theft,Male,0-12,4877,3494,1383,3614,1263
2001,Urban,Karnataka,Crime Against Women,Molestation,Female,31-45,5122,2730,2392,2916,2206
2010,Rural,Rajasthan,Property Crime,Theft,Female,46-60,331,300,31,329,2
2002,Urban,Tripura,Property Crime,Theft,Female,18-30,699,105,594,583,116
2005,Urban,Jharkhand,Other Crimes,Corruption,Male,13-17,3451,3036,415,3049,402
2002,Urban,Kerala,Crime Against Women,Domestic Violence,Female,31-45,180,176,4,180,0
2004,Rural,Uttarakhand,Crime Against Women,Molestation,Female,13-17,2755,2579,176,2615,140
2005,Urban,Odisha,Property Crime,Theft,Female,46-60,284,40,244,279,5
2005,Urban,Madhya Pradesh,Crime Against Children,Trafficking,Male,46-60,3164,2475,689,2820,344
2005,Urban,Manipur,Crime Against Children,Kidnapping,Male,13-17,9036,5033,4003,5855,3181
2010,Urban,Meghalaya,Crime Against Men,Murder,Female,0-12,2852,1153,1699,1280,1572
2004,Rural,Punjab,Crime Against Children,Child Labor,Female,60+,2486,1652,834,2074,412
2007,Urban,Tripura,Crime Against Women,Molestation,Female,0-12,4230,233,3997,899,3331
2003,Rural,Gujarat,Property Crime,Burglary,Male,46-60,6321,3524,2797,6031,290
2004,Rural,Tripura,Crime Against Men,Murder,Female,31-45,5617,3330,2287,5008,609
2008,Rural,Chhattisgarh,Crime Against Children,Trafficking,Male,46-60,2254,1502,752,1742,512
2008,Urban,Nagaland,Crime Against Men,Robbery,Male,0-12,3595,377,3218,905,2690
2009,Urban,Uttarakhand,Other Crimes,Corruption,Male,0-12,243,56,187,73,170
2005,Rural,Andhra Pradesh,Crime Against Women,Domestic Violence,Female,18-30,8153,4925,3228,6329,1824
2001,Rural,Uttarakhand,Other Crimes,Corruption,Female,60+,3564,1151,2413,3336,228
2006,Urban,Nagaland,Property Crime,Theft,Female,0-12,8461,6015,2446,6477,1984
2002,Urban,Manipur,Property Crime,Theft,Male,31-45,5916,2512,3404,5708,208
2008,Urban,Gujarat,Other Crimes,Cyber Crime,Male,0-12,8512,1279,7233,5471,3041
2005,Urban,Jammu & Kashmir,Crime Against Men,Extortion,Male,46-60,9937,8697,1240,9168,769
2007,Urban,Kerala,Property Crime,Arson,Female,13-17,8686,4168,4518,4971,3715
2008,Urban,West Bengal,Crime Against Children,Kidnapping,Female,0-12,2536,798,1738,2146,390
2005,Urban,Sikkim,Crime Against Women,Domestic Violence,Male,46-60,1793,554,1239,1252,541
2010,Rural,Nagaland,Other Crimes,Fraud,Female,31-45,389,217,172,370,19
2004,Urban,Odisha,Crime Against Women,Dowry Deaths,Female,31-45,7623,2857,4766,5599,2024
2003,Rural,Andhra Pradesh,Property Crime,Arson,Female,13-17,1695,353,1342,1678,17
2006,Urban,Manipur,Other Crimes,Fraud,Male,60+,7658,1692,5966,5971,1687
2002,Urban,Jammu & Kashmir,Crime Against Men,Murder,Female,31-45,3180,3172,8,3172,8
2002,Rural,Odisha,Crime Against Women,Rape,Male,0-12,2819,1411,1408,2357,462
2009,Urban,Jharkhand,Crime Against Men,Murder,Female,18-30,5418,1657,3761,3749,1669
2003,Rural,Uttar Pradesh,Crime Against Men,Assault,Female,18-30,4027,248,3779,1882,2145
2006,Rural,Rajasthan,Crime Against Men,Murder,Male,60+,3330,3197,133,3318,12
2002,Rural,Tripura,Crime Against Children,Kidnapping,Female,13-17,4956,1021,3935,1888,3068
2002,Rural,Madhya Pradesh,Crime Against Children,Trafficking,Male,60+,6611,5605,1006,5913,698
2003,Urban,Goa,Property Crime,Burglary,Male,60+,2378,2351,27,2363,15
2007,Urban,Manipur,Crime Against Women,Molestation,Male,60+,2914,721,2193,1162,1752
2006,Rural,Goa,Crime Against Men,Murder,Male,0-12,6802,5590,1212,6718,84
2010,Rural,Gujarat,Crime Against Children,Child Labor,Male,60+,5611,3637,1974,4008,1603
2003,Rural,Mizoram,Crime Against Men,Assault,Male,0-12,7496,6095,1401,6480,1016
2004,Rural,Tamil Nadu,Crime Against Men,Murder,Female,46-60,3666,1222,2444,1531,2135
2006,Urban,Goa,Other Crimes,Cyber Crime,Male,18-30,9057,7146,1911,8251,806
2005,Rural,Andhra Pradesh,Crime Against Children,Kidnapping,Female,31-45,1257,558,699,1227,30
2010,Rural,Mizoram,Property Crime,Vandalism,Male,31-45,5052,4336,716,4443,609
2002,Rural,Assam,Crime Against Women,Molestation,Male,13-17,6758,4436,2322,4968,1790
2001,Urban,Manipur,Crime Against Men,Murder,Male,18-30,6635,4682,1953,5833,802
2008,Rural,Manipur,Crime Against Children,Kidnapping,Male,13-17,8330,8028,302,8188,142
2005,Urban,Tripura,Crime Against Children,Child Labor,Male,18-30,8971,1251,7720,8587,384
2003,Urban,Chhattisgarh,Other Crimes,Fraud,Female,18-30,4264,3901,363,4259,5
2004,Rural,Tamil Nadu,Property Crime,Vandalism,Female,46-60,6262,2765,3497,4163,2099
2007,Rural,Punjab,Crime Against Men,Assault,Female,60+,5948,3971,1977,4777,1171
2006,Urban,Tamil Nadu,Other Crimes,Corruption,Female,46-60,4300,1991,2309,2936,1364
2005,Urban,Tamil Nadu,Other Crimes,Corruption,Female,18-30,391,308,83,388,3
2001,Rural,Bihar,Crime Against Children,Trafficking,Female,60+,9191,6439,2752,8977,214
2004,Urban,Gujarat,Crime Against Women,Molestation,Female,46-60,1719,1076,643,1316,403
2009,Rural,Uttar Pradesh,Property Crime,Burglary,Male,18-30,1076,1076,0,1076,0
2003,Urban,Himachal Pradesh,Crime Against Women,Domestic Violence,Female,0-12,1760,1418,342,1691,69
2007,Urban,Rajasthan,Property Crime,Theft,Female,46-60,4243,3285,958,4009,234
2005,Rural,Manipur,Crime Against Women,Domestic Violence,Male,13-17,7327,3500,3827,6908,419
2002,Urban,Uttarakhand,Property Crime,Vandalism,Female,13-17,3499,97,3402,593,2906
2002,Rural,Maharashtra,Crime Against Children,Child Abuse,Male,60+,7826,6110,1716,7317,509
2001,Urban,Karnataka,Property Crime,Vandalism,Female,60+,5700,771,4929,2407,3293
2005,Rural,Arunachal Pradesh,Crime Against Men,Robbery,Male,31-45,6883,3773,3110,5266,1617
2004,Rural,Arunachal Pradesh,Crime Against Women,Dowry Deaths,Male,60+,5756,3730,2026,5583,173
2006,Rural,Goa,Property Crime,Vandalism,Female,60+,4444,3822,622,3908,536
2008,Rural,West Bengal,Other Crimes,Cyber Crime,Male,60+,6299,3888,2411,4768,1531
2002,Urban,West Bengal,Other Crimes,Drug Offense,Male,46-60,4322,3766,556,4319,3
2010,Rural,Jammu & Kashmir,Other Crimes,Cyber Crime,Male,60+,4475,4114,361,4130,345
2006,Rural,Mizoram,Crime Against Women,Dowry Deaths,Male,18-30,6055,4734,1321,5476,579
2010,Rural,Jharkhand,Property Crime,Theft,Female,46-60,9958,4265,5693,7306,2652
2001,Urban,Punjab,Crime Against Men,Murder,Female,60+,2010,342,1668,1126,884
2003,Urban,Meghalaya,Property Crime,Theft,Male,31-45,448,224,224,297,151
2002,Rural,Chhattisgarh,Property Crime,Arson,Female,0-12,4289,127,4162,3066,1223
2008,Urban,Delhi,Property Crime,Vandalism,Male,18-30,1732,953,779,1185,547
2006,Urban,Gujarat,Crime Against Children,Kidnapping,Male,60+,7601,6080,1521,6136,1465
2006,Urban,Uttar Pradesh,Other Crimes,Corruption,Female,0-12,5833,168,5665,4191,1642
2008,Urban,Meghalaya,Other Crimes,Corruption,Female,13-17,7896,1816,6080,3438,4458
2007,Rural,Kerala,Crime Against Women,Domestic Violence,Female,31-45,4806,2955,1851,3513,1293
2009,Rural,Delhi,Crime Against Men,Murder,Female,0-12,5949,5828,121,5906,43
2006,Rural,Karnataka,Crime Against Children,Child Abuse,Female,46-60,690,568,122,638,52
2005,Rural,Nagaland,Crime Against Children,Trafficking,Female,60+,8690,5516,3174,6790,1900
2002,Rural,Karnataka,Crime Against Children,Child Labor,Male,18-30,3120,2819,301,2917,203
2001,Rural,Karnataka,Other Crimes,Drug Offense,Male,0-12,5012,1997,3015,3311,1701
2009,Urban,Gujarat,Property Crime,Burglary,Female,60+,5882,4533,1349,4929,953
2004,Rural,Himachal Pradesh,Crime Against Women,Domestic Violence,Male,31-45,3067,242,2825,1644,1423
2005,Rural,Manipur,Crime Against Men,Robbery,Female,18-30,8932,6894,2038,7612,1320
2006,Urban,Haryana,Crime Against Men,Extortion,Female,13-17,7874,4016,3858,5861,2013
2005,Urban,West Bengal,Other Crimes,Fraud,Female,46-60,2891,243,2648,942,1949
2010,Rural,Arunachal Pradesh,Crime Against Women,Dowry Deaths,Female,31-45,7236,3460,3776,3918,3318
2001,Urban,Tripura,Crime Against Children,Child Abuse,Female,60+,2817,517,2300,1603,1214
2005,Urban,Uttarakhand,Crime Against Children,Kidnapping,Female,18-30,4116,951,3165,3214,902
2002,Rural,Andhra Pradesh,Crime Against Children,Child Abuse,Male,18-30,8822,2731,6091,6193,2629
2006,Rural,Goa,Other Crimes,Cyber Crime,Male,0-12,3208,141,3067,1523,1685
2005,Urban,Himachal Pradesh,Property Crime,Theft,Female,13-17,5013,2658,2355,2788,2225
2003,Rural,Himachal Pradesh,Crime Against Men,Murder,Female,60+,3722,3110,612,3368,354
2003,Urban,Arunachal Pradesh,Crime Against Children,Child Labor,Male,46-60,2982,210,2772,2255,727
2004,Rural,Kerala,Crime Against Children,Child Labor,Male,0-12,2238,1605,633,2153,85
2003,Urban,Delhi,Crime Against Children,Trafficking,Female,60+,5435,3758,1677,5396,39
2003,Urban,Andhra Pradesh,Other Crimes,Fraud,Female,31-45,2523,2393,130,2405,118
2007,Rural,Bihar,Crime Against Children,Child Abuse,Female,60+,287,48,239,259,28
2005,Rural,Jammu & Kashmir,Crime Against Women,Molestation,Male,18-30,8883,60,8823,954,7929
2007,Urban,Tamil Nadu,Crime Against Men,Robbery,Male,60+,1878,856,1022,1474,404
2004,Rural,Sikkim,Crime Against Children,Child Labor,Male,0-12,6771,2575,4196,5904,867
2009,Urban,Goa,Crime Against Men,Assault,Male,18-30,5668,2804,2864,3319,2349
2001,Rural,Punjab,Crime Against Men,Extortion,Male,13-17,4198,1088,3110,1211,2987
2009,Urban,Arunachal Pradesh,Property Crime,Burglary,Male,31-45,4924,3473,1451,3713,1211
2007,Rural,Uttarakhand,Crime Against Men,Murder,Female,31-45,9741,3205,6536,3431,6310
2005,Rural,Jammu & Kashmir,Crime Against Men,Assault,Male,60+,834,598,236,669,165
2002,Rural,Karnataka,Crime Against Men,Assault,Male,60+,815,745,70,809,6
2003,Rural,Odisha,Crime Against Women,Rape,Female,46-60,1581,1260,321,1524,57
2008,Rural,Himachal Pradesh,Crime Against Children,Child Abuse,Female,60+,731,23,708,484,247
2010,Rural,Andhra Pradesh,Crime Against Women,Domestic Violence,Female,13-17,7525,6915,610,7390,135
2002,Rural,Assam,Crime Against Children,Child Abuse,Male,46-60,9439,6636,2803,6851,2588
2002,Urban,Delhi,Crime Against Men,Assault,Female,0-12,6906,2133,4773,5557,1349
2004,Urban,Chhattisgarh,Crime Against Women,Dowry Deaths,Male,18-30,6793,6720,73,6776,17
2008,Urban,Bihar,Crime Against Men,Murder,Female,31-45,884,651,233,761,123
2010,Urban,Tamil Nadu,Other Crimes,Fraud,Male,13-17,7111,6860,251,6886,225
2007,Urban,Haryana,Other Crimes,Fraud,Male,46-60,8223,410,7813,5126,3097
2006,Rural,Andhra Pradesh,Crime Against Children,Child Abuse,Male,13-17,3075,1045,2030,1067,2008
2006,Rural,Delhi,Property Crime,Arson,Female,46-60,3890,2399,1491,2592,1298
2010,Rural,Goa,Crime Against Women,Rape,Female,0-12,2948,2497,451,2575,373
2003,Rural,Arunachal Pradesh,Crime Against Men,Extortion,Male,31-45,4931,4374,557,4805,126
2009,Urban,West Bengal,Crime Against Men,Assault,Female,13-17,7753,1585,6168,7343,410
2007,Urban,Jammu & Kashmir,Property Crime,Burglary,Male,31-45,1201,826,375,1006,195
2005,Urban,Meghalaya,Property Crime,Vandalism,Female,31-45,9449,8205,1244,8785,664
2004,Urban,Himachal Pradesh,Crime Against Women,Molestation,Female,18-30,1611,254,1357,486,1125
2007,Rural,Rajasthan,Crime Against Children,Child Abuse,Female,31-45,6885,4974,1911,5941,944
2002,Urban,Sikkim,Other Crimes,Cyber Crime,Female,31-45,8237,2672,5565,7102,1135
2005,Rural,Haryana,Crime Against Children,Trafficking,Male,60+,4936,3683,1253,4167,769
2003,Rural,Sikkim,Other Crimes,Cyber Crime,Male,60+,3903,2941,962,3196,707
2008,Urban,Punjab,Crime Against Women,Molestation,Male,13-17,7931,6423,1508,6755,1176
2007,Rural,Jammu & Kashmir,Other Crimes,Fraud,Male,18-30,6544,861,5683,6170,374
2008,Urban,West Bengal,Crime Against Women,Rape,Male,60+,294,93,201,143,151
2010,Rural,Sikkim,Crime Against Men,Robbery,Male,60+,3529,1235,2294,2463,1066
2006,Urban,Bihar,Crime Against Children,Kidnapping,Male,0-12,2971,1023,1948,1674,1297
2010,Urban,Telangana,Crime Against Men,Extortion,Female,13-17,6839,4559,2280,6486,353
2009,Rural,Meghalaya,Crime Against Men,Robbery,Female,46-60,3538,1077,2461,2731,807
2010,Urban,Haryana,Crime Against Men,Robbery,Female,0-12,2038,301,1737,1241,797
2010,Rural,Madhya Pradesh,Property Crime,Arson,Male,0-12,5091,3002,2089,3047,2044
2009,Rural,Rajasthan,Property Crime,Arson,Male,0-12,111,43,68,75,36
2003,Rural,Nagaland,Crime Against Women,Molestation,Male,18-30,4909,4092,817,4398,511
2001,Rural,Karnataka,Other Crimes,Drug Offense,Male,46-60,9462,3504,5958,3975,5487
2002,Urban,Odisha,Crime Against Men,Extortion,Male,31-45,9877,5819,4058,9070,807
2003,Rural,Assam,Property Crime,Vandalism,Male,0-12,3728,3337,391,3528,200
2002,Rural,Assam,Crime Against Men,Extortion,Female,60+,1846,1446,400,1673,173
2001,Urban,Meghalaya,Crime Against Men,Robbery,Female,0-12,3145,2135,1010,2237,908
2002,Rural,Jharkhand,Crime Against Children,Kidnapping,Female,13-17,4414,827,3587,2647,1767
2010,Rural,Assam,Property Crime,Vandalism,Male,46-60,4857,3816,1041,4409,448
2005,Rural,West Bengal,Crime Against Men,Murder,Male,0-12,3720,2090,1630,3542,178
2005,Urban,Bihar,Crime Against Children,Trafficking,Female,46-60,2818,2250,568,2651,167
2001,Rural,Himachal Pradesh,Other Crimes,Corruption,Male,46-60,3441,735,2706,2243,1198
2003,Rural,Andhra Pradesh,Other Crimes,Cyber Crime,Male,13-17,4181,3648,533,4087,94
2005,Urban,Jharkhand,Crime Against Children,Child Abuse,Female,60+,7704,4592,3112,6088,1616
2001,Rural,Assam,Crime Against Children,Trafficking,Male,18-30,9570,5995,3575,6182,3388
2004,Rural,Jharkhand,Property Crime,Theft,Female,13-17,6055,1152,4903,1209,4846
2002,Rural,Manipur,Property Crime,Theft,Female,46-60,4454,542,3912,4062,392
2002,Rural,Maharashtra,Other Crimes,Cyber Crime,Female,60+,9987,7927,2060,8512,1475
2002,Urban,Gujarat,Crime Against Women,Molestation,Female,18-30,3899,3391,508,3796,103
2009,Rural,Haryana,Crime Against Men,Extortion,Female,0-12,9147,6911,2236,8651,496
2004,Rural,Haryana,Crime Against Children,Kidnapping,Male,46-60,8736,49,8687,4411,4325
2003,Urban,Bihar,Crime Against Women,Dowry Deaths,Male,31-45,1150,286,864,873,277
2001,Rural,Kerala,Property Crime,Burglary,Male,18-30,518,101,417,386,132
2005,Rural,Tamil Nadu,Crime Against Men,Assault,Female,60+,5495,400,5095,2230,3265
2004,Urban,Assam,Crime Against Children,Kidnapping,Female,0-12,2894,1936,958,2549,345
2009,Urban,Himachal Pradesh,Crime Against Men,Robbery,Male,13-17,6481,960,5521,4612,1869
2003,Urban,Uttarakhand,Other Crimes,Cyber Crime,Male,31-45,3804,3597,207,3742,62
2003,Rural,Haryana,Crime Against Women,Rape,Male,0-12,9830,3499,6331,7793,2037
2010,Urban,Tripura,Crime Against Men,Robbery,Male,60+,8242,3341,4901,6990,1252
2007,Rural,Sikkim,Crime Against Children,Trafficking,Male,0-12,1488,412,1076,918,570
2005,Rural,Chhattisgarh,Property Crime,Burglary,Female,18-30,903,169,734,829,74
2004,Urban,Punjab,Crime Against Men,Murder,Male,46-60,2207,764,1443,1551,656
2008,Rural,Odisha,Crime Against Men,Murder,Female,0-12,1935,1199,736,1432,503
2002,Rural,Karnataka,Crime Against Children,Kidnapping,Female,0-12,8475,374,8101,6574,1901
2001,Rural,Manipur,Crime Against Men,Extortion,Male,31-45,9293,8323,970,8869,424
2001,Rural,West Bengal,Crime Against Men,Murder,Male,18-30,6364,1983,4381,4273,2091
2008,Rural,Gujarat,Crime Against Children,Child Abuse,Female,13-17,7386,4895,2491,6364,1022
2001,Rural,Assam,Crime Against Women,Molestation,Female,60+,5810,4358,1452,4462,1348
2001,Rural,Chhattisgarh,Crime Against Men,Murder,Female,60+,657,332,325,648,9
2009,Rural,Punjab,Property Crime,Theft,Male,13-17,7646,287,7359,5255,2391
2002,Urban,Telangana,Crime Against Men,Robbery,Female,0-12,3155,1833,1322,2601,554
2001,Urban,Jharkhand,Other Crimes,Drug Offense,Male,18-30,9895,7458,2437,7481,2414
2010,Urban,Gujarat,Other Crimes,Cyber Crime,Female,46-60,289,97,192,205,84
2007,Rural,Tripura,Crime Against Women,Rape,Male,31-45,3826,242,3584,3497,329
2007,Urban,Delhi,Crime Against Children,Trafficking,Male,46-60,6170,4636,1534,5036,1134
2002,Urban,Arunachal Pradesh,Crime Against Women,Rape,Female,0-12,9141,7550,1591,8712,429
2009,Urban,Odisha,Crime Against Children,Child Abuse,Male,46-60,5144,3189,1955,3817,1327
2001,Rural,Tripura,Other Crimes,Corruption,Female,13-17,4201,2029,2172,2777,1424
2009,Urban,Rajasthan,Crime Against Children,Child Labor,Female,31-45,4036,1655,2381,3971,65
2005,Rural,Chhattisgarh,Other Crimes,Drug Offense,Male,18-30,8782,3534,5248,4195,4587
2006,Rural,Arunachal Pradesh,Crime Against Children,Trafficking,Male,46-60,8199,4201,3998,6866,1333
2002,Urban,Madhya Pradesh,Crime Against Children,Child Abuse,Male,18-30,7930,6423,1507,7047,883
2006,Rural,Delhi,Crime Against Children,Kidnapping,Female,31-45,4307,2433,1874,2640,1667
2007,Rural,Uttarakhand,Crime Against Children,Kidnapping,Female,13-17,7287,6659,628,7055,232
2008,Urban,Andhra Pradesh,Crime Against Women,Rape,Male,31-45,2662,2316,346,2496,166
2009,Rural,Himachal Pradesh,Other Crimes,Fraud,Male,31-45,9177,4255,4922,5617,3560
2002,Rural,Andhra Pradesh,Other Crimes,Drug Offense,Female,31-45,8955,8700,255,8703,252
2003,Urban,Uttarakhand,Crime Against Men,Extortion,Female,18-30,7396,3584,3812,4800,2596
2006,Urban,Madhya Pradesh,Crime Against Women,Molestation,Female,60+,8447,7671,776,8389,58
2009,Urban,Gujarat,Property Crime,Vandalism,Female,46-60,7562,2471,5091,4924,2638
2007,Rural,Haryana,Crime Against Men,Extortion,Female,13-17,6920,3562,3358,5291,1629
2005,Rural,Nagaland,Crime Against Men,Murder,Female,31-45,5313,1621,3692,3139,2174
2010,Rural,Andhra Pradesh,Other Crimes,Corruption,Male,46-60,1129,378,751,388,741
2004,Urban,Maharashtra,Crime Against Women,Dowry Deaths,Female,31-45,5148,3067,2081,4440,708
2007,Rural,Manipur,Crime Against Women,Molestation,Male,60+,8087,6874,1213,7307,780
2008,Rural,Manipur,Crime Against Children,Child Labor,Female,13-17,7979,5936,2043,6702,1277
2003,Urban,Goa,Other Crimes,Cyber Crime,Female,13-17,6099,3725,2374,5489,610
2009,Urban,Delhi,Crime Against Children,Child Abuse,Male,31-45,9623,798,8825,7625,1998
2010,Urban,Andhra Pradesh,Crime Against Men,Extortion,Female,18-30,786,784,2,785,1
2009,Urban,Meghalaya,Crime Against Children,Trafficking,Male,13-17,9989,1742,8247,3127,6862
2010,Urban,Gujarat,Property Crime,Vandalism,Female,60+,831,362,469,515,316
2004,Urban,Jammu & Kashmir,Property Crime,Vandalism,Male,0-12,6330,817,5513,971,5359
2006,Urban,Rajasthan,Crime Against Children,Child Labor,Male,60+,6816,3060,3756,4495,2321
2005,Urban,Haryana,Crime Against Women,Molestation,Male,0-12,1182,71,1111,1127,55
2010,Rural,Tripura,Crime Against Children,Child Abuse,Male,60+,9640,7522,2118,8043,1597
2003,Rural,Nagaland,Crime Against Women,Rape,Female,0-12,3485,3384,101,3419,66
2008,Rural,Jammu & Kashmir,Crime Against Children,Child Labor,Female,13-17,2034,318,1716,752,1282
2001,Rural,Tripura,Other Crimes,Drug Offense,Male,13-17,9912,2031,7881,9063,849
2010,Urban,Uttar Pradesh,Other Crimes,Corruption,Female,31-45,5762,30,5732,2415,3347
2008,Urban,Haryana,Property Crime,Arson,Female,60+,6253,31,6222,5682,571
2008,Rural,Madhya Pradesh,Other Crimes,Corruption,Male,31-45,5827,3585,2242,3884,1943
2006,Rural,Gujarat,Property Crime,Burglary,Male,60+,7768,5364,2404,7013,755
2002,Rural,Arunachal Pradesh,Crime Against Men,Robbery,Male,0-12,4360,3184,1176,3681,679
2004,Rural,Tamil Nadu,Other Crimes,Drug Offense,Female,18-30,563,91,472,496,67
2010,Urban,Punjab,Crime Against Women,Domestic Violence,Male,0-12,1982,1697,285,1905,77
2009,Urban,Madhya Pradesh,Crime Against Men,Murder,Male,31-45,2002,1354,648,1524,478
2005,Rural,Haryana,Crime Against Children,Child Abuse,Female,13-17,1363,772,591,1168,195
2007,Rural,West Bengal,Other Crimes,Cyber Crime,Female,31-45,7070,4938,2132,5819,1251
2005,Rural,Mizoram,Crime Against Children,Child Abuse,Female,0-12,6375,507,5868,582,5793
2005,Rural,Sikkim,Crime Against Children,Child Labor,Male,13-17,9627,3305,6322,3601,6026
2004,Urban,Sikkim,Property Crime,Arson,Male,18-30,4487,62,4425,1509,2978
2005,Urban,Tamil Nadu,Property Crime,Burglary,Male,0-12,1454,1419,35,1421,33
2003,Urban,Kerala,Crime Against Men,Robbery,Male,46-60,3375,2102,1273,3162,213
2006,Rural,Chhattisgarh,Crime Against Women,Dowry Deaths,Female,0-12,6609,3153,3456,5188,1421
2010,Rural,Assam,Property Crime,Arson,Female,0-12,2423,180,2243,1341,1082
2004,Rural,Uttarakhand,Crime Against Men,Assault,Male,13-17,1920,540,1380,1297,623
2007,Urban,Andhra Pradesh,Crime Against Women,Molestation,Male,18-30,5158,3964,1194,4784,374
2007,Rural,Odisha,Crime Against Women,Molestation,Male,0-12,4396,2540,1856,2616,1780
2004,Rural,Bihar,Property Crime,Arson,Male,60+,6220,4131,2089,5626,594
2001,Urban,Mizoram,Property Crime,Arson,Male,60+,4036,2585,1451,4036,0
2005,Rural,Arunachal Pradesh,Crime Against Children,Trafficking,Male,13-17,1882,1283,599,1683,199
2002,Urban,Rajasthan,Crime Against Women,Molestation,Female,46-60,3332,1324,2008,2775,557
2006,Rural,Jammu & Kashmir,Other Crimes,Fraud,Female,0-12,3275,1568,1707,3241,34
2007,Urban,Meghalaya,Crime Against Men,Murder,Female,46-60,7002,936,6066,5329,1673
2010,Urban,Assam,Property Crime,Theft,Female,0-12,3406,1489,1917,2501,905
2001,Urban,Haryana,Property Crime,Vandalism,Male,46-60,2482,158,2324,996,1486
2004,Rural,Andhra Pradesh,Crime Against Men,Murder,Female,46-60,1301,953,348,1054,247
2002,Urban,Karnataka,Crime Against Children,Trafficking,Male,31-45,9858,3000,6858,7485,2373
2009,Rural,Sikkim,Property Crime,Vandalism,Female,13-17,6348,3689,2659,4099,2249
2001,Urban,Delhi,Crime Against Men,Murder,Male,0-12,6052,1645,4407,5330,722
2002,Rural,Tamil Nadu,Property Crime,Burglary,Male,0-12,6758,585,6173,2287,4471
2001,Urban,Punjab,Crime Against Children,Child Abuse,Female,0-12,7176,198,6978,3136,4040
2008,Rural,Goa,Crime Against Women,Domestic Violence,Female,60+,1252,240,1012,498,754
2007,Rural,Uttar Pradesh,Crime Against Women,Rape,Male,18-30,8789,2019,6770,5726,3063
2008,Urban,Gujarat,Crime Against Women,Dowry Deaths,Male,31-45,8413,8314,99,8386,27
2002,Urban,Odisha,Crime Against Women,Molestation,Male,60+,5554,739,4815,3263,2291
2007,Rural,Himachal Pradesh,Crime Against Men,Extortion,Male,60+,9722,9693,29,9706,16
2002,Rural,Mizoram,Other Crimes,Corruption,Female,31-45,4392,2729,1663,2956,1436
2003,Rural,Delhi,Property Crime,Burglary,Male,13-17,9722,1844,7878,4961,4761
2001,Urban,Andhra Pradesh,Crime Against Women,Dowry Deaths,Male,0-12,4602,3523,1079,4203,399
2002,Urban,Uttar Pradesh,Crime Against Women,Domestic Violence,Male,0-12,1864,1218,646,1380,484
2007,Urban,Assam,Crime Against Children,Child Abuse,Male,60+,1731,225,1506,1241,490
2007,Rural,Assam,Property Crime,Theft,Female,60+,3741,924,2817,2489,1252
2004,Urban,Punjab,Other Crimes,Corruption,Female,60+,9707,5278,4429,7849,1858
2003,Urban,West Bengal,Crime Against Women,Domestic Violence,Female,0-12,851,381,470,418,433
2001,Rural,Tripura,Crime Against Women,Molestation,Male,13-17,6197,5514,683,6130,67
2006,Rural,Arunachal Pradesh,Crime Against Children,Kidnapping,Male,0-12,6248,2388,3860,2873,3375
2009,Urban,Kerala,Crime Against Women,Rape,Female,31-45,9196,1405,7791,6677,2519
2006,Rural,Himachal Pradesh,Crime Against Men,Extortion,Male,60+,3259,1875,1384,2529,730
2006,Urban,Chhattisgarh,Crime Against Women,Rape,Female,0-12,2922,2105,817,2722,200
2009,Rural,Meghalaya,Crime Against Women,Rape,Male,60+,2447,1041,1406,1695,752
2007,Urban,Tamil Nadu,Property Crime,Arson,Male,18-30,2879,448,2431,1577,1302
2004,Urban,Sikkim,Other Crimes,Corruption,Female,31-45,8138,7800,338,8091,47
2002,Urban,Punjab,Crime Against Men,Robbery,Male,60+,243,114,129,235,8
2006,Rural,Rajasthan,Crime Against Men,Robbery,Female,13-17,103,33,70,46,57
2009,Rural,Goa,Property Crime,Burglary,Male,0-12,9348,4965,4383,8908,440
2010,Rural,Jharkhand,Other Crimes,Corruption,Male,31-45,7364,6182,1182,7090,274
2007,Rural,Delhi,Crime Against Men,Murder,Female,0-12,5456,2530,2926,3681,1775
2009,Rural,Madhya Pradesh,Crime Against Children,Trafficking,Male,31-45,1586,1053,533,1132,454
2007,Urban,Chhattisgarh,Crime Against Women,Domestic Violence,Male,18-30,9340,7101,2239,7272,2068
2003,Rural,Punjab,Crime Against Women,Rape,Female,46-60,3057,1229,1828,2232,825
2001,Rural,Arunachal Pradesh,Property Crime,Arson,Female,31-45,7669,74,7595,1318,6351
2002,Rural,Sikkim,Property Crime,Burglary,Female,13-17,6131,1501,4630,2764,3367
2002,Urban,Tripura,Crime Against Women,Rape,Male,46-60,90,65,25,80,10
2006,Rural,Jharkhand,Property Crime,Burglary,Male,18-30,1944,1018,926,1248,696
2010,Rural,Odisha,Other Crimes,Drug Offense,Female,0-12,8106,2725,5381,7411,695
2005,Urban,Tripura,Crime Against Men,Assault,Female,60+,7179,6477,702,6794,385
2009,Rural,Sikkim,Property Crime,Arson,Male,0-12,9763,5513,4250,8674,1089
2008,Urban,Mizoram,Crime Against Women,Rape,Female,18-30,3051,1500,1551,2354,697
2008,Urban,Jammu & Kashmir,Property Crime,Vandalism,Male,13-17,5510,4193,1317,4241,1269
2008,Rural,West Bengal,Crime Against Children,Child Labor,Male,31-45,2005,951,1054,1424,581
2006,Rural,Gujarat,Other Crimes,Drug Offense,Male,31-45,1589,1492,97,1533,56
2006,Rural,Jammu & Kashmir,Crime Against Women,Rape,Female,46-60,9139,8617,522,8693,446
2010,Rural,Maharashtra,Crime Against Women,Molestation,Female,60+,7953,5656,2297,5769,2184
2001,Rural,Tamil Nadu,Property Crime,Burglary,Male,18-30,3712,3654,58,3710,2
2003,Urban,Uttar Pradesh,Other Crimes,Cyber Crime,Male,31-45,1824,1347,477,1446,378
2003,Urban,Tamil Nadu,Property Crime,Burglary,Male,13-17,4378,3276,1102,3828,550
2006,Urban,Nagaland,Property Crime,Theft,Male,0-12,4204,4078,126,4150,54
2007,Rural,Tripura,Crime Against Children,Child Labor,Female,46-60,6790,1947,4843,4206,2584
2008,Urban,Chhattisgarh,Other Crimes,Cyber Crime,Male,13-17,8306,7752,554,7919,387
2004,Urban,Madhya Pradesh,Property Crime,Burglary,Male,46-60,354,104,250,185,169
2007,Urban,Gujarat,Other Crimes,Drug Offense,Male,0-12,3405,2756,649,2883,522
2009,Urban,Madhya Pradesh,Crime Against Women,Molestation,Male,46-60,3220,2046,1174,2132,1088
2006,Rural,Goa,Other Crimes,Corruption,Male,0-12,340,153,187,223,117
2008,Urban,Bihar,Property Crime,Vandalism,Male,31-45,2963,1682,1281,1863,1100
2005,Urban,Sikkim,Crime Against Children,Trafficking,Male,13-17,560,5,555,459,101
2004,Rural,Tripura,Other Crimes,Drug Offense,Male,31-45,8761,4474,4287,5753,3008
2007,Urban,Bihar,Property Crime,Burglary,Female,46-60,7917,4712,3205,7833,84
2005,Rural,Jharkhand,Other Crimes,Corruption,Male,13-17,8260,6991,1269,7462,798
2007,Rural,Madhya Pradesh,Property Crime,Vandalism,Female,60+,6716,1968,4748,5523,1193
2003,Urban,Mizoram,Property Crime,Vandalism,Female,13-17,2632,519,2113,1600,1032
2008,Urban,Arunachal Pradesh,Property Crime,Vandalism,Male,0-12,2685,1362,1323,2251,434
2001,Rural,Kerala,Crime Against Men,Robbery,Male,18-30,1251,161,1090,204,1047
2007,Rural,Arunachal Pradesh,Property Crime,Theft,Female,46-60,2495,116,2379,2467,28
2006,Rural,Sikkim,Crime Against Men,Robbery,Female,18-30,8104,4965,3139,6866,1238
2005,Urban,Karnataka,Crime Against Women,Rape,Male,13-17,9657,2771,6886,9492,165
2010,Rural,Punjab,Crime Against Children,Child Labor,Male,18-30,6942,4278,2664,4992,1950
2010,Urban,Punjab,Crime Against Men,Extortion,Female,13-17,7028,5741,1287,6829,199
2002,Urban,Uttar Pradesh,Other Crimes,Corruption,Male,60+,981,487,494,585,396
2004,Rural,Tripura,Crime Against Children,Child Labor,Male,46-60,4336,1733,2603,2480,1856
2009,Urban,Uttar Pradesh,Crime Against Children,Kidnapping,Male,46-60,2533,439,2094,2365,168
2002,Rural,Gujarat,Crime Against Women,Rape,Male,31-45,8632,4679,3953,4882,3750
2007,Rural,Andhra Pradesh,Crime Against Women,Domestic Violence,Female,0-12,9727,8480,1247,9516,211
2001,Urban,Karnataka,Crime Against Children,Kidnapping,Male,13-17,6133,4360,1773,5314,819
2005,Urban,Karnataka,Crime Against Women,Domestic Violence,Female,18-30,9607,1651,7956,8609,998
2008,Urban,Jammu & Kashmir,Crime Against Women,Molestation,Female,18-30,8536,6994,1542,8146,390
2006,Rural,Manipur,Crime Against Women,Dowry Deaths,Male,0-12,984,221,763,244,740
2005,Urban,Odisha,Crime Against Women,Domestic Violence,Male,0-12,6824,5617,1207,6357,467
2007,Urban,Delhi,Crime Against Men,Murder,Male,60+,124,42,82,89,35
2004,Urban,Odisha,Crime Against Men,Robbery,Female,18-30,7891,1034,6857,5714,2177
2002,Urban,Jammu & Kashmir,Crime Against Women,Dowry Deaths,Female,31-45,6621,3567,3054,5018,1603
2003,Urban,West Bengal,Property Crime,Vandalism,Female,0-12,6580,5330,1250,6079,501
2005,Urban,Punjab,Crime Against Men,Robbery,Male,13-17,7996,2256,5740,4662,3334
2005,Urban,Tripura,Crime Against Children,Trafficking,Female,18-30,8682,4883,3799,6025,2657
2009,Rural,Mizoram,Crime Against Women,Rape,Male,46-60,9028,214,8814,6846,2182
2008,Rural,Delhi,Other Crimes,Drug Offense,Female,60+,1907,696,1211,1427,480
2006,Urban,Gujarat,Crime Against Children,Child Labor,Female,13-17,7677,328,7349,7541,136
2004,Rural,Jharkhand,Crime Against Women,Rape,Female,60+,7623,563,7060,5897,1726
2002,Urban,Punjab,Property Crime,Arson,Female,46-60,9677,2054,7623,2634,7043
2007,Urban,Andhra Pradesh,Crime Against Women,Molestation,Female,0-12,208,108,100,113,95
2009,Urban,Maharashtra,Crime Against Children,Trafficking,Female,0-12,1493,987,506,991,502
2008,Urban,Arunachal Pradesh,Crime Against Children,Trafficking,Male,0-12,8411,6062,2349,7754,657
2009,Rural,Kerala,Other Crimes,Drug Offense,Male,13-17,2868,403,2465,1414,1454
2004,Urban,Odisha,Crime Against Men,Murder,Female,13-17,4484,101,4383,1498,2986
2002,Rural,Himachal Pradesh,Crime Against Women,Rape,Male,18-30,2546,1152,1394,2409,137
2009,Rural,Kerala,Property Crime,Arson,Female,13-17,1507,1334,173,1365,142
2005,Rural,Kerala,Crime Against Men,Murder,Male,60+,3794,3398,396,3673,121
2006,Rural,Uttar Pradesh,Crime Against Men,Extortion,Female,46-60,8832,7142,1690,7744,1088
2002,Rural,Maharashtra,Crime Against Men,Robbery,Male,0-12,2724,1616,1108,2173,551
2005,Urban,Nagaland,Property Crime,Arson,Male,60+,6333,3222,3111,4368,1965
2003,Urban,Tamil Nadu,Property Crime,Burglary,Female,18-30,8194,2063,6131,5047,3147
2004,Urban,Jammu & Kashmir,Crime Against Women,Domestic Violence,Male,60+,9617,1456,8161,5700,3917
2010,Rural,Himachal Pradesh,Crime Against Women,Molestation,Male,0-12,6889,6203,686,6856,33
2010,Urban,Assam,Crime Against Men,Assault,Male,13-17,5399,1521,3878,2052,3347
2004,Urban,Uttarakhand,Crime Against Children,Trafficking,Male,31-45,6327,1229,5098,4279,2048
2007,Rural,Odisha,Crime Against Men,Robbery,Female,18-30,4002,659,3343,2450,1552
2005,Rural,Meghalaya,Property Crime,Burglary,Female,18-30,165,154,11,158,7
2002,Rural,Mizoram,Crime Against Women,Rape,Female,13-17,3976,464,3512,2396,1580
2003,Rural,Haryana,Crime Against Men,Extortion,Male,13-17,6818,5905,913,6126,692
2005,Rural,Haryana,Other Crimes,Corruption,Female,0-12,8291,7168,1123,7974,317
2007,Rural,Punjab,Crime Against Children,Child Abuse,Female,0-12,1016,837,179,897,119
2010,Urban,Maharashtra,Crime Against Men,Extortion,Male,31-45,4832,2248,2584,3991,841
2001,Urban,Karnataka,Crime Against Women,Molestation,Female,13-17,9617,5012,4605,8848,769
2008,Rural,Jammu & Kashmir,Crime Against Women,Molestation,Female,0-12,5237,3145,2092,4555,682
2009,Rural,Kerala,Crime Against Children,Kidnapping,Male,60+,3663,1001,2662,1271,2392
2008,Rural,Mizoram,Other Crimes,Corruption,Female,18-30,2763,780,1983,1924,839
2010,Urban,Bihar,Crime Against Women,Rape,Male,46-60,7449,2520,4929,3188,4261
2008,Rural,Goa,Crime Against Women,Molestation,Female,60+,2997,1762,1235,2777,220
2009,Rural,Arunachal Pradesh,Crime Against Men,Robbery,Male,0-12,3919,40,3879,3770,149
2006,Rural,Assam,Crime Against Women,Rape,Male,46-60,1446,428,1018,538,908
2007,Rural,Delhi,Property Crime,Vandalism,Female,60+,5294,1555,3739,2755,2539
2003,Urban,Odisha,Property Crime,Burglary,Male,60+,4120,3710,410,4070,50
2010,Urban,Chhattisgarh,Other Crimes,Fraud,Male,46-60,8509,1529,6980,5538,2971
2009,Rural,Jharkhand,Other Crimes,Corruption,Female,13-17,1397,1306,91,1325,72
2005,Urban,Tamil Nadu,Crime Against Men,Robbery,Male,13-17,3989,3805,184,3943,46
2008,Rural,Tripura,Property Crime,Vandalism,Male,31-45,9990,813,9177,5623,4367
2002,Urban,Goa,Crime Against Children,Child Abuse,Female,18-30,4797,4126,671,4654,143
2004,Urban,Karnataka,Crime Against Children,Trafficking,Male,18-30,9416,2455,6961,2953,6463
2004,Rural,Haryana,Crime Against Women,Dowry Deaths,Male,0-12,4714,3657,1057,4285,429
2006,Urban,Gujarat,Crime Against Men,Assault,Female,18-30,1366,269,1097,1118,248
2010,Rural,Uttarakhand,Crime Against Women,Domestic Violence,Male,31-45,507,57,450,322,185
2009,Rural,Mizoram,Crime Against Women,Domestic Violence,Female,60+,5222,377,4845,995,4227
2007,Urban,Chhattisgarh,Property Crime,Arson,Male,31-45,974,225,749,971,3
2006,Urban,Nagaland,Property Crime,Burglary,Female,31-45,8285,4790,3495,6053,2232
2004,Urban,Jammu & Kashmir,Crime Against Women,Dowry Deaths,Male,46-60,3753,2379,1374,2807,946
2005,Rural,Bihar,Crime Against Men,Murder,Female,18-30,8353,6087,2266,7472,881
2008,Urban,Himachal Pradesh,Crime Against Women,Molestation,Female,60+,4942,4147,795,4760,182
2009,Urban,Assam,Crime Against Men,Robbery,Male,31-45,7736,5209,2527,7277,459
2004,Urban,Odisha,Crime Against Men,Assault,Female,60+,3724,3463,261,3722,2
2008,Urban,Goa,Other Crimes,Fraud,Female,0-12,4918,195,4723,743,4175
2008,Rural,Telangana,Other Crimes,Cyber Crime,Female,13-17,7697,2653,5044,6552,1145
2001,Urban,Sikkim,Crime Against Children,Kidnapping,Male,0-12,8860,176,8684,8194,666
2002,Urban,Jammu & Kashmir,Crime Against Men,Assault,Male,60+,3498,3439,59,3451,47
2008,Rural,Goa,Crime Against Men,Robbery,Female,0-12,6751,5176,1575,6697,54
2003,Urban,Manipur,Crime Against Men,Murder,Male,60+,2039,1842,197,1918,121
2008,Rural,Assam,Crime Against Men,Extortion,Male,13-17,2919,53,2866,243,2676
2007,Rural,Sikkim,Crime Against Children,Kidnapping,Male,60+,6623,4367,2256,4490,2133
2002,Urban,Punjab,Crime Against Men,Murder,Female,18-30,7297,4259,3038,5019,2278
2006,Urban,West Bengal,Crime Against Women,Rape,Male,13-17,1718,1405,313,1494,224
2001,Rural,Arunachal Pradesh,Crime Against Women,Rape,Female,46-60,9883,8055,1828,8746,1137
2003,Rural,Arunachal Pradesh,Crime Against Children,Kidnapping,Male,13-17,3746,2388,1358,3142,604
2009,Urban,Manipur,Crime Against Children,Trafficking,Female,0-12,723,168,555,179,544
2008,Urban,Karnataka,Crime Against Women,Domestic Violence,Male,0-12,6127,550,5577,4981,1146
2002,Urban,Kerala,Other Crimes,Corruption,Male,60+,109,29,80,95,14
2005,Urban,Jammu & Kashmir,Crime Against Women,Molestation,Male,0-12,2811,1592,1219,2347,464
2006,Urban,Andhra Pradesh,Crime Against Women,Domestic Violence,Female,31-45,2252,2130,122,2130,122
2007,Rural,Chhattisgarh,Crime Against Women,Dowry Deaths,Female,46-60,5311,226,5085,4889,422
2006,Urban,Karnataka,Crime Against Children,Kidnapping,Female,0-12,2505,1730,775,2091,414
2008,Rural,Delhi,Crime Against Children,Trafficking,Female,60+,5965,1058,4907,5609,356
2006,Rural,Mizoram,Property Crime,Burglary,Female,46-60,3674,1525,2149,2303,1371
2006,Urban,Rajasthan,Other Crimes,Cyber Crime,Female,60+,4717,3868,849,4505,212
2002,Urban,Andhra Pradesh,Crime Against Women,Dowry Deaths,Female,18-30,9550,336,9214,4714,4836
2009,Rural,Jharkhand,Other Crimes,Cyber Crime,Male,46-60,7555,201,7354,5540,2015
2007,Urban,Andhra Pradesh,Crime Against Men,Robbery,Female,31-45,1444,928,516,1029,415
2009,Rural,Meghalaya,Property Crime,Burglary,Male,31-45,1621,850,771,1141,480
2007,Rural,Jammu & Kashmir,Crime Against Children,Child Labor,Female,60+,7605,2750,4855,5363,2242
2008,Rural,Madhya Pradesh,Crime Against Men,Robbery,Female,18-30,7535,1354,6181,2699,4836
2007,Rural,Jharkhand,Property Crime,Theft,Male,46-60,3499,2732,767,3344,155
2010,Rural,Maharashtra,Crime Against Men,Assault,Male,0-12,2614,337,2277,450,2164
2010,Rural,Haryana,Other Crimes,Fraud,Female,46-60,5696,4372,1324,4599,1097
2007,Urban,Assam,Crime Against Women,Dowry Deaths,Male,46-60,1033,381,652,770,263
2010,Urban,Goa,Property Crime,Theft,Male,60+,6754,1933,4821,5420,1334
2005,Urban,Tamil Nadu,Property Crime,Burglary,Male,0-12,9044,6770,2274,8942,102
2001,Rural,Assam,Crime Against Men,Extortion,Female,60+,1773,266,1507,1693,80
2010,Rural,Assam,Property Crime,Arson,Male,46-60,5856,2457,3399,5766,90
2007,Urban,Karnataka,Property Crime,Arson,Male,13-17,8010,7001,1009,7943,67
2010,Rural,Delhi,Property Crime,Burglary,Male,13-17,3219,1299,1920,1811,1408
2004,Urban,Karnataka,Crime Against Children,Child Labor,Female,18-30,3428,3225,203,3267,161
2001,Rural,Kerala,Property Crime,Arson,Male,0-12,3370,1439,1931,3062,308
2004,Rural,Odisha,Property Crime,Burglary,Female,18-30,2721,817,1904,1242,1479
2005,Rural,Nagaland,Crime Against Children,Kidnapping,Male,0-12,4107,1840,2267,2449,1658
2006,Urban,Delhi,Crime Against Women,Molestation,Female,18-30,5448,4237,1211,4992,456
2007,Urban,Jharkhand,Crime Against Men,Robbery,Male,0-12,5978,1859,4119,4113,1865
2008,Rural,Rajasthan,Crime Against Women,Dowry Deaths,Male,46-60,4546,3078,1468,3385,1161
2001,Rural,Sikkim,Crime Against Men,Robbery,Female,60+,6536,134,6402,5588,948
2010,Urban,West Bengal,Crime Against Women,Dowry Deaths,Female,0-12,8948,2301,6647,3358,5590
2007,Rural,Tamil Nadu,Crime Against Children,Child Abuse,Male,13-17,7916,1879,6037,4204,3712
2001,Rural,Karnataka,Property Crime,Arson,Male,0-12,2720,2642,78,2709,11
2002,Urban,Jharkhand,Other Crimes,Corruption,Male,13-17,9771,4737,5034,7373,2398
2004,Rural,Himachal Pradesh,Other Crimes,Cyber Crime,Female,46-60,9302,5921,3381,8585,717
2008,Rural,Kerala,Crime Against Children,Kidnapping,Male,31-45,3677,2636,1041,3440,237
2006,Rural,Nagaland,Property Crime,Arson,Female,60+,5433,2018,3415,4746,687
2009,Urban,Goa,Crime Against Women,Rape,Male,31-45,9870,3236,6634,3877,5993
2010,Urban,Gujarat,Crime Against Children,Kidnapping,Male,31-45,4474,797,3677,1095,3379
2003,Rural,Odisha,Other Crimes,Corruption,Male,46-60,2823,1573,1250,2031,792
2004,Urban,Bihar,Crime Against Children,Child Abuse,Female,60+,7625,6024,1601,7610,15
2008,Rural,Uttar Pradesh,Property Crime,Theft,Female,13-17,6969,4050,2919,5968,1001
2001,Rural,Rajasthan,Property Crime,Vandalism,Male,18-30,3110,1859,1251,2489,621
2010,Rural,Odisha,Crime Against Men,Murder,Male,13-17,4079,1657,2422,3797,282
2007,Rural,Chhattisgarh,Property Crime,Arson,Female,46-60,1514,486,1028,622,892
2001,Rural,Gujarat,Property Crime,Burglary,Female,18-30,6772,2699,4073,2817,3955
2009,Urban,Goa,Crime Against Children,Child Abuse,Female,46-60,4656,2372,2284,2729,1927
2004,Rural,West Bengal,Crime Against Men,Assault,Female,13-17,4812,3371,1441,4482,330
2009,Rural,Rajasthan,Crime Against Children,Child Labor,Female,0-12,308,229,79,296,12
2005,Rural,Uttar Pradesh,Other Crimes,Fraud,Female,13-17,5263,279,4984,1799,3464
2010,Rural,Karnataka,Crime Against Men,Robbery,Male,13-17,8653,3734,4919,3804,4849
2009,Urban,Madhya Pradesh,Property Crime,Burglary,Female,46-60,7575,5014,2561,6280,1295
2007,Urban,Andhra Pradesh,Crime Against Women,Dowry Deaths,Male,0-12,4742,2297,2445,2795,1947
2005,Urban,West Bengal,Other Crimes,Corruption,Female,31-45,9998,461,9537,1538,8460
2008,Urban,Andhra Pradesh,Other Crimes,Drug Offense,Male,13-17,3494,2617,877,3324,170
2002,Rural,Sikkim,Property Crime,Vandalism,Female,31-45,5610,5160,450,5575,35
2002,Rural,Bihar,Crime Against Women,Dowry Deaths,Male,0-12,5107,3550,1557,4475,632
2009,Rural,Tripura,Other Crimes,Fraud,Female,0-12,6475,1722,4753,3501,2974
2003,Rural,Jammu & Kashmir,Other Crimes,Cyber Crime,Female,13-17,9703,9320,383,9654,49
2004,Rural,Delhi,Crime Against Men,Extortion,Male,60+,1695,1204,491,1606,89
2006,Urban,Himachal Pradesh,Crime Against Children,Kidnapping,Male,46-60,8653,5961,2692,8521,132
2007,Urban,Tamil Nadu,Other Crimes,Drug Offense,Male,13-17,923,406,517,704,219
2003,Rural,Tripura,Other Crimes,Cyber Crime,Male,18-30,5755,3424,2331,3542,2213
2002,Urban,Bihar,Crime Against Men,Assault,Female,13-17,2188,376,1812,813,1375
2001,Rural,West Bengal,Crime Against Men,Robbery,Female,46-60,9434,630,8804,7827,1607
2009,Urban,Goa,Other Crimes,Drug Offense,Male,46-60,3717,2473,1244,3111,606
2004,Urban,Delhi,Crime Against Men,Assault,Male,18-30,4628,4108,520,4238,390
2005,Urban,Kerala,Crime Against Children,Kidnapping,Male,46-60,8012,480,7532,3523,4489
2009,Urban,Kerala,Other Crimes,Cyber Crime,Male,60+,7653,6163,1490,6682,971
2007,Urban,Meghalaya,Crime Against Children,Child Labor,Male,0-12,9291,273,9018,8692,599
2001,Urban,West Bengal,Property Crime,Vandalism,Female,46-60,8884,5807,3077,7944,940
2005,Urban,Nagaland,Crime Against Children,Child Labor,Male,18-30,5861,83,5778,4785,1076
2005,Urban,Jharkhand,Property Crime,Theft,Female,46-60,1305,639,666,783,522
2008,Urban,Jharkhand,Crime Against Children,Trafficking,Female,31-45,1637,361,1276,1637,0
2009,Urban,Jharkhand,Crime Against Men,Extortion,Female,18-30,9739,1027,8712,2049,7690
2001,Rural,Manipur,Property Crime,Vandalism,Female,13-17,5534,2574,2960,4883,651
2006,Urban,Uttarakhand,Crime Against Women,Dowry Deaths,Female,46-60,4001,3383,618,3775,226
2001,Rural,Punjab,Crime Against Men,Extortion,Male,13-17,6841,3921,2920,5901,940
2005,Rural,Himachal Pradesh,Property Crime,Arson,Male,0-12,2801,826,1975,2552,249
2010,Rural,Odisha,Property Crime,Burglary,Male,60+,1682,811,871,1431,251
2004,Urban,Bihar,Property Crime,Vandalism,Female,60+,4188,2402,1786,3610,578
2010,Rural,West Bengal,Property Crime,Theft,Female,46-60,87,85,2,85,2
2005,Rural,Goa,Crime Against Women,Molestation,Female,0-12,9809,221,9588,4296,5513
2003,Rural,Maharashtra,Other Crimes,Fraud,Female,31-45,9252,3217,6035,6155,3097
2009,Urban,Goa,Crime Against Women,Rape,Male,46-60,2084,157,1927,644,1440
2007,Urban,Mizoram,Other Crimes,Fraud,Male,18-30,4362,2874,1488,3292,1070
2008,Urban,Chhattisgarh,Crime Against Women,Domestic Violence,Female,46-60,2760,902,1858,1791,969
2001,Urban,Chhattisgarh,Property Crime,Theft,Female,46-60,8060,5606,2454,7192,868
2002,Rural,Jharkhand,Property Crime,Arson,Male,31-45,1765,871,894,989,776
2008,Rural,Jammu & Kashmir,Property Crime,Arson,Female,0-12,9943,7264,2679,9482,461
2006,Rural,Jammu & Kashmir,Other Crimes,Corruption,Female,60+,3983,2999,984,3180,803
2004,Urban,Mizoram,Crime Against Women,Rape,Female,18-30,965,823,142,881,84
2009,Urban,Sikkim,Property Crime,Theft,Male,18-30,2393,1668,725,1683,710
2010,Urban,Nagaland,Crime Against Women,Domestic Violence,Male,60+,7145,2649,4496,3700,3445
2002,Rural,Arunachal Pradesh,Crime Against Women,Domestic Violence,Male,46-60,7344,52,7292,3346,3998
2002,Urban,Uttarakhand,Crime Against Men,Robbery,Male,0-12,4129,3935,194,4032,97
2007,Rural,Manipur,Other Crimes,Cyber Crime,Female,46-60,376,360,16,376,0
2003,Rural,Goa,Crime Against Children,Kidnapping,Male,46-60,6963,4980,1983,6475,488
2001,Rural,Himachal Pradesh,Crime Against Children,Trafficking,Male,0-12,3238,324,2914,2636,602
2003,Rural,Madhya Pradesh,Crime Against Children,Kidnapping,Male,46-60,1497,65,1432,460,1037
2010,Rural,Andhra Pradesh,Property Crime,Theft,Female,13-17,8795,2274,6521,5849,2946
2010,Rural,Mizoram,Other Crimes,Cyber Crime,Female,60+,9612,9232,380,9321,291
2005,Rural,Kerala,Crime Against Men,Assault,Male,60+,5077,850,4227,4340,737
2007,Rural,Kerala,Crime Against Children,Trafficking,Male,18-30,5077,1826,3251,2786,2291
2002,Rural,Telangana,Crime Against Women,Domestic Violence,Male,46-60,7474,6469,1005,6507,967
2006,Urban,Uttar Pradesh,Other Crimes,Cyber Crime,Male,31-45,5456,2695,2761,4414,1042
2001,Rural,Madhya Pradesh,Crime Against Men,Robbery,Female,31-45,1419,651,768,1044,375
2004,Urban,Jharkhand,Other Crimes,Cyber Crime,Male,13-17,3096,1027,2069,1090,2006
2008,Urban,Delhi,Other Crimes,Drug Offense,Male,0-12,4013,312,3701,3734,279
2006,Rural,Kerala,Other Crimes,Drug Offense,Male,0-12,8844,6446,2398,6537,2307
2005,Urban,Haryana,Crime Against Men,Extortion,Female,60+,9938,1213,8725,6947,2991
2004,Urban,Tripura,Property Crime,Burglary,Male,46-60,647,439,208,547,100
2004,Urban,Mizoram,Crime Against Children,Child Abuse,Male,13-17,9919,4930,4989,6421,3498
2007,Rural,Chhattisgarh,Crime Against Women,Domestic Violence,Male,46-60,3947,2175,1772,2851,1096
2004,Urban,Sikkim,Crime Against Women,Domestic Violence,Female,13-17,8860,7610,1250,8650,210
2010,Urban,Madhya Pradesh,Crime Against Men,Extortion,Female,0-12,1623,730,893,953,670
2003,Rural,Haryana,Property Crime,Theft,Female,0-12,1978,756,1222,1731,247
2002,Rural,Haryana,Crime Against Women,Domestic Violence,Female,13-17,8898,6481,2417,7591,1307
2007,Urban,Jharkhand,Crime Against Men,Assault,Male,46-60,5060,3558,1502,4358,702
2005,Rural,Arunachal Pradesh,Crime Against Men,Murder,Male,60+,3552,3353,199,3532,20
2001,Urban,Manipur,Crime Against Children,Child Abuse,Female,60+,8007,1146,6861,3465,4542
2009,Urban,Tripura,Crime Against Children,Kidnapping,Male,18-30,796,707,89,780,16
2010,Rural,Andhra Pradesh,Crime Against Children,Kidnapping,Male,18-30,1841,1740,101,1820,21
2007,Rural,Himachal Pradesh,Crime Against Men,Extortion,Male,13-17,8891,6242,2649,7231,1660
2003,Rural,Jharkhand,Crime Against Children,Child Labor,Female,0-12,2506,1959,547,2326,180
2006,Rural,Himachal Pradesh,Crime Against Women,Molestation,Female,0-12,645,211,434,503,142
2010,Urban,Meghalaya,Crime Against Women,Dowry Deaths,Male,46-60,6721,5416,1305,6427,294
2010,Urban,Bihar,Other Crimes,Fraud,Male,31-45,7089,3661,3428,5997,1092
2007,Urban,Delhi,Other Crimes,Drug Offense,Male,18-30,9596,3268,6328,6944,2652
2009,Rural,Jammu & Kashmir,Property Crime,Vandalism,Female,18-30,5523,4624,899,5231,292
2006,Rural,Haryana,Crime Against Children,Child Labor,Male,18-30,2466,693,1773,967,1499
2010,Rural,Nagaland,Other Crimes,Cyber Crime,Female,13-17,5230,1260,3970,3670,1560
2002,Urban,Jharkhand,Property Crime,Burglary,Male,31-45,4728,2273,2455,2957,1771
2007,Rural,Tripura,Crime Against Children,Child Abuse,Male,31-45,6899,5500,1399,5526,1373
2001,Rural,Himachal Pradesh,Property Crime,Vandalism,Male,60+,2553,968,1585,1169,1384
2010,Rural,Nagaland,Crime Against Men,Extortion,Female,60+,9696,9341,355,9428,268
2003,Urban,Jharkhand,Crime Against Children,Child Abuse,Female,13-17,3646,3023,623,3540,106
2010,Urban,Maharashtra,Crime Against Children,Child Labor,Male,0-12,3362,1210,2152,2074,1288
2007,Rural,Delhi,Property Crime,Burglary,Male,31-45,1161,444,717,551,610
2008,Urban,Maharashtra,Crime Against Men,Assault,Male,13-17,1027,778,249,902,125
2006,Rural,Punjab,Crime Against Children,Child Labor,Male,18-30,8780,5979,2801,7048,1732
2010,Urban,Bihar,Other Crimes,Corruption,Female,31-45,3337,175,3162,3149,188
2007,Rural,Gujarat,Crime Against Men,Extortion,Male,31-45,7698,3482,4216,7451,247
2005,Urban,Mizoram,Crime Against Children,Child Abuse,Male,60+,4436,3849,587,4250,186
2007,Rural,Kerala,Crime Against Men,Extortion,Male,60+,7454,4333,3121,6761,693
2002,Urban,West Bengal,Property Crime,Theft,Female,13-17,9059,8078,981,8487,572
2003,Urban,Uttarakhand,Other Crimes,Fraud,Male,0-12,6163,5153,1010,5888,275
2008,Urban,Tripura,Crime Against Women,Rape,Female,0-12,8740,2854,5886,7332,1408
2001,Rural,Goa,Other Crimes,Fraud,Male,13-17,4031,1885,2146,3935,96
2006,Rural,Rajasthan,Crime Against Women,Dowry Deaths,Female,0-12,7437,5224,2213,5411,2026
2008,Urban,Sikkim,Crime Against Women,Domestic Violence,Male,60+,4588,1698,2890,2995,1593
2009,Rural,Arunachal Pradesh,Crime Against Men,Assault,Female,46-60,2998,1703,1295,2071,927
2002,Rural,Nagaland,Crime Against Men,Extortion,Male,18-30,4702,4288,414,4460,242
2003,Urban,Haryana,Crime Against Men,Robbery,Female,18-30,2010,1999,11,2006,4
2009,Urban,Assam,Other Crimes,Fraud,Female,46-60,4581,2839,1742,3724,857
2002,Rural,Haryana,Crime Against Men,Murder,Male,60+,5500,408,5092,5496,4
2008,Rural,Jammu & Kashmir,Crime Against Men,Extortion,Male,13-17,9635,3164,6471,5537,4098
2010,Rural,Odisha,Crime Against Men,Robbery,Female,18-30,4615,4581,34,4605,10
2006,Urban,Meghalaya,Crime Against Women,Dowry Deaths,Male,18-30,1013,648,365,895,118
2004,Urban,Madhya Pradesh,Crime Against Men,Assault,Female,60+,1078,237,841,240,838
2001,Rural,Jharkhand,Crime Against Men,Murder,Female,0-12,1557,129,1428,219,1338
2009,Rural,Tripura,Other Crimes,Drug Offense,Male,31-45,2839,486,2353,1618,1221
2002,Rural,Bihar,Crime Against Men,Murder,Female,0-12,5088,3697,1391,4427,661
2003,Urban,Meghalaya,Other Crimes,Fraud,Female,0-12,215,168,47,180,35
2003,Urban,Madhya Pradesh,Crime Against Men,Robbery,Male,46-60,9781,7545,2236,7873,1908
2009,Rural,Sikkim,Other Crimes,Cyber Crime,Male,31-45,5646,4884,762,5558,88
2007,Rural,Kerala,Property Crime,Burglary,Male,18-30,4429,2926,1503,3895,534
2010,Urban,Delhi,Property Crime,Burglary,Female,18-30,2530,1559,971,1743,787
2005,Urban,West Bengal,Crime Against Men,Murder,Male,60+,198,134,64,142,56
2009,Urban,Andhra Pradesh,Property Crime,Theft,Male,31-45,8539,724,7815,6379,2160
2009,Rural,Andhra Pradesh,Crime Against Children,Kidnapping,Male,0-12,3522,1836,1686,2677,845
2001,Rural,Maharashtra,Other Crimes,Drug Offense,Male,13-17,6369,5706,663,6162,207
2009,Urban,Haryana,Crime Against Men,Robbery,Male,60+,902,902,0,902,0
2002,Rural,Kerala,Crime Against Children,Kidnapping,Female,31-45,8343,7079,1264,8108,235
2003,Urban,Tripura,Crime Against Women,Domestic Violence,Female,60+,8769,2618,6151,8749,20
2009,Urban,Haryana,Crime Against Women,Dowry Deaths,Female,18-30,5952,864,5088,2832,3120
2006,Rural,Tripura,Other Crimes,Cyber Crime,Female,60+,3707,2892,815,3073,634
2008,Urban,Jammu & Kashmir,Crime Against Children,Child Abuse,Female,0-12,740,347,393,676,64
2004,Urban,Andhra Pradesh,Property Crime,Vandalism,Male,0-12,751,633,118,731,20
2002,Rural,Rajasthan,Other Crimes,Corruption,Female,13-17,2940,994,1946,2790,150
2004,Rural,Tamil Nadu,Crime Against Children,Child Labor,Female,31-45,9836,2263,7573,8820,1016
2009,Rural,Chhattisgarh,Other Crimes,Drug Offense,Female,13-17,7462,2522,4940,6601,861
2009,Urban,Mizoram,Property Crime,Vandalism,Male,46-60,3397,319,3078,3394,3
2006,Urban,Karnataka,Other Crimes,Drug Offense,Female,18-30,4780,4610,170,4728,52
2002,Rural,Haryana,Crime Against Men,Assault,Male,0-12,7003,2482,4521,5825,1178
2008,Rural,Delhi,Crime Against Children,Trafficking,Male,13-17,5059,1900,3159,2082,2977
2005,Rural,Karnataka,Crime Against Men,Extortion,Male,60+,3419,2920,499,2978,441
2007,Rural,Uttarakhand,Property Crime,Burglary,Female,0-12,794,213,581,603,191
2005,Rural,Tripura,Crime Against Children,Trafficking,Male,0-12,399,324,75,328,71
2001,Rural,Assam,Property Crime,Arson,Female,31-45,1121,858,263,860,261
2009,Urban,Himachal Pradesh,Crime Against Men,Extortion,Female,18-30,529,349,180,350,179
2010,Rural,Punjab,Property Crime,Theft,Male,0-12,6624,4637,1987,6541,83
2004,Rural,Goa,Other Crimes,Corruption,Female,31-45,7442,5293,2149,5684,1758
2005,Rural,Telangana,Property Crime,Vandalism,Female,0-12,7770,1034,6736,3258,4512
2008,Urban,Himachal Pradesh,Crime Against Women,Rape,Male,18-30,5488,2241,3247,2943,2545
2007,Urban,Andhra Pradesh,Crime Against Children,Kidnapping,Male,31-45,2929,1803,1126,2383,546
2005,Rural,Meghalaya,Crime Against Men,Extortion,Female,18-30,507,457,50,493,14
2006,Rural,Jammu & Kashmir,Other Crimes,Cyber Crime,Female,60+,7708,2762,4946,3603,4105
2004,Rural,Uttarakhand,Crime Against Children,Kidnapping,Female,18-30,8223,705,7518,3142,5081
2002,Urban,Rajasthan,Property Crime,Theft,Female,60+,5758,2882,2876,5418,340
2009,Urban,Uttar Pradesh,Property Crime,Arson,Male,31-45,6364,3018,3346,3725,2639
2006,Rural,Delhi,Property Crime,Burglary,Male,0-12,8254,5448,2806,6575,1679
2006,Rural,Goa,Property Crime,Arson,Male,0-12,7392,1822,5570,5026,2366
2006,Urban,Sikkim,Other Crimes,Drug Offense,Female,0-12,3942,386,3556,559,3383
2004,Urban,Mizoram,Other Crimes,Drug Offense,Female,0-12,6999,5566,1433,6967,32
2004,Urban,Maharashtra,Crime Against Children,Kidnapping,Male,13-17,4281,4036,245,4141,140
2010,Urban,Arunachal Pradesh,Property Crime,Arson,Female,18-30,2030,1622,408,1865,165
2001,Rural,Odisha,Crime Against Women,Dowry Deaths,Female,60+,5327,5315,12,5315,12
2006,Rural,Jammu & Kashmir,Other Crimes,Corruption,Male,60+,7621,1366,6255,5147,2474
2001,Urban,Tripura,Crime Against Children,Trafficking,Male,13-17,9404,2377,7027,7168,2236
2009,Urban,Karnataka,Property Crime,Arson,Female,13-17,2668,1972,696,2383,285
2010,Urban,Haryana,Crime Against Men,Extortion,Male,31-45,154,119,35,120,34
2007,Rural,Rajasthan,Property Crime,Theft,Female,13-17,2190,1797,393,2000,190
2001,Rural,Uttarakhand,Crime Against Men,Extortion,Male,60+,9318,675,8643,6992,2326
2002,Rural,Tamil Nadu,Other Crimes,Drug Offense,Male,18-30,3596,1926,1670,1949,1647
2007,Rural,Tripura,Crime Against Men,Extortion,Male,46-60,7865,1931,5934,3707,4158
2006,Rural,Tripura,Crime Against Men,Robbery,Female,18-30,7904,3511,4393,3784,4120
2006,Rural,Bihar,Crime Against Men,Extortion,Female,31-45,6281,2597,3684,4852,1429
2007,Rural,Mizoram,Crime Against Women,Dowry Deaths,Male,13-17,2421,1505,916,2386,35
2006,Urban,Goa,Crime Against Women,Domestic Violence,Male,60+,5743,2581,3162,4624,1119
2005,Urban,Madhya Pradesh,Crime Against Women,Molestation,Male,0-12,3038,3032,6,3037,1
2007,Urban,Jharkhand,Crime Against Children,Kidnapping,Female,60+,2693,2007,686,2405,288
2007,Urban,Bihar,Crime Against Children,Child Labor,Male,31-45,58,33,25,49,9
2008,Urban,Meghalaya,Other Crimes,Cyber Crime,Female,18-30,5766,1709,4057,5221,545
2010,Urban,Jammu & Kashmir,Other Crimes,Cyber Crime,Male,0-12,5072,1094,3978,2045,3027
2007,Urban,Arunachal Pradesh,Other Crimes,Fraud,Female,0-12,258,190,68,242,16
2003,Urban,Meghalaya,Crime Against Children,Kidnapping,Male,13-17,4196,110,4086,3270,926
2004,Rural,Punjab,Crime Against Men,Extortion,Female,18-30,7753,3170,4583,5072,2681
2009,Rural,Maharashtra,Other Crimes,Fraud,Female,18-30,5242,1519,3723,4002,1240
2009,Urban,Meghalaya,Crime Against Children,Kidnapping,Female,46-60,4632,642,3990,2922,1710
2008,Urban,Uttar Pradesh,Crime Against Women,Rape,Male,46-60,9309,7144,2165,7607,1702
2007,Rural,Mizoram,Property Crime,Arson,Male,60+,2656,2587,69,2646,10
2007,Rural,Manipur,Crime Against Children,Child Abuse,Male,13-17,2963,2046,917,2235,728
2006,Urban,Himachal Pradesh,Crime Against Men,Murder,Female,31-45,5217,4881,336,5158,59
2007,Urban,Uttarakhand,Crime Against Children,Trafficking,Female,60+,3530,1639,1891,2454,1076
2007,Urban,Madhya Pradesh,Other Crimes,Cyber Crime,Female,31-45,5838,2963,2875,3539,2299
2005,Urban,West Bengal,Crime Against Men,Robbery,Male,13-17,3031,2969,62,3023,8
2001,Rural,Karnataka,Crime Against Men,Extortion,Male,13-17,9461,4474,4987,5621,3840
2007,Rural,Assam,Property Crime,Arson,Male,31-45,3305,1145,2160,2498,807
2005,Urban,Madhya Pradesh,Crime Against Men,Robbery,Male,13-17,6845,4,6841,4016,2829
2009,Rural,Meghalaya,Crime Against Men,Assault,Female,60+,1132,673,459,678,454
2009,Urban,Uttarakhand,Crime Against Women,Molestation,Female,18-30,3786,2,3784,2621,1165
2005,Rural,Andhra Pradesh,Crime Against Women,Dowry Deaths,Female,18-30,2982,2743,239,2774,208
2007,Urban,Telangana,Property Crime,Arson,Female,0-12,9660,2125,7535,4665,4995
2010,Rural,Uttar Pradesh,Property Crime,Arson,Male,46-60,1768,1506,262,1736,32
2007,Urban,Tripura,Crime Against Children,Child Labor,Female,13-17,4018,641,3377,1348,2670
2007,Rural,Tripura,Other Crimes,Cyber Crime,Female,13-17,1130,934,196,1049,81
2010,Rural,Chhattisgarh,Crime Against Children,Kidnapping,Male,31-45,5218,3271,1947,4843,375
2001,Urban,Odisha,Property Crime,Theft,Female,46-60,1349,874,475,976,373
2004,Rural,Jammu & Kashmir,Property Crime,Vandalism,Male,46-60,86,68,18,79,7
2003,Rural,Odisha,Crime Against Children,Kidnapping,Female,31-45,6572,5122,1450,5155,1417
2007,Urban,West Bengal,Crime Against Men,Murder,Female,31-45,7463,7103,360,7279,184
2009,Urban,Jammu & Kashmir,Crime Against Men,Extortion,Male,60+,1163,1066,97,1074,89
2001,Rural,Uttar Pradesh,Crime Against Women,Domestic Violence,Male,31-45,820,30,790,32,788
2005,Urban,Sikkim,Other Crimes,Corruption,Male,13-17,4715,3050,1665,4378,337
2002,Rural,Tamil Nadu,Property Crime,Theft,Male,13-17,8063,4277,3786,6373,1690
2001,Rural,Madhya Pradesh,Crime Against Men,Extortion,Female,0-12,3663,1115,2548,2480,1183
2004,Urban,Meghalaya,Crime Against Women,Domestic Violence,Male,0-12,4898,3510,1388,4758,140
2010,Rural,Meghalaya,Property Crime,Arson,Female,46-60,8912,974,7938,8405,507
2002,Urban,Nagaland,Crime Against Men,Assault,Female,60+,7963,4230,3733,4502,3461
2008,Rural,Himachal Pradesh,Crime Against Men,Murder,Female,13-17,1310,1030,280,1181,129
2004,Urban,Delhi,Other Crimes,Drug Offense,Female,31-45,6928,1804,5124,6001,927
2005,Urban,West Bengal,Crime Against Children,Kidnapping,Female,60+,7238,4184,3054,5049,2189
2010,Rural,Andhra Pradesh,Crime Against Men,Murder,Female,13-17,5502,4330,1172,4671,831
2004,Urban,Punjab,Crime Against Children,Child Labor,Male,18-30,8303,8186,117,8230,73
2009,Rural,Telangana,Property Crime,Theft,Male,46-60,7663,1066,6597,2139,5524
2008,Urban,Telangana,Crime Against Men,Robbery,Female,46-60,1379,1260,119,1377,2
2005,Urban,Kerala,Other Crimes,Cyber Crime,Male,0-12,3356,532,2824,1191,2165
2004,Rural,Tamil Nadu,Property Crime,Theft,Female,13-17,5188,1542,3646,4126,1062
2002,Rural,Andhra Pradesh,Crime Against Women,Rape,Female,13-17,1120,993,127,1019,101
2005,Urban,Odisha,Crime Against Women,Molestation,Male,31-45,3253,2800,453,3164,89
2009,Urban,Tripura,Crime Against Men,Extortion,Female,46-60,6687,2653,4034,3060,3627
2010,Rural,Madhya Pradesh,Property Crime,Vandalism,Female,46-60,6508,3222,3286,4321,2187
2008,Urban,Meghalaya,Other Crimes,Corruption,Female,60+,7442,3922,3520,7203,239
2006,Rural,Madhya Pradesh,Property Crime,Burglary,Female,60+,5502,2117,3385,3296,2206
2005,Urban,Odisha,Crime Against Men,Extortion,Male,0-12,2898,1667,1231,2424,474
2003,Rural,Meghalaya,Crime Against Children,Child Abuse,Female,13-17,7260,2033,5227,2110,5150
2007,Urban,Chhattisgarh,Crime Against Children,Trafficking,Male,0-12,2591,235,2356,2225,366
2003,Urban,Gujarat,Crime Against Children,Kidnapping,Female,13-17,4773,2161,2612,4711,62
2002,Urban,Goa,Crime Against Women,Rape,Female,31-45,3738,354,3384,3627,111
2006,Urban,Chhattisgarh,Property Crime,Arson,Female,0-12,2765,2602,163,2661,104
2010,Urban,Bihar,Other Crimes,Corruption,Male,0-12,3637,2826,811,3098,539
2002,Urban,Meghalaya,Crime Against Men,Murder,Female,31-45,4841,3428,1413,4420,421
2010,Urban,Assam,Property Crime,Burglary,Male,13-17,6436,697,5739,2347,4089
2008,Rural,Tamil Nadu,Other Crimes,Cyber Crime,Female,18-30,2063,271,1792,367,1696
2008,Urban,Meghalaya,Crime Against Women,Dowry Deaths,Male,13-17,7192,3394,3798,4076,3116
2009,Urban,Telangana,Crime Against Women,Rape,Female,18-30,4849,302,4547,1054,3795
2003,Urban,Delhi,Crime Against Children,Child Abuse,Female,46-60,5898,4738,1160,5455,443
2003,Rural,Haryana,Crime Against Children,Child Abuse,Female,31-45,6809,5878,931,6304,505
2008,Urban,Telangana,Crime Against Children,Trafficking,Male,0-12,8175,2858,5317,6519,1656
2009,Urban,Uttarakhand,Crime Against Men,Robbery,Male,31-45,1285,754,531,1150,135
2007,Rural,Jammu & Kashmir,Property Crime,Vandalism,Female,46-60,1825,1746,79,1800,25
2008,Urban,Gujarat,Property Crime,Vandalism,Female,13-17,9143,6902,2241,8977,166
2003,Rural,Uttarakhand,Other Crimes,Drug Offense,Male,46-60,1930,1047,883,1615,315
2001,Rural,Madhya Pradesh,Crime Against Children,Trafficking,Female,46-60,9778,2669,7109,6157,3621
2006,Urban,Tamil Nadu,Crime Against Women,Molestation,Male,31-45,8829,507,8322,982,7847
2010,Urban,Meghalaya,Crime Against Children,Trafficking,Male,13-17,2487,1517,970,1751,736
2004,Urban,Gujarat,Crime Against Men,Extortion,Female,18-30,8953,5346,3607,5879,3074
2007,Urban,Uttar Pradesh,Crime Against Children,Trafficking,Male,31-45,9968,3323,6645,5997,3971
2009,Urban,Kerala,Other Crimes,Fraud,Male,46-60,5389,1049,4340,3843,1546
2003,Rural,Tripura,Crime Against Women,Domestic Violence,Male,18-30,5379,2466,2913,4768,611
2007,Rural,Nagaland,Crime Against Children,Child Labor,Male,18-30,6751,3378,3373,6575,176
2005,Rural,Manipur,Crime Against Women,Molestation,Male,13-17,900,708,192,792,108
2006,Rural,Tripura,Crime Against Children,Child Labor,Male,18-30,8330,7441,889,7546,784
2009,Rural,Uttar Pradesh,Property Crime,Vandalism,Female,60+,2933,1930,1003,2658,275
2001,Rural,Chhattisgarh,Property Crime,Arson,Male,13-17,2160,377,1783,2066,94
2009,Rural,Chhattisgarh,Crime Against Men,Extortion,Female,60+,5950,2122,3828,2966,2984
2010,Urban,Tamil Nadu,Crime Against Children,Kidnapping,Female,18-30,927,902,25,909,18
2010,Urban,Tripura,Property Crime,Burglary,Female,60+,1257,701,556,822,435
2005,Rural,Madhya Pradesh,Crime Against Men,Assault,Male,31-45,3214,2221,993,2470,744
2008,Urban,Mizoram,Other Crimes,Cyber Crime,Male,46-60,7696,104,7592,2718,4978
2006,Urban,Meghalaya,Other Crimes,Corruption,Male,46-60,6900,6279,621,6470,430
2003,Urban,Karnataka,Crime Against Children,Child Labor,Male,13-17,1534,809,725,1066,468
2004,Urban,Assam,Crime Against Men,Robbery,Female,13-17,1991,1001,990,1919,72
2005,Rural,Meghalaya,Other Crimes,Fraud,Female,31-45,7770,556,7214,4003,3767
2007,Rural,Manipur,Crime Against Men,Robbery,Female,0-12,2053,1268,785,1851,202
2007,Urban,Punjab,Crime Against Children,Kidnapping,Male,18-30,9393,6755,2638,6957,2436
2005,Urban,Bihar,Other Crimes,Cyber Crime,Female,31-45,4070,894,3176,3150,920
2009,Urban,Maharashtra,Other Crimes,Corruption,Male,18-30,2438,1139,1299,2378,60
2006,Urban,Odisha,Crime Against Women,Molestation,Female,18-30,722,39,683,304,418
2005,Urban,Sikkim,Crime Against Men,Murder,Male,0-12,8694,7211,1483,8123,571
2008,Urban,Tripura,Property Crime,Theft,Male,18-30,686,675,11,681,5
2005,Urban,Gujarat,Crime Against Children,Kidnapping,Male,18-30,4996,4237,759,4938,58
2005,Urban,Karnataka,Other Crimes,Drug Offense,Female,46-60,574,207,367,501,73
2004,Urban,Bihar,Other Crimes,Fraud,Female,0-12,5334,3683,1651,4060,1274
2009,Rural,Manipur,Crime Against Women,Domestic Violence,Female,31-45,6827,3188,3639,5245,1582
2002,Urban,Odisha,Property Crime,Vandalism,Female,46-60,7834,5425,2409,5825,2009
2005,Urban,Jammu & Kashmir,Crime Against Children,Child Abuse,Male,0-12,418,312,106,393,25
2005,Urban,Madhya Pradesh,Property Crime,Burglary,Male,18-30,4289,102,4187,1109,3180
2010,Rural,Tripura,Other Crimes,Drug Offense,Female,31-45,1899,940,959,1227,672
2003,Rural,Uttarakhand,Crime Against Men,Assault,Male,31-45,5882,3562,2320,4946,936
2002,Urban,Sikkim,Crime Against Children,Child Labor,Male,31-45,7274,7031,243,7067,207
2006,Urban,Maharashtra,Other Crimes,Drug Offense,Female,31-45,7568,7479,89,7486,82
2005,Rural,Andhra Pradesh,Other Crimes,Cyber Crime,Male,31-45,3431,2797,634,3213,218
2004,Rural,Goa,Crime Against Women,Rape,Female,13-17,7297,5810,1487,5944,1353
2001,Urban,Uttarakhand,Crime Against Women,Rape,Male,18-30,3447,2588,859,3250,197
2001,Urban,Gujarat,Crime Against Women,Rape,Female,18-30,6267,4488,1779,6112,155
2004,Urban,Chhattisgarh,Crime Against Women,Dowry Deaths,Male,60+,8606,5453,3153,7505,1101
2009,Rural,Uttar Pradesh,Property Crime,Vandalism,Male,60+,5086,508,4578,3842,1244
2002,Urban,Madhya Pradesh,Crime Against Children,Trafficking,Female,60+,605,45,560,298,307
2004,Rural,Rajasthan,Crime Against Women,Dowry Deaths,Female,18-30,5251,3369,1882,4695,556
2009,Rural,Sikkim,Other Crimes,Drug Offense,Female,18-30,5983,4717,1266,5002,981
2007,Rural,Himachal Pradesh,Crime Against Women,Dowry Deaths,Female,46-60,7116,5092,2024,5982,1134
2009,Rural,Goa,Crime Against Women,Molestation,Female,60+,9542,5547,3995,8986,556
2001,Urban,West Bengal,Crime Against Men,Assault,Female,13-17,7252,4833,2419,7030,222
2003,Urban,Nagaland,Property Crime,Arson,Female,46-60,2855,1959,896,2603,252
2008,Urban,Delhi,Crime Against Men,Assault,Female,0-12,6418,4866,1552,5527,891
2001,Urban,Haryana,Other Crimes,Fraud,Male,0-12,8280,3561,4719,8002,278
2009,Urban,Chhattisgarh,Crime Against Women,Dowry Deaths,Male,60+,7219,196,7023,3801,3418
2010,Rural,Karnataka,Crime Against Children,Child Labor,Female,46-60,6086,1506,4580,5299,787
2002,Rural,Uttar Pradesh,Crime Against Children,Child Labor,Male,60+,1027,18,1009,979,48
2010,Urban,Tripura,Other Crimes,Drug Offense,Male,18-30,3983,2253,1730,3135,848
2006,Rural,Mizoram,Crime Against Children,Trafficking,Male,18-30,1970,975,995,1299,671
2003,Urban,Haryana,Property Crime,Theft,Male,60+,57,19,38,30,27
2003,Urban,Arunachal Pradesh,Crime Against Women,Molestation,Female,0-12,9834,3412,6422,7438,2396
2010,Rural,Uttar Pradesh,Other Crimes,Corruption,Female,13-17,702,626,76,684,18
2001,Rural,Tamil Nadu,Other Crimes,Corruption,Male,13-17,3290,701,2589,705,2585
2009,Urban,Assam,Crime Against Men,Robbery,Female,60+,190,95,95,167,23
2002,Urban,Madhya Pradesh,Crime Against Men,Assault,Female,60+,3605,3469,136,3598,7
2004,Rural,Himachal Pradesh,Property Crime,Arson,Female,0-12,355,197,158,331,24
2002,Urban,Andhra Pradesh,Crime Against Women,Domestic Violence,Female,0-12,4960,4458,502,4933,27
2008,Rural,Jammu & Kashmir,Crime Against Men,Robbery,Female,46-60,7852,5248,2604,6812,1040
2002,Urban,Goa,Crime Against Women,Domestic Violence,Male,60+,4818,4787,31,4797,21
2002,Rural,Karnataka,Crime Against Children,Kidnapping,Female,0-12,8582,2276,6306,5988,2594
2004,Rural,Haryana,Crime Against Children,Child Abuse,Female,13-17,3326,1442,1884,1753,1573
2005,Rural,Chhattisgarh,Crime Against Women,Rape,Male,46-60,474,367,107,430,44
2009,Rural,Delhi,Crime Against Children,Child Labor,Male,0-12,3217,1449,1768,2669,548
2010,Rural,Rajasthan,Crime Against Children,Kidnapping,Male,31-45,8840,2672,6168,8610,230
2005,Rural,Haryana,Crime Against Children,Child Labor,Female,13-17,9900,7365,2535,8702,1198
2004,Urban,Karnataka,Crime Against Children,Child Labor,Female,18-30,9992,6857,3135,9231,761
2008,Rural,Jharkhand,Property Crime,Arson,Female,13-17,3804,1932,1872,3242,562
2010,Urban,Odisha,Crime Against Women,Rape,Male,60+,339,165,174,335,4
2003,Rural,Himachal Pradesh,Crime Against Women,Dowry Deaths,Female,13-17,4783,72,4711,2826,1957
2001,Rural,Delhi,Crime Against Men,Robbery,Male,31-45,3144,2509,635,3079,65
2010,Rural,Odisha,Other Crimes,Fraud,Female,0-12,2487,2108,379,2216,271
2003,Rural,Madhya Pradesh,Other Crimes,Cyber Crime,Female,60+,8227,367,7860,3431,4796
2006,Urban,Andhra Pradesh,Crime Against Men,Assault,Male,0-12,4023,3175,848,3528,495
2009,Rural,Delhi,Crime Against Men,Assault,Female,13-17,6969,6068,901,6523,446
2002,Rural,Madhya Pradesh,Other Crimes,Drug Offense,Female,46-60,6071,2745,3326,3928,2143
2010,Rural,Maharashtra,Other Crimes,Drug Offense,Male,13-17,6040,762,5278,1118,4922
2008,Urban,Rajasthan,Other Crimes,Corruption,Male,0-12,3966,1033,2933,1710,2256
2008,Urban,Arunachal Pradesh,Crime Against Children,Child Labor,Male,31-45,4406,904,3502,3540,866
2006,Rural,Gujarat,Crime Against Men,Assault,Female,0-12,6661,2655,4006,3184,3477
2010,Rural,Maharashtra,Other Crimes,Corruption,Female,31-45,8586,5036,3550,5152,3434
2006,Urban,Odisha,Crime Against Women,Dowry Deaths,Female,18-30,5444,2827,2617,4587,857
2010,Rural,Andhra Pradesh,Property Crime,Vandalism,Male,46-60,305,232,73,300,5
2008,Urban,Tamil Nadu,Crime Against Men,Extortion,Female,0-12,645,427,218,432,213
2007,Rural,Rajasthan,Crime Against Women,Molestation,Male,13-17,4497,3039,1458,3899,598
2005,Urban,Bihar,Crime Against Men,Robbery,Female,46-60,3715,552,3163,1485,2230
2007,Urban,Punjab,Crime Against Women,Rape,Male,31-45,1238,655,583,1088,150
2003,Urban,Punjab,Other Crimes,Cyber Crime,Male,60+,546,129,417,208,338
2009,Rural,Punjab,Other Crimes,Cyber Crime,Female,13-17,8334,1302,7032,6946,1388
2008,Urban,Karnataka,Crime Against Men,Robbery,Female,31-45,2049,1431,618,1823,226
2003,Rural,Kerala,Crime Against Men,Extortion,Male,18-30,9680,7160,2520,9533,147
2008,Urban,Punjab,Property Crime,Burglary,Male,31-45,2588,2498,90,2520,68
2002,Urban,Jammu & Kashmir,Crime Against Men,Assault,Female,0-12,4493,2144,2349,3214,1279
2005,Rural,Sikkim,Crime Against Children,Child Abuse,Male,13-17,5613,5428,185,5486,127
2006,Rural,Kerala,Other Crimes,Cyber Crime,Female,60+,1161,438,723,775,386
2001,Rural,Manipur,Crime Against Children,Child Abuse,Male,13-17,9628,6607,3021,8637,991
2005,Rural,Rajasthan,Crime Against Women,Rape,Female,60+,7620,2083,5537,4392,3228
2004,Urban,Goa,Crime Against Children,Child Labor,Female,60+,2635,972,1663,2279,356
2007,Urban,Karnataka,Crime Against Children,Kidnapping,Female,46-60,8809,4141,4668,4939,3870
2002,Urban,Delhi,Other Crimes,Corruption,Female,0-12,7486,2238,5248,3238,4248
2010,Rural,Bihar,Property Crime,Theft,Male,13-17,9483,1088,8395,2847,6636
2009,Rural,Maharashtra,Crime Against Men,Extortion,Female,60+,4011,1921,2090,2770,1241
2004,Rural,Karnataka,Crime Against Children,Child Labor,Female,13-17,1753,1251,502,1651,102
2009,Urban,Meghalaya,Crime Against Men,Robbery,Female,60+,8254,4302,3952,5167,3087
2010,Urban,Madhya Pradesh,Crime Against Women,Domestic Violence,Male,31-45,550,452,98,506,44
2001,Rural,Arunachal Pradesh,Crime Against Children,Trafficking,Male,0-12,8440,8310,130,8332,108
2002,Rural,Meghalaya,Crime Against Men,Murder,Female,0-12,7081,1742,5339,6029,1052
2004,Urban,Jammu & Kashmir,Other Crimes,Corruption,Female,31-45,5300,492,4808,1827,3473
2003,Urban,Gujarat,Crime Against Children,Trafficking,Male,60+,9434,7010,2424,8933,501
2002,Urban,Andhra Pradesh,Crime Against Children,Child Abuse,Female,18-30,181,11,170,177,4
2002,Urban,Mizoram,Crime Against Men,Assault,Male,13-17,2277,1467,810,2164,113
2001,Urban,Jharkhand,Crime Against Women,Dowry Deaths,Female,31-45,7499,3401,4098,4573,2926
2003,Rural,West Bengal,Other Crimes,Fraud,Female,0-12,5475,4094,1381,4920,555
2008,Urban,Gujarat,Other Crimes,Fraud,Male,18-30,5184,4862,322,4984,200
2002,Rural,Karnataka,Crime Against Women,Domestic Violence,Male,18-30,8971,8670,301,8899,72
2002,Rural,Haryana,Crime Against Children,Kidnapping,Female,0-12,5563,59,5504,575,4988
2007,Urban,Maharashtra,Other Crimes,Fraud,Male,60+,2450,1488,962,1842,608
2008,Urban,Mizoram,Crime Against Men,Robbery,Male,18-30,2373,1336,1037,2038,335
2002,Rural,Sikkim,Crime Against Children,Child Abuse,Female,18-30,1004,959,45,961,43
2002,Rural,Himachal Pradesh,Crime Against Children,Child Labor,Male,13-17,4255,658,3597,2027,2228
2003,Rural,West Bengal,Crime Against Children,Kidnapping,Female,0-12,2058,867,1191,871,1187
2007,Urban,Andhra Pradesh,Property Crime,Burglary,Male,13-17,876,13,863,364,512
2008,Urban,Kerala,Crime Against Women,Rape,Male,13-17,2464,22,2442,1287,1177
2002,Rural,Punjab,Other Crimes,Cyber Crime,Male,13-17,3918,3115,803,3250,668
2009,Rural,Manipur,Crime Against Men,Robbery,Female,0-12,3436,2271,1165,3060,376
2008,Urban,Tamil Nadu,Crime Against Men,Robbery,Male,60+,1393,25,1368,444,949
2001,Urban,Jammu & Kashmir,Crime Against Children,Child Labor,Male,13-17,7935,5281,2654,5471,2464
2007,Rural,Rajasthan,Crime Against Children,Child Abuse,Female,0-12,4723,2333,2390,2984,1739
2007,Urban,Manipur,Property Crime,Arson,Male,18-30,2261,449,1812,921,1340
2009,Urban,Kerala,Crime Against Women,Molestation,Female,18-30,2553,1455,1098,2314,239
2008,Rural,West Bengal,Other Crimes,Fraud,Female,60+,367,270,97,340,27
2003,Urban,Meghalaya,Crime Against Children,Trafficking,Female,0-12,7231,6428,803,6817,414
2004,Urban,Bihar,Property Crime,Theft,Male,18-30,7317,5447,1870,6655,662
2005,Urban,Tripura,Property Crime,Vandalism,Female,13-17,5506,1937,3569,3546,1960
2002,Rural,Tamil Nadu,Other Crimes,Drug Offense,Male,60+,9832,481,9351,7759,2073
2004,Urban,Jammu & Kashmir,Crime Against Men,Assault,Male,18-30,7340,6812,528,7142,198
2006,Urban,Karnataka,Other Crimes,Fraud,Male,18-30,6243,3440,2803,5384,859
2004,Urban,Assam,Property Crime,Arson,Male,18-30,2209,1760,449,2136,73
2008,Rural,Andhra Pradesh,Crime Against Men,Robbery,Female,31-45,8738,2463,6275,8396,342
2009,Rural,Odisha,Crime Against Children,Child Labor,Male,60+,7366,6475,891,6879,487
2008,Urban,Maharashtra,Property Crime,Arson,Male,46-60,5837,1450,4387,2919,2918
2003,Urban,Bihar,Crime Against Men,Murder,Male,31-45,4860,3021,1839,3312,1548
2009,Rural,Kerala,Crime Against Men,Robbery,Male,31-45,5083,3330,1753,4342,741
2001,Urban,Tripura,Other Crimes,Cyber Crime,Female,31-45,1135,469,666,1061,74
2007,Rural,Karnataka,Other Crimes,Drug Offense,Male,31-45,1087,288,799,551,536
2010,Rural,Jharkhand,Crime Against Children,Kidnapping,Female,60+,9589,8226,1363,9424,165
2007,Rural,Meghalaya,Property Crime,Arson,Male,46-60,5032,3063,1969,3803,1229
2008,Urban,Karnataka,Other Crimes,Drug Offense,Male,13-17,9325,4626,4699,8714,611
2010,Urban,Kerala,Crime Against Women,Molestation,Female,13-17,3148,2200,948,2447,701
2009,Rural,Manipur,Crime Against Men,Murder,Male,18-30,7026,636,6390,6853,173
2007,Rural,Madhya Pradesh,Other Crimes,Drug Offense,Female,0-12,2918,2214,704,2829,89
2005,Urban,Delhi,Property Crime,Vandalism,Male,46-60,8566,802,7764,5432,3134
2001,Rural,Delhi,Property Crime,Burglary,Male,31-45,8830,6136,2694,8156,674
2008,Rural,Uttarakhand,Crime Against Men,Murder,Male,60+,3828,553,3275,1169,2659
2003,Urban,Bihar,Property Crime,Vandalism,Female,13-17,3553,1484,2069,2259,1294
2009,Rural,Himachal Pradesh,Property Crime,Vandalism,Female,60+,4260,1279,2981,1960,2300
2009,Urban,Assam,Property Crime,Burglary,Female,0-12,369,250,119,321,48
2003,Rural,Uttar Pradesh,Property Crime,Vandalism,Female,31-45,59,2,57,43,16
2003,Rural,Tamil Nadu,Crime Against Women,Dowry Deaths,Male,31-45,6895,3715,3180,5717,1178
2002,Urban,Jammu & Kashmir,Crime Against Men,Robbery,Female,13-17,1239,1007,232,1035,204
2005,Rural,Odisha,Other Crimes,Corruption,Male,60+,4791,3245,1546,3841,950
2008,Urban,Tripura,Crime Against Children,Child Labor,Female,13-17,2099,1333,766,1495,604
2004,Urban,Andhra Pradesh,Other Crimes,Cyber Crime,Female,18-30,3820,1568,2252,2814,1006
2006,Urban,Telangana,Other Crimes,Fraud,Male,13-17,5433,1012,4421,1834,3599
2005,Urban,Himachal Pradesh,Crime Against Women,Domestic Violence,Male,60+,8823,2565,6258,4276,4547
2010,Rural,Bihar,Other Crimes,Drug Offense,Male,13-17,2544,2101,443,2239,305
2003,Urban,Bihar,Property Crime,Arson,Female,0-12,6635,921,5714,2598,4037
2007,Rural,Telangana,Crime Against Men,Assault,Male,0-12,8285,4557,3728,7425,860
2005,Urban,Tamil Nadu,Crime Against Women,Dowry Deaths,Male,60+,1752,841,911,945,807
2004,Urban,Assam,Crime Against Men,Robbery,Female,18-30,4131,1676,2455,3888,243
2006,Rural,Karnataka,Crime Against Men,Murder,Male,46-60,2599,1127,1472,2281,318
2001,Rural,Tamil Nadu,Property Crime,Burglary,Male,60+,3861,1783,2078,2253,1608
2009,Urban,Tamil Nadu,Other Crimes,Drug Offense,Male,18-30,4553,1356,3197,4403,150
2001,Rural,Madhya Pradesh,Crime Against Women,Domestic Violence,Female,46-60,2868,604,2264,1792,1076
2009,Urban,Haryana,Crime Against Women,Dowry Deaths,Male,31-45,2552,2105,447,2377,175
2003,Urban,Bihar,Crime Against Men,Extortion,Female,13-17,7607,3980,3627,5212,2395
2007,Urban,Chhattisgarh,Crime Against Children,Trafficking,Male,31-45,6478,2157,4321,2945,3533
2005,Urban,Jharkhand,Property Crime,Burglary,Male,0-12,8789,2871,5918,8724,65
2002,Urban,Assam,Crime Against Men,Assault,Female,0-12,8372,3076,5296,3826,4546
2009,Rural,Tripura,Crime Against Women,Dowry Deaths,Male,60+,1262,89,1173,450,812
2009,Urban,Telangana,Crime Against Women,Molestation,Female,18-30,1913,229,1684,717,1196
2003,Rural,Jharkhand,Property Crime,Vandalism,Female,31-45,3804,2220,1584,3758,46
2010,Rural,Jharkhand,Property Crime,Burglary,Female,46-60,4631,4033,598,4184,447
2003,Rural,Bihar,Crime Against Men,Extortion,Male,13-17,571,387,184,437,134
2002,Urban,Nagaland,Crime Against Children,Child Labor,Female,0-12,6099,2123,3976,3338,2761
2004,Rural,Gujarat,Crime Against Women,Molestation,Female,60+,97,78,19,87,10
2008,Urban,Nagaland,Crime Against Women,Domestic Violence,Female,46-60,2087,225,1862,1419,668
2006,Rural,Madhya Pradesh,Crime Against Men,Robbery,Male,60+,2141,1348,793,1804,337
2005,Rural,Chhattisgarh,Crime Against Children,Child Abuse,Male,60+,9243,6575,2668,7146,2097
2001,Rural,Sikkim,Crime Against Children,Child Abuse,Female,31-45,6966,1746,5220,3617,3349
2009,Rural,Assam,Crime Against Children,Child Abuse,Female,0-12,2219,810,1409,2081,138
2010,Urban,Kerala,Crime Against Women,Domestic Violence,Male,60+,5951,1975,3976,2309,3642
2002,Rural,Uttar Pradesh,Other Crimes,Cyber Crime,Male,46-60,8920,8033,887,8589,331
2007,Rural,Jharkhand,Property Crime,Vandalism,Female,31-45,3776,2729,1047,3560,216
2007,Rural,Haryana,Crime Against Men,Assault,Female,60+,4062,1782,2280,2953,1109
2004,Urban,Odisha,Crime Against Men,Assault,Male,13-17,6061,3509,2552,5546,515
2006,Rural,Kerala,Property Crime,Vandalism,Male,31-45,5419,1019,4400,4454,965
2003,Urban,Tamil Nadu,Crime Against Children,Child Labor,Male,18-30,6510,886,5624,4949,1561
2009,Rural,Goa,Other Crimes,Drug Offense,Female,60+,1403,660,743,824,579
2008,Urban,Sikkim,Crime Against Children,Child Labor,Male,0-12,3934,2029,1905,3038,896
2004,Rural,Maharashtra,Crime Against Women,Molestation,Female,13-17,3434,2371,1063,3270,164
2006,Rural,Andhra Pradesh,Property Crime,Arson,Female,18-30,1431,1419,12,1428,3
2004,Rural,Jammu & Kashmir,Crime Against Women,Molestation,Female,31-45,734,588,146,707,27
2005,Rural,Jammu & Kashmir,Crime Against Women,Domestic Violence,Male,0-12,919,914,5,915,4
2007,Urban,Assam,Crime Against Children,Kidnapping,Male,0-12,4059,2831,1228,3306,753
2008,Rural,Manipur,Property Crime,Arson,Female,0-12,6147,5777,370,5906,241
2010,Urban,Chhattisgarh,Crime Against Children,Kidnapping,Female,31-45,1474,1364,110,1425,49
2007,Rural,Meghalaya,Property Crime,Vandalism,Male,0-12,5947,3301,2646,5579,368
2001,Rural,Goa,Crime Against Children,Child Abuse,Male,0-12,4147,3905,242,3924,223
2005,Urban,Arunachal Pradesh,Crime Against Women,Rape,Female,46-60,8408,1913,6495,5745,2663
2009,Rural,Madhya Pradesh,Property Crime,Arson,Female,0-12,4768,1353,3415,4408,360
2001,Rural,Maharashtra,Crime Against Men,Robbery,Male,46-60,616,295,321,304,312
2008,Rural,Jammu & Kashmir,Other Crimes,Corruption,Male,31-45,3511,3058,453,3229,282
2007,Rural,Manipur,Crime Against Children,Kidnapping,Male,18-30,7078,2038,5040,3982,3096
2006,Rural,Himachal Pradesh,Crime Against Children,Child Labor,Female,18-30,3658,41,3617,3635,23
2004,Rural,Jammu & Kashmir,Other Crimes,Cyber Crime,Male,0-12,8494,5318,3176,7333,1161
2009,Rural,Haryana,Crime Against Women,Domestic Violence,Female,0-12,2482,1658,824,1981,501
2002,Rural,Gujarat,Crime Against Men,Murder,Female,60+,7923,5384,2539,7495,428
2004,Urban,Chhattisgarh,Other Crimes,Cyber Crime,Male,18-30,9351,1551,7800,7396,1955
2003,Urban,Meghalaya,Crime Against Women,Dowry Deaths,Male,31-45,1233,434,799,837,396
2004,Rural,Haryana,Crime Against Men,Robbery,Female,18-30,6916,2974,3942,6875,41
2004,Urban,Bihar,Crime Against Men,Assault,Male,18-30,156,153,3,154,2
2005,Rural,Uttarakhand,Crime Against Women,Molestation,Male,18-30,3267,11,3256,2132,1135
2006,Rural,Madhya Pradesh,Other Crimes,Corruption,Male,46-60,5869,4814,1055,5119,750
2009,Rural,Bihar,Crime Against Children,Kidnapping,Male,13-17,9929,8054,1875,8268,1661
2001,Urban,Karnataka,Crime Against Men,Robbery,Male,13-17,4156,2162,1994,2858,1298
2008,Urban,Odisha,Crime Against Men,Murder,Female,18-30,1979,1763,216,1924,55
2008,Urban,Gujarat,Property Crime,Theft,Male,0-12,563,87,476,389,174
2003,Rural,Arunachal Pradesh,Property Crime,Theft,Male,0-12,4200,2257,1943,3243,957
2007,Rural,Jammu & Kashmir,Crime Against Men,Assault,Male,60+,4884,1526,3358,1603,3281
2005,Rural,Goa,Crime Against Children,Trafficking,Male,31-45,4595,442,4153,4559,36
2010,Rural,Kerala,Property Crime,Vandalism,Male,31-45,6729,4775,1954,5630,1099
2005,Rural,West Bengal,Crime Against Children,Child Abuse,Female,60+,8542,4698,3844,4786,3756
2002,Urban,Chhattisgarh,Crime Against Women,Molestation,Male,0-12,3547,1869,1678,3400,147
2003,Rural,Jharkhand,Crime Against Men,Murder,Male,13-17,6991,6541,450,6912,79
2005,Rural,Manipur,Other Crimes,Cyber Crime,Female,0-12,4659,2737,1922,2782,1877
2006,Urban,Sikkim,Other Crimes,Cyber Crime,Male,31-45,766,96,670,596,170
2003,Urban,Arunachal Pradesh,Other Crimes,Corruption,Female,18-30,838,791,47,824,14
2001,Urban,Uttar Pradesh,Other Crimes,Corruption,Female,13-17,8101,3622,4479,6383,1718
2002,Urban,Karnataka,Crime Against Children,Trafficking,Male,31-45,5564,5245,319,5272,292
2004,Urban,Haryana,Crime Against Women,Dowry Deaths,Male,18-30,7916,4114,3802,6327,1589
2004,Urban,Bihar,Crime Against Men,Extortion,Male,60+,3090,1195,1895,2095,995
2007,Rural,Tripura,Crime Against Women,Dowry Deaths,Female,31-45,6191,3723,2468,4871,1320
2007,Rural,Maharashtra,Crime Against Women,Rape,Female,18-30,1092,257,835,1016,76
2010,Urban,Goa,Crime Against Children,Child Labor,Male,31-45,6687,5963,724,6598,89
2007,Urban,Kerala,Crime Against Children,Child Abuse,Female,46-60,403,151,252,359,44
2001,Rural,Jammu & Kashmir,Other Crimes,Corruption,Female,13-17,2093,1914,179,2016,77
2002,Urban,Haryana,Crime Against Women,Domestic Violence,Female,31-45,7838,7500,338,7814,24
2005,Urban,Madhya Pradesh,Crime Against Women,Domestic Violence,Male,46-60,6321,4844,1477,5775,546
2005,Urban,West Bengal,Crime Against Children,Trafficking,Female,31-45,89,75,14,78,11
2002,Urban,Rajasthan,Crime Against Children,Child Labor,Male,0-12,2099,869,1230,1064,1035
2009,Rural,Odisha,Crime Against Men,Assault,Female,18-30,8678,159,8519,6100,2578
2008,Urban,Mizoram,Crime Against Women,Molestation,Male,0-12,6917,5174,1743,5388,1529
2007,Urban,Uttar Pradesh,Crime Against Children,Trafficking,Male,31-45,5160,3658,1502,3947,1213
2008,Rural,Meghalaya,Other Crimes,Cyber Crime,Female,60+,5934,119,5815,3631,2303
2010,Urban,Tripura,Crime Against Children,Kidnapping,Male,31-45,1316,209,1107,440,876
2010,Urban,Jharkhand,Other Crimes,Corruption,Male,31-45,9122,4778,4344,4999,4123
2008,Urban,Andhra Pradesh,Crime Against Men,Extortion,Female,0-12,6995,3838,3157,4778,2217
2003,Rural,West Bengal,Other Crimes,Corruption,Female,31-45,7674,58,7616,2294,5380
2007,Rural,Goa,Crime Against Women,Molestation,Male,46-60,7035,3041,3994,6235,800
2008,Urban,Karnataka,Crime Against Children,Kidnapping,Male,60+,9925,985,8940,2887,7038
2006,Rural,Himachal Pradesh,Crime Against Children,Kidnapping,Male,13-17,5580,2731,2849,2786,2794
2009,Urban,Tripura,Crime Against Men,Assault,Male,60+,3170,543,2627,1482,1688
2009,Rural,Arunachal Pradesh,Crime Against Women,Rape,Male,18-30,7292,3668,3624,3702,3590
2006,Rural,Jharkhand,Other Crimes,Corruption,Female,0-12,3459,954,2505,3397,62
2009,Rural,Delhi,Other Crimes,Cyber Crime,Male,46-60,4650,1484,3166,2542,2108
2007,Urban,Nagaland,Crime Against Women,Molestation,Male,31-45,4404,338,4066,3331,1073
2001,Rural,Himachal Pradesh,Crime Against Women,Rape,Male,60+,499,304,195,338,161
2008,Rural,Nagaland,Property Crime,Burglary,Female,31-45,4930,3298,1632,4074,856
2001,Rural,Haryana,Crime Against Children,Trafficking,Female,13-17,8282,2144,6138,4453,3829
2010,Rural,Uttarakhand,Crime Against Children,Kidnapping,Male,13-17,5339,2607,2732,5021,318
2010,Urban,Kerala,Crime Against Children,Child Labor,Female,0-12,2822,296,2526,2014,808
2006,Rural,Goa,Crime Against Men,Robbery,Female,46-60,8685,7276,1409,7866,819
2005,Urban,Manipur,Crime Against Children,Trafficking,Female,60+,9540,262,9278,5610,3930
2004,Urban,Kerala,Crime Against Men,Robbery,Female,46-60,2905,1217,1688,1795,1110
2008,Rural,Punjab,Other Crimes,Cyber Crime,Female,31-45,2646,710,1936,2393,253
2002,Urban,Arunachal Pradesh,Property Crime,Theft,Male,18-30,3020,2889,131,2971,49
2007,Rural,Tamil Nadu,Other Crimes,Drug Offense,Female,60+,2546,921,1625,1128,1418
2006,Urban,Madhya Pradesh,Crime Against Children,Trafficking,Male,0-12,397,162,235,380,17
2002,Urban,Karnataka,Crime Against Women,Rape,Female,0-12,5886,746,5140,4631,1255
2001,Urban,West Bengal,Crime Against Men,Extortion,Female,18-30,1662,703,959,877,785
2009,Urban,Nagaland,Crime Against Women,Rape,Female,18-30,4402,3102,1300,3605,797
2008,Rural,Uttarakhand,Property Crime,Arson,Male,13-17,6859,2379,4480,4129,2730
2010,Urban,Haryana,Property Crime,Theft,Male,46-60,436,183,253,219,217
2008,Rural,Manipur,Property Crime,Vandalism,Male,60+,1667,1512,155,1575,92
2003,Rural,Jharkhand,Property Crime,Theft,Male,60+,2038,1607,431,1888,150
2010,Urban,Telangana,Crime Against Children,Kidnapping,Female,13-17,9900,1812,8088,2626,7274
2004,Rural,Rajasthan,Property Crime,Theft,Male,13-17,3249,2841,408,2945,304
2008,Rural,Himachal Pradesh,Other Crimes,Fraud,Female,0-12,6855,5718,1137,6774,81
2001,Urban,Himachal Pradesh,Crime Against Women,Rape,Female,0-12,9825,8325,1500,8681,1144
2010,Urban,Arunachal Pradesh,Other Crimes,Cyber Crime,Female,0-12,4964,3199,1765,4286,678
2007,Urban,Bihar,Crime Against Children,Child Abuse,Male,31-45,5932,3969,1963,4218,1714
2001,Rural,Tamil Nadu,Other Crimes,Corruption,Male,18-30,7171,5809,1362,6663,508
2008,Rural,Uttar Pradesh,Property Crime,Burglary,Male,31-45,3398,2379,1019,2633,765
2010,Urban,Odisha,Crime Against Children,Child Abuse,Female,31-45,6025,5401,624,5975,50
2008,Rural,Manipur,Crime Against Women,Rape,Female,46-60,179,89,90,108,71
2005,Rural,Uttar Pradesh,Crime Against Men,Extortion,Male,60+,905,699,206,891,14
2005,Rural,Delhi,Crime Against Women,Dowry Deaths,Female,60+,5628,920,4708,3066,2562
2003,Rural,Jharkhand,Crime Against Women,Domestic Violence,Female,60+,3751,175,3576,728,3023
2005,Rural,Bihar,Other Crimes,Fraud,Female,60+,98,22,76,71,27
2002,Urban,Jharkhand,Other Crimes,Cyber Crime,Male,31-45,8961,6352,2609,6713,2248
2003,Urban,Kerala,Crime Against Children,Child Abuse,Female,18-30,2379,1856,523,1988,391
2010,Urban,Tripura,Other Crimes,Fraud,Male,0-12,6381,4519,1862,4615,1766
2006,Urban,West Bengal,Crime Against Women,Dowry Deaths,Female,0-12,9538,2387,7151,7817,1721
2005,Rural,Sikkim,Property Crime,Theft,Female,60+,1016,96,920,923,93
2004,Rural,Chhattisgarh,Crime Against Children,Child Abuse,Male,31-45,6130,3948,2182,6106,24
2006,Urban,Odisha,Crime Against Women,Rape,Male,31-45,4450,3193,1257,3767,683
2002,Rural,Madhya Pradesh,Crime Against Children,Kidnapping,Female,13-17,9621,3241,6380,8947,674
2001,Urban,Punjab,Crime Against Women,Molestation,Male,46-60,3901,3897,4,3898,3
2003,Rural,Maharashtra,Crime Against Women,Dowry Deaths,Male,60+,6136,2118,4018,5602,534
2007,Rural,Maharashtra,Crime Against Men,Assault,Female,18-30,4461,1276,3185,2827,1634
2003,Urban,Himachal Pradesh,Crime Against Women,Dowry Deaths,Female,18-30,5031,3817,1214,4850,181
2007,Urban,Sikkim,Property Crime,Theft,Male,0-12,5443,4234,1209,5442,1
2006,Rural,Mizoram,Other Crimes,Fraud,Male,46-60,1184,144,1040,1105,79
2003,Rural,Punjab,Other Crimes,Fraud,Male,60+,9455,4985,4470,7089,2366
2007,Rural,Bihar,Crime Against Children,Trafficking,Female,0-12,2475,908,1567,1579,896
2009,Rural,Gujarat,Property Crime,Arson,Male,0-12,3247,2342,905,3247,0
2002,Rural,Maharashtra,Crime Against Women,Domestic Violence,Male,0-12,7128,1934,5194,6579,549
2002,Urban,Assam,Other Crimes,Drug Offense,Male,60+,2091,832,1259,1633,458
2009,Rural,Himachal Pradesh,Crime Against Women,Molestation,Male,31-45,3914,494,3420,2873,1041
2007,Urban,Haryana,Crime Against Children,Trafficking,Female,0-12,2379,1756,623,2140,239
2006,Urban,Gujarat,Property Crime,Burglary,Female,31-45,2535,1998,537,2001,534
2004,Urban,Madhya Pradesh,Crime Against Children,Trafficking,Male,31-45,4041,372,3669,3965,76
2003,Urban,Goa,Crime Against Children,Trafficking,Male,31-45,7368,6852,516,7304,64
2010,Rural,Rajasthan,Other Crimes,Drug Offense,Female,18-30,4639,8,4631,3348,1291
2004,Rural,Haryana,Crime Against Men,Assault,Female,18-30,395,212,183,276,119
2003,Rural,Mizoram,Other Crimes,Drug Offense,Male,18-30,2682,732,1950,1111,1571
2008,Rural,Kerala,Other Crimes,Cyber Crime,Female,31-45,4670,2380,2290,2682,1988
2004,Rural,Nagaland,Crime Against Children,Child Labor,Female,0-12,560,464,96,493,67
2005,Urban,Andhra Pradesh,Crime Against Children,Kidnapping,Female,31-45,4275,194,4081,2648,1627
2003,Urban,Haryana,Crime Against Children,Child Abuse,Female,18-30,3533,2966,567,3042,491
2007,Rural,Gujarat,Crime Against Women,Molestation,Male,46-60,3062,579,2483,2625,437
2004,Rural,Jammu & Kashmir,Property Crime,Arson,Female,60+,3678,752,2926,1867,1811
2002,Urban,Karnataka,Other Crimes,Fraud,Male,31-45,4885,1636,3249,4803,82
2002,Rural,Sikkim,Crime Against Women,Molestation,Female,60+,180,35,145,109,71
2006,Rural,Delhi,Property Crime,Burglary,Female,0-12,9713,7549,2164,9707,6
2006,Rural,Sikkim,Crime Against Women,Molestation,Female,60+,7417,561,6856,4204,3213
2006,Urban,Nagaland,Property Crime,Arson,Male,18-30,796,182,614,680,116
2002,Rural,Uttarakhand,Crime Against Women,Dowry Deaths,Male,31-45,1942,874,1068,1183,759
2006,Urban,Himachal Pradesh,Other Crimes,Fraud,Female,18-30,1752,1238,514,1358,394
2006,Urban,Punjab,Property Crime,Burglary,Female,60+,6414,2860,3554,4773,1641
2002,Urban,West Bengal,Crime Against Children,Child Labor,Male,60+,844,829,15,832,12
2004,Rural,Jammu & Kashmir,Property Crime,Theft,Male,60+,3200,32,3168,2023,1177
2004,Rural,Tamil Nadu,Property Crime,Theft,Female,13-17,7730,4103,3627,7060,670
2008,Urban,Gujarat,Other Crimes,Drug Offense,Female,18-30,7024,6638,386,6640,384
2005,Urban,Tamil Nadu,Crime Against Men,Murder,Male,31-45,6383,1679,4704,3835,2548
2008,Rural,Karnataka,Other Crimes,Drug Offense,Male,46-60,6978,2772,4206,4123,2855
2005,Urban,Tripura,Crime Against Women,Dowry Deaths,Female,60+,5481,5132,349,5357,124
2001,Urban,Delhi,Property Crime,Burglary,Female,46-60,5359,5073,286,5212,147
2001,Rural,Telangana,Property Crime,Vandalism,Female,31-45,3908,494,3414,533,3375
2010,Urban,Tripura,Crime Against Children,Trafficking,Female,0-12,3950,3343,607,3366,584
2003,Urban,Punjab,Crime Against Men,Extortion,Male,13-17,1059,201,858,847,212
2006,Urban,Delhi,Crime Against Women,Domestic Violence,Female,0-12,2932,1576,1356,2397,535
2001,Urban,Uttarakhand,Other Crimes,Cyber Crime,Female,46-60,8414,3207,5207,4784,3630
2001,Rural,Tamil Nadu,Crime Against Men,Assault,Male,31-45,1453,685,768,1096,357
2010,Urban,Uttar Pradesh,Property Crime,Theft,Male,60+,7923,5585,2338,7545,378
2009,Urban,Chhattisgarh,Crime Against Men,Murder,Male,13-17,6008,659,5349,2507,3501
2004,Urban,Mizoram,Crime Against Children,Child Labor,Male,46-60,9030,2269,6761,7501,1529
2007,Urban,Uttar Pradesh,Property Crime,Theft,Male,13-17,2593,531,2062,2504,89
2007,Rural,Delhi,Property Crime,Theft,Male,0-12,2980,2829,151,2857,123
2009,Urban,Goa,Crime Against Men,Murder,Male,18-30,4904,3449,1455,3756,1148
2008,Urban,Mizoram,Property Crime,Arson,Male,18-30,7513,581,6932,2654,4859
2001,Rural,Sikkim,Crime Against Men,Murder,Female,46-60,3360,2595,765,3014,346
2005,Urban,Uttarakhand,Crime Against Women,Molestation,Male,13-17,8296,2059,6237,5624,2672
2008,Rural,Uttarakhand,Crime Against Men,Extortion,Male,60+,2449,2348,101,2351,98
2006,Rural,Gujarat,Other Crimes,Corruption,Female,60+,7176,5257,1919,6624,552
2003,Rural,Delhi,Crime Against Men,Robbery,Female,13-17,8358,3873,4485,7596,762
2006,Urban,Tripura,Crime Against Women,Dowry Deaths,Female,60+,4375,2582,1793,3882,493
2002,Urban,Meghalaya,Crime Against Children,Kidnapping,Female,31-45,2348,1086,1262,1200,1148
2004,Urban,Haryana,Other Crimes,Corruption,Female,13-17,1132,744,388,813,319
2001,Rural,West Bengal,Crime Against Children,Trafficking,Male,18-30,9211,8961,250,8977,234
2002,Rural,Bihar,Property Crime,Vandalism,Female,60+,3663,2790,873,3363,300
2010,Rural,Chhattisgarh,Crime Against Men,Extortion,Female,13-17,621,37,584,513,108
2001,Urban,West Bengal,Crime Against Children,Child Abuse,Male,13-17,544,92,452,142,402
2001,Rural,Jharkhand,Property Crime,Theft,Male,13-17,9466,4400,5066,7250,2216
2007,Urban,Nagaland,Crime Against Men,Murder,Female,0-12,359,77,282,142,217
2007,Urban,Maharashtra,Crime Against Men,Robbery,Female,0-12,5120,928,4192,1452,3668
2004,Urban,Himachal Pradesh,Crime Against Men,Robbery,Female,60+,8433,3015,5418,4003,4430
2004,Urban,Chhattisgarh,Crime Against Children,Child Abuse,Male,31-45,1010,435,575,852,158
2006,Rural,Meghalaya,Other Crimes,Cyber Crime,Female,60+,1829,1734,95,1825,4
2004,Rural,Bihar,Other Crimes,Fraud,Female,31-45,6977,3490,3487,6782,195
2004,Urban,Uttar Pradesh,Property Crime,Arson,Female,13-17,443,62,381,73,370
2002,Urban,Uttar Pradesh,Crime Against Men,Murder,Male,0-12,94,70,24,73,21
2004,Urban,Tamil Nadu,Crime Against Children,Child Labor,Male,13-17,2235,1505,730,1982,253
2005,Urban,Delhi,Crime Against Women,Dowry Deaths,Male,31-45,8372,168,8204,5247,3125
2003,Urban,Sikkim,Property Crime,Theft,Male,31-45,403,175,228,357,46
2005,Urban,Manipur,Other Crimes,Fraud,Female,0-12,7729,5460,2269,6680,1049
2006,Urban,Assam,Property Crime,Burglary,Male,60+,1695,722,973,1242,453
2002,Rural,Rajasthan,Property Crime,Vandalism,Female,0-12,9424,1666,7758,7420,2004
2001,Urban,Punjab,Other Crimes,Fraud,Male,18-30,8552,5384,3168,6949,1603
2008,Rural,Tamil Nadu,Crime Against Women,Domestic Violence,Female,46-60,9538,9188,350,9252,286
2003,Urban,Uttar Pradesh,Property Crime,Arson,Male,46-60,8942,1804,7138,5839,3103
2007,Urban,Delhi,Crime Against Children,Trafficking,Male,31-45,4066,1610,2456,2797,1269
2004,Rural,Arunachal Pradesh,Property Crime,Arson,Male,0-12,7264,1505,5759,6579,685
2010,Urban,Uttar Pradesh,Crime Against Women,Dowry Deaths,Female,46-60,3128,2205,923,2342,786
2006,Rural,Arunachal Pradesh,Other Crimes,Corruption,Female,31-45,6943,6876,67,6913,30
2001,Urban,Mizoram,Crime Against Men,Extortion,Male,18-30,2053,394,1659,1856,197
2006,Urban,Mizoram,Crime Against Children,Trafficking,Female,0-12,4887,726,4161,3538,1349
2009,Rural,Odisha,Crime Against Women,Dowry Deaths,Female,0-12,2915,1445,1470,2663,252
2008,Rural,Tamil Nadu,Property Crime,Arson,Male,13-17,3782,3446,336,3496,286
2003,Urban,Maharashtra,Crime Against Women,Dowry Deaths,Female,0-12,3356,2689,667,2856,500
2008,Rural,Assam,Crime Against Children,Trafficking,Female,18-30,476,140,336,476,0
2001,Rural,Chhattisgarh,Crime Against Children,Child Labor,Male,0-12,4785,3126,1659,3352,1433
2007,Urban,Tripura,Other Crimes,Drug Offense,Male,18-30,2704,1437,1267,2619,85
2002,Rural,Andhra Pradesh,Crime Against Men,Robbery,Female,46-60,1938,372,1566,637,1301
2004,Rural,Nagaland,Crime Against Men,Murder,Male,0-12,7144,1597,5547,2244,4900
2006,Urban,Delhi,Property Crime,Theft,Female,46-60,8030,6234,1796,7971,59
2001,Rural,Telangana,Other Crimes,Corruption,Male,0-12,9893,5409,4484,8382,1511
2005,Rural,Delhi,Property Crime,Arson,Male,18-30,501,194,307,234,267
2007,Rural,Rajasthan,Property Crime,Burglary,Female,13-17,5762,2431,3331,5540,222
2003,Rural,West Bengal,Property Crime,Arson,Female,0-12,6341,3070,3271,5610,731
2002,Urban,Haryana,Crime Against Women,Rape,Male,18-30,400,244,156,347,53
2006,Urban,Haryana,Property Crime,Theft,Female,0-12,2665,2431,234,2567,98
2008,Rural,Karnataka,Other Crimes,Corruption,Female,46-60,8809,8332,477,8658,151
2007,Urban,Arunachal Pradesh,Crime Against Children,Trafficking,Female,60+,111,27,84,106,5
2003,Urban,Nagaland,Other Crimes,Fraud,Male,60+,8064,623,7441,905,7159
2007,Rural,Goa,Property Crime,Theft,Male,60+,3971,322,3649,786,3185
2003,Rural,Punjab,Crime Against Children,Child Abuse,Female,60+,7958,1192,6766,2112,5846
2007,Urban,Telangana,Crime Against Men,Murder,Male,18-30,516,451,65,470,46
2001,Rural,Delhi,Crime Against Men,Extortion,Female,46-60,4954,4262,692,4883,71
2009,Urban,Rajasthan,Crime Against Children,Child Abuse,Female,46-60,1687,555,1132,566,1121
2007,Rural,Uttar Pradesh,Property Crime,Arson,Female,31-45,7063,5095,1968,6729,334
2006,Urban,Odisha,Crime Against Children,Child Abuse,Male,0-12,6562,1514,5048,4473,2089
2005,Rural,Jammu & Kashmir,Other Crimes,Drug Offense,Female,60+,429,357,72,406,23
2010,Urban,Uttarakhand,Crime Against Women,Dowry Deaths,Female,13-17,2998,2401,597,2635,363
2009,Rural,Madhya Pradesh,Crime Against Men,Robbery,Female,31-45,9079,8244,835,9015,64
2010,Rural,Uttarakhand,Crime Against Children,Kidnapping,Male,0-12,3884,1808,2076,3299,585
2007,Urban,Goa,Property Crime,Theft,Male,18-30,8272,3337,4935,4976,3296
2010,Urban,Arunachal Pradesh,Crime Against Women,Molestation,Female,31-45,1011,832,179,936,75
2008,Urban,Karnataka,Crime Against Children,Kidnapping,Female,60+,3848,3239,609,3784,64
2008,Urban,West Bengal,Crime Against Men,Extortion,Female,31-45,109,102,7,102,7
2003,Urban,Jharkhand,Property Crime,Vandalism,Female,60+,100,47,53,92,8
2009,Urban,Jammu & Kashmir,Property Crime,Vandalism,Female,60+,6861,1865,4996,5767,1094
2001,Urban,Odisha,Crime Against Children,Child Abuse,Female,46-60,278,178,100,259,19
2007,Rural,Sikkim,Crime Against Men,Robbery,Female,13-17,882,722,160,741,141
2002,Urban,Himachal Pradesh,Property Crime,Theft,Male,0-12,785,630,155,752,33
2007,Urban,Manipur,Crime Against Women,Dowry Deaths,Female,31-45,5295,1954,3341,4057,1238
2001,Rural,Manipur,Property Crime,Arson,Female,60+,679,66,613,69,610
2006,Urban,Karnataka,Other Crimes,Fraud,Male,31-45,606,191,415,342,264
2001,Rural,Uttarakhand,Crime Against Children,Child Labor,Female,13-17,4383,1848,2535,2328,2055
2003,Rural,Tripura,Crime Against Children,Child Labor,Female,60+,3545,19,3526,1900,1645
2002,Urban,Telangana,Property Crime,Vandalism,Female,31-45,318,8,310,315,3
2007,Rural,Uttarakhand,Property Crime,Burglary,Female,0-12,3466,1042,2424,1139,2327
2008,Rural,Delhi,Crime Against Children,Child Labor,Female,46-60,2712,1930,782,2192,520
2003,Urban,Delhi,Crime Against Men,Assault,Male,13-17,2306,1658,648,1853,453
2004,Rural,West Bengal,Crime Against Women,Rape,Male,0-12,4952,1652,3300,4734,218
2009,Rural,Kerala,Property Crime,Theft,Female,0-12,3110,2684,426,2706,404
2004,Rural,Karnataka,Property Crime,Arson,Female,31-45,9494,3423,6071,4345,5149
2002,Urban,Mizoram,Other Crimes,Fraud,Female,13-17,9396,7889,1507,8215,1181
2001,Urban,Madhya Pradesh,Crime Against Men,Extortion,Female,31-45,7375,3038,4337,3178,4197
2005,Rural,Tamil Nadu,Other Crimes,Drug Offense,Male,18-30,1099,149,950,611,488
2004,Rural,Sikkim,Crime Against Men,Murder,Female,0-12,6590,1075,5515,1368,5222
2008,Rural,Odisha,Crime Against Men,Assault,Female,60+,606,526,80,588,18
2006,Urban,Chhattisgarh,Crime Against Women,Domestic Violence,Male,60+,2816,333,2483,498,2318
2009,Urban,Uttar Pradesh,Property Crime,Arson,Male,18-30,3548,1077,2471,1362,2186
2004,Rural,Uttar Pradesh,Crime Against Children,Child Labor,Male,46-60,8486,6785,1701,8141,345
2009,Urban,Jharkhand,Crime Against Women,Dowry Deaths,Male,18-30,6342,273,6069,1577,4765
2007,Rural,Himachal Pradesh,Crime Against Women,Dowry Deaths,Male,0-12,6245,2404,3841,5678,567
2010,Rural,Assam,Crime Against Children,Trafficking,Female,60+,5872,3693,2179,5293,579
2002,Rural,Tamil Nadu,Other Crimes,Drug Offense,Male,0-12,3956,2205,1751,3166,790
2008,Urban,Uttar Pradesh,Other Crimes,Cyber Crime,Male,31-45,2945,1715,1230,2742,203
2002,Rural,Bihar,Crime Against Men,Murder,Male,0-12,2307,789,1518,1005,1302
2003,Rural,Gujarat,Other Crimes,Drug Offense,Male,0-12,8511,2675,5836,3600,4911
2002,Rural,Himachal Pradesh,Crime Against Children,Child Labor,Female,31-45,1656,1143,513,1421,235
2010,Rural,Himachal Pradesh,Other Crimes,Cyber Crime,Female,31-45,8826,1020,7806,8801,25
2004,Rural,Tamil Nadu,Crime Against Women,Dowry Deaths,Female,46-60,253,219,34,248,5
2003,Rural,Manipur,Property Crime,Burglary,Female,60+,5952,927,5025,1777,4175
2004,Rural,Bihar,Property Crime,Arson,Male,13-17,6669,4889,1780,5368,1301
2002,Urban,Tamil Nadu,Crime Against Women,Domestic Violence,Female,60+,5892,5576,316,5704,188
2007,Rural,Kerala,Property Crime,Vandalism,Female,0-12,3328,2302,1026,2740,588
2005,Urban,Telangana,Crime Against Children,Child Abuse,Male,60+,9865,7712,2153,8989,876
2001,Rural,Andhra Pradesh,Crime Against Children,Trafficking,Male,18-30,9264,5813,3451,6686,2578
2007,Urban,Kerala,Crime Against Children,Kidnapping,Male,60+,6544,5829,715,5979,565
2010,Urban,Tamil Nadu,Property Crime,Burglary,Male,60+,9313,3278,6035,6932,2381
2008,Rural,Uttar Pradesh,Property Crime,Theft,Male,31-45,9409,5202,4207,6191,3218
2005,Urban,Sikkim,Crime Against Women,Rape,Female,0-12,4935,3742,1193,4432,503
2004,Urban,Himachal Pradesh,Other Crimes,Drug Offense,Female,46-60,7016,3727,3289,4268,2748
2007,Rural,Kerala,Crime Against Children,Trafficking,Female,0-12,6521,1293,5228,4003,2518
2004,Urban,Telangana,Crime Against Children,Kidnapping,Female,0-12,2608,2592,16,2608,0
2008,Rural,Madhya Pradesh,Crime Against Children,Child Labor,Female,0-12,9420,9393,27,9407,13
2009,Rural,Mizoram,Other Crimes,Fraud,Female,60+,1471,614,857,1112,359
2004,Urban,Assam,Other Crimes,Corruption,Male,13-17,3989,219,3770,3720,269
2004,Rural,Goa,Property Crime,Burglary,Female,60+,4076,3184,892,3595,481
2009,Urban,Assam,Crime Against Children,Child Labor,Female,13-17,4485,3044,1441,4359,126
2006,Urban,Karnataka,Crime Against Men,Murder,Female,31-45,6299,120,6179,4457,1842
2007,Rural,Maharashtra,Crime Against Children,Child Abuse,Female,60+,1132,230,902,763,369
2002,Rural,Mizoram,Other Crimes,Corruption,Male,31-45,5561,2845,2716,4850,711
2002,Urban,Goa,Other Crimes,Drug Offense,Female,46-60,5664,5492,172,5545,119
2008,Rural,Karnataka,Crime Against Women,Molestation,Female,46-60,7400,6458,942,6529,871
2003,Rural,Maharashtra,Crime Against Children,Child Labor,Male,18-30,191,29,162,148,43
2008,Rural,Uttarakhand,Crime Against Women,Domestic Violence,Male,13-17,536,10,526,454,82
2003,Rural,Bihar,Property Crime,Vandalism,Female,13-17,2453,742,1711,1592,861
2008,Rural,Uttar Pradesh,Crime Against Children,Trafficking,Female,18-30,5544,1362,4182,2156,3388
2008,Urban,Nagaland,Crime Against Men,Robbery,Male,18-30,1093,202,891,546,547
2001,Urban,Chhattisgarh,Crime Against Men,Murder,Male,13-17,7916,2833,5083,5972,1944
2004,Rural,Himachal Pradesh,Crime Against Children,Child Abuse,Male,18-30,6840,6522,318,6764,76
2004,Rural,Chhattisgarh,Crime Against Children,Child Abuse,Male,0-12,7093,1876,5217,3131,3962
2008,Rural,Jammu & Kashmir,Crime Against Women,Molestation,Male,13-17,987,538,449,742,245
2007,Urban,Bihar,Crime Against Men,Assault,Male,18-30,1966,329,1637,1225,741
2008,Rural,Himachal Pradesh,Crime Against Women,Dowry Deaths,Female,46-60,912,57,855,550,362
2004,Rural,Himachal Pradesh,Other Crimes,Cyber Crime,Male,18-30,789,761,28,771,18
2003,Rural,Odisha,Property Crime,Vandalism,Male,60+,4340,1379,2961,3886,454
2008,Urban,Tripura,Crime Against Men,Murder,Male,31-45,7288,7041,247,7248,40
2001,Urban,Tamil Nadu,Property Crime,Burglary,Female,46-60,5325,2017,3308,4894,431
2007,Rural,Odisha,Crime Against Women,Rape,Male,13-17,1203,633,570,653,550
2008,Rural,Assam,Crime Against Children,Trafficking,Male,60+,6216,4817,1399,5711,505
2004,Urban,Meghalaya,Crime Against Women,Molestation,Male,60+,8775,5701,3074,5886,2889
2006,Urban,Nagaland,Property Crime,Theft,Male,46-60,3834,726,3108,3007,827
2010,Rural,Sikkim,Crime Against Men,Assault,Male,0-12,5284,4677,607,4814,470
2006,Rural,Mizoram,Crime Against Children,Kidnapping,Female,60+,3806,206,3600,445,3361
2004,Urban,Telangana,Property Crime,Arson,Female,31-45,847,258,589,538,309
2004,Rural,Andhra Pradesh,Crime Against Women,Rape,Female,46-60,7614,2749,4865,5456,2158
2002,Rural,Himachal Pradesh,Crime Against Men,Extortion,Female,0-12,7449,3632,3817,6080,1369
2001,Rural,Tamil Nadu,Crime Against Children,Trafficking,Male,0-12,7266,1601,5665,4089,3177
2003,Rural,West Bengal,Crime Against Women,Molestation,Female,46-60,630,353,277,477,153
2010,Urban,Uttar Pradesh,Property Crime,Vandalism,Female,31-45,7977,5876,2101,6732,1245
2002,Rural,Uttarakhand,Other Crimes,Fraud,Female,0-12,7139,5805,1334,6583,556
2007,Rural,Uttar Pradesh,Crime Against Children,Trafficking,Female,60+,3797,1826,1971,2615,1182
2003,Urban,Delhi,Property Crime,Burglary,Female,31-45,8906,622,8284,5740,3166
2006,Urban,Gujarat,Other Crimes,Corruption,Male,0-12,7270,2992,4278,6026,1244
2003,Rural,Odisha,Other Crimes,Fraud,Male,0-12,4327,2879,1448,3798,529
2006,Rural,Haryana,Other Crimes,Drug Offense,Female,0-12,6571,3494,3077,5234,1337
2008,Urban,Madhya Pradesh,Property Crime,Theft,Male,18-30,9367,3980,5387,8215,1152
2002,Rural,Maharashtra,Crime Against Women,Rape,Female,13-17,1770,1271,499,1637,133
2008,Rural,Uttarakhand,Other Crimes,Fraud,Male,46-60,4705,2127,2578,3444,1261
2008,Rural,Tripura,Crime Against Women,Rape,Female,60+,2471,2312,159,2433,38
2010,Urban,Uttar Pradesh,Crime Against Men,Extortion,Female,0-12,5239,4942,297,5065,174
2009,Urban,Tamil Nadu,Other Crimes,Fraud,Female,60+,3317,322,2995,942,2375
2003,Rural,Madhya Pradesh,Crime Against Men,Robbery,Female,18-30,9919,784,9135,9517,402
2005,Rural,Assam,Property Crime,Vandalism,Female,13-17,5404,4207,1197,4927,477
2005,Urban,West Bengal,Crime Against Children,Kidnapping,Male,46-60,4955,3361,1594,4257,698
2008,Rural,Delhi,Crime Against Men,Extortion,Female,60+,1463,645,818,1131,332
2009,Rural,Punjab,Crime Against Children,Child Labor,Female,60+,365,263,102,363,2
2006,Urban,Kerala,Crime Against Children,Child Labor,Female,13-17,145,18,127,39,106
2009,Rural,Madhya Pradesh,Other Crimes,Drug Offense,Male,31-45,386,41,345,52,334
2005,Rural,Himachal Pradesh,Property Crime,Arson,Female,60+,6594,3884,2710,4866,1728
2001,Urban,Kerala,Crime Against Men,Robbery,Male,31-45,5477,1484,3993,2481,2996
2009,Rural,Jammu & Kashmir,Crime Against Women,Molestation,Male,0-12,6278,551,5727,3449,2829
2001,Urban,Bihar,Property Crime,Arson,Female,13-17,8492,5463,3029,6933,1559
2009,Urban,Mizoram,Crime Against Women,Domestic Violence,Female,18-30,7523,1311,6212,6501,1022
2003,Rural,Punjab,Crime Against Children,Trafficking,Female,31-45,9431,2614,6817,7061,2370
2003,Rural,Jharkhand,Crime Against Children,Trafficking,Female,0-12,1471,1164,307,1205,266
2006,Rural,Arunachal Pradesh,Other Crimes,Cyber Crime,Female,0-12,4171,200,3971,2398,1773
2007,Rural,West Bengal,Other Crimes,Corruption,Male,31-45,3656,56,3600,318,3338
2005,Rural,Himachal Pradesh,Crime Against Children,Child Labor,Male,18-30,5057,4405,652,5002,55
2001,Rural,Jammu & Kashmir,Crime Against Women,Domestic Violence,Female,46-60,3389,776,2613,1362,2027
2007,Rural,Assam,Crime Against Women,Rape,Female,13-17,9939,95,9844,4833,5106
2004,Rural,Haryana,Property Crime,Theft,Female,0-12,5224,359,4865,3886,1338
2008,Urban,Nagaland,Other Crimes,Cyber Crime,Male,13-17,9396,3376,6020,3440,5956
2009,Rural,Tamil Nadu,Crime Against Children,Child Abuse,Male,18-30,6791,4300,2491,6411,380
2004,Rural,Arunachal Pradesh,Other Crimes,Cyber Crime,Male,18-30,8468,6017,2451,7055,1413
2003,Rural,Chhattisgarh,Crime Against Women,Molestation,Female,18-30,8163,6922,1241,7974,189
2005,Urban,Haryana,Property Crime,Arson,Female,31-45,69,60,9,69,0
2001,Urban,Nagaland,Crime Against Women,Dowry Deaths,Female,60+,8293,98,8195,7951,342
2005,Urban,Uttarakhand,Crime Against Men,Murder,Female,60+,6664,6633,31,6655,9
2006,Rural,Uttarakhand,Other Crimes,Cyber Crime,Female,18-30,5475,3427,2048,4446,1029
2004,Rural,Assam,Crime Against Men,Murder,Female,0-12,7464,1882,5582,2386,5078
2009,Rural,Mizoram,Crime Against Men,Robbery,Male,60+,7498,3330,4168,7048,450
2010,Rural,Goa,Crime Against Children,Kidnapping,Female,60+,4360,3704,656,3766,594
2001,Rural,Goa,Crime Against Children,Child Abuse,Female,0-12,1706,1094,612,1120,586
2007,Urban,Uttar Pradesh,Crime Against Children,Child Abuse,Male,18-30,9668,2547,7121,3508,6160
2006,Rural,Meghalaya,Crime Against Women,Domestic Violence,Female,0-12,9109,3250,5859,4034,5075
2004,Rural,Karnataka,Crime Against Children,Trafficking,Female,31-45,1836,279,1557,882,954
2004,Urban,Maharashtra,Crime Against Men,Extortion,Female,60+,6499,336,6163,4661,1838
2006,Urban,Haryana,Crime Against Children,Trafficking,Male,31-45,8837,2147,6690,4177,4660
2001,Rural,Himachal Pradesh,Crime Against Women,Dowry Deaths,Male,31-45,3650,503,3147,790,2860
2001,Rural,Sikkim,Crime Against Men,Robbery,Female,0-12,3907,1819,2088,3131,776
2005,Rural,Gujarat,Crime Against Men,Assault,Male,18-30,1719,69,1650,1337,382
2006,Urban,Kerala,Crime Against Children,Trafficking,Female,31-45,951,899,52,950,1
2004,Urban,Kerala,Crime Against Women,Dowry Deaths,Female,13-17,5853,2587,3266,3706,2147
2010,Rural,Rajasthan,Property Crime,Theft,Female,0-12,1933,377,1556,1796,137
2003,Urban,Mizoram,Other Crimes,Fraud,Male,13-17,6555,35,6520,5548,1007
2007,Urban,Goa,Other Crimes,Fraud,Female,31-45,7063,4059,3004,5926,1137
2004,Urban,Rajasthan,Property Crime,Arson,Female,18-30,5879,3771,2108,5837,42
2001,Urban,Manipur,Crime Against Women,Molestation,Male,31-45,7394,4341,3053,6076,1318
2006,Rural,Goa,Property Crime,Vandalism,Female,18-30,2756,1992,764,2123,633
2006,Rural,Odisha,Crime Against Women,Dowry Deaths,Male,46-60,9575,2006,7569,2852,6723
2010,Rural,Punjab,Crime Against Women,Rape,Male,46-60,6619,5044,1575,5061,1558
2005,Urban,Madhya Pradesh,Crime Against Children,Child Labor,Female,60+,8536,2961,5575,3167,5369
2007,Urban,Tripura,Other Crimes,Fraud,Male,31-45,4364,2084,2280,2097,2267
2010,Rural,Sikkim,Crime Against Men,Extortion,Female,18-30,2590,1769,821,2421,169
2008,Rural,Punjab,Crime Against Women,Molestation,Male,46-60,1673,511,1162,624,1049
2007,Rural,Sikkim,Crime Against Children,Kidnapping,Male,18-30,1150,50,1100,1149,1
2007,Rural,Tripura,Other Crimes,Fraud,Female,18-30,6925,5525,1400,5755,1170
2004,Urban,Jharkhand,Property Crime,Theft,Male,31-45,5518,2282,3236,4945,573
2007,Urban,Jharkhand,Crime Against Children,Trafficking,Female,60+,4754,4193,561,4493,261
2003,Rural,Mizoram,Property Crime,Theft,Female,18-30,5741,1380,4361,5710,31
2007,Rural,Delhi,Crime Against Children,Kidnapping,Male,46-60,8044,986,7058,7191,853
2010,Urban,Karnataka,Other Crimes,Drug Offense,Male,0-12,9780,719,9061,4664,5116
2007,Urban,Sikkim,Crime Against Children,Child Abuse,Female,31-45,3034,1130,1904,2421,613
2005,Urban,Nagaland,Crime Against Children,Kidnapping,Female,13-17,6282,6144,138,6207,75
2002,Urban,West Bengal,Crime Against Children,Trafficking,Male,0-12,5968,1872,4096,5900,68
2003,Rural,Nagaland,Property Crime,Theft,Male,60+,6410,4708,1702,4941,1469
2006,Urban,Andhra Pradesh,Crime Against Women,Molestation,Female,46-60,3679,979,2700,2647,1032
2006,Rural,Himachal Pradesh,Crime Against Women,Rape,Male,18-30,6663,2436,4227,2774,3889
2007,Rural,Chhattisgarh,Property Crime,Arson,Male,18-30,768,223,545,762,6
2005,Urban,Telangana,Crime Against Children,Child Labor,Male,13-17,6763,300,6463,6689,74
2010,Urban,Tripura,Crime Against Children,Child Labor,Female,31-45,6261,2361,3900,3786,2475
2007,Rural,Odisha,Property Crime,Theft,Male,18-30,1455,1313,142,1350,105
2004,Urban,Uttar Pradesh,Property Crime,Burglary,Male,18-30,326,7,319,225,101
2002,Urban,Kerala,Crime Against Men,Assault,Female,0-12,1592,375,1217,608,984
2002,Rural,Odisha,Crime Against Women,Rape,Female,18-30,1278,814,464,1211,67
2009,Rural,Jharkhand,Property Crime,Arson,Male,0-12,1636,735,901,1306,330
2002,Rural,Kerala,Crime Against Women,Rape,Male,0-12,6807,1085,5722,4151,2656
2005,Rural,Tripura,Crime Against Women,Molestation,Female,13-17,5327,894,4433,4546,781
2004,Urban,Uttar Pradesh,Crime Against Women,Molestation,Male,46-60,971,72,899,750,221
2007,Rural,Manipur,Crime Against Children,Child Labor,Male,31-45,9185,1092,8093,7101,2084
2002,Urban,Karnataka,Property Crime,Burglary,Female,13-17,4926,4829,97,4911,15
2005,Urban,Delhi,Crime Against Women,Domestic Violence,Female,0-12,3445,2981,464,3173,272
2006,Urban,Telangana,Crime Against Men,Extortion,Female,18-30,8404,6068,2336,6297,2107
2008,Rural,Rajasthan,Property Crime,Arson,Male,0-12,1993,154,1839,1849,144
2006,Rural,Telangana,Crime Against Women,Molestation,Male,13-17,9352,608,8744,8343,1009
2005,Urban,Assam,Crime Against Women,Molestation,Female,0-12,7224,1446,5778,6171,1053
2004,Rural,Goa,Other Crimes,Corruption,Male,0-12,8571,3693,4878,7765,806
2010,Rural,Tamil Nadu,Crime Against Children,Child Labor,Male,13-17,6871,1423,5448,5599,1272
2007,Rural,Arunachal Pradesh,Other Crimes,Fraud,Female,18-30,6710,3709,3001,4340,2370
2009,Urban,Odisha,Crime Against Women,Molestation,Female,46-60,8284,3034,5250,5329,2955
2001,Urban,Rajasthan,Crime Against Children,Kidnapping,Female,18-30,7580,474,7106,879,6701
2006,Rural,Odisha,Other Crimes,Fraud,Male,31-45,2822,1268,1554,1451,1371
2010,Rural,Tamil Nadu,Other Crimes,Fraud,Male,31-45,7253,4937,2316,5678,1575
2007,Urban,Kerala,Other Crimes,Fraud,Female,46-60,6727,3798,2929,5333,1394
2008,Rural,Delhi,Crime Against Men,Robbery,Female,60+,7093,3329,3764,5596,1497
2009,Urban,Karnataka,Crime Against Women,Molestation,Male,18-30,6333,1069,5264,5572,761
2002,Urban,Odisha,Crime Against Men,Robbery,Male,0-12,979,798,181,965,14
2009,Urban,Tripura,Crime Against Men,Robbery,Female,13-17,9415,4233,5182,9153,262
2009,Urban,Gujarat,Crime Against Women,Rape,Female,13-17,2029,1632,397,1820,209
2009,Rural,Nagaland,Property Crime,Arson,Female,31-45,7303,5966,1337,7155,148
2007,Rural,Tamil Nadu,Crime Against Men,Extortion,Male,18-30,7489,4852,2637,5807,1682
2004,Rural,Telangana,Property Crime,Theft,Female,60+,6860,6125,735,6718,142
2002,Urban,Odisha,Crime Against Children,Trafficking,Male,46-60,6741,2129,4612,5749,992
2006,Rural,Sikkim,Crime Against Children,Child Abuse,Female,13-17,5168,1182,3986,2605,2563
2003,Rural,Gujarat,Property Crime,Theft,Male,60+,5422,3942,1480,5043,379
2003,Urban,Uttar Pradesh,Crime Against Men,Extortion,Female,60+,8724,2940,5784,3404,5320
2009,Urban,Maharashtra,Crime Against Men,Assault,Female,60+,9181,6814,2367,7153,2028
2003,Urban,Delhi,Crime Against Men,Assault,Male,13-17,6482,3883,2599,4352,2130
2010,Urban,Manipur,Crime Against Men,Assault,Male,0-12,3645,631,3014,1111,2534
2007,Rural,Gujarat,Other Crimes,Cyber Crime,Male,18-30,4827,1568,3259,3695,1132
2002,Urban,Rajasthan,Crime Against Men,Murder,Female,0-12,4121,1942,2179,2750,1371
2007,Rural,Uttarakhand,Crime Against Men,Assault,Female,18-30,8741,4911,3830,6164,2577
2009,Rural,Nagaland,Crime Against Women,Rape,Male,60+,5360,4928,432,4974,386
2010,Urban,Uttarakhand,Crime Against Children,Kidnapping,Male,60+,7607,3152,4455,3174,4433
2009,Urban,Odisha,Crime Against Children,Child Abuse,Female,13-17,5365,586,4779,3776,1589
2010,Rural,Chhattisgarh,Crime Against Women,Domestic Violence,Male,18-30,6977,799,6178,3658,3319
2006,Rural,Madhya Pradesh,Crime Against Children,Kidnapping,Female,31-45,7683,2826,4857,5620,2063
2003,Rural,Tripura,Crime Against Men,Murder,Male,60+,4132,2488,1644,3569,563
2008,Urban,Punjab,Crime Against Men,Murder,Female,46-60,8104,5020,3084,7125,979
2005,Urban,Manipur,Crime Against Children,Child Abuse,Male,18-30,7669,4503,3166,6737,932
2007,Rural,Haryana,Crime Against Men,Extortion,Male,18-30,7162,2398,4764,5673,1489
2009,Rural,Uttarakhand,Crime Against Men,Robbery,Female,0-12,2663,503,2160,1263,1400
2008,Rural,Assam,Property Crime,Theft,Male,60+,4269,4041,228,4100,169
2006,Urban,West Bengal,Property Crime,Burglary,Female,0-12,429,334,95,373,56
2003,Rural,Uttar Pradesh,Crime Against Children,Child Labor,Female,46-60,465,240,225,277,188
2006,Urban,Mizoram,Crime Against Men,Murder,Female,46-60,7317,1576,5741,1790,5527
2001,Rural,Uttarakhand,Crime Against Women,Dowry Deaths,Female,46-60,8199,4016,4183,5720,2479
2010,Urban,Mizoram,Crime Against Men,Murder,Female,0-12,3758,1778,1980,2396,1362
2005,Rural,Haryana,Property Crime,Burglary,Female,31-45,2498,863,1635,2119,379
2010,Urban,Uttar Pradesh,Crime Against Women,Dowry Deaths,Male,0-12,340,302,38,305,35
2009,Rural,Manipur,Property Crime,Burglary,Male,0-12,9876,7998,1878,8298,1578
2009,Rural,Bihar,Property Crime,Theft,Male,0-12,9043,6517,2526,7498,1545
2001,Rural,Karnataka,Property Crime,Theft,Male,18-30,6212,6014,198,6118,94
2006,Rural,Rajasthan,Other Crimes,Drug Offense,Male,18-30,3040,555,2485,2742,298
2001,Rural,Himachal Pradesh,Crime Against Women,Dowry Deaths,Male,46-60,1232,542,690,910,322
2003,Rural,Delhi,Crime Against Women,Rape,Male,46-60,2686,2025,661,2426,260
2002,Rural,Manipur,Crime Against Women,Domestic Violence,Male,18-30,68,52,16,57,11
2002,Urban,Odisha,Crime Against Children,Kidnapping,Male,46-60,8540,7953,587,8514,26
2007,Urban,Rajasthan,Crime Against Children,Child Labor,Male,46-60,1528,1139,389,1201,327
2003,Rural,Maharashtra,Crime Against Women,Domestic Violence,Female,18-30,9362,9115,247,9131,231
2010,Urban,Himachal Pradesh,Property Crime,Theft,Male,46-60,8394,2079,6315,4162,4232
2003,Rural,Uttar Pradesh,Property Crime,Burglary,Male,18-30,7899,5916,1983,6540,1359
2002,Urban,Uttarakhand,Crime Against Men,Robbery,Female,13-17,3013,2517,496,2925,88
2007,Rural,Himachal Pradesh,Crime Against Children,Child Abuse,Female,31-45,4048,1665,2383,2985,1063
2006,Rural,West Bengal,Crime Against Children,Child Abuse,Male,18-30,1297,604,693,1157,140
2002,Urban,Bihar,Crime Against Women,Rape,Male,18-30,8659,5059,3600,8307,352
2005,Rural,Chhattisgarh,Crime Against Women,Rape,Male,46-60,3629,705,2924,2415,1214
2006,Urban,Odisha,Crime Against Children,Kidnapping,Male,18-30,670,636,34,642,28
2004,Urban,Madhya Pradesh,Crime Against Children,Kidnapping,Male,18-30,5553,5273,280,5458,95
2006,Rural,Tripura,Crime Against Men,Assault,Female,18-30,7743,4302,3441,6190,1553
2006,Urban,Arunachal Pradesh,Crime Against Children,Trafficking,Female,46-60,73,52,21,60,13
2004,Urban,Madhya Pradesh,Crime Against Children,Child Labor,Female,18-30,2087,1171,916,1701,386
2004,Rural,Jharkhand,Crime Against Children,Kidnapping,Male,46-60,5579,5020,559,5516,63
2003,Urban,West Bengal,Property Crime,Burglary,Female,18-30,7813,2706,5107,5239,2574
2006,Urban,Mizoram,Crime Against Women,Dowry Deaths,Female,0-12,9812,7228,2584,9034,778
2004,Rural,Gujarat,Crime Against Women,Domestic Violence,Female,31-45,8581,4228,4353,5509,3072
2010,Rural,Chhattisgarh,Property Crime,Vandalism,Male,13-17,6420,3937,2483,5985,435
2001,Urban,Jammu & Kashmir,Other Crimes,Drug Offense,Male,46-60,2325,1486,839,1961,364
2010,Rural,Jammu & Kashmir,Other Crimes,Corruption,Female,0-12,5178,468,4710,3730,1448
2003,Urban,Meghalaya,Crime Against Women,Domestic Violence,Male,31-45,7485,7404,81,7457,28
2007,Urban,Maharashtra,Crime Against Men,Extortion,Male,13-17,7386,2131,5255,4401,2985
2002,Urban,Delhi,Crime Against Men,Murder,Female,13-17,3479,1023,2456,2030,1449
2003,Urban,Nagaland,Crime Against Women,Molestation,Female,13-17,981,915,66,964,17
2002,Rural,Himachal Pradesh,Crime Against Women,Rape,Female,31-45,5896,3463,2433,5186,710
2005,Urban,Telangana,Other Crimes,Corruption,Female,0-12,7835,6528,1307,7485,350
2003,Rural,Mizoram,Crime Against Children,Child Labor,Male,0-12,9165,7130,2035,7253,1912
2002,Urban,West Bengal,Other Crimes,Fraud,Male,46-60,5945,4523,1422,5072,873
2009,Urban,Bihar,Other Crimes,Corruption,Female,18-30,1411,315,1096,1248,163
2002,Rural,Manipur,Other Crimes,Fraud,Male,18-30,7861,3423,4438,4725,3136
2007,Rural,Punjab,Property Crime,Theft,Female,31-45,3466,801,2665,2302,1164
2007,Urban,Andhra Pradesh,Crime Against Men,Robbery,Male,0-12,7457,1821,5636,2399,5058
2010,Urban,West Bengal,Property Crime,Theft,Male,60+,9847,7878,1969,9648,199
2010,Rural,Himachal Pradesh,Crime Against Women,Rape,Male,31-45,5938,2740,3198,4960,978
2003,Urban,Kerala,Property Crime,Arson,Male,13-17,939,488,451,662,277
2004,Rural,Nagaland,Other Crimes,Fraud,Male,46-60,3366,2124,1242,3221,145
2007,Rural,Telangana,Crime Against Children,Child Labor,Male,13-17,3147,1132,2015,2463,684
2005,Rural,Andhra Pradesh,Other Crimes,Corruption,Male,0-12,4535,3357,1178,3783,752
2009,Urban,Jammu & Kashmir,Crime Against Children,Trafficking,Female,13-17,4422,694,3728,4178,244
2010,Rural,Haryana,Crime Against Children,Trafficking,Male,46-60,1114,903,211,1058,56
2006,Rural,Jammu & Kashmir,Crime Against Children,Child Labor,Female,0-12,6408,4217,2191,5736,672
2008,Rural,Delhi,Crime Against Women,Domestic Violence,Male,0-12,6880,4114,2766,5007,1873
2006,Urban,Telangana,Crime Against Children,Trafficking,Male,0-12,1311,301,1010,575,736
2002,Rural,Punjab,Crime Against Women,Molestation,Male,46-60,797,784,13,790,7
2005,Urban,Meghalaya,Crime Against Women,Rape,Female,13-17,5370,3024,2346,3466,1904
2009,Rural,Rajasthan,Other Crimes,Cyber Crime,Female,13-17,2072,1242,830,1794,278
2006,Rural,Assam,Crime Against Women,Molestation,Male,31-45,8028,4309,3719,4643,3385
2008,Rural,Kerala,Crime Against Men,Extortion,Female,46-60,8661,3343,5318,4224,4437
2009,Rural,Manipur,Other Crimes,Drug Offense,Male,13-17,155,23,132,78,77
2001,Rural,Meghalaya,Property Crime,Vandalism,Female,46-60,2330,1825,505,2105,225
2001,Urban,Haryana,Other Crimes,Fraud,Male,31-45,7875,2612,5263,3410,4465
2010,Rural,Mizoram,Crime Against Men,Assault,Female,0-12,630,62,568,575,55
2006,Rural,Jammu & Kashmir,Crime Against Women,Molestation,Male,31-45,3218,1915,1303,2191,1027
2001,Rural,Gujarat,Other Crimes,Fraud,Male,60+,5779,2552,3227,3088,2691
2010,Rural,Gujarat,Crime Against Children,Kidnapping,Male,46-60,4868,1120,3748,2486,2382
2010,Urban,Chhattisgarh,Property Crime,Vandalism,Female,60+,9177,3292,5885,3542,5635
2009,Rural,Goa,Property Crime,Burglary,Female,46-60,1527,105,1422,1370,157
2009,Rural,Haryana,Other Crimes,Corruption,Female,13-17,296,91,205,139,157
2002,Urban,West Bengal,Crime Against Children,Child Abuse,Female,13-17,8970,3110,5860,5629,3341
2009,Rural,Telangana,Other Crimes,Corruption,Male,46-60,6497,2280,4217,4182,2315
2007,Rural,Odisha,Property Crime,Vandalism,Female,0-12,3316,1357,1959,3289,27
2001,Rural,Jammu & Kashmir,Crime Against Men,Extortion,Female,46-60,9789,478,9311,5992,3797
2005,Rural,Himachal Pradesh,Crime Against Men,Murder,Male,60+,1767,1183,584,1705,62
2001,Rural,Nagaland,Crime Against Men,Robbery,Male,18-30,4572,3226,1346,3863,709
2009,Urban,Assam,Crime Against Children,Kidnapping,Female,0-12,5204,4711,493,4917,287
2002,Urban,Uttar Pradesh,Crime Against Women,Dowry Deaths,Male,46-60,3843,2352,1491,3609,234
2006,Rural,Odisha,Other Crimes,Cyber Crime,Female,0-12,972,446,526,773,199
2007,Urban,Sikkim,Other Crimes,Cyber Crime,Male,31-45,8287,6861,1426,7211,1076
2009,Rural,Maharashtra,Crime Against Children,Kidnapping,Male,18-30,3579,649,2930,1784,1795
2004,Urban,Arunachal Pradesh,Property Crime,Vandalism,Male,31-45,4191,495,3696,2398,1793
2006,Rural,Goa,Crime Against Men,Extortion,Male,13-17,7598,4154,3444,7122,476
2005,Rural,Gujarat,Other Crimes,Corruption,Female,31-45,2560,1987,573,2042,518
2003,Urban,Tamil Nadu,Other Crimes,Fraud,Female,0-12,9163,5435,3728,6797,2366
2005,Rural,Punjab,Crime Against Women,Dowry Deaths,Male,31-45,9716,8517,1199,8980,736
2010,Urban,Nagaland,Other Crimes,Fraud,Male,13-17,9493,5047,4446,6987,2506
2007,Rural,Rajasthan,Crime Against Men,Murder,Male,18-30,8909,3240,5669,5605,3304
2004,Rural,Himachal Pradesh,Crime Against Children,Trafficking,Female,60+,4945,1890,3055,4545,400
2001,Rural,Karnataka,Crime Against Women,Domestic Violence,Female,46-60,6827,1842,4985,1974,4853
2010,Urban,Himachal Pradesh,Property Crime,Theft,Female,60+,1025,223,802,272,753
2010,Urban,Mizoram,Crime Against Women,Domestic Violence,Male,13-17,574,564,10,572,2
2001,Rural,Maharashtra,Crime Against Children,Trafficking,Male,0-12,3552,1589,1963,2346,1206
2002,Rural,Manipur,Other Crimes,Drug Offense,Female,46-60,2913,964,1949,1460,1453
2002,Urban,Maharashtra,Crime Against Women,Molestation,Female,0-12,7786,7600,186,7759,27
2005,Rural,Mizoram,Other Crimes,Cyber Crime,Female,31-45,3184,246,2938,1597,1587
2002,Urban,Assam,Crime Against Men,Assault,Male,0-12,7956,4335,3621,6784,1172
2002,Urban,Himachal Pradesh,Other Crimes,Cyber Crime,Male,31-45,6131,5371,760,6056,75
2006,Urban,Gujarat,Crime Against Women,Molestation,Male,60+,2933,1915,1018,2600,333
2003,Urban,Gujarat,Property Crime,Burglary,Female,31-45,1019,954,65,958,61
2010,Rural,Tamil Nadu,Crime Against Women,Rape,Male,18-30,6603,5757,846,6070,533
2006,Urban,Meghalaya,Crime Against Women,Dowry Deaths,Female,46-60,7228,1468,5760,5267,1961
2004,Urban,Jammu & Kashmir,Other Crimes,Cyber Crime,Female,0-12,7400,5811,1589,7175,225
2004,Urban,Meghalaya,Crime Against Women,Molestation,Female,31-45,5515,3855,1660,4499,1016
2008,Urban,Manipur,Property Crime,Burglary,Female,13-17,5955,4464,1491,4896,1059
2009,Rural,Kerala,Property Crime,Burglary,Male,60+,4927,3139,1788,4105,822
2006,Urban,Uttar Pradesh,Crime Against Children,Child Abuse,Female,13-17,6434,3407,3027,3940,2494
2008,Rural,Assam,Other Crimes,Fraud,Male,31-45,7924,4752,3172,5586,2338
2001,Rural,Andhra Pradesh,Property Crime,Arson,Female,18-30,3875,3625,250,3733,142
2001,Rural,Tripura,Property Crime,Theft,Female,31-45,9925,2079,7846,7783,2142
2005,Urban,Rajasthan,Crime Against Women,Molestation,Male,60+,4922,3400,1522,3473,1449
2006,Rural,Sikkim,Crime Against Women,Domestic Violence,Male,13-17,1694,104,1590,852,842
2008,Rural,Madhya Pradesh,Property Crime,Burglary,Female,18-30,674,479,195,577,97
2008,Rural,Bihar,Crime Against Women,Molestation,Female,0-12,4996,15,4981,1829,3167
2004,Rural,Tamil Nadu,Crime Against Children,Kidnapping,Female,13-17,4597,2928,1669,3469,1128
2001,Rural,Telangana,Other Crimes,Drug Offense,Male,0-12,8140,5670,2470,6535,1605
2009,Rural,Arunachal Pradesh,Crime Against Women,Domestic Violence,Female,13-17,6045,2581,3464,5152,893
2002,Rural,Kerala,Crime Against Men,Robbery,Male,13-17,9498,8721,777,9354,144
2003,Urban,Manipur,Crime Against Men,Murder,Male,13-17,1318,231,1087,348,970
2006,Urban,Telangana,Property Crime,Arson,Male,0-12,6900,2147,4753,6139,761
2008,Rural,Gujarat,Crime Against Women,Domestic Violence,Male,13-17,8483,4730,3753,4851,3632
2001,Rural,Tamil Nadu,Other Crimes,Corruption,Male,60+,9616,3961,5655,5001,4615
2006,Urban,Madhya Pradesh,Crime Against Men,Robbery,Female,13-17,4562,28,4534,3984,578
2004,Urban,Assam,Crime Against Women,Domestic Violence,Female,18-30,115,60,55,100,15
2005,Urban,Kerala,Crime Against Children,Child Abuse,Female,46-60,9056,1532,7524,8304,752
2008,Rural,Nagaland,Crime Against Women,Domestic Violence,Male,0-12,9931,3470,6461,9642,289
2010,Rural,Jharkhand,Crime Against Men,Murder,Male,60+,4163,2142,2021,2217,1946
2006,Rural,Assam,Other Crimes,Drug Offense,Male,60+,9712,3331,6381,8413,1299
2003,Rural,Madhya Pradesh,Crime Against Children,Kidnapping,Female,46-60,3156,1268,1888,2458,698
2009,Rural,Mizoram,Property Crime,Theft,Female,46-60,9705,5937,3768,7268,2437
2004,Urban,Uttar Pradesh,Property Crime,Arson,Female,13-17,5550,1877,3673,4226,1324
2003,Rural,Manipur,Crime Against Children,Child Labor,Male,60+,2475,2075,400,2247,228
2010,Rural,Odisha,Crime Against Men,Extortion,Male,13-17,9110,1974,7136,7914,1196
2008,Urban,Tripura,Crime Against Women,Molestation,Female,60+,9687,241,9446,8872,815
2004,Urban,Chhattisgarh,Property Crime,Arson,Male,60+,4051,3282,769,4020,31
2006,Urban,Uttar Pradesh,Property Crime,Burglary,Male,18-30,2452,2265,187,2420,32
2003,Urban,Haryana,Other Crimes,Cyber Crime,Female,46-60,7885,3375,4510,7636,249
2003,Urban,Punjab,Crime Against Women,Domestic Violence,Male,31-45,873,322,551,553,320
2007,Rural,Madhya Pradesh,Crime Against Men,Robbery,Female,13-17,9548,5036,4512,8151,1397
2004,Rural,Sikkim,Property Crime,Burglary,Female,60+,1742,1168,574,1466,276
2003,Rural,Assam,Crime Against Men,Assault,Female,13-17,6603,6544,59,6592,11
2010,Urban,Mizoram,Property Crime,Theft,Male,60+,6129,4493,1636,5989,140
2008,Urban,Uttarakhand,Crime Against Children,Child Abuse,Male,46-60,3765,626,3139,1010,2755
2003,Urban,Haryana,Property Crime,Arson,Female,31-45,4784,4430,354,4756,28
2003,Rural,West Bengal,Crime Against Men,Assault,Female,18-30,1636,93,1543,1144,492
2008,Urban,Assam,Crime Against Women,Dowry Deaths,Female,18-30,7604,7092,512,7149,455
2002,Urban,Odisha,Property Crime,Theft,Female,46-60,4127,2605,1522,2930,1197
2005,Urban,West Bengal,Crime Against Children,Child Abuse,Female,0-12,2419,1142,1277,1958,461
2006,Rural,Bihar,Property Crime,Theft,Female,46-60,7367,4352,3015,6404,963
2010,Urban,Bihar,Crime Against Men,Assault,Female,31-45,829,180,649,213,616
2009,Rural,Telangana,Crime Against Women,Domestic Violence,Female,60+,6707,1445,5262,3646,3061
2005,Urban,Meghalaya,Crime Against Men,Extortion,Female,0-12,4571,1611,2960,3930,641
2006,Urban,Nagaland,Other Crimes,Cyber Crime,Female,0-12,496,50,446,292,204
2003,Rural,Sikkim,Property Crime,Theft,Female,60+,5908,1049,4859,4150,1758
2009,Rural,Nagaland,Property Crime,Arson,Male,0-12,9130,2829,6301,4216,4914
2004,Rural,Jharkhand,Other Crimes,Drug Offense,Female,18-30,1698,868,830,1637,61
2010,Urban,Kerala,Property Crime,Arson,Male,18-30,1341,525,816,1069,272
2007,Urban,Goa,Crime Against Men,Murder,Male,0-12,6088,1706,4382,3135,2953
2008,Rural,Himachal Pradesh,Property Crime,Theft,Female,18-30,8352,1226,7126,3984,4368
2010,Urban,Assam,Crime Against Women,Molestation,Male,60+,6302,2877,3425,3871,2431
2001,Urban,Jammu & Kashmir,Property Crime,Arson,Male,31-45,5870,3409,2461,4166,1704
2003,Urban,West Bengal,Crime Against Men,Assault,Female,18-30,8814,476,8338,4861,3953
2001,Rural,Tripura,Crime Against Children,Child Labor,Male,31-45,95,65,30,76,19
2007,Urban,Bihar,Other Crimes,Drug Offense,Female,60+,9529,4506,5023,4938,4591
2005,Urban,Delhi,Crime Against Women,Molestation,Male,18-30,1721,432,1289,1282,439
2004,Urban,Haryana,Property Crime,Vandalism,Male,60+,6516,3007,3509,5637,879
2008,Urban,Assam,Crime Against Men,Extortion,Female,60+,2367,1908,459,1988,379
2004,Rural,Goa,Other Crimes,Drug Offense,Male,18-30,7078,3241,3837,4728,2350
2001,Rural,Assam,Other Crimes,Corruption,Male,0-12,1136,1052,84,1082,54
2006,Urban,Himachal Pradesh,Property Crime,Vandalism,Male,13-17,9549,3674,5875,6863,2686
2010,Urban,Uttar Pradesh,Property Crime,Vandalism,Female,0-12,3376,287,3089,2491,885
2002,Rural,Kerala,Other Crimes,Cyber Crime,Male,60+,6313,1376,4937,1459,4854
2003,Rural,Arunachal Pradesh,Crime Against Men,Extortion,Female,46-60,9108,6685,2423,7842,1266
2008,Urban,Manipur,Crime Against Men,Assault,Female,46-60,3686,2694,992,2963,723
2001,Rural,Nagaland,Crime Against Women,Rape,Female,18-30,9300,565,8735,7897,1403
2001,Urban,Sikkim,Other Crimes,Cyber Crime,Male,0-12,4677,43,4634,4477,200
2006,Rural,Odisha,Other Crimes,Cyber Crime,Female,0-12,4855,1955,2900,4142,713
2003,Rural,Odisha,Crime Against Men,Robbery,Male,18-30,8720,1225,7495,5627,3093
2002,Urban,Madhya Pradesh,Property Crime,Burglary,Female,31-45,4824,1326,3498,1970,2854
2002,Rural,Gujarat,Property Crime,Burglary,Male,46-60,4325,4247,78,4269,56
2005,Urban,Mizoram,Crime Against Men,Murder,Male,18-30,1358,399,959,1288,70
2003,Rural,Rajasthan,Crime Against Children,Child Abuse,Male,18-30,7329,3172,4157,5146,2183
2005,Urban,Kerala,Crime Against Children,Kidnapping,Female,13-17,9882,217,9665,5712,4170
2010,Rural,Sikkim,Crime Against Men,Assault,Male,18-30,5074,4618,456,4696,378
2008,Urban,Punjab,Crime Against Women,Molestation,Male,0-12,9080,1193,7887,1706,7374
2006,Urban,Rajasthan,Property Crime,Burglary,Male,31-45,4550,2948,1602,3756,794
2006,Urban,Maharashtra,Crime Against Women,Molestation,Female,18-30,6398,209,6189,509,5889
2005,Urban,Nagaland,Other Crimes,Drug Offense,Female,13-17,9417,1125,8292,9159,258
2007,Rural,Telangana,Other Crimes,Corruption,Female,0-12,1477,1338,139,1412,65
2001,Urban,Jammu & Kashmir,Crime Against Men,Assault,Male,18-30,2162,1598,564,1844,318
2004,Rural,Uttar Pradesh,Property Crime,Theft,Female,60+,6793,2163,4630,4416,2377
2010,Rural,Rajasthan,Other Crimes,Corruption,Female,13-17,2716,50,2666,275,2441
2004,Urban,Manipur,Property Crime,Arson,Male,46-60,378,180,198,346,32
2009,Urban,Haryana,Property Crime,Burglary,Female,13-17,2227,2224,3,2224,3
2010,Urban,Himachal Pradesh,Property Crime,Theft,Female,46-60,3461,2504,957,2991,470
2009,Urban,Gujarat,Other Crimes,Drug Offense,Male,13-17,8281,1245,7036,5938,2343
2009,Urban,Kerala,Property Crime,Vandalism,Male,46-60,1312,1110,202,1152,160
2001,Urban,Jharkhand,Other Crimes,Corruption,Male,60+,8697,2265,6432,5525,3172
2001,Urban,Manipur,Crime Against Men,Assault,Male,18-30,8430,921,7509,2265,6165
2004,Urban,Andhra Pradesh,Property Crime,Vandalism,Male,18-30,3223,2242,981,2952,271
2003,Urban,Gujarat,Crime Against Children,Child Abuse,Female,60+,5651,2689,2962,5632,19
2005,Urban,Goa,Crime Against Children,Child Labor,Female,60+,7143,3800,3343,6172,971
2003,Rural,Goa,Crime Against Men,Robbery,Male,60+,3795,2907,888,3238,557
2005,Rural,Uttarakhand,Crime Against Women,Dowry Deaths,Male,60+,9516,6540,2976,8535,981
2004,Rural,Kerala,Crime Against Men,Murder,Male,18-30,8550,7296,1254,8115,435
2001,Rural,Mizoram,Property Crime,Arson,Female,13-17,494,272,222,294,200
2001,Rural,Mizoram,Property Crime,Theft,Male,13-17,2898,2482,416,2604,294
2005,Rural,Nagaland,Property Crime,Burglary,Female,31-45,3484,962,2522,3167,317
2002,Urban,Chhattisgarh,Crime Against Women,Dowry Deaths,Female,13-17,4304,572,3732,2658,1646
2007,Urban,Haryana,Crime Against Women,Domestic Violence,Male,46-60,9357,5515,3842,8869,488
2001,Rural,Karnataka,Property Crime,Arson,Female,13-17,2192,1042,1150,2035,157
2004,Urban,West Bengal,Crime Against Children,Child Abuse,Male,31-45,5485,4936,549,4975,510
2010,Urban,Tripura,Other Crimes,Drug Offense,Male,46-60,6271,3032,3239,4322,1949
2006,Urban,Arunachal Pradesh,Crime Against Children,Child Labor,Male,13-17,1080,475,605,821,259
2002,Rural,Sikkim,Property Crime,Vandalism,Female,46-60,1701,1076,625,1550,151
2002,Rural,Rajasthan,Property Crime,Burglary,Female,18-30,7887,5784,2103,5816,2071
2002,Rural,Odisha,Crime Against Children,Child Abuse,Female,18-30,3613,2967,646,3352,261
2001,Urban,Himachal Pradesh,Crime Against Children,Trafficking,Male,60+,9165,7918,1247,8072,1093
2005,Urban,Kerala,Property Crime,Vandalism,Female,0-12,2483,2129,354,2449,34
2008,Urban,Andhra Pradesh,Crime Against Men,Murder,Female,13-17,2703,2703,0,2703,0
2009,Urban,Odisha,Crime Against Children,Trafficking,Male,60+,9395,4390,5005,5587,3808
2003,Urban,Himachal Pradesh,Crime Against Men,Murder,Female,46-60,8913,8497,416,8567,346
2003,Rural,Meghalaya,Crime Against Men,Extortion,Male,31-45,1767,1008,759,1600,167
2004,Urban,Uttarakhand,Other Crimes,Fraud,Male,60+,2318,885,1433,2221,97
2001,Rural,Jharkhand,Other Crimes,Fraud,Male,60+,2238,695,1543,1236,1002
2003,Rural,Andhra Pradesh,Crime Against Women,Rape,Female,46-60,5465,4117,1348,5185,280
2004,Urban,Odisha,Other Crimes,Fraud,Female,31-45,4298,743,3555,3993,305
2004,Rural,West Bengal,Other Crimes,Fraud,Male,46-60,3154,1636,1518,3015,139
2003,Rural,Haryana,Crime Against Women,Molestation,Male,0-12,5982,816,5166,3818,2164
2002,Urban,Arunachal Pradesh,Crime Against Women,Domestic Violence,Female,13-17,7483,6746,737,7172,311
2005,Urban,Bihar,Crime Against Men,Robbery,Male,60+,8348,3809,4539,5595,2753
2008,Rural,Kerala,Crime Against Women,Domestic Violence,Male,31-45,4763,1330,3433,3381,1382
2002,Urban,Himachal Pradesh,Property Crime,Burglary,Male,31-45,5047,3011,2036,4916,131
2009,Urban,Madhya Pradesh,Crime Against Men,Murder,Male,31-45,4034,853,3181,1572,2462
2003,Rural,Tripura,Crime Against Children,Kidnapping,Male,18-30,8137,819,7318,1102,7035
2003,Rural,Manipur,Property Crime,Arson,Female,0-12,5319,2243,3076,4718,601
2008,Rural,Gujarat,Crime Against Children,Child Abuse,Male,18-30,3394,2459,935,2886,508
2008,Rural,Madhya Pradesh,Crime Against Women,Molestation,Male,13-17,5818,3028,2790,4845,973
2001,Urban,Jammu & Kashmir,Crime Against Women,Dowry Deaths,Female,18-30,6047,4198,1849,4444,1603
2002,Rural,Haryana,Property Crime,Arson,Male,46-60,739,568,171,722,17
2004,Urban,Jammu & Kashmir,Crime Against Women,Rape,Male,0-12,4000,3145,855,3939,61
2003,Urban,Rajasthan,Crime Against Children,Child Abuse,Female,60+,9067,7729,1338,7951,1116
2010,Urban,Nagaland,Crime Against Men,Robbery,Male,60+,5070,4144,926,4946,124
2002,Rural,West Bengal,Crime Against Children,Kidnapping,Female,31-45,1458,1152,306,1221,237
2006,Rural,Delhi,Crime Against Women,Dowry Deaths,Female,46-60,7529,3222,4307,6601,928
2009,Urban,Goa,Property Crime,Arson,Male,18-30,689,198,491,501,188
2006,Urban,Haryana,Crime Against Women,Molestation,Female,31-45,1519,449,1070,1076,443
2007,Urban,Sikkim,Other Crimes,Fraud,Male,31-45,594,440,154,555,39
2004,Urban,Assam,Crime Against Children,Trafficking,Male,31-45,3242,1370,1872,1459,1783
2009,Rural,Jharkhand,Property Crime,Arson,Female,60+,6467,5161,1306,6159,308
2006,Rural,Meghalaya,Crime Against Children,Child Labor,Female,46-60,4750,804,3946,2350,2400
2003,Rural,Jammu & Kashmir,Property Crime,Arson,Female,0-12,6206,4641,1565,5252,954
2002,Rural,Mizoram,Crime Against Women,Rape,Male,31-45,6652,4993,1659,6354,298
2008,Urban,Nagaland,Other Crimes,Fraud,Male,60+,8528,4744,3784,7077,1451
2009,Urban,Nagaland,Crime Against Men,Extortion,Female,13-17,4389,1204,3185,2735,1654
2010,Rural,Manipur,Property Crime,Theft,Male,31-45,488,185,303,417,71
2001,Urban,Andhra Pradesh,Crime Against Women,Dowry Deaths,Male,0-12,5314,4779,535,4803,511
2005,Urban,Jammu & Kashmir,Crime Against Children,Kidnapping,Female,46-60,1145,1069,76,1120,25
2010,Rural,Andhra Pradesh,Crime Against Children,Child Abuse,Male,13-17,4174,3023,1151,3866,308
2009,Urban,Odisha,Property Crime,Vandalism,Male,0-12,55,9,46,42,13
2007,Rural,Jharkhand,Other Crimes,Fraud,Female,60+,1280,722,558,1125,155
2007,Rural,Telangana,Other Crimes,Drug Offense,Female,0-12,253,146,107,176,77
2009,Urban,Kerala,Crime Against Men,Assault,Female,60+,7655,2860,4795,4692,2963
2008,Urban,Nagaland,Other Crimes,Corruption,Male,0-12,7271,6850,421,7232,39
2003,Urban,Madhya Pradesh,Property Crime,Vandalism,Female,13-17,9904,6282,3622,7668,2236
2005,Urban,West Bengal,Property Crime,Vandalism,Male,60+,493,170,323,377,116
2003,Rural,Madhya Pradesh,Other Crimes,Drug Offense,Female,18-30,1072,480,592,829,243
2010,Rural,Goa,Other Crimes,Drug Offense,Female,31-45,2436,2134,302,2373,63
2005,Rural,Himachal Pradesh,Property Crime,Burglary,Male,13-17,4369,2214,2155,3368,1001
2009,Rural,Rajasthan,Crime Against Men,Extortion,Female,60+,9439,9422,17,9427,12
2007,Rural,Bihar,Crime Against Men,Robbery,Female,13-17,8253,3384,4869,4761,3492
2002,Rural,Rajasthan,Crime Against Men,Assault,Male,31-45,6407,2687,3720,3892,2515
2009,Rural,Bihar,Crime Against Women,Molestation,Male,46-60,9377,6238,3139,6336,3041
2006,Rural,Manipur,Crime Against Children,Kidnapping,Female,18-30,2785,1763,1022,2442,343
2008,Rural,Himachal Pradesh,Crime Against Women,Rape,Male,60+,8438,1973,6465,2727,5711
2007,Rural,Delhi,Crime Against Men,Robbery,Male,46-60,7471,1073,6398,5315,2156
2001,Rural,Gujarat,Crime Against Men,Extortion,Female,46-60,3562,507,3055,3260,302
2007,Rural,Delhi,Property Crime,Burglary,Male,13-17,4658,4080,578,4179,479
2003,Rural,Odisha,Crime Against Women,Molestation,Female,31-45,5307,1237,4070,1457,3850
2004,Rural,Jharkhand,Other Crimes,Fraud,Male,18-30,9434,4967,4467,7508,1926
2010,Urban,Punjab,Crime Against Men,Assault,Female,31-45,5193,753,4440,3924,1269
2010,Urban,Meghalaya,Crime Against Women,Dowry Deaths,Female,13-17,5732,2093,3639,5255,477
2010,Urban,Sikkim,Crime Against Women,Molestation,Male,13-17,4501,1911,2590,2249,2252
2005,Rural,Jammu & Kashmir,Crime Against Children,Trafficking,Female,60+,2616,2268,348,2576,40
2006,Urban,Kerala,Other Crimes,Cyber Crime,Male,18-30,3478,802,2676,2777,701
2004,Urban,Himachal Pradesh,Crime Against Children,Child Abuse,Female,60+,6929,2771,4158,5358,1571
2010,Urban,Sikkim,Property Crime,Theft,Female,0-12,6809,3697,3112,6170,639
2006,Urban,Maharashtra,Crime Against Men,Murder,Female,46-60,2365,2288,77,2301,64
2001,Rural,Arunachal Pradesh,Other Crimes,Drug Offense,Female,60+,6009,2105,3904,5438,571
2004,Urban,Haryana,Other Crimes,Corruption,Male,46-60,9841,595,9246,7763,2078
2002,Urban,Arunachal Pradesh,Other Crimes,Fraud,Male,0-12,1018,744,274,946,72
2004,Rural,Jharkhand,Crime Against Men,Extortion,Male,46-60,3636,1165,2471,2785,851
2002,Urban,Maharashtra,Crime Against Women,Domestic Violence,Female,60+,9971,8320,1651,9401,570
2009,Urban,Jammu & Kashmir,Property Crime,Arson,Male,13-17,5965,3358,2607,4492,1473
2003,Urban,Arunachal Pradesh,Other Crimes,Cyber Crime,Female,0-12,1886,1027,859,1619,267
2005,Urban,Bihar,Property Crime,Burglary,Female,0-12,334,70,264,254,80
2003,Urban,Chhattisgarh,Property Crime,Arson,Female,60+,4534,2317,2217,4088,446
2007,Urban,Maharashtra,Property Crime,Arson,Male,60+,1758,587,1171,1022,736
2005,Urban,Gujarat,Crime Against Women,Molestation,Male,31-45,432,133,299,253,179
2009,Rural,Telangana,Property Crime,Theft,Female,13-17,8562,6947,1615,7422,1140
2010,Rural,Assam,Crime Against Children,Child Abuse,Female,13-17,3728,395,3333,2222,1506
2003,Urban,Punjab,Crime Against Women,Rape,Male,0-12,9403,2899,6504,6803,2600
2009,Rural,Karnataka,Crime Against Men,Robbery,Female,31-45,412,76,336,394,18
2007,Rural,Kerala,Property Crime,Vandalism,Female,60+,239,99,140,142,97
2010,Urban,Kerala,Crime Against Women,Domestic Violence,Male,46-60,8114,1047,7067,8053,61
2001,Rural,Jharkhand,Crime Against Women,Molestation,Female,60+,249,232,17,236,13
2004,Rural,West Bengal,Property Crime,Burglary,Male,0-12,3424,2680,744,3060,364
2007,Rural,Meghalaya,Crime Against Women,Dowry Deaths,Male,60+,3307,255,3052,2628,679
2007,Rural,Delhi,Crime Against Women,Rape,Female,13-17,9822,7953,1869,9095,727
2005,Rural,Rajasthan,Other Crimes,Fraud,Male,46-60,9058,5620,3438,6213,2845
2008,Urban,Jammu & Kashmir,Crime Against Women,Domestic Violence,Male,0-12,952,206,746,232,720
2010,Urban,Uttarakhand,Crime Against Men,Extortion,Male,13-17,5077,3332,1745,4360,717
2006,Urban,Karnataka,Property Crime,Vandalism,Male,0-12,500,326,174,413,87
2010,Rural,Karnataka,Other Crimes,Cyber Crime,Male,60+,2778,627,2151,636,2142
2010,Rural,Uttar Pradesh,Other Crimes,Cyber Crime,Male,60+,2666,673,1993,1352,1314
2010,Urban,Punjab,Crime Against Men,Murder,Female,13-17,9547,4460,5087,6495,3052
2007,Rural,Punjab,Crime Against Children,Child Labor,Female,13-17,5832,4679,1153,5381,451
2008,Urban,Haryana,Crime Against Women,Molestation,Female,13-17,7646,4215,3431,7570,76
2006,Urban,Assam,Property Crime,Vandalism,Male,13-17,2976,1621,1355,2588,388
2003,Urban,Mizoram,Crime Against Men,Robbery,Male,0-12,3673,3554,119,3652,21
2006,Rural,Bihar,Crime Against Children,Child Abuse,Male,60+,3821,665,3156,2983,838
2005,Rural,Delhi,Other Crimes,Cyber Crime,Female,13-17,5158,3495,1663,4980,178
2007,Rural,Manipur,Crime Against Children,Child Labor,Male,18-30,9010,8448,562,8854,156
2009,Urban,Kerala,Crime Against Children,Child Labor,Male,18-30,1249,291,958,973,276
2002,Urban,Tripura,Property Crime,Theft,Female,0-12,4345,582,3763,2219,2126
2007,Urban,Chhattisgarh,Crime Against Women,Rape,Female,0-12,9276,4938,4338,5369,3907
2001,Rural,Arunachal Pradesh,Property Crime,Theft,Female,46-60,4441,4334,107,4336,105
2001,Rural,Rajasthan,Other Crimes,Cyber Crime,Female,13-17,4182,2008,2174,2331,1851
2010,Urban,Karnataka,Property Crime,Burglary,Male,60+,5964,2202,3762,3208,2756
2009,Rural,Andhra Pradesh,Crime Against Women,Domestic Violence,Female,18-30,4296,1575,2721,3746,550
2002,Urban,Himachal Pradesh,Crime Against Men,Robbery,Female,60+,462,401,61,415,47
2010,Urban,Delhi,Crime Against Children,Kidnapping,Male,60+,4490,755,3735,2669,1821
2002,Urban,Manipur,Crime Against Men,Extortion,Male,0-12,4694,3545,1149,3736,958
2002,Urban,Andhra Pradesh,Other Crimes,Drug Offense,Female,31-45,7136,6964,172,6993,143
2005,Rural,Uttar Pradesh,Other Crimes,Fraud,Female,13-17,6187,3284,2903,4446,1741
2006,Urban,Madhya Pradesh,Crime Against Women,Rape,Female,31-45,5613,3220,2393,3819,1794
2010,Rural,Arunachal Pradesh,Property Crime,Burglary,Female,60+,9250,388,8862,5803,3447
2008,Urban,Punjab,Crime Against Children,Child Abuse,Female,60+,4633,1662,2971,4565,68
2007,Urban,Tripura,Other Crimes,Cyber Crime,Female,13-17,9838,7329,2509,9330,508
2002,Urban,Assam,Other Crimes,Drug Offense,Male,18-30,3981,2326,1655,2396,1585
2006,Rural,Manipur,Crime Against Men,Robbery,Male,13-17,7903,2672,5231,3048,4855
2004,Urban,Manipur,Property Crime,Burglary,Male,46-60,4080,761,3319,3448,632
2005,Rural,Gujarat,Crime Against Men,Assault,Female,31-45,8747,896,7851,2686,6061
2003,Rural,Rajasthan,Crime Against Children,Child Labor,Female,60+,1946,1945,1,1946,0
2005,Rural,Arunachal Pradesh,Crime Against Children,Child Abuse,Male,46-60,8255,3470,4785,6496,1759
2006,Urban,Tripura,Property Crime,Burglary,Female,46-60,5283,3245,2038,4266,1017
2007,Rural,Chhattisgarh,Crime Against Children,Child Abuse,Male,46-60,3541,2861,680,3541,0
2005,Urban,West Bengal,Property Crime,Arson,Female,0-12,873,374,499,433,440
2003,Rural,Maharashtra,Crime Against Children,Child Abuse,Female,18-30,6947,2594,4353,4872,2075
2006,Rural,Telangana,Crime Against Women,Dowry Deaths,Female,13-17,9736,8236,1500,9643,93
2005,Rural,Assam,Other Crimes,Fraud,Male,13-17,7019,768,6251,1227,5792
2005,Rural,Kerala,Other Crimes,Cyber Crime,Male,13-17,7188,5586,1602,5844,1344
2004,Urban,Jammu & Kashmir,Crime Against Children,Child Abuse,Female,0-12,1808,820,988,1234,574
2006,Urban,Tamil Nadu,Property Crime,Burglary,Female,0-12,5317,402,4915,3753,1564
2009,Rural,Madhya Pradesh,Crime Against Children,Trafficking,Female,0-12,339,69,270,230,109
2010,Urban,Sikkim,Property Crime,Theft,Female,60+,4434,2689,1745,2816,1618
2007,Rural,Sikkim,Other Crimes,Drug Offense,Male,13-17,9747,2176,7571,3339,6408
2004,Urban,Bihar,Crime Against Women,Rape,Male,46-60,1652,356,1296,1259,393
2004,Urban,Manipur,Crime Against Men,Murder,Female,0-12,4816,2441,2375,3019,1797
2006,Urban,Odisha,Crime Against Men,Assault,Female,46-60,4229,4095,134,4223,6
2008,Urban,Uttar Pradesh,Other Crimes,Drug Offense,Male,31-45,9025,5997,3028,7054,1971
2001,Urban,Rajasthan,Other Crimes,Cyber Crime,Male,60+,1871,727,1144,875,996
2007,Urban,Tripura,Property Crime,Vandalism,Female,60+,2529,154,2375,777,1752
2004,Urban,Rajasthan,Property Crime,Theft,Female,46-60,6651,6571,80,6606,45
2010,Urban,Maharashtra,Crime Against Women,Rape,Female,60+,4695,4202,493,4502,193
2009,Rural,Tamil Nadu,Crime Against Women,Domestic Violence,Male,60+,1919,334,1585,543,1376
2002,Urban,Jammu & Kashmir,Crime Against Women,Domestic Violence,Male,60+,7216,2242,4974,5721,1495
2007,Urban,Haryana,Crime Against Men,Assault,Male,18-30,1037,409,628,444,593
2009,Urban,Himachal Pradesh,Other Crimes,Cyber Crime,Female,31-45,5103,3388,1715,4594,509
2008,Urban,Arunachal Pradesh,Crime Against Men,Extortion,Female,18-30,7467,484,6983,6425,1042
2010,Rural,Gujarat,Other Crimes,Fraud,Female,60+,2702,1956,746,2037,665
2007,Urban,Andhra Pradesh,Property Crime,Theft,Male,31-45,7460,1719,5741,4471,2989
2006,Urban,Tripura,Crime Against Men,Extortion,Female,31-45,3546,2768,778,3539,7
2010,Urban,Gujarat,Property Crime,Vandalism,Male,18-30,7954,3422,4532,6918,1036
2006,Rural,Jharkhand,Property Crime,Vandalism,Female,31-45,5421,3688,1733,3982,1439
2008,Rural,Chhattisgarh,Crime Against Men,Extortion,Male,31-45,7082,4328,2754,4643,2439
2001,Urban,Madhya Pradesh,Crime Against Men,Extortion,Female,18-30,6789,1390,5399,2449,4340
2001,Rural,Nagaland,Crime Against Children,Kidnapping,Male,13-17,7639,3819,3820,4791,2848
2009,Rural,Kerala,Other Crimes,Fraud,Female,0-12,7970,2431,5539,3745,4225
2003,Urban,Madhya Pradesh,Other Crimes,Fraud,Female,0-12,9478,5406,4072,8615,863
2008,Rural,Andhra Pradesh,Other Crimes,Corruption,Male,31-45,1656,1230,426,1372,284
2008,Rural,Tripura,Property Crime,Vandalism,Female,18-30,685,184,501,415,270
2008,Urban,Arunachal Pradesh,Crime Against Men,Robbery,Female,0-12,6899,398,6501,686,6213
2010,Rural,Telangana,Other Crimes,Corruption,Male,46-60,672,152,520,643,29
2001,Urban,Haryana,Crime Against Men,Murder,Male,18-30,343,65,278,150,193
2009,Urban,Uttarakhand,Crime Against Children,Child Abuse,Male,46-60,870,515,355,522,348
2004,Urban,Delhi,Property Crime,Burglary,Male,46-60,4474,1804,2670,4108,366
2006,Rural,Odisha,Property Crime,Theft,Male,31-45,4281,1349,2932,3278,1003
2007,Rural,Rajasthan,Crime Against Women,Dowry Deaths,Female,0-12,8526,860,7666,1038,7488
2006,Urban,West Bengal,Crime Against Women,Rape,Female,60+,9493,2159,7334,4324,5169
2003,Rural,Goa,Other Crimes,Cyber Crime,Male,46-60,1936,1839,97,1848,88
2008,Rural,Nagaland,Crime Against Men,Murder,Female,13-17,7209,895,6314,1750,5459
2008,Rural,Maharashtra,Crime Against Women,Molestation,Female,13-17,6106,3933,2173,5295,811
2006,Urban,Arunachal Pradesh,Property Crime,Theft,Female,46-60,7485,6988,497,7017,468
2009,Rural,Sikkim,Crime Against Women,Molestation,Male,13-17,8891,6145,2746,8046,845
2002,Rural,Arunachal Pradesh,Crime Against Men,Extortion,Male,13-17,8365,685,7680,2628,5737
2010,Urban,Meghalaya,Crime Against Men,Extortion,Male,18-30,7653,1583,6070,2639,5014
2009,Urban,Goa,Other Crimes,Cyber Crime,Female,13-17,3645,2404,1241,2761,884
2010,Rural,Tripura,Crime Against Women,Rape,Female,31-45,1206,472,734,979,227
2007,Rural,Assam,Other Crimes,Corruption,Female,13-17,8749,2440,6309,6028,2721
2005,Urban,Manipur,Other Crimes,Fraud,Male,13-17,9125,3844,5281,4710,4415
2010,Urban,Mizoram,Crime Against Children,Trafficking,Male,60+,1156,307,849,1120,36
2006,Rural,Nagaland,Crime Against Children,Child Labor,Male,18-30,9153,143,9010,8301,852
2003,Urban,Uttarakhand,Property Crime,Vandalism,Male,31-45,5499,1569,3930,3330,2169
2007,Rural,Rajasthan,Other Crimes,Fraud,Female,60+,9106,7872,1234,9013,93
2007,Urban,Maharashtra,Property Crime,Burglary,Male,13-17,1786,1312,474,1652,134
2010,Rural,West Bengal,Other Crimes,Cyber Crime,Female,18-30,440,379,61,392,48
2001,Rural,Odisha,Crime Against Children,Kidnapping,Female,13-17,6117,5257,860,5773,344
2002,Rural,Assam,Property Crime,Theft,Male,31-45,6977,276,6701,4789,2188
2007,Rural,Rajasthan,Crime Against Women,Rape,Male,13-17,4463,2870,1593,4440,23
2003,Urban,Rajasthan,Crime Against Children,Child Abuse,Male,0-12,4258,1961,2297,1986,2272
2002,Urban,Rajasthan,Other Crimes,Drug Offense,Female,0-12,123,97,26,122,1
2002,Rural,Kerala,Crime Against Women,Dowry Deaths,Male,0-12,3460,61,3399,1094,2366
2004,Urban,Himachal Pradesh,Crime Against Women,Dowry Deaths,Female,18-30,977,53,924,748,229
2003,Rural,Himachal Pradesh,Crime Against Children,Kidnapping,Female,13-17,371,184,187,323,48
2004,Urban,Andhra Pradesh,Other Crimes,Fraud,Male,0-12,8686,3167,5519,8320,366
2002,Rural,Uttar Pradesh,Crime Against Men,Murder,Male,46-60,9662,3882,5780,6553,3109
2010,Rural,Tripura,Other Crimes,Cyber Crime,Male,60+,7895,913,6982,1020,6875
2006,Urban,Mizoram,Crime Against Men,Extortion,Male,0-12,623,188,435,211,412
2004,Urban,Sikkim,Other Crimes,Fraud,Female,31-45,2888,125,2763,405,2483
2003,Rural,Maharashtra,Crime Against Children,Child Labor,Male,18-30,6182,2980,3202,5518,664
2008,Urban,Chhattisgarh,Property Crime,Arson,Male,18-30,7876,976,6900,6646,1230
2005,Rural,Sikkim,Crime Against Women,Dowry Deaths,Female,46-60,1170,1138,32,1144,26
2003,Urban,Punjab,Crime Against Men,Extortion,Female,0-12,241,229,12,237,4
2003,Rural,Rajasthan,Crime Against Men,Murder,Female,13-17,575,169,406,525,50
2005,Rural,Punjab,Other Crimes,Drug Offense,Male,60+,1434,1380,54,1421,13
2001,Rural,Manipur,Property Crime,Theft,Female,0-12,1013,516,497,968,45
2007,Urban,Telangana,Crime Against Children,Child Labor,Female,13-17,8818,1356,7462,2850,5968
2002,Urban,Rajasthan,Crime Against Men,Assault,Female,31-45,4712,4484,228,4566,146
2002,Rural,Andhra Pradesh,Other Crimes,Cyber Crime,Female,0-12,1374,857,517,1126,248
2006,Urban,Rajasthan,Crime Against Women,Molestation,Male,0-12,3436,1592,1844,2467,969
2008,Rural,Andhra Pradesh,Crime Against Children,Child Abuse,Female,13-17,4451,1256,3195,1706,2745
2001,Urban,Andhra Pradesh,Crime Against Children,Child Labor,Female,18-30,8439,7439,1000,8106,333
2002,Rural,Chhattisgarh,Other Crimes,Corruption,Male,0-12,691,505,186,613,78
2005,Rural,Himachal Pradesh,Crime Against Children,Kidnapping,Female,31-45,3035,2788,247,2837,198
2005,Rural,Bihar,Crime Against Men,Extortion,Male,0-12,1128,354,774,832,296
2010,Rural,Bihar,Crime Against Men,Murder,Male,18-30,1417,798,619,1392,25
2005,Rural,Tamil Nadu,Property Crime,Arson,Female,31-45,3358,1892,1466,2164,1194
2002,Urban,Rajasthan,Crime Against Women,Rape,Male,0-12,9471,5537,3934,7752,1719
2004,Urban,Jammu & Kashmir,Crime Against Men,Assault,Female,31-45,1706,1058,648,1690,16
2003,Rural,Uttarakhand,Crime Against Children,Child Labor,Male,18-30,2861,1493,1368,1990,871
2008,Rural,Himachal Pradesh,Property Crime,Arson,Female,60+,3323,1552,1771,2305,1018
2001,Urban,Rajasthan,Property Crime,Burglary,Female,0-12,2397,793,1604,1842,555
2009,Rural,Uttar Pradesh,Crime Against Men,Assault,Male,0-12,6790,878,5912,4891,1899
2003,Urban,Haryana,Property Crime,Arson,Female,18-30,682,160,522,328,354
2005,Rural,Arunachal Pradesh,Crime Against Children,Child Abuse,Male,13-17,3944,1377,2567,2830,1114
2009,Urban,Meghalaya,Property Crime,Theft,Female,46-60,1280,776,504,1223,57
2009,Urban,Andhra Pradesh,Crime Against Women,Molestation,Male,31-45,2168,1072,1096,1229,939
2004,Urban,Jharkhand,Other Crimes,Fraud,Male,31-45,3051,60,2991,717,2334
2002,Urban,Delhi,Crime Against Men,Assault,Male,13-17,173,49,124,110,63
2009,Rural,Rajasthan,Crime Against Children,Child Abuse,Female,0-12,8044,845,7199,5753,2291
2003,Urban,Nagaland,Other Crimes,Fraud,Male,18-30,709,382,327,595,114
2005,Urban,Bihar,Crime Against Children,Child Labor,Female,60+,9243,5534,3709,7034,2209
2003,Urban,Maharashtra,Crime Against Men,Extortion,Male,46-60,264,246,18,247,17
2007,Rural,Goa,Crime Against Women,Molestation,Female,60+,604,342,262,442,162
2001,Urban,Jharkhand,Crime Against Men,Robbery,Female,46-60,1983,467,1516,958,1025
2010,Urban,Karnataka,Crime Against Women,Molestation,Male,13-17,2565,724,1841,1064,1501
2005,Urban,West Bengal,Crime Against Women,Rape,Male,18-30,994,589,405,770,224
2001,Urban,Tamil Nadu,Property Crime,Arson,Female,0-12,8696,5921,2775,6512,2184
2005,Urban,Haryana,Crime Against Men,Assault,Male,0-12,7690,6466,1224,7677,13
2007,Urban,Tamil Nadu,Crime Against Children,Kidnapping,Female,46-60,9627,1372,8255,8591,1036
2008,Rural,Meghalaya,Crime Against Women,Molestation,Female,60+,4359,3157,1202,3199,1160
2009,Urban,Punjab,Crime Against Men,Extortion,Male,46-60,2828,2021,807,2573,255
2003,Urban,Andhra Pradesh,Crime Against Women,Dowry Deaths,Male,46-60,306,113,193,293,13
2007,Urban,Madhya Pradesh,Crime Against Men,Assault,Male,13-17,6205,60,6145,6156,49
2001,Urban,Maharashtra,Property Crime,Burglary,Female,0-12,4005,1203,2802,3127,878
2006,Urban,Himachal Pradesh,Other Crimes,Drug Offense,Male,18-30,2460,2118,342,2214,246
2007,Urban,Maharashtra,Other Crimes,Cyber Crime,Female,46-60,3426,2938,488,3041,385
2008,Rural,Uttar Pradesh,Crime Against Men,Murder,Female,60+,5159,4529,630,5039,120
2010,Rural,Nagaland,Crime Against Women,Dowry Deaths,Male,60+,2269,253,2016,1557,712
2003,Rural,Telangana,Crime Against Children,Child Abuse,Female,0-12,2374,1742,632,2135,239
2006,Urban,Meghalaya,Crime Against Children,Child Abuse,Female,46-60,775,652,123,752,23
2005,Urban,Punjab,Other Crimes,Cyber Crime,Female,13-17,6252,3326,2926,4855,1397
2010,Urban,Kerala,Crime Against Women,Dowry Deaths,Female,60+,464,269,195,324,140
2010,Rural,Manipur,Other Crimes,Corruption,Male,46-60,4464,3114,1350,4180,284
2010,Rural,Karnataka,Crime Against Children,Child Abuse,Female,13-17,9139,5498,3641,8380,759
2010,Rural,Meghalaya,Other Crimes,Corruption,Female,0-12,5055,3147,1908,3349,1706
2004,Urban,Gujarat,Property Crime,Theft,Female,60+,6864,2780,4084,6398,466
2001,Urban,Gujarat,Crime Against Men,Robbery,Male,18-30,2182,2111,71,2141,41
2003,Urban,Punjab,Crime Against Children,Child Abuse,Male,46-60,5422,4571,851,5023,399
2001,Rural,Manipur,Other Crimes,Cyber Crime,Male,60+,5996,314,5682,1792,4204
2010,Urban,Punjab,Other Crimes,Corruption,Male,31-45,2353,2345,8,2353,0
2002,Urban,Mizoram,Crime Against Women,Rape,Male,0-12,5257,1896,3361,4675,582
2008,Rural,Tamil Nadu,Property Crime,Vandalism,Female,60+,6355,4866,1489,5705,650
2010,Urban,Madhya Pradesh,Crime Against Men,Robbery,Female,31-45,8876,8535,341,8594,282
2001,Rural,Arunachal Pradesh,Property Crime,Burglary,Female,18-30,9613,4916,4697,5521,4092
2001,Rural,Himachal Pradesh,Other Crimes,Corruption,Female,31-45,1066,939,127,1044,22
2009,Urban,Mizoram,Property Crime,Vandalism,Female,46-60,6593,6301,292,6433,160
2010,Urban,Punjab,Other Crimes,Fraud,Female,13-17,1186,782,404,816,370
2008,Rural,West Bengal,Crime Against Women,Rape,Female,13-17,2399,2359,40,2385,14
2006,Rural,Punjab,Crime Against Children,Child Labor,Male,13-17,1255,563,692,866,389
2008,Urban,Karnataka,Crime Against Women,Dowry Deaths,Male,31-45,5414,5205,209,5407,7
2002,Rural,Odisha,Property Crime,Theft,Male,60+,3665,1722,1943,2512,1153
2001,Rural,Madhya Pradesh,Crime Against Men,Assault,Male,31-45,8015,4419,3596,6866,1149
2009,Rural,Tamil Nadu,Crime Against Men,Murder,Male,31-45,7691,4952,2739,6041,1650
2002,Urban,Karnataka,Other Crimes,Corruption,Female,13-17,2749,990,1759,1234,1515
2003,Urban,Gujarat,Crime Against Women,Domestic Violence,Male,18-30,2055,366,1689,376,1679
2002,Urban,Karnataka,Crime Against Children,Trafficking,Female,0-12,321,251,70,316,5
2010,Urban,Madhya Pradesh,Crime Against Men,Extortion,Male,0-12,4372,644,3728,3191,1181
2003,Urban,Delhi,Crime Against Children,Trafficking,Male,31-45,1495,1339,156,1429,66
2001,Urban,Assam,Crime Against Children,Child Abuse,Male,13-17,3517,1096,2421,3389,128
2007,Rural,Tripura,Crime Against Men,Extortion,Female,18-30,8768,2547,6221,6826,1942
2007,Rural,Madhya Pradesh,Crime Against Children,Child Labor,Male,60+,2376,253,2123,573,1803
2004,Urban,Jharkhand,Other Crimes,Corruption,Male,60+,5902,313,5589,2840,3062
2003,Urban,Odisha,Property Crime,Arson,Female,31-45,1291,921,370,967,324
2005,Urban,Uttar Pradesh,Crime Against Men,Robbery,Female,18-30,5783,466,5317,4695,1088
2009,Rural,Rajasthan,Crime Against Women,Molestation,Male,0-12,8717,363,8354,7658,1059
2008,Rural,Himachal Pradesh,Crime Against Women,Domestic Violence,Male,60+,7742,589,7153,1272,6470
2005,Urban,Bihar,Other Crimes,Fraud,Female,60+,6254,4034,2220,4229,2025
2010,Urban,Chhattisgarh,Other Crimes,Cyber Crime,Female,60+,9540,1325,8215,6159,3381
2003,Rural,Telangana,Property Crime,Vandalism,Female,60+,3300,1280,2020,2857,443
2002,Rural,West Bengal,Property Crime,Burglary,Female,13-17,6727,5577,1150,6205,522
2005,Urban,Uttar Pradesh,Crime Against Women,Dowry Deaths,Female,31-45,3232,333,2899,964,2268
2002,Urban,Tripura,Other Crimes,Cyber Crime,Female,0-12,3212,1077,2135,1834,1378
2005,Urban,Nagaland,Property Crime,Burglary,Male,60+,1053,499,554,778,275
2004,Urban,Goa,Crime Against Men,Robbery,Female,18-30,2282,583,1699,681,1601
2010,Urban,Meghalaya,Property Crime,Burglary,Male,60+,572,62,510,137,435
2003,Rural,Madhya Pradesh,Crime Against Children,Child Labor,Female,31-45,2932,1713,1219,1742,1190
2009,Rural,Himachal Pradesh,Crime Against Men,Murder,Male,46-60,3848,2123,1725,3800,48
2008,Rural,Rajasthan,Crime Against Men,Extortion,Female,31-45,4708,1544,3164,4560,148
2002,Rural,Nagaland,Crime Against Women,Molestation,Male,13-17,706,383,323,639,67
2003,Rural,Manipur,Other Crimes,Fraud,Male,60+,4934,3208,1726,4166,768
2007,Urban,Rajasthan,Crime Against Children,Trafficking,Female,60+,9756,8866,890,9213,543
2006,Urban,Bihar,Crime Against Men,Assault,Female,13-17,9123,6230,2893,6508,2615
2008,Urban,Kerala,Crime Against Women,Rape,Male,46-60,6140,4717,1423,5513,627
2004,Urban,Chhattisgarh,Crime Against Women,Dowry Deaths,Female,0-12,1367,1219,148,1269,98
2010,Urban,Manipur,Other Crimes,Cyber Crime,Male,13-17,8297,8159,138,8193,104
2003,Urban,Gujarat,Crime Against Men,Robbery,Male,60+,3656,3259,397,3376,280
2001,Urban,West Bengal,Crime Against Women,Molestation,Male,60+,4823,52,4771,2651,2172
2008,Urban,Maharashtra,Crime Against Children,Kidnapping,Female,46-60,8753,1581,7172,1675,7078
2005,Rural,Meghalaya,Other Crimes,Cyber Crime,Female,46-60,5748,5737,11,5744,4
2002,Rural,Haryana,Crime Against Women,Dowry Deaths,Male,31-45,8210,2766,5444,7398,812
2006,Rural,Andhra Pradesh,Crime Against Women,Rape,Female,0-12,3428,1254,2174,2037,1391
2002,Urban,Mizoram,Crime Against Children,Trafficking,Female,46-60,8173,2954,5219,3437,4736
2007,Rural,Delhi,Other Crimes,Fraud,Male,60+,8197,677,7520,6620,1577
2001,Urban,Punjab,Property Crime,Vandalism,Male,60+,8578,871,7707,2888,5690
2007,Urban,Telangana,Property Crime,Arson,Male,46-60,9395,4454,4941,4567,4828
2005,Urban,Madhya Pradesh,Crime Against Children,Child Abuse,Female,13-17,6334,1736,4598,2617,3717
2009,Urban,Himachal Pradesh,Crime Against Children,Trafficking,Male,18-30,2027,1436,591,1694,333
2009,Rural,Gujarat,Other Crimes,Drug Offense,Female,60+,9963,859,9104,7690,2273
2004,Urban,Manipur,Crime Against Men,Assault,Male,60+,6938,3877,3061,5906,1032
2005,Urban,Bihar,Crime Against Women,Domestic Violence,Male,46-60,9988,7536,2452,8954,1034
2003,Urban,Tripura,Other Crimes,Fraud,Male,13-17,1308,508,800,1222,86
2003,Rural,Tamil Nadu,Crime Against Children,Child Abuse,Male,13-17,2434,2175,259,2311,123
2009,Urban,Karnataka,Crime Against Men,Robbery,Female,13-17,2491,2301,190,2444,47
2004,Urban,Mizoram,Crime Against Women,Dowry Deaths,Female,31-45,5806,1850,3956,4648,1158
2003,Urban,Karnataka,Other Crimes,Corruption,Female,18-30,8701,1101,7600,8083,618
2005,Rural,Uttar Pradesh,Crime Against Men,Assault,Male,46-60,2001,1697,304,1763,238
2001,Urban,Punjab,Other Crimes,Fraud,Female,46-60,1244,72,1172,529,715
2009,Rural,Haryana,Crime Against Women,Dowry Deaths,Male,13-17,5593,2994,2599,4848,745
2010,Urban,Manipur,Crime Against Children,Child Labor,Male,0-12,613,191,422,452,161
2008,Rural,Uttarakhand,Crime Against Children,Kidnapping,Male,0-12,1999,534,1465,682,1317
2007,Urban,Uttarakhand,Crime Against Men,Murder,Female,18-30,9703,7538,2165,7942,1761
2002,Urban,Gujarat,Crime Against Children,Child Labor,Female,0-12,3430,1679,1751,2176,1254
2003,Rural,Manipur,Crime Against Children,Trafficking,Female,31-45,7906,5255,2651,6334,1572
2005,Rural,Punjab,Crime Against Men,Extortion,Male,18-30,7361,4132,3229,5374,1987
2002,Rural,Uttarakhand,Other Crimes,Drug Offense,Female,0-12,6487,882,5605,5074,1413
2005,Urban,Kerala,Property Crime,Burglary,Female,0-12,6500,3791,2709,5216,1284
2007,Rural,Assam,Crime Against Men,Robbery,Male,60+,240,218,22,239,1
2006,Urban,Andhra Pradesh,Property Crime,Vandalism,Female,18-30,1233,893,340,932,301
2002,Rural,Haryana,Crime Against Children,Kidnapping,Male,13-17,8099,7756,343,8016,83
2004,Rural,Gujarat,Crime Against Women,Dowry Deaths,Male,0-12,5878,5052,826,5316,562
2004,Rural,Andhra Pradesh,Property Crime,Burglary,Male,46-60,1198,355,843,1169,29
2010,Rural,Andhra Pradesh,Crime Against Men,Extortion,Female,60+,2945,1411,1534,2615,330
2009,Urban,Karnataka,Other Crimes,Fraud,Male,0-12,105,0,105,41,64
2009,Urban,Nagaland,Crime Against Men,Extortion,Male,31-45,5709,5091,618,5303,406
2002,Rural,Meghalaya,Crime Against Children,Kidnapping,Male,13-17,9240,8455,785,9131,109
2005,Urban,Haryana,Property Crime,Arson,Female,13-17,408,160,248,216,192
2004,Rural,Assam,Other Crimes,Drug Offense,Female,60+,5297,4693,604,4903,394
2010,Urban,Haryana,Property Crime,Theft,Male,60+,8800,350,8450,1335,7465
2010,Rural,Goa,Crime Against Children,Kidnapping,Female,46-60,7861,142,7719,1360,6501
2006,Rural,Telangana,Property Crime,Theft,Male,0-12,1113,462,651,838,275
2006,Urban,Assam,Crime Against Children,Child Labor,Male,31-45,2580,1693,887,2349,231
2004,Urban,Haryana,Property Crime,Theft,Male,18-30,3722,3665,57,3669,53
2007,Urban,Telangana,Crime Against Women,Domestic Violence,Male,13-17,4490,1615,2875,4092,398
2008,Urban,Jammu & Kashmir,Crime Against Women,Dowry Deaths,Female,31-45,1593,1490,103,1546,47
2007,Urban,Kerala,Crime Against Men,Assault,Female,46-60,4079,1724,2355,1899,2180
2010,Rural,Gujarat,Crime Against Men,Murder,Female,31-45,8296,4613,3683,6925,1371
2007,Rural,Odisha,Crime Against Children,Kidnapping,Female,0-12,483,410,73,447,36
2002,Urban,Goa,Crime Against Men,Extortion,Male,0-12,225,139,86,149,76
2006,Rural,Delhi,Other Crimes,Cyber Crime,Female,0-12,9092,1427,7665,8298,794
2001,Urban,Madhya Pradesh,Other Crimes,Corruption,Female,18-30,7628,4247,3381,4694,2934
2004,Urban,Delhi,Crime Against Women,Dowry Deaths,Female,60+,5991,2786,3205,3819,2172
2006,Urban,Assam,Other Crimes,Drug Offense,Male,18-30,4481,187,4294,644,3837
2001,Rural,Andhra Pradesh,Crime Against Men,Assault,Female,18-30,8331,6657,1674,7636,695
2004,Rural,Sikkim,Crime Against Men,Extortion,Female,0-12,3838,1577,2261,1963,1875
2009,Rural,Haryana,Crime Against Men,Murder,Male,18-30,4081,2329,1752,3584,497
2009,Rural,Punjab,Crime Against Children,Child Labor,Male,60+,7685,5079,2606,6527,1158
2010,Urban,Arunachal Pradesh,Other Crimes,Corruption,Male,0-12,3177,920,2257,3146,31
2003,Rural,Tamil Nadu,Other Crimes,Corruption,Male,13-17,6865,4943,1922,5708,1157
2009,Rural,Telangana,Crime Against Children,Child Labor,Female,13-17,6130,3277,2853,3826,2304
2010,Urban,Andhra Pradesh,Other Crimes,Cyber Crime,Male,31-45,8303,6537,1766,7903,400
2002,Urban,Jharkhand,Other Crimes,Drug Offense,Male,46-60,7258,4669,2589,5592,1666
2006,Rural,Madhya Pradesh,Crime Against Women,Domestic Violence,Male,0-12,7978,4870,3108,6684,1294
2009,Urban,Chhattisgarh,Crime Against Children,Child Labor,Female,31-45,3806,3470,336,3774,32
2005,Rural,Uttarakhand,Crime Against Women,Dowry Deaths,Male,18-30,4758,4230,528,4648,110
2003,Urban,Haryana,Crime Against Women,Molestation,Male,31-45,9137,9,9128,4051,5086
2005,Urban,Bihar,Crime Against Men,Extortion,Female,18-30,6803,1690,5113,5088,1715
2002,Urban,Uttar Pradesh,Crime Against Men,Extortion,Female,13-17,9478,1220,8258,8532,946
2003,Rural,Kerala,Crime Against Women,Domestic Violence,Male,46-60,1532,14,1518,723,809
2003,Rural,West Bengal,Property Crime,Vandalism,Female,46-60,6692,3751,2941,6162,530
2004,Urban,Sikkim,Crime Against Children,Kidnapping,Female,18-30,5625,1467,4158,2714,2911
2007,Urban,Kerala,Other Crimes,Corruption,Female,13-17,6260,6189,71,6210,50
2008,Urban,Chhattisgarh,Crime Against Men,Murder,Male,60+,899,435,464,459,440
2002,Urban,Madhya Pradesh,Other Crimes,Fraud,Male,60+,104,102,2,102,2
2008,Rural,Manipur,Crime Against Women,Rape,Female,0-12,138,125,13,136,2
2002,Rural,Himachal Pradesh,Property Crime,Burglary,Female,0-12,145,30,115,87,58
2009,Rural,Assam,Other Crimes,Cyber Crime,Female,46-60,446,372,74,423,23
2009,Urban,Jharkhand,Other Crimes,Corruption,Male,31-45,2396,1592,804,1883,513
2001,Rural,Uttar Pradesh,Crime Against Women,Molestation,Male,46-60,8972,7283,1689,7567,1405
2010,Urban,Odisha,Property Crime,Arson,Female,46-60,5660,1694,3966,3477,2183
2006,Urban,Punjab,Crime Against Women,Rape,Male,18-30,8737,4483,4254,8062,675
2009,Rural,Rajasthan,Crime Against Women,Rape,Female,0-12,7193,5759,1434,7033,160
2008,Urban,Chhattisgarh,Crime Against Men,Assault,Female,46-60,1585,1205,380,1531,54
2010,Rural,Madhya Pradesh,Other Crimes,Corruption,Female,60+,8304,7845,459,7883,421
2005,Urban,Tamil Nadu,Crime Against Women,Molestation,Male,31-45,7590,2209,5381,3857,3733
2003,Rural,Nagaland,Crime Against Children,Child Labor,Male,13-17,6404,5223,1181,6166,238
2007,Urban,Nagaland,Crime Against Children,Child Abuse,Male,46-60,6627,1495,5132,6006,621
2001,Rural,Telangana,Crime Against Children,Child Abuse,Male,0-12,7374,2069,5305,3901,3473
2009,Rural,Manipur,Crime Against Children,Child Abuse,Female,18-30,6451,230,6221,4038,2413
2001,Rural,Assam,Crime Against Children,Trafficking,Female,60+,6757,1444,5313,5156,1601
2008,Urban,Andhra Pradesh,Crime Against Women,Dowry Deaths,Male,60+,7435,6511,924,7201,234
2007,Urban,Mizoram,Property Crime,Arson,Female,13-17,5183,4920,263,5026,157
2009,Rural,Himachal Pradesh,Crime Against Children,Kidnapping,Female,60+,2015,1218,797,1831,184
2002,Urban,Jharkhand,Crime Against Women,Dowry Deaths,Female,46-60,5214,1163,4051,4149,1065
2008,Urban,Karnataka,Crime Against Children,Kidnapping,Female,0-12,9761,8750,1011,9060,701
2002,Urban,Chhattisgarh,Property Crime,Theft,Female,0-12,5119,581,4538,2627,2492
2007,Urban,Arunachal Pradesh,Property Crime,Burglary,Female,46-60,3155,3137,18,3155,0
2003,Urban,Jharkhand,Property Crime,Theft,Male,18-30,4632,638,3994,1083,3549
2009,Urban,Haryana,Crime Against Children,Child Labor,Male,13-17,6573,3519,3054,5643,930
2009,Urban,Tamil Nadu,Crime Against Children,Kidnapping,Male,13-17,9758,9725,33,9745,13
2008,Urban,Manipur,Crime Against Women,Domestic Violence,Female,46-60,9808,4331,5477,4813,4995
2004,Urban,Kerala,Crime Against Children,Trafficking,Female,18-30,5609,3191,2418,4619,990
2005,Urban,Manipur,Crime Against Children,Kidnapping,Male,31-45,7414,839,6575,2681,4733
2002,Urban,Odisha,Other Crimes,Corruption,Male,60+,9244,6767,2477,8610,634
2006,Urban,Delhi,Property Crime,Theft,Female,46-60,3308,1050,2258,2329,979
2005,Rural,Sikkim,Crime Against Women,Rape,Female,13-17,345,297,48,332,13
2010,Rural,West Bengal,Crime Against Children,Child Labor,Female,13-17,6967,6821,146,6892,75
2006,Urban,Himachal Pradesh,Crime Against Men,Assault,Male,18-30,3145,466,2679,1473,1672
2004,Rural,Meghalaya,Property Crime,Vandalism,Male,0-12,2175,964,1211,1648,527
2010,Rural,Telangana,Property Crime,Vandalism,Female,18-30,8235,5073,3162,7491,744
2007,Rural,Telangana,Crime Against Women,Dowry Deaths,Male,18-30,1492,1318,174,1363,129
2004,Rural,Odisha,Other Crimes,Fraud,Male,18-30,6958,1919,5039,6577,381
2004,Urban,Maharashtra,Crime Against Women,Molestation,Male,46-60,9736,76,9660,8098,1638
2006,Urban,Jammu & Kashmir,Crime Against Children,Child Labor,Male,31-45,2212,331,1881,990,1222
2005,Rural,Sikkim,Crime Against Children,Trafficking,Female,13-17,6931,3561,3370,5184,1747
2004,Urban,Himachal Pradesh,Property Crime,Burglary,Female,46-60,5112,1405,3707,2377,2735
2010,Urban,Maharashtra,Other Crimes,Cyber Crime,Male,13-17,2956,127,2829,1625,1331
2001,Rural,Manipur,Other Crimes,Corruption,Male,60+,7089,4,7085,6736,353
2006,Rural,Gujarat,Other Crimes,Cyber Crime,Male,13-17,3235,1623,1612,2122,1113
2010,Rural,Rajasthan,Property Crime,Arson,Female,60+,3861,1537,2324,3186,675
2010,Urban,Sikkim,Crime Against Men,Assault,Female,60+,7376,6274,1102,6392,984
2008,Urban,Jharkhand,Property Crime,Burglary,Male,18-30,1415,580,835,946,469
2003,Rural,Telangana,Crime Against Men,Murder,Male,46-60,7607,5226,2381,6029,1578
2008,Rural,Meghalaya,Property Crime,Arson,Male,31-45,8546,3277,5269,7729,817
2010,Rural,Arunachal Pradesh,Other Crimes,Cyber Crime,Male,46-60,6401,6293,108,6396,5
2008,Rural,Tamil Nadu,Crime Against Women,Dowry Deaths,Female,18-30,3175,527,2648,1147,2028
2001,Rural,Delhi,Crime Against Men,Assault,Female,18-30,4617,1531,3086,4219,398
2009,Urban,Jharkhand,Crime Against Children,Child Labor,Female,46-60,6097,3550,2547,5053,1044
2002,Urban,Tamil Nadu,Crime Against Women,Domestic Violence,Female,18-30,1699,1218,481,1284,415
2006,Urban,Meghalaya,Crime Against Women,Domestic Violence,Female,46-60,3064,1556,1508,1743,1321
2001,Rural,Uttarakhand,Crime Against Men,Assault,Female,60+,7630,7626,4,7628,2
2002,Urban,Uttar Pradesh,Crime Against Men,Murder,Male,18-30,1633,1253,380,1566,67
2007,Urban,Telangana,Crime Against Children,Child Labor,Male,13-17,9909,8774,1135,8910,999
2001,Rural,Tripura,Other Crimes,Fraud,Female,13-17,7271,2079,5192,5309,1962
2002,Rural,Tamil Nadu,Other Crimes,Drug Offense,Male,60+,1058,612,446,640,418
2008,Rural,Chhattisgarh,Crime Against Children,Child Abuse,Female,46-60,8729,689,8040,1270,7459
2008,Urban,Karnataka,Crime Against Women,Dowry Deaths,Female,60+,9557,8468,1089,8475,1082
2002,Rural,Telangana,Crime Against Women,Rape,Female,31-45,5266,2799,2467,3737,1529
2007,Rural,Assam,Property Crime,Arson,Male,0-12,7932,4324,3608,4421,3511
2009,Rural,Uttarakhand,Crime Against Women,Domestic Violence,Male,13-17,2257,1401,856,1409,848
2007,Urban,Punjab,Crime Against Men,Robbery,Female,13-17,9957,4252,5705,4327,5630
2003,Rural,Madhya Pradesh,Crime Against Children,Child Labor,Male,0-12,3632,1528,2104,3122,510
2010,Urban,Rajasthan,Other Crimes,Drug Offense,Female,18-30,1935,890,1045,935,1000
2007,Rural,Uttar Pradesh,Property Crime,Burglary,Male,0-12,4788,3629,1159,3745,1043
2010,Urban,Karnataka,Crime Against Women,Rape,Male,18-30,4913,4035,878,4454,459
2002,Urban,Punjab,Crime Against Men,Assault,Female,13-17,4137,1441,2696,2512,1625
2006,Rural,Tamil Nadu,Other Crimes,Corruption,Male,13-17,3391,297,3094,1469,1922
2003,Rural,Jammu & Kashmir,Crime Against Children,Trafficking,Female,31-45,9598,3014,6584,3195,6403
2007,Urban,Mizoram,Crime Against Children,Kidnapping,Male,31-45,5682,1354,4328,2905,2777
2008,Urban,Rajasthan,Crime Against Women,Dowry Deaths,Female,46-60,1271,1035,236,1259,12
2004,Urban,Jharkhand,Crime Against Women,Rape,Male,46-60,914,337,577,800,114
2009,Rural,Andhra Pradesh,Crime Against Children,Child Labor,Female,31-45,7055,3295,3760,4201,2854
2006,Rural,Meghalaya,Crime Against Women,Dowry Deaths,Male,60+,9131,6803,2328,9028,103
2010,Rural,Meghalaya,Crime Against Children,Kidnapping,Male,46-60,8891,7452,1439,8198,693
2007,Urban,Assam,Crime Against Children,Child Abuse,Female,0-12,9870,2762,7108,3891,5979
2010,Rural,West Bengal,Other Crimes,Cyber Crime,Female,18-30,7461,2264,5197,5253,2208
2008,Rural,Manipur,Crime Against Men,Robbery,Male,18-30,3341,1805,1536,2695,646
2001,Rural,Gujarat,Crime Against Men,Robbery,Female,18-30,521,501,20,516,5
2006,Rural,Tripura,Property Crime,Vandalism,Female,60+,3965,2627,1338,3741,224
2010,Urban,Maharashtra,Other Crimes,Drug Offense,Female,46-60,3815,2672,1143,3686,129
2010,Rural,Madhya Pradesh,Other Crimes,Fraud,Female,46-60,5802,347,5455,5737,65
2001,Urban,Goa,Crime Against Women,Rape,Female,46-60,6931,5552,1379,6479,452
2004,Urban,Bihar,Other Crimes,Fraud,Male,0-12,473,96,377,289,184
2004,Rural,Delhi,Property Crime,Arson,Female,0-12,7851,642,7209,6583,1268
2007,Urban,Madhya Pradesh,Property Crime,Burglary,Female,0-12,8894,4398,4496,4753,4141
2009,Urban,Assam,Crime Against Women,Molestation,Male,0-12,5512,2078,3434,2306,3206
2001,Rural,Jharkhand,Crime Against Men,Extortion,Female,13-17,6308,1691,4617,4344,1964
2005,Urban,Punjab,Crime Against Children,Child Abuse,Female,0-12,941,866,75,925,16
2010,Urban,Madhya Pradesh,Crime Against Women,Molestation,Male,31-45,7521,6338,1183,7144,377
2006,Rural,Karnataka,Property Crime,Arson,Male,31-45,6007,3661,2346,4976,1031
2005,Rural,Manipur,Crime Against Women,Molestation,Female,60+,9931,1730,8201,2986,6945
2003,Rural,Gujarat,Crime Against Women,Dowry Deaths,Male,18-30,8898,2985,5913,6622,2276
2003,Rural,Kerala,Crime Against Children,Kidnapping,Female,0-12,6849,4233,2616,6796,53
2002,Rural,Karnataka,Other Crimes,Cyber Crime,Male,0-12,2997,2497,500,2753,244
2008,Rural,Uttar Pradesh,Crime Against Children,Kidnapping,Female,13-17,6710,1648,5062,2044,4666
2004,Urban,Goa,Crime Against Children,Kidnapping,Male,13-17,476,197,279,448,28
2004,Rural,Punjab,Other Crimes,Corruption,Female,18-30,5966,1045,4921,2038,3928
2001,Urban,Manipur,Property Crime,Burglary,Female,13-17,9868,7681,2187,8167,1701
2002,Urban,West Bengal,Crime Against Women,Domestic Violence,Male,18-30,1529,1421,108,1426,103
2009,Rural,Sikkim,Crime Against Men,Extortion,Male,0-12,636,297,339,409,227
2006,Urban,Punjab,Crime Against Men,Extortion,Male,18-30,5174,3913,1261,4959,215
2008,Rural,Uttarakhand,Property Crime,Theft,Female,60+,4116,2023,2093,2876,1240
2009,Urban,Kerala,Property Crime,Theft,Male,46-60,8303,2012,6291,5444,2859
2002,Rural,Jammu & Kashmir,Crime Against Men,Robbery,Female,18-30,2957,1650,1307,2301,656
2008,Urban,Maharashtra,Property Crime,Arson,Female,46-60,4661,1621,3040,1765,2896
2002,Rural,Mizoram,Other Crimes,Corruption,Male,60+,7771,3248,4523,6907,864
2006,Urban,Tripura,Property Crime,Vandalism,Female,31-45,9387,8112,1275,8919,468
2010,Rural,Karnataka,Other Crimes,Cyber Crime,Male,31-45,655,554,101,561,94
2001,Rural,Odisha,Crime Against Women,Molestation,Female,0-12,7864,3360,4504,6179,1685
2002,Rural,Tamil Nadu,Crime Against Children,Trafficking,Male,18-30,8890,570,8320,4393,4497
2003,Urban,Rajasthan,Crime Against Men,Murder,Male,18-30,1213,81,1132,868,345
2002,Rural,Sikkim,Crime Against Women,Dowry Deaths,Female,13-17,7492,4039,3453,7441,51
2007,Rural,Tripura,Property Crime,Arson,Male,31-45,5979,5135,844,5547,432
2001,Rural,Uttarakhand,Crime Against Men,Murder,Female,46-60,6434,731,5703,2985,3449
2010,Urban,Meghalaya,Other Crimes,Drug Offense,Female,18-30,2179,1681,498,1917,262
2002,Urban,Sikkim,Crime Against Women,Molestation,Male,0-12,6462,4969,1493,5397,1065
2002,Rural,Himachal Pradesh,Property Crime,Burglary,Male,13-17,3841,1290,2551,2593,1248
2010,Urban,Goa,Crime Against Women,Domestic Violence,Male,13-17,3204,1603,1601,2853,351
2009,Rural,Manipur,Property Crime,Vandalism,Male,0-12,2133,1459,674,1616,517
2007,Rural,Tamil Nadu,Crime Against Men,Assault,Male,46-60,8203,6675,1528,7089,1114
2003,Rural,West Bengal,Crime Against Men,Assault,Female,60+,1286,732,554,1240,46
2009,Urban,Jammu & Kashmir,Other Crimes,Corruption,Female,0-12,9380,3551,5829,7690,1690
2005,Rural,Tamil Nadu,Crime Against Men,Robbery,Male,31-45,8743,2637,6106,4906,3837
2004,Urban,Assam,Crime Against Children,Child Labor,Male,31-45,3580,886,2694,2486,1094
2010,Rural,Manipur,Crime Against Women,Molestation,Male,0-12,5508,2706,2802,4454,1054
2009,Rural,Chhattisgarh,Crime Against Men,Assault,Male,31-45,9180,8073,1107,9113,67
2002,Rural,Uttar Pradesh,Other Crimes,Drug Offense,Female,60+,1563,1500,63,1549,14
2005,Rural,West Bengal,Crime Against Women,Dowry Deaths,Female,0-12,1410,478,932,1226,184
2001,Rural,Punjab,Crime Against Women,Rape,Male,46-60,7750,1502,6248,7532,218
2009,Urban,Telangana,Crime Against Children,Trafficking,Female,0-12,7415,4786,2629,7070,345
2007,Rural,Maharashtra,Crime Against Children,Child Abuse,Female,46-60,7980,7456,524,7825,155
2009,Rural,Uttarakhand,Crime Against Women,Domestic Violence,Male,18-30,3512,576,2936,1226,2286
2001,Urban,Delhi,Crime Against Men,Assault,Male,18-30,2305,936,1369,1713,592
2008,Rural,Chhattisgarh,Crime Against Men,Murder,Male,0-12,7593,4345,3248,4988,2605
2007,Rural,Mizoram,Other Crimes,Cyber Crime,Female,46-60,5269,4827,442,5061,208
2002,Rural,Bihar,Crime Against Men,Extortion,Male,46-60,9099,1455,7644,7381,1718
2002,Urban,Kerala,Property Crime,Vandalism,Male,0-12,156,38,118,38,118
2007,Urban,Madhya Pradesh,Property Crime,Arson,Female,18-30,2895,793,2102,2253,642
2002,Rural,Nagaland,Crime Against Men,Assault,Male,13-17,7544,3689,3855,7116,428
2006,Rural,Punjab,Crime Against Women,Rape,Male,46-60,7440,4884,2556,5879,1561
2005,Urban,Uttar Pradesh,Crime Against Men,Extortion,Male,18-30,7604,5612,1992,6211,1393
2009,Urban,Karnataka,Other Crimes,Cyber Crime,Female,31-45,6804,1471,5333,6134,670
2001,Rural,Uttar Pradesh,Property Crime,Burglary,Female,0-12,4053,558,3495,1011,3042
2003,Urban,Arunachal Pradesh,Crime Against Children,Child Labor,Male,13-17,6288,5793,495,6225,63
2004,Rural,Jammu & Kashmir,Other Crimes,Fraud,Female,31-45,1916,1167,749,1482,434
2005,Urban,Chhattisgarh,Other Crimes,Corruption,Male,13-17,4411,2720,1691,3423,988
2001,Rural,Andhra Pradesh,Crime Against Men,Assault,Male,60+,7544,5104,2440,5185,2359
2004,Rural,Jharkhand,Other Crimes,Drug Offense,Male,60+,8298,5062,3236,5420,2878
2001,Urban,Goa,Crime Against Children,Child Abuse,Male,31-45,3295,2198,1097,2803,492
2002,Urban,Rajasthan,Property Crime,Vandalism,Female,0-12,5026,4170,856,4430,596
2007,Rural,Goa,Other Crimes,Drug Offense,Male,31-45,3968,3470,498,3783,185
2006,Urban,Haryana,Crime Against Men,Murder,Male,46-60,4686,2952,1734,4327,359
2009,Rural,Bihar,Property Crime,Arson,Female,60+,2887,2528,359,2759,128
2008,Rural,Gujarat,Crime Against Men,Assault,Female,13-17,9254,6422,2832,6504,2750
2009,Rural,Manipur,Crime Against Women,Rape,Female,60+,9847,6205,3642,6230,3617
2008,Rural,Goa,Crime Against Children,Child Abuse,Male,31-45,8509,8199,310,8293,216
2009,Rural,Assam,Crime Against Children,Child Abuse,Female,13-17,152,26,126,111,41
2001,Rural,Chhattisgarh,Crime Against Children,Trafficking,Female,31-45,5313,3216,2097,4216,1097
2008,Urban,Punjab,Crime Against Men,Robbery,Female,31-45,9020,4699,4321,5587,3433
2005,Urban,Jharkhand,Other Crimes,Fraud,Female,60+,2304,1588,716,1768,536
2004,Rural,Jammu & Kashmir,Crime Against Children,Child Abuse,Male,31-45,4396,1061,3335,3019,1377
2002,Rural,West Bengal,Crime Against Women,Molestation,Male,31-45,9494,1230,8264,7852,1642
2001,Urban,Goa,Crime Against Children,Kidnapping,Male,0-12,6736,5707,1029,6599,137
2001,Rural,Odisha,Property Crime,Arson,Female,0-12,1985,794,1191,1668,317
2009,Rural,Tamil Nadu,Crime Against Children,Kidnapping,Male,46-60,3723,12,3711,977,2746
2009,Rural,Kerala,Crime Against Children,Child Labor,Female,46-60,8149,6617,1532,6913,1236
2004,Rural,Telangana,Other Crimes,Corruption,Male,31-45,9178,7684,1494,8382,796
2006,Urban,Jharkhand,Crime Against Children,Child Abuse,Female,0-12,277,107,170,276,1
2009,Urban,Sikkim,Crime Against Men,Murder,Male,60+,8559,8541,18,8542,17
2004,Urban,Sikkim,Property Crime,Vandalism,Female,46-60,8937,7444,1493,7850,1087
2003,Rural,Gujarat,Crime Against Women,Rape,Male,0-12,392,6,386,362,30
2002,Urban,Maharashtra,Crime Against Children,Trafficking,Female,31-45,6785,4159,2626,5508,1277
2009,Rural,Karnataka,Other Crimes,Corruption,Male,18-30,305,271,34,273,32
2007,Urban,Meghalaya,Other Crimes,Cyber Crime,Male,0-12,5224,2755,2469,4526,698
2008,Rural,Punjab,Property Crime,Arson,Male,13-17,2280,1516,764,1580,700
2010,Urban,Arunachal Pradesh,Crime Against Men,Murder,Female,13-17,635,534,101,584,51
2007,Urban,Andhra Pradesh,Crime Against Women,Molestation,Male,13-17,2666,1747,919,2284,382
2010,Rural,Nagaland,Crime Against Men,Robbery,Female,18-30,9002,5221,3781,8543,459
2004,Rural,Uttarakhand,Property Crime,Arson,Male,18-30,3274,141,3133,2048,1226
2010,Rural,Maharashtra,Other Crimes,Fraud,Male,18-30,1975,1525,450,1834,141
2009,Rural,Karnataka,Crime Against Children,Kidnapping,Male,60+,2472,1789,683,2029,443
2001,Urban,Odisha,Crime Against Children,Child Abuse,Female,31-45,7122,1116,6006,1470,5652
2003,Urban,Andhra Pradesh,Crime Against Men,Murder,Female,60+,5934,1870,4064,4049,1885
2003,Urban,Goa,Other Crimes,Cyber Crime,Male,18-30,8001,2850,5151,7940,61
2005,Rural,Sikkim,Crime Against Men,Assault,Male,0-12,3377,1172,2205,1479,1898
2005,Urban,Rajasthan,Crime Against Women,Rape,Male,18-30,8206,6421,1785,7020,1186
2004,Urban,Maharashtra,Other Crimes,Cyber Crime,Male,18-30,7516,1341,6175,5282,2234
2002,Urban,Arunachal Pradesh,Crime Against Children,Child Labor,Female,46-60,2043,66,1977,1576,467
2004,Rural,Andhra Pradesh,Crime Against Children,Kidnapping,Male,13-17,4961,2534,2427,2653,2308
2010,Rural,Punjab,Crime Against Children,Trafficking,Female,31-45,743,239,504,546,197
2001,Rural,Tamil Nadu,Crime Against Men,Robbery,Male,13-17,1589,726,863,806,783
2005,Urban,Manipur,Crime Against Children,Trafficking,Female,18-30,9983,2359,7624,8782,1201
2003,Rural,Sikkim,Crime Against Women,Rape,Female,60+,3623,177,3446,1636,1987
2007,Rural,Manipur,Crime Against Men,Robbery,Male,18-30,7064,3484,3580,4589,2475
2006,Urban,Telangana,Crime Against Men,Extortion,Female,18-30,4432,3059,1373,3449,983
2010,Rural,Mizoram,Crime Against Children,Child Abuse,Female,18-30,693,679,14,691,2
2009,Urban,Assam,Property Crime,Burglary,Male,18-30,6896,1449,5447,2555,4341
2003,Urban,Chhattisgarh,Other Crimes,Fraud,Male,31-45,1640,1600,40,1625,15
2010,Urban,Chhattisgarh,Other Crimes,Drug Offense,Female,60+,4169,3641,528,3998,171
2006,Urban,Jammu & Kashmir,Property Crime,Arson,Male,31-45,634,361,273,414,220
2001,Urban,Arunachal Pradesh,Property Crime,Arson,Male,13-17,1033,56,977,541,492
2006,Urban,Odisha,Crime Against Children,Child Labor,Female,18-30,2406,1531,875,1582,824
2003,Urban,Uttarakhand,Crime Against Women,Domestic Violence,Female,60+,9036,6171,2865,6688,2348
2009,Urban,Himachal Pradesh,Crime Against Men,Robbery,Male,46-60,9042,880,8162,7679,1363
2003,Urban,Punjab,Property Crime,Theft,Female,31-45,4978,4329,649,4384,594
2010,Rural,Andhra Pradesh,Crime Against Women,Domestic Violence,Female,18-30,2190,2052,138,2106,84
2003,Urban,Nagaland,Crime Against Women,Dowry Deaths,Female,18-30,905,137,768,320,585
2008,Rural,Telangana,Crime Against Women,Dowry Deaths,Male,46-60,1464,942,522,1314,150
2007,Rural,Himachal Pradesh,Crime Against Children,Kidnapping,Male,31-45,993,883,110,940,53
2001,Rural,Gujarat,Other Crimes,Fraud,Male,46-60,3617,2475,1142,3382,235
2008,Urban,Rajasthan,Crime Against Children,Child Labor,Male,31-45,9833,1246,8587,6174,3659
2001,Rural,Jharkhand,Crime Against Children,Trafficking,Female,13-17,1290,406,884,1093,197
2004,Urban,Maharashtra,Crime Against Women,Rape,Male,0-12,8536,2546,5990,7005,1531
2001,Rural,Haryana,Crime Against Children,Kidnapping,Male,31-45,3081,977,2104,3071,10
2001,Rural,Tripura,Crime Against Children,Kidnapping,Female,13-17,4814,4718,96,4779,35
2007,Urban,West Bengal,Crime Against Women,Rape,Female,60+,7653,4820,2833,5414,2239
2006,Urban,Assam,Crime Against Children,Child Labor,Female,31-45,2027,1612,415,1664,363
2010,Urban,Nagaland,Crime Against Women,Molestation,Female,13-17,4132,3777,355,3787,345
2009,Urban,Goa,Property Crime,Arson,Female,18-30,1941,1389,552,1753,188
2009,Urban,Manipur,Crime Against Children,Kidnapping,Male,13-17,4989,2277,2712,4750,239
2010,Rural,Rajasthan,Crime Against Children,Trafficking,Female,31-45,221,189,32,202,19
2005,Urban,Manipur,Property Crime,Vandalism,Male,18-30,9714,4821,4893,8136,1578
2006,Rural,Tamil Nadu,Crime Against Men,Extortion,Male,60+,7285,4653,2632,6586,699
2006,Urban,Tripura,Crime Against Men,Assault,Male,60+,9035,8159,876,8396,639
2008,Rural,Chhattisgarh,Crime Against Children,Child Labor,Male,0-12,820,35,785,352,468
2007,Urban,Mizoram,Crime Against Women,Rape,Male,0-12,6664,1346,5318,5226,1438
2008,Rural,Chhattisgarh,Crime Against Women,Molestation,Male,0-12,5381,1454,3927,5218,163
2008,Rural,Uttarakhand,Other Crimes,Corruption,Female,60+,4692,1298,3394,2969,1723
2003,Urban,Delhi,Crime Against Children,Child Labor,Male,31-45,3551,1846,1705,2211,1340
2001,Urban,Andhra Pradesh,Property Crime,Arson,Male,0-12,4056,814,3242,2125,1931
2008,Urban,Rajasthan,Property Crime,Arson,Female,31-45,3576,3264,312,3371,205
2009,Urban,Goa,Property Crime,Vandalism,Female,31-45,6017,3664,2353,4057,1960
2004,Urban,Uttarakhand,Crime Against Children,Child Abuse,Male,46-60,4237,1277,2960,3649,588
2007,Urban,Nagaland,Property Crime,Theft,Female,0-12,2486,3,2483,1671,815
2003,Urban,Punjab,Property Crime,Burglary,Male,13-17,7464,4309,3155,7150,314
2006,Rural,Uttarakhand,Crime Against Children,Child Abuse,Male,13-17,6101,1017,5084,2326,3775
2004,Urban,Haryana,Other Crimes,Drug Offense,Male,18-30,2409,422,1987,1227,1182
2010,Urban,Punjab,Other Crimes,Fraud,Male,31-45,178,73,105,98,80
2009,Urban,Delhi,Crime Against Men,Extortion,Female,13-17,8724,7683,1041,8067,657
2009,Urban,Maharashtra,Crime Against Men,Murder,Male,46-60,4898,3599,1299,4025,873
2005,Urban,Himachal Pradesh,Property Crime,Vandalism,Male,60+,2124,1545,579,1577,547
2009,Urban,Andhra Pradesh,Crime Against Children,Child Labor,Female,13-17,3280,3118,162,3129,151
2004,Urban,Tripura,Crime Against Children,Trafficking,Male,31-45,1993,1754,239,1941,52
2010,Urban,Delhi,Crime Against Children,Child Abuse,Female,18-30,8184,4099,4085,6200,1984
2001,Urban,Uttar Pradesh,Property Crime,Vandalism,Male,60+,5956,5377,579,5537,419
2010,Urban,Punjab,Crime Against Children,Child Labor,Male,31-45,5329,3009,2320,4123,1206
2010,Urban,Uttar Pradesh,Property Crime,Vandalism,Female,31-45,1222,440,782,490,732
2001,Rural,Chhattisgarh,Crime Against Children,Child Labor,Female,13-17,4823,1430,3393,1905,2918
2005,Urban,Nagaland,Crime Against Children,Child Abuse,Female,60+,6958,5848,1110,6673,285
2005,Rural,Assam,Other Crimes,Corruption,Male,18-30,6666,1721,4945,4714,1952
2007,Rural,Maharashtra,Property Crime,Arson,Male,46-60,229,67,162,156,73
2009,Rural,Gujarat,Other Crimes,Corruption,Male,18-30,8340,8103,237,8103,237
2001,Rural,Uttarakhand,Crime Against Men,Robbery,Male,60+,5627,2768,2859,5483,144
2004,Rural,Uttarakhand,Other Crimes,Fraud,Female,60+,3939,1213,2726,1758,2181
2004,Urban,Rajasthan,Property Crime,Arson,Male,31-45,9632,8341,1291,8908,724
2009,Rural,Karnataka,Property Crime,Theft,Female,31-45,3744,2509,1235,3364,380
2004,Rural,Odisha,Property Crime,Burglary,Male,46-60,7954,5236,2718,5276,2678
2006,Rural,Delhi,Crime Against Children,Child Abuse,Male,46-60,486,262,224,291,195
2008,Rural,Madhya Pradesh,Crime Against Men,Robbery,Female,60+,5779,3951,1828,5336,443
2003,Rural,Maharashtra,Crime Against Children,Child Labor,Male,31-45,2519,1177,1342,2352,167
2008,Urban,West Bengal,Other Crimes,Drug Offense,Male,13-17,7340,3120,4220,5653,1687
2005,Rural,Odisha,Property Crime,Arson,Male,18-30,7161,6626,535,7047,114
2003,Urban,Tripura,Property Crime,Vandalism,Female,18-30,470,252,218,331,139
2005,Rural,Haryana,Crime Against Men,Assault,Female,60+,918,356,562,667,251
2005,Rural,Karnataka,Crime Against Men,Assault,Male,60+,184,139,45,170,14
2004,Urban,Gujarat,Crime Against Men,Extortion,Male,46-60,6949,423,6526,2809,4140
2005,Urban,Nagaland,Crime Against Women,Molestation,Male,18-30,1164,985,179,1044,120
2006,Rural,Mizoram,Property Crime,Arson,Male,31-45,8952,8501,451,8861,91
2008,Rural,Jammu & Kashmir,Crime Against Men,Murder,Male,18-30,5020,2887,2133,3501,1519
2003,Rural,Sikkim,Crime Against Men,Assault,Male,0-12,9451,3331,6120,7307,2144
2010,Rural,Andhra Pradesh,Crime Against Children,Trafficking,Female,18-30,9354,4246,5108,6251,3103
2004,Rural,Uttar Pradesh,Crime Against Women,Molestation,Male,46-60,8139,2490,5649,4968,3171
2004,Rural,Arunachal Pradesh,Other Crimes,Fraud,Male,60+,6718,5105,1613,6707,11
2007,Rural,Maharashtra,Crime Against Children,Trafficking,Female,18-30,8582,4009,4573,4297,4285
2005,Rural,West Bengal,Property Crime,Arson,Male,13-17,8555,4665,3890,7624,931
2006,Rural,Rajasthan,Other Crimes,Fraud,Male,46-60,9199,8653,546,8823,376
2010,Rural,Nagaland,Crime Against Children,Child Labor,Female,13-17,3247,557,2690,1665,1582
2003,Urban,Tamil Nadu,Property Crime,Burglary,Male,18-30,2124,1853,271,2077,47
2006,Urban,West Bengal,Crime Against Men,Extortion,Male,60+,1968,1104,864,1507,461
2007,Rural,Mizoram,Other Crimes,Fraud,Male,18-30,911,850,61,884,27
2001,Rural,Sikkim,Crime Against Women,Dowry Deaths,Female,31-45,1470,1317,153,1453,17
2006,Rural,Nagaland,Crime Against Men,Assault,Female,18-30,1924,484,1440,1036,888
2009,Rural,Telangana,Other Crimes,Fraud,Female,0-12,9544,6513,3031,8863,681
2003,Rural,Gujarat,Property Crime,Arson,Female,0-12,4639,1002,3637,1359,3280
2008,Rural,Uttarakhand,Property Crime,Arson,Female,0-12,5615,2707,2908,4011,1604
2004,Urban,Bihar,Crime Against Women,Domestic Violence,Female,31-45,1128,1004,124,1022,106
2001,Urban,Kerala,Property Crime,Arson,Male,18-30,7721,6089,1632,6802,919
2008,Urban,Arunachal Pradesh,Crime Against Men,Robbery,Male,18-30,3384,1914,1470,3045,339
2009,Rural,Sikkim,Crime Against Women,Molestation,Female,60+,3831,2193,1638,2342,1489
2009,Urban,Haryana,Crime Against Women,Molestation,Male,18-30,2462,1031,1431,1292,1170
2003,Urban,Madhya Pradesh,Crime Against Women,Domestic Violence,Male,0-12,5925,2614,3311,3584,2341
2006,Urban,Gujarat,Crime Against Women,Dowry Deaths,Male,13-17,7748,4179,3569,7016,732
2004,Rural,Rajasthan,Crime Against Men,Assault,Male,18-30,384,121,263,219,165
2004,Urban,Karnataka,Crime Against Men,Murder,Male,46-60,1132,759,373,860,272
2006,Rural,Manipur,Crime Against Men,Robbery,Male,60+,9076,1960,7116,4867,4209
2009,Rural,Delhi,Crime Against Women,Rape,Female,60+,3038,92,2946,2891,147
2009,Rural,Manipur,Crime Against Children,Trafficking,Female,18-30,9561,1413,8148,3429,6132
2005,Urban,Rajasthan,Crime Against Women,Rape,Female,46-60,7047,4599,2448,6136,911
2010,Urban,Assam,Crime Against Children,Kidnapping,Male,18-30,4304,1219,3085,1405,2899
2004,Rural,Tamil Nadu,Other Crimes,Cyber Crime,Male,60+,5324,343,4981,4328,996
2002,Rural,Assam,Other Crimes,Fraud,Male,0-12,1630,1163,467,1460,170
2006,Urban,Telangana,Crime Against Women,Domestic Violence,Male,18-30,8907,7693,1214,8431,476
2006,Rural,Uttar Pradesh,Crime Against Women,Molestation,Female,46-60,459,258,201,333,126
2010,Rural,Kerala,Crime Against Women,Dowry Deaths,Male,46-60,6968,1576,5392,4237,2731
2010,Urban,Chhattisgarh,Crime Against Men,Murder,Male,31-45,4997,4602,395,4703,294
2005,Urban,Gujarat,Property Crime,Arson,Female,31-45,5047,2401,2646,4023,1024
2009,Rural,Rajasthan,Property Crime,Vandalism,Male,46-60,2170,172,1998,1291,879
2003,Urban,West Bengal,Crime Against Children,Child Abuse,Female,18-30,2373,439,1934,1699,674
2005,Rural,West Bengal,Property Crime,Burglary,Female,60+,1550,540,1010,733,817
2010,Urban,Gujarat,Property Crime,Vandalism,Male,0-12,3719,839,2880,1906,1813
2010,Rural,Jammu & Kashmir,Other Crimes,Cyber Crime,Male,60+,8437,2435,6002,4089,4348
2003,Rural,Assam,Property Crime,Arson,Male,60+,7599,512,7087,3351,4248
2005,Rural,West Bengal,Crime Against Men,Robbery,Male,31-45,669,25,644,356,313
2006,Urban,Telangana,Crime Against Children,Child Abuse,Female,46-60,9076,47,9029,7168,1908
2006,Rural,Delhi,Property Crime,Burglary,Male,13-17,9759,1364,8395,1558,8201
2004,Rural,Goa,Crime Against Children,Kidnapping,Male,31-45,7853,2384,5469,3101,4752
2006,Urban,Chhattisgarh,Crime Against Women,Molestation,Female,13-17,2783,1226,1557,1581,1202
2003,Urban,Sikkim,Property Crime,Theft,Male,31-45,488,466,22,472,16
2010,Rural,Andhra Pradesh,Property Crime,Vandalism,Male,13-17,8122,7651,471,7927,195
2006,Rural,Madhya Pradesh,Property Crime,Vandalism,Female,0-12,7790,5707,2083,6914,876
2005,Rural,Jammu & Kashmir,Crime Against Children,Trafficking,Male,13-17,7979,791,7188,900,7079
2001,Rural,Madhya Pradesh,Crime Against Children,Trafficking,Female,60+,1877,1184,693,1693,184
2008,Urban,Punjab,Property Crime,Theft,Male,60+,2269,47,2222,1541,728
2008,Urban,Gujarat,Property Crime,Arson,Female,13-17,3419,2005,1414,3277,142
2009,Urban,Karnataka,Crime Against Children,Child Abuse,Female,18-30,1748,733,1015,998,750
2001,Urban,Uttar Pradesh,Crime Against Children,Trafficking,Male,46-60,7978,3796,4182,6311,1667
2001,Rural,Uttarakhand,Crime Against Women,Rape,Male,18-30,3464,3230,234,3246,218
2003,Rural,Bihar,Other Crimes,Cyber Crime,Male,31-45,8667,1485,7182,2801,5866
2004,Rural,Himachal Pradesh,Crime Against Women,Dowry Deaths,Female,60+,9718,4046,5672,4166,5552
2007,Urban,Rajasthan,Other Crimes,Cyber Crime,Male,18-30,4674,2887,1787,3834,840
2003,Rural,Rajasthan,Crime Against Men,Assault,Male,31-45,6274,730,5544,2324,3950
2004,Urban,Madhya Pradesh,Crime Against Women,Molestation,Female,13-17,3120,2880,240,3038,82
2003,Urban,Jammu & Kashmir,Property Crime,Theft,Male,60+,5824,3914,1910,5089,735
2010,Urban,Sikkim,Property Crime,Arson,Male,46-60,651,531,120,622,29
2009,Rural,Karnataka,Other Crimes,Cyber Crime,Female,31-45,9909,2946,6963,3510,6399
2010,Rural,Karnataka,Crime Against Men,Assault,Male,0-12,8092,4304,3788,6948,1144
2005,Urban,Sikkim,Other Crimes,Corruption,Male,60+,206,9,197,28,178
2003,Rural,Tripura,Crime Against Men,Assault,Male,0-12,3128,2622,506,2868,260
2002,Urban,Haryana,Crime Against Women,Molestation,Female,60+,2418,456,1962,1153,1265
2005,Rural,Odisha,Crime Against Men,Assault,Female,13-17,1643,1056,587,1360,283
2002,Rural,Meghalaya,Crime Against Men,Robbery,Male,0-12,9767,9422,345,9492,275
2007,Rural,Rajasthan,Crime Against Men,Extortion,Male,13-17,5271,3311,1960,3421,1850
2008,Rural,Andhra Pradesh,Crime Against Women,Molestation,Female,0-12,3376,2846,530,3202,174
2003,Urban,Haryana,Property Crime,Burglary,Male,31-45,6739,1836,4903,3427,3312
2008,Urban,Jharkhand,Crime Against Women,Rape,Female,46-60,2926,1689,1237,1776,1150
2006,Urban,Uttar Pradesh,Property Crime,Vandalism,Male,18-30,4832,2390,2442,4164,668
2010,Rural,Sikkim,Property Crime,Arson,Male,60+,4361,4268,93,4273,88
2005,Urban,Sikkim,Property Crime,Arson,Male,13-17,2743,1046,1697,1503,1240
2003,Urban,Odisha,Other Crimes,Drug Offense,Male,60+,3559,928,2631,2333,1226
2005,Urban,Telangana,Crime Against Men,Murder,Female,13-17,3593,2818,775,3578,15
2001,Urban,Meghalaya,Other Crimes,Corruption,Male,18-30,1126,303,823,475,651
2001,Rural,Goa,Crime Against Women,Domestic Violence,Female,46-60,7878,6719,1159,7230,648
2008,Rural,West Bengal,Crime Against Children,Trafficking,Female,31-45,2700,1302,1398,1850,850
2005,Rural,Goa,Crime Against Women,Dowry Deaths,Female,60+,6089,4327,1762,4686,1403
2003,Urban,Madhya Pradesh,Other Crimes,Drug Offense,Male,18-30,4906,3769,1137,4470,436
2002,Urban,Gujarat,Crime Against Men,Assault,Female,13-17,2057,1438,619,1712,345
2005,Rural,Madhya Pradesh,Crime Against Men,Robbery,Male,46-60,7201,1140,6061,4700,2501
2003,Urban,Tamil Nadu,Crime Against Men,Assault,Female,18-30,2966,2731,235,2843,123
2001,Urban,Bihar,Crime Against Women,Dowry Deaths,Female,31-45,8908,2702,6206,2709,6199
2009,Urban,Jammu & Kashmir,Property Crime,Burglary,Male,18-30,3475,944,2531,3369,106
2010,Rural,Tripura,Crime Against Women,Dowry Deaths,Female,0-12,9719,9579,140,9715,4
2003,Urban,Arunachal Pradesh,Property Crime,Theft,Female,46-60,1192,643,549,1183,9
2010,Urban,Arunachal Pradesh,Crime Against Men,Murder,Male,46-60,3557,3557,0,3557,0
2008,Urban,Chhattisgarh,Property Crime,Theft,Male,0-12,4496,211,4285,234,4262
2005,Urban,West Bengal,Crime Against Men,Robbery,Male,13-17,6829,6131,698,6457,372
2006,Urban,Delhi,Crime Against Men,Extortion,Female,18-30,4700,3807,893,4313,387
2008,Urban,Delhi,Property Crime,Theft,Male,13-17,2003,918,1085,1590,413
2003,Rural,Arunachal Pradesh,Crime Against Women,Rape,Female,0-12,3324,2865,459,2896,428
2008,Rural,Assam,Crime Against Children,Trafficking,Male,31-45,4818,4228,590,4467,351
2005,Urban,Haryana,Crime Against Children,Child Abuse,Female,60+,4149,884,3265,3499,650
2002,Urban,Arunachal Pradesh,Property Crime,Arson,Male,60+,379,6,373,194,185
2010,Rural,Odisha,Other Crimes,Fraud,Female,60+,969,120,849,251,718
2010,Urban,Andhra Pradesh,Crime Against Men,Assault,Male,31-45,1238,1037,201,1055,183
2007,Urban,Nagaland,Other Crimes,Cyber Crime,Male,60+,5799,1648,4151,5443,356
2002,Urban,Kerala,Crime Against Women,Molestation,Female,13-17,6005,2586,3419,4286,1719
2007,Rural,Karnataka,Other Crimes,Cyber Crime,Male,0-12,977,196,781,855,122
2005,Rural,Haryana,Crime Against Men,Murder,Female,46-60,3986,716,3270,1228,2758
2008,Rural,Andhra Pradesh,Property Crime,Theft,Male,13-17,1516,407,1109,1467,49
2009,Urban,Bihar,Crime Against Women,Molestation,Female,0-12,6572,1849,4723,6021,551
2003,Rural,Telangana,Property Crime,Burglary,Male,18-30,862,669,193,702,160
2004,Urban,Himachal Pradesh,Crime Against Men,Assault,Female,18-30,4871,2381,2490,2645,2226
2008,Urban,Meghalaya,Other Crimes,Fraud,Male,60+,8314,2479,5835,5741,2573
2007,Rural,Goa,Property Crime,Vandalism,Male,60+,5049,3981,1068,4775,274
2002,Urban,Chhattisgarh,Other Crimes,Drug Offense,Male,60+,1581,824,757,1270,311
2001,Urban,Tripura,Crime Against Children,Child Abuse,Female,18-30,1107,881,226,1073,34
2010,Urban,Jharkhand,Crime Against Children,Child Abuse,Male,0-12,2463,1377,1086,2414,49
2005,Urban,West Bengal,Crime Against Children,Kidnapping,Male,31-45,2598,1655,943,1660,938
2002,Urban,Arunachal Pradesh,Other Crimes,Fraud,Female,18-30,5625,2292,3333,4008,1617
2004,Rural,Jammu & Kashmir,Property Crime,Theft,Male,0-12,8862,7559,1303,7756,1106
2007,Rural,Himachal Pradesh,Crime Against Women,Rape,Male,13-17,802,213,589,569,233
2002,Urban,Tamil Nadu,Crime Against Children,Child Abuse,Female,46-60,1398,749,649,1140,258
2002,Urban,Punjab,Crime Against Men,Extortion,Male,31-45,467,10,457,319,148
2003,Rural,Sikkim,Crime Against Children,Trafficking,Male,60+,6568,3426,3142,5905,663
2010,Urban,Haryana,Crime Against Women,Rape,Female,18-30,9862,176,9686,5727,4135
2004,Urban,Madhya Pradesh,Crime Against Men,Assault,Female,46-60,797,406,391,757,40
2006,Urban,Punjab,Property Crime,Theft,Male,60+,6645,816,5829,5466,1179
2008,Urban,Madhya Pradesh,Crime Against Men,Extortion,Male,18-30,437,349,88,421,16
2004,Rural,Madhya Pradesh,Other Crimes,Corruption,Female,18-30,445,288,157,408,37
2006,Rural,Madhya Pradesh,Crime Against Children,Child Abuse,Male,60+,3906,1702,2204,3287,619
2009,Rural,Madhya Pradesh,Crime Against Men,Robbery,Male,18-30,4252,2639,1613,3873,379
2002,Urban,Uttar Pradesh,Property Crime,Arson,Female,0-12,4726,3614,1112,4510,216
2004,Rural,Rajasthan,Crime Against Men,Robbery,Male,60+,9472,5642,3830,5689,3783
2009,Urban,Gujarat,Crime Against Children,Child Labor,Male,46-60,1525,601,924,947,578
2004,Urban,Rajasthan,Crime Against Men,Extortion,Female,60+,826,333,493,577,249
2003,Urban,Bihar,Other Crimes,Fraud,Female,13-17,7763,3761,4002,6632,1131
2010,Rural,Jammu & Kashmir,Crime Against Children,Kidnapping,Female,13-17,2729,633,2096,2687,42
2004,Urban,Uttarakhand,Crime Against Men,Extortion,Male,46-60,8854,7919,935,8260,594
2002,Urban,Uttarakhand,Other Crimes,Cyber Crime,Female,0-12,8733,6730,2003,8627,106
2005,Urban,Assam,Crime Against Men,Robbery,Female,13-17,7707,4627,3080,7670,37
2008,Rural,Tamil Nadu,Crime Against Women,Domestic Violence,Male,31-45,129,28,101,41,88
2010,Rural,Manipur,Crime Against Women,Dowry Deaths,Male,0-12,9219,7450,1769,8082,1137
2009,Rural,West Bengal,Other Crimes,Cyber Crime,Female,18-30,2511,964,1547,991,1520
2009,Urban,Kerala,Property Crime,Burglary,Female,13-17,2193,904,1289,1682,511
2008,Rural,Karnataka,Crime Against Men,Murder,Male,46-60,4170,3507,663,4156,14
2004,Rural,Bihar,Crime Against Men,Murder,Female,46-60,4792,4066,726,4503,289
2005,Urban,Maharashtra,Crime Against Children,Child Labor,Female,60+,3362,1832,1530,2590,772
2001,Rural,Goa,Crime Against Children,Child Labor,Male,18-30,3167,1254,1913,1356,1811
2006,Urban,Odisha,Other Crimes,Drug Offense,Male,0-12,7599,567,7032,5197,2402
2009,Rural,Himachal Pradesh,Crime Against Children,Child Abuse,Male,31-45,1901,1242,659,1645,256
2005,Urban,Arunachal Pradesh,Crime Against Men,Extortion,Male,18-30,4736,607,4129,2062,2674
2001,Urban,Delhi,Property Crime,Arson,Female,13-17,2227,1714,513,1879,348
2007,Rural,Himachal Pradesh,Crime Against Children,Child Labor,Male,31-45,365,95,270,102,263
2002,Rural,Uttar Pradesh,Crime Against Men,Extortion,Female,13-17,4943,2530,2413,4369,574
2001,Urban,Telangana,Other Crimes,Fraud,Male,31-45,965,179,786,468,497
2003,Rural,Tamil Nadu,Crime Against Men,Murder,Female,46-60,440,141,299,263,177
2001,Urban,Madhya Pradesh,Other Crimes,Fraud,Male,0-12,3268,2702,566,2949,319
2002,Urban,Haryana,Property Crime,Arson,Male,13-17,2013,1714,299,1841,172
2003,Urban,Madhya Pradesh,Property Crime,Burglary,Female,0-12,58,43,15,58,0
2001,Rural,Gujarat,Property Crime,Theft,Female,60+,1935,1210,725,1248,687
2009,Urban,Tripura,Crime Against Men,Robbery,Female,0-12,388,235,153,325,63
2006,Urban,Assam,Crime Against Men,Extortion,Male,0-12,3304,1346,1958,3000,304
2003,Rural,Nagaland,Crime Against Men,Assault,Male,60+,1159,52,1107,219,940
2001,Urban,Haryana,Crime Against Men,Murder,Male,60+,1497,84,1413,228,1269
2006,Urban,Rajasthan,Crime Against Women,Rape,Male,31-45,4256,2636,1620,4126,130
2002,Urban,Uttar Pradesh,Property Crime,Burglary,Female,60+,729,629,100,665,64
2005,Urban,Kerala,Property Crime,Vandalism,Male,31-45,2390,2329,61,2380,10
2004,Rural,Bihar,Crime Against Men,Robbery,Female,13-17,4430,4358,72,4396,34
2009,Rural,Odisha,Property Crime,Arson,Male,31-45,6077,1320,4757,5005,1072
2008,Rural,Gujarat,Crime Against Women,Rape,Female,31-45,5994,4694,1300,5325,669
2009,Rural,Nagaland,Other Crimes,Corruption,Female,0-12,3439,232,3207,3397,42
2001,Rural,Karnataka,Other Crimes,Fraud,Female,18-30,5283,225,5058,3535,1748
2002,Urban,Kerala,Crime Against Women,Domestic Violence,Female,46-60,4934,1934,3000,3891,1043
2008,Urban,Jammu & Kashmir,Other Crimes,Fraud,Male,18-30,6897,4624,2273,4927,1970
2005,Urban,Tamil Nadu,Crime Against Men,Robbery,Male,18-30,1200,432,768,1030,170
2010,Rural,Maharashtra,Other Crimes,Drug Offense,Female,18-30,2150,830,1320,1281,869
2008,Urban,Assam,Property Crime,Vandalism,Female,18-30,4580,3401,1179,3601,979
2008,Urban,Uttarakhand,Crime Against Women,Dowry Deaths,Male,46-60,4599,699,3900,1574,3025
2004,Urban,Maharashtra,Crime Against Women,Molestation,Male,13-17,782,102,680,162,620
2009,Rural,Uttarakhand,Crime Against Children,Trafficking,Male,60+,5111,4758,353,5104,7
2010,Urban,Arunachal Pradesh,Crime Against Women,Domestic Violence,Male,46-60,6534,823,5711,3646,2888
2008,Urban,Uttar Pradesh,Crime Against Women,Domestic Violence,Male,60+,1666,1526,140,1566,100
2010,Urban,Assam,Crime Against Children,Kidnapping,Male,13-17,1631,1576,55,1595,36
2004,Rural,Tripura,Crime Against Women,Rape,Female,46-60,6930,2352,4578,3420,3510
2010,Urban,Madhya Pradesh,Crime Against Men,Assault,Male,0-12,5987,2029,3958,3261,2726
2008,Rural,Manipur,Crime Against Men,Extortion,Male,46-60,9767,6310,3457,8074,1693
2008,Rural,Manipur,Crime Against Children,Trafficking,Female,0-12,5521,1780,3741,3660,1861
2009,Urban,Delhi,Crime Against Children,Kidnapping,Female,13-17,4275,2721,1554,3015,1260
2004,Urban,Himachal Pradesh,Crime Against Women,Rape,Male,46-60,6373,4259,2114,5000,1373
2007,Rural,Sikkim,Property Crime,Theft,Female,18-30,214,162,52,177,37
2007,Urban,Odisha,Other Crimes,Fraud,Female,18-30,3759,3710,49,3741,18
2003,Urban,Tamil Nadu,Property Crime,Arson,Female,46-60,2384,2075,309,2347,37
2003,Rural,Haryana,Crime Against Women,Molestation,Male,60+,4473,4235,238,4399,74
2001,Rural,Telangana,Crime Against Women,Molestation,Female,18-30,7733,2640,5093,5130,2603
2010,Urban,Manipur,Crime Against Children,Kidnapping,Female,60+,4165,1719,2446,1853,2312
2009,Rural,Sikkim,Other Crimes,Cyber Crime,Male,46-60,5337,5060,277,5111,226
2004,Rural,Uttarakhand,Crime Against Children,Trafficking,Female,0-12,4903,656,4247,1944,2959
2010,Rural,Nagaland,Crime Against Men,Murder,Male,46-60,7990,2346,5644,5460,2530
2002,Rural,Rajasthan,Crime Against Men,Assault,Male,0-12,6952,1482,5470,5488,1464
2008,Rural,Nagaland,Crime Against Men,Extortion,Female,60+,8329,2725,5604,7933,396
2007,Rural,Odisha,Other Crimes,Drug Offense,Female,31-45,4980,3942,1038,4752,228
2001,Urban,Andhra Pradesh,Crime Against Women,Rape,Male,31-45,8290,2739,5551,5792,2498
2010,Rural,Assam,Crime Against Women,Dowry Deaths,Male,46-60,7656,4557,3099,7283,373
2008,Urban,Sikkim,Crime Against Men,Assault,Male,46-60,1862,443,1419,1171,691
2002,Urban,Nagaland,Crime Against Children,Trafficking,Male,13-17,8698,2529,6169,7226,1472
2006,Rural,Chhattisgarh,Property Crime,Arson,Female,60+,9101,7281,1820,8133,968
2004,Urban,Jammu & Kashmir,Crime Against Children,Trafficking,Female,13-17,3330,498,2832,847,2483
2005,Rural,Goa,Crime Against Children,Child Abuse,Female,46-60,8422,2372,6050,8192,230
2005,Rural,Rajasthan,Crime Against Men,Murder,Male,13-17,7267,2121,5146,3964,3303
2009,Urban,Uttar Pradesh,Other Crimes,Drug Offense,Male,46-60,8282,6342,1940,7316,966
2008,Urban,Andhra Pradesh,Crime Against Men,Robbery,Male,60+,1367,1076,291,1344,23
2009,Urban,Goa,Crime Against Women,Dowry Deaths,Female,13-17,4053,2118,1935,2717,1336
2001,Urban,Delhi,Property Crime,Burglary,Male,13-17,4695,3639,1056,4048,647
2007,Urban,Andhra Pradesh,Crime Against Children,Trafficking,Female,18-30,9933,4844,5089,8997,936
2001,Rural,Uttarakhand,Crime Against Women,Dowry Deaths,Female,0-12,3872,2315,1557,3441,431
2007,Urban,Telangana,Other Crimes,Corruption,Female,18-30,6276,5860,416,5977,299
2003,Rural,Tripura,Other Crimes,Drug Offense,Female,0-12,7822,5609,2213,5796,2026
2009,Rural,Arunachal Pradesh,Property Crime,Theft,Male,0-12,1971,595,1376,1388,583
2007,Rural,Jharkhand,Property Crime,Burglary,Male,0-12,9555,6675,2880,9230,325
2005,Urban,Jammu & Kashmir,Crime Against Women,Domestic Violence,Male,60+,1815,950,865,1350,465
2004,Rural,Assam,Other Crimes,Cyber Crime,Male,60+,3020,1026,1994,2278,742
2004,Rural,Meghalaya,Crime Against Men,Assault,Female,31-45,649,191,458,640,9
2003,Urban,Kerala,Crime Against Men,Extortion,Male,13-17,3249,818,2431,2347,902
2007,Urban,Kerala,Crime Against Men,Robbery,Female,0-12,9463,9357,106,9410,53
2006,Urban,Gujarat,Crime Against Women,Rape,Female,18-30,3332,1947,1385,2892,440
2010,Urban,Uttar Pradesh,Crime Against Women,Dowry Deaths,Male,0-12,1272,1212,60,1222,50
2005,Rural,Himachal Pradesh,Crime Against Men,Robbery,Female,60+,2345,646,1699,842,1503
2006,Rural,Jammu & Kashmir,Other Crimes,Cyber Crime,Female,18-30,9362,8183,1179,9123,239
2004,Urban,West Bengal,Property Crime,Theft,Male,0-12,2067,400,1667,501,1566
2009,Rural,Madhya Pradesh,Crime Against Women,Domestic Violence,Female,46-60,1080,309,771,959,121
2007,Rural,Goa,Crime Against Children,Child Abuse,Male,0-12,3299,1926,1373,3097,202
2004,Rural,Sikkim,Crime Against Men,Assault,Female,31-45,4927,2910,2017,4216,711
2008,Rural,Uttar Pradesh,Crime Against Women,Rape,Female,18-30,6595,3002,3593,4844,1751
2002,Rural,Tamil Nadu,Property Crime,Arson,Male,46-60,3098,1823,1275,3068,30
2001,Urban,Tripura,Property Crime,Arson,Male,31-45,8493,3122,5371,3623,4870
2001,Urban,Assam,Crime Against Women,Rape,Female,31-45,1677,130,1547,1040,637
2007,Rural,Chhattisgarh,Property Crime,Burglary,Male,18-30,3448,1627,1821,2305,1143
2010,Urban,Himachal Pradesh,Crime Against Children,Child Abuse,Male,0-12,357,119,238,171,186
2007,Rural,Nagaland,Crime Against Children,Kidnapping,Male,0-12,7780,5274,2506,5469,2311
2006,Urban,Jammu & Kashmir,Crime Against Women,Dowry Deaths,Female,31-45,3795,2226,1569,2382,1413
2006,Urban,Chhattisgarh,Property Crime,Arson,Female,46-60,3603,576,3027,2262,1341
2001,Rural,Kerala,Other Crimes,Fraud,Male,60+,8645,789,7856,6347,2298
2009,Rural,Gujarat,Crime Against Men,Assault,Male,0-12,4281,3712,569,3863,418
2006,Urban,Jammu & Kashmir,Crime Against Men,Assault,Female,13-17,5299,1824,3475,4959,340
2005,Rural,Haryana,Other Crimes,Cyber Crime,Male,13-17,5122,3935,1187,4045,1077
2006,Rural,Meghalaya,Crime Against Women,Molestation,Female,31-45,2027,731,1296,1428,599
2006,Urban,Jharkhand,Crime Against Women,Domestic Violence,Male,0-12,4645,2451,2194,3550,1095
2004,Rural,Himachal Pradesh,Crime Against Men,Robbery,Female,18-30,4985,1612,3373,4109,876
2004,Urban,Gujarat,Crime Against Children,Child Labor,Male,0-12,6946,1101,5845,3416,3530
2009,Rural,Mizoram,Crime Against Women,Domestic Violence,Female,13-17,1842,1377,465,1506,336
2003,Rural,Karnataka,Other Crimes,Corruption,Male,0-12,7523,6681,842,7110,413
2008,Urban,Jammu & Kashmir,Crime Against Children,Kidnapping,Female,18-30,5962,5280,682,5480,482
2005,Rural,Andhra Pradesh,Other Crimes,Corruption,Female,46-60,8818,6405,2413,8026,792
2002,Urban,Mizoram,Property Crime,Arson,Male,31-45,5105,4848,257,5057,48
2005,Urban,Meghalaya,Property Crime,Vandalism,Female,31-45,8021,1368,6653,6674,1347
2007,Rural,Goa,Crime Against Children,Child Abuse,Female,31-45,4700,2035,2665,4615,85
2006,Rural,Uttarakhand,Crime Against Children,Child Labor,Male,18-30,355,239,116,269,86
2007,Rural,Madhya Pradesh,Crime Against Children,Kidnapping,Female,18-30,3213,575,2638,1896,1317
2002,Rural,Punjab,Property Crime,Burglary,Male,60+,3420,2309,1111,3093,327
2008,Rural,Madhya Pradesh,Crime Against Men,Extortion,Male,31-45,4577,1153,3424,1507,3070
2008,Urban,Madhya Pradesh,Other Crimes,Fraud,Male,13-17,1580,923,657,1469,111
2010,Urban,Sikkim,Crime Against Men,Robbery,Female,0-12,8453,8173,280,8411,42
2006,Urban,Maharashtra,Property Crime,Vandalism,Male,18-30,1592,237,1355,959,633
2010,Urban,Gujarat,Property Crime,Arson,Male,18-30,3170,2078,1092,2295,875
2001,Urban,Maharashtra,Other Crimes,Cyber Crime,Female,46-60,6095,3205,2890,5538,557
2010,Rural,Jammu & Kashmir,Crime Against Men,Extortion,Female,0-12,194,68,126,126,68
2007,Rural,Delhi,Crime Against Women,Domestic Violence,Male,60+,5547,3596,1951,4753,794
2001,Rural,Manipur,Crime Against Children,Trafficking,Male,46-60,4787,666,4121,2081,2706
2008,Rural,Odisha,Crime Against Men,Assault,Female,60+,1008,995,13,995,13
2003,Rural,Haryana,Crime Against Children,Child Abuse,Male,60+,9000,7150,1850,8917,83
2006,Urban,Uttarakhand,Crime Against Men,Murder,Female,18-30,9504,3325,6179,8819,685
2003,Urban,Chhattisgarh,Crime Against Women,Dowry Deaths,Female,46-60,2745,1275,1470,1961,784
2004,Urban,Andhra Pradesh,Property Crime,Theft,Female,60+,6857,4685,2172,6006,851
2003,Urban,Haryana,Crime Against Women,Rape,Male,46-60,1875,970,905,1709,166
2006,Rural,Maharashtra,Other Crimes,Corruption,Female,0-12,5687,3520,2167,4788,899
2003,Rural,Madhya Pradesh,Crime Against Men,Murder,Male,46-60,1226,525,701,730,496
2003,Rural,Meghalaya,Other Crimes,Corruption,Female,60+,5808,1191,4617,3164,2644
2006,Urban,Gujarat,Crime Against Men,Robbery,Female,60+,190,147,43,167,23
2009,Rural,Meghalaya,Crime Against Women,Molestation,Female,0-12,1368,723,645,1269,99
2009,Rural,Manipur,Crime Against Men,Extortion,Female,60+,2459,932,1527,1263,1196
2009,Urban,Assam,Crime Against Women,Molestation,Male,60+,355,25,330,171,184
2008,Urban,West Bengal,Crime Against Men,Extortion,Female,31-45,5074,440,4634,4286,788
2005,Urban,Arunachal Pradesh,Crime Against Women,Dowry Deaths,Male,46-60,3461,3210,251,3430,31
2008,Urban,Uttar Pradesh,Property Crime,Vandalism,Female,46-60,6190,567,5623,5748,442
2009,Urban,Chhattisgarh,Other Crimes,Cyber Crime,Female,0-12,7034,1993,5041,6023,1011
2009,Urban,Haryana,Other Crimes,Drug Offense,Male,0-12,2192,822,1370,1340,852
2008,Rural,Tripura,Crime Against Women,Dowry Deaths,Female,0-12,1990,1712,278,1888,102
2005,Urban,Goa,Property Crime,Burglary,Male,0-12,451,133,318,325,126
2007,Urban,Madhya Pradesh,Crime Against Children,Kidnapping,Male,31-45,9475,5589,3886,6849,2626
2009,Rural,Arunachal Pradesh,Crime Against Men,Murder,Female,60+,3916,2544,1372,3354,562
2007,Urban,Maharashtra,Crime Against Men,Extortion,Male,0-12,4817,4264,553,4580,237
2007,Rural,Gujarat,Crime Against Women,Rape,Female,46-60,9447,6978,2469,7693,1754
2010,Rural,Assam,Crime Against Children,Child Abuse,Male,13-17,1931,395,1536,1070,861
2007,Rural,Himachal Pradesh,Crime Against Children,Kidnapping,Male,31-45,6211,3318,2893,5282,929
2003,Rural,Haryana,Crime Against Women,Molestation,Female,60+,6987,1605,5382,6836,151
2001,Urban,Bihar,Crime Against Children,Kidnapping,Male,18-30,1041,386,655,834,207
2002,Urban,Himachal Pradesh,Property Crime,Burglary,Female,0-12,5268,2973,2295,4555,713
2006,Urban,Arunachal Pradesh,Crime Against Women,Molestation,Female,31-45,828,47,781,309,519
2010,Urban,Manipur,Other Crimes,Fraud,Male,13-17,8280,2342,5938,4514,3766
2010,Urban,Telangana,Crime Against Men,Murder,Male,31-45,8086,3345,4741,4327,3759
2006,Rural,Punjab,Crime Against Men,Robbery,Male,60+,9958,6146,3812,9821,137
2006,Rural,Goa,Crime Against Men,Robbery,Female,13-17,8052,441,7611,5592,2460
2001,Urban,Goa,Other Crimes,Fraud,Male,13-17,3909,130,3779,3263,646
2010,Rural,Rajasthan,Crime Against Women,Domestic Violence,Female,60+,7492,4965,2527,6043,1449
2001,Rural,Sikkim,Property Crime,Burglary,Female,31-45,7008,6909,99,6958,50
2005,Rural,Uttarakhand,Property Crime,Vandalism,Male,13-17,3297,466,2831,2574,723
2003,Urban,Haryana,Other Crimes,Cyber Crime,Male,0-12,3504,2827,677,3326,178
2004,Urban,Jharkhand,Crime Against Men,Murder,Male,0-12,9683,5150,4533,9267,416
2001,Urban,Punjab,Crime Against Women,Molestation,Male,0-12,938,354,584,934,4
2007,Urban,Odisha,Other Crimes,Drug Offense,Female,18-30,1179,929,250,932,247
2009,Rural,Kerala,Crime Against Men,Robbery,Male,0-12,6681,2821,3860,2909,3772
2002,Rural,Gujarat,Property Crime,Theft,Male,31-45,9512,1430,8082,1652,7860
2005,Rural,Punjab,Crime Against Men,Extortion,Male,46-60,7306,5621,1685,6280,1026
2007,Rural,Odisha,Property Crime,Theft,Female,0-12,3529,2597,932,2692,837
2005,Urban,Odisha,Crime Against Children,Trafficking,Male,31-45,9285,7064,2221,7257,2028
2004,Urban,Arunachal Pradesh,Crime Against Women,Molestation,Female,0-12,7301,4512,2789,6307,994
2006,Rural,Delhi,Other Crimes,Fraud,Female,0-12,5489,4826,663,4884,605
2005,Rural,Sikkim,Crime Against Men,Assault,Female,60+,9522,3601,5921,4309,5213
2008,Rural,Telangana,Crime Against Women,Molestation,Female,13-17,3778,1712,2066,3132,646
2010,Urban,West Bengal,Other Crimes,Fraud,Male,13-17,3056,1634,1422,1895,1161
2010,Rural,Karnataka,Property Crime,Theft,Male,31-45,4069,3942,127,4038,31
2008,Urban,Telangana,Crime Against Women,Molestation,Male,60+,6333,900,5433,5439,894
2008,Urban,Kerala,Crime Against Women,Dowry Deaths,Male,31-45,2027,1827,200,1856,171
2003,Urban,Assam,Crime Against Women,Domestic Violence,Male,46-60,3271,687,2584,2561,710
2002,Rural,Sikkim,Property Crime,Vandalism,Male,60+,4077,2791,1286,3309,768
2002,Rural,Nagaland,Crime Against Children,Kidnapping,Female,0-12,7162,315,6847,1613,5549
2007,Rural,Haryana,Property Crime,Burglary,Female,0-12,5169,1306,3863,1383,3786
2008,Urban,Tamil Nadu,Crime Against Children,Child Abuse,Female,13-17,7706,55,7651,2949,4757
2010,Urban,Assam,Crime Against Men,Robbery,Male,13-17,3539,1030,2509,2261,1278
2001,Urban,Haryana,Crime Against Men,Robbery,Female,13-17,7350,1962,5388,6584,766
2005,Urban,Assam,Property Crime,Arson,Male,31-45,3036,34,3002,1671,1365
2006,Rural,Rajasthan,Crime Against Children,Trafficking,Female,13-17,7956,394,7562,7835,121
2003,Urban,Rajasthan,Crime Against Men,Robbery,Female,0-12,488,13,475,103,385
2002,Rural,Karnataka,Property Crime,Arson,Male,18-30,3878,1488,2390,1673,2205
2009,Rural,Sikkim,Other Crimes,Drug Offense,Male,31-45,5534,4629,905,5229,305
2008,Rural,Uttarakhand,Property Crime,Theft,Male,13-17,7639,2739,4900,5068,2571
2002,Rural,Bihar,Crime Against Women,Rape,Male,46-60,7868,789,7079,3517,4351
2001,Urban,Mizoram,Crime Against Women,Rape,Female,60+,5348,381,4967,2529,2819
2007,Urban,Chhattisgarh,Crime Against Children,Trafficking,Male,13-17,5633,1926,3707,3797,1836
2010,Rural,Jharkhand,Crime Against Women,Domestic Violence,Male,13-17,5762,144,5618,3859,1903
2004,Urban,Haryana,Crime Against Children,Child Abuse,Male,31-45,1526,27,1499,543,983
2004,Rural,Odisha,Crime Against Men,Robbery,Male,60+,7492,6899,593,7109,383
2009,Urban,Tripura,Other Crimes,Fraud,Female,18-30,6984,4218,2766,5518,1466
2008,Rural,Punjab,Property Crime,Arson,Female,0-12,510,79,431,233,277
2010,Urban,Tamil Nadu,Crime Against Men,Robbery,Male,0-12,4599,1864,2735,3508,1091
2007,Rural,Madhya Pradesh,Other Crimes,Cyber Crime,Male,31-45,9960,9330,630,9656,304
2001,Rural,Haryana,Other Crimes,Cyber Crime,Female,13-17,7644,4036,3608,5553,2091
2010,Urban,Rajasthan,Crime Against Men,Extortion,Male,0-12,5516,1124,4392,3980,1536
2007,Urban,Himachal Pradesh,Crime Against Children,Child Abuse,Male,46-60,1784,346,1438,698,1086
2008,Urban,Rajasthan,Other Crimes,Drug Offense,Male,31-45,1900,531,1369,1354,546
2004,Urban,Chhattisgarh,Crime Against Men,Extortion,Male,0-12,571,83,488,228,343
2003,Urban,Mizoram,Crime Against Men,Murder,Male,60+,2871,2427,444,2848,23
2002,Urban,Tripura,Other Crimes,Fraud,Female,60+,5953,5279,674,5643,310
2008,Rural,Mizoram,Crime Against Women,Rape,Female,60+,931,769,162,884,47
2003,Urban,Haryana,Property Crime,Arson,Female,46-60,737,725,12,737,0
2002,Rural,Arunachal Pradesh,Property Crime,Burglary,Male,0-12,5781,1631,4150,4244,1537
2005,Urban,Haryana,Crime Against Women,Rape,Female,46-60,7832,4504,3328,5924,1908
2005,Rural,Punjab,Crime Against Men,Assault,Female,31-45,5013,4124,889,4685,328
2004,Urban,Maharashtra,Other Crimes,Corruption,Male,0-12,4656,3992,664,4085,571
2009,Urban,Arunachal Pradesh,Crime Against Men,Murder,Female,18-30,1246,147,1099,435,811
2008,Rural,Manipur,Other Crimes,Drug Offense,Male,0-12,5664,655,5009,4385,1279
2004,Rural,Sikkim,Crime Against Men,Robbery,Male,18-30,3818,1622,2196,3100,718
2007,Urban,Maharashtra,Other Crimes,Drug Offense,Female,13-17,6942,1876,5066,2943,3999
2010,Urban,West Bengal,Property Crime,Vandalism,Male,46-60,3434,151,3283,2524,910
2005,Rural,Jharkhand,Crime Against Women,Molestation,Female,18-30,9754,1144,8610,9047,707
2002,Urban,Madhya Pradesh,Crime Against Women,Domestic Violence,Female,13-17,6917,2742,4175,5841,1076
2007,Urban,Rajasthan,Property Crime,Theft,Female,18-30,9103,6444,2659,8812,291
2009,Urban,Uttarakhand,Crime Against Children,Child Abuse,Female,18-30,8848,5695,3153,6063,2785
2007,Urban,West Bengal,Crime Against Women,Molestation,Female,13-17,6724,812,5912,6000,724
2003,Urban,Haryana,Other Crimes,Cyber Crime,Male,18-30,4739,4717,22,4731,8
2001,Urban,Meghalaya,Crime Against Men,Assault,Male,0-12,447,163,284,314,133
2004,Rural,Kerala,Property Crime,Burglary,Male,18-30,6426,6387,39,6388,38
2001,Rural,Madhya Pradesh,Property Crime,Arson,Female,60+,9382,1795,7587,8858,524
2003,Rural,Gujarat,Property Crime,Theft,Female,13-17,2003,929,1074,1226,777
2010,Urban,Andhra Pradesh,Crime Against Women,Molestation,Male,13-17,7295,3093,4202,6047,1248
2005,Urban,Punjab,Crime Against Children,Child Abuse,Female,0-12,8024,6982,1042,6999,1025
2004,Urban,Odisha,Crime Against Children,Trafficking,Male,0-12,2338,2153,185,2295,43
2001,Rural,Uttarakhand,Other Crimes,Drug Offense,Female,13-17,7413,1317,6096,6139,1274
2006,Rural,Telangana,Property Crime,Burglary,Female,46-60,5050,4600,450,4627,423
2001,Rural,Madhya Pradesh,Crime Against Children,Child Abuse,Male,0-12,1052,528,524,546,506
2006,Urban,Assam,Crime Against Men,Murder,Male,46-60,9786,6205,3581,8587,1199
2008,Rural,Delhi,Property Crime,Vandalism,Female,0-12,7829,574,7255,5671,2158
2004,Rural,Himachal Pradesh,Other Crimes,Cyber Crime,Female,46-60,6977,1013,5964,3763,3214
2007,Rural,Chhattisgarh,Other Crimes,Corruption,Male,0-12,3815,1185,2630,2939,876
2004,Rural,Mizoram,Property Crime,Arson,Male,13-17,6417,4650,1767,4780,1637
2001,Rural,Haryana,Crime Against Women,Dowry Deaths,Male,60+,8178,1418,6760,3283,4895
2004,Rural,Nagaland,Other Crimes,Fraud,Male,13-17,4718,2051,2667,2897,1821
2007,Rural,West Bengal,Property Crime,Theft,Female,18-30,3955,1663,2292,2427,1528
2008,Urban,Tamil Nadu,Property Crime,Burglary,Male,60+,6834,6078,756,6746,88
2006,Urban,Jammu & Kashmir,Other Crimes,Fraud,Female,0-12,9339,1737,7602,5085,4254
2004,Rural,Chhattisgarh,Crime Against Children,Kidnapping,Male,60+,1152,402,750,470,682
2006,Urban,Uttarakhand,Property Crime,Vandalism,Male,13-17,5289,1199,4090,2188,3101
2003,Urban,Sikkim,Crime Against Women,Rape,Male,0-12,340,294,46,297,43
2004,Rural,Tripura,Other Crimes,Cyber Crime,Female,18-30,2756,2402,354,2626,130
2006,Urban,Tamil Nadu,Crime Against Men,Extortion,Female,60+,5853,2992,2861,5177,676
2007,Rural,Jharkhand,Property Crime,Theft,Female,60+,4514,2895,1619,3676,838
2009,Urban,West Bengal,Property Crime,Vandalism,Male,31-45,3784,2854,930,3134,650
2005,Rural,Telangana,Property Crime,Vandalism,Male,31-45,962,764,198,771,191
2007,Rural,Arunachal Pradesh,Crime Against Children,Child Abuse,Female,18-30,5749,1464,4285,3782,1967
2003,Rural,Sikkim,Crime Against Women,Domestic Violence,Female,31-45,8762,2842,5920,5208,3554
2005,Rural,Manipur,Property Crime,Arson,Male,60+,1664,188,1476,250,1414
2003,Rural,Punjab,Property Crime,Arson,Male,18-30,7186,120,7066,5746,1440
2003,Rural,Karnataka,Other Crimes,Cyber Crime,Female,0-12,9292,7205,2087,7495,1797
2007,Rural,Maharashtra,Property Crime,Burglary,Male,60+,3159,309,2850,842,2317
2008,Urban,Himachal Pradesh,Crime Against Men,Murder,Female,0-12,1011,235,776,502,509
2008,Urban,Mizoram,Crime Against Children,Child Abuse,Female,0-12,8912,5252,3660,7266,1646
2002,Rural,Tripura,Property Crime,Arson,Male,46-60,3688,3546,142,3611,77
2007,Rural,Odisha,Property Crime,Burglary,Male,46-60,8681,3915,4766,7855,826
2002,Rural,Assam,Crime Against Men,Murder,Male,31-45,6149,4804,1345,5729,420
2005,Rural,Manipur,Property Crime,Arson,Male,60+,7059,5786,1273,6245,814
2006,Urban,Chhattisgarh,Other Crimes,Corruption,Male,13-17,2654,2474,180,2532,122
2008,Urban,Telangana,Crime Against Men,Murder,Male,31-45,4647,3491,1156,4369,278
2003,Rural,Punjab,Crime Against Children,Trafficking,Male,60+,2927,165,2762,1493,1434
2005,Rural,Andhra Pradesh,Crime Against Men,Extortion,Female,46-60,4699,2030,2669,4683,16
2008,Rural,Delhi,Crime Against Children,Child Labor,Female,31-45,5000,2597,2403,4446,554
2008,Rural,Haryana,Other Crimes,Drug Offense,Female,60+,4282,218,4064,3472,810
2009,Rural,Nagaland,Crime Against Men,Assault,Male,46-60,9797,8511,1286,9599,198
2005,Urban,Andhra Pradesh,Crime Against Women,Dowry Deaths,Female,13-17,6405,1716,4689,4670,1735
2007,Urban,Karnataka,Crime Against Women,Dowry Deaths,Female,13-17,3227,836,2391,1344,1883
2002,Rural,Manipur,Other Crimes,Cyber Crime,Female,0-12,9124,752,8372,4669,4455
2004,Rural,Arunachal Pradesh,Crime Against Children,Child Labor,Male,60+,8436,369,8067,3337,5099
2009,Urban,Goa,Crime Against Women,Dowry Deaths,Male,46-60,8349,7868,481,7968,381
2005,Urban,Karnataka,Crime Against Women,Domestic Violence,Male,31-45,2777,2081,696,2154,623
2010,Urban,Kerala,Property Crime,Vandalism,Female,0-12,2516,1382,1134,1776,740
2001,Urban,Chhattisgarh,Crime Against Women,Dowry Deaths,Female,46-60,1126,934,192,1103,23
2006,Urban,Tamil Nadu,Crime Against Children,Trafficking,Male,46-60,1187,364,823,437,750
2002,Urban,Jammu & Kashmir,Crime Against Women,Rape,Male,46-60,9527,8691,836,9490,37
2001,Urban,Madhya Pradesh,Property Crime,Vandalism,Female,13-17,4593,2266,2327,3347,1246
2001,Urban,West Bengal,Crime Against Men,Robbery,Female,18-30,8321,6754,1567,7335,986
2005,Urban,Karnataka,Other Crimes,Cyber Crime,Male,31-45,9903,3815,6088,5601,4302
2002,Urban,Mizoram,Crime Against Men,Murder,Male,46-60,6629,3972,2657,3998,2631
2004,Urban,Sikkim,Crime Against Women,Rape,Male,46-60,3703,2194,1509,2340,1363
2002,Urban,Goa,Crime Against Men,Extortion,Male,31-45,5722,5209,513,5702,20
2010,Rural,Punjab,Crime Against Children,Child Labor,Female,31-45,585,571,14,581,4
2006,Rural,Sikkim,Crime Against Children,Child Abuse,Female,18-30,9765,8671,1094,9174,591
2002,Rural,Madhya Pradesh,Crime Against Children,Child Labor,Female,18-30,7552,6070,1482,7367,185
2007,Urban,Bihar,Crime Against Women,Rape,Male,0-12,2298,353,1945,394,1904
2010,Urban,Kerala,Property Crime,Vandalism,Male,18-30,3968,1129,2839,2232,1736
2003,Urban,Tripura,Crime Against Men,Murder,Female,0-12,5214,254,4960,1193,4021
2001,Rural,Uttar Pradesh,Crime Against Women,Dowry Deaths,Female,60+,4064,1476,2588,2991,1073
2003,Rural,Madhya Pradesh,Other Crimes,Corruption,Female,31-45,3517,3212,305,3387,130
2002,Urban,Andhra Pradesh,Other Crimes,Corruption,Male,0-12,5780,5219,561,5683,97
2001,Urban,Mizoram,Other Crimes,Cyber Crime,Male,46-60,1285,992,293,1257,28
2010,Rural,Odisha,Crime Against Children,Trafficking,Male,18-30,2515,802,1713,2000,515
2004,Urban,Tamil Nadu,Other Crimes,Corruption,Female,60+,5465,2569,2896,3392,2073
2002,Urban,Sikkim,Crime Against Men,Robbery,Male,31-45,4108,637,3471,3856,252
2006,Rural,Goa,Crime Against Women,Dowry Deaths,Male,31-45,1383,289,1094,309,1074
2003,Rural,Gujarat,Crime Against Women,Molestation,Female,46-60,5460,4903,557,5228,232
2001,Rural,Kerala,Other Crimes,Fraud,Female,31-45,1365,880,485,1173,192
2008,Urban,Delhi,Crime Against Men,Murder,Male,0-12,1248,1156,92,1186,62
2001,Urban,Jammu & Kashmir,Crime Against Women,Dowry Deaths,Male,0-12,9900,7533,2367,8436,1464
2010,Rural,Jharkhand,Other Crimes,Fraud,Male,18-30,8032,7128,904,7519,513
2001,Urban,Kerala,Crime Against Women,Rape,Female,0-12,3407,2563,844,3297,110
2001,Rural,Telangana,Other Crimes,Drug Offense,Female,31-45,305,215,90,271,34
2003,Rural,Meghalaya,Property Crime,Burglary,Male,46-60,2950,2604,346,2851,99
2001,Urban,Tripura,Crime Against Children,Child Abuse,Male,18-30,505,432,73,466,39
2005,Urban,Odisha,Property Crime,Vandalism,Female,18-30,8834,6691,2143,7026,1808
2007,Rural,Himachal Pradesh,Other Crimes,Corruption,Male,60+,4479,2822,1657,3391,1088
2010,Rural,Nagaland,Other Crimes,Cyber Crime,Female,18-30,8180,1780,6400,6864,1316
2002,Rural,West Bengal,Other Crimes,Cyber Crime,Male,0-12,7139,2155,4984,4154,2985
2005,Rural,Gujarat,Other Crimes,Corruption,Male,60+,1645,913,732,1073,572
2009,Urban,Jharkhand,Crime Against Children,Trafficking,Male,46-60,1544,303,1241,1309,235
2006,Rural,West Bengal,Crime Against Children,Child Labor,Female,31-45,7909,2235,5674,6744,1165
2008,Urban,Nagaland,Crime Against Men,Extortion,Male,46-60,1314,365,949,661,653
2002,Rural,Tamil Nadu,Property Crime,Arson,Female,46-60,7738,2132,5606,5837,1901
2001,Urban,Chhattisgarh,Crime Against Men,Assault,Male,31-45,6065,2959,3106,3619,2446
2009,Rural,Uttar Pradesh,Crime Against Women,Rape,Female,60+,3023,2548,475,2654,369
2002,Urban,Himachal Pradesh,Crime Against Women,Rape,Male,46-60,6961,4984,1977,4994,1967
2004,Rural,Mizoram,Crime Against Men,Murder,Male,18-30,2633,2619,14,2630,3
2009,Urban,Odisha,Property Crime,Theft,Female,60+,616,594,22,605,11
2009,Rural,West Bengal,Other Crimes,Cyber Crime,Female,0-12,6606,1892,4714,6405,201
2010,Urban,West Bengal,Crime Against Women,Domestic Violence,Male,31-45,2787,330,2457,618,2169
2003,Rural,Uttar Pradesh,Crime Against Women,Rape,Female,18-30,7236,6260,976,6337,899
2010,Rural,Delhi,Property Crime,Arson,Male,60+,2815,2346,469,2803,12
2001,Rural,Uttar Pradesh,Crime Against Children,Trafficking,Male,46-60,2594,628,1966,1038,1556
2002,Rural,Kerala,Property Crime,Theft,Male,18-30,5524,4407,1117,5313,211
2004,Rural,Chhattisgarh,Property Crime,Theft,Female,31-45,7727,1864,5863,7372,355
2009,Rural,Uttarakhand,Property Crime,Theft,Male,18-30,9448,6032,3416,6783,2665
2001,Urban,Nagaland,Crime Against Women,Molestation,Female,0-12,6825,3510,3315,6021,804
2005,Rural,Maharashtra,Crime Against Women,Molestation,Male,46-60,2916,1949,967,2823,93
2006,Rural,Sikkim,Crime Against Men,Extortion,Female,31-45,3140,2932,208,3125,15
2006,Urban,Bihar,Property Crime,Arson,Female,31-45,2644,1394,1250,2436,208
2005,Rural,Bihar,Crime Against Women,Molestation,Male,46-60,1237,63,1174,548,689
2005,Urban,Jammu & Kashmir,Crime Against Men,Murder,Female,0-12,1721,1377,344,1496,225
2007,Rural,Himachal Pradesh,Crime Against Children,Child Labor,Female,13-17,6058,2100,3958,3472,2586
2005,Urban,Mizoram,Crime Against Women,Molestation,Female,31-45,8914,6132,2782,6823,2091
2001,Urban,Sikkim,Crime Against Children,Child Labor,Female,46-60,106,37,69,69,37
2007,Rural,Punjab,Crime Against Men,Robbery,Female,60+,6111,2503,3608,3159,2952
2010,Rural,Goa,Other Crimes,Cyber Crime,Male,13-17,2426,64,2362,1798,628
2009,Urban,Assam,Property Crime,Arson,Male,18-30,4340,976,3364,3311,1029
2008,Rural,Bihar,Crime Against Women,Domestic Violence,Female,60+,9670,5403,4267,8623,1047
2002,Urban,Rajasthan,Property Crime,Arson,Male,46-60,6384,4321,2063,5871,513
2007,Rural,Bihar,Other Crimes,Cyber Crime,Male,46-60,1004,59,945,785,219
2003,Urban,Arunachal Pradesh,Crime Against Women,Molestation,Male,0-12,3778,2012,1766,2595,1183
2001,Rural,Andhra Pradesh,Crime Against Children,Child Labor,Female,18-30,4218,680,3538,3522,696
2001,Rural,West Bengal,Other Crimes,Corruption,Female,0-12,1390,193,1197,1205,185
2007,Urban,Tamil Nadu,Crime Against Children,Kidnapping,Male,13-17,8987,7319,1668,8843,144
2006,Urban,Tripura,Other Crimes,Corruption,Female,46-60,5841,3664,2177,3761,2080
2005,Rural,Meghalaya,Property Crime,Theft,Female,60+,671,113,558,149,522
2003,Urban,Gujarat,Other Crimes,Cyber Crime,Female,46-60,1948,1017,931,1423,525
2006,Rural,Arunachal Pradesh,Crime Against Women,Rape,Female,13-17,3498,2685,813,3420,78
2009,Urban,Tamil Nadu,Crime Against Children,Trafficking,Female,46-60,3894,1282,2612,3523,371
2004,Urban,Sikkim,Property Crime,Burglary,Male,46-60,5393,1642,3751,5349,44
2010,Rural,Punjab,Crime Against Men,Extortion,Female,31-45,8433,3019,5414,6020,2413
2004,Rural,Mizoram,Other Crimes,Cyber Crime,Male,60+,2924,2195,729,2440,484
2006,Urban,Karnataka,Crime Against Men,Extortion,Male,18-30,7535,473,7062,3370,4165
2010,Rural,Haryana,Other Crimes,Drug Offense,Male,46-60,4361,2278,2083,3708,653
2003,Rural,Kerala,Crime Against Women,Molestation,Female,46-60,5055,4430,625,4600,455
2008,Urban,Gujarat,Property Crime,Vandalism,Female,13-17,4255,663,3592,1331,2924
2002,Urban,Chhattisgarh,Crime Against Children,Kidnapping,Female,13-17,5415,3845,1570,4882,533
2004,Urban,Gujarat,Crime Against Women,Dowry Deaths,Female,60+,6903,4342,2561,5032,1871
2004,Rural,Uttarakhand,Crime Against Men,Extortion,Female,31-45,1623,1163,460,1441,182
2001,Urban,Tamil Nadu,Crime Against Children,Kidnapping,Male,13-17,4533,2502,2031,4378,155
2006,Rural,Gujarat,Other Crimes,Fraud,Female,60+,156,144,12,153,3
2003,Urban,Haryana,Crime Against Men,Murder,Male,13-17,9479,6108,3371,6799,2680
2007,Rural,Mizoram,Other Crimes,Corruption,Male,46-60,3302,3190,112,3301,1
2006,Rural,Tripura,Crime Against Women,Molestation,Female,31-45,4554,1431,3123,4379,175
2006,Rural,Goa,Crime Against Children,Child Labor,Female,13-17,5666,4274,1392,4769,897
2009,Urban,West Bengal,Other Crimes,Cyber Crime,Male,0-12,2430,492,1938,2400,30
2009,Urban,Chhattisgarh,Property Crime,Burglary,Male,31-45,1679,721,958,1082,597
2003,Urban,West Bengal,Crime Against Men,Robbery,Female,18-30,7184,4268,2916,4871,2313
2008,Rural,Delhi,Property Crime,Arson,Female,0-12,1681,49,1632,304,1377
2003,Rural,Jammu & Kashmir,Crime Against Children,Child Labor,Female,60+,6259,797,5462,3044,3215
2001,Urban,Odisha,Other Crimes,Corruption,Male,60+,7426,5456,1970,5668,1758
2004,Urban,Manipur,Crime Against Women,Rape,Female,46-60,931,849,82,862,69
2006,Urban,Telangana,Crime Against Children,Trafficking,Male,46-60,2371,2152,219,2262,109
2009,Rural,Sikkim,Property Crime,Arson,Female,0-12,9405,6187,3218,7888,1517
2005,Urban,Maharashtra,Property Crime,Vandalism,Female,46-60,5465,2892,2573,3409,2056
2008,Rural,Goa,Crime Against Men,Assault,Female,0-12,866,89,777,181,685
2009,Rural,Uttarakhand,Crime Against Women,Dowry Deaths,Female,46-60,4680,2209,2471,3842,838
2004,Rural,Meghalaya,Property Crime,Arson,Female,0-12,7598,561,7037,2227,5371
2003,Urban,Meghalaya,Crime Against Men,Assault,Male,13-17,5889,760,5129,5146,743
2004,Urban,Gujarat,Crime Against Women,Domestic Violence,Male,0-12,7201,47,7154,2970,4231
2008,Rural,Assam,Crime Against Children,Trafficking,Female,60+,911,907,4,911,0
2009,Urban,Karnataka,Crime Against Children,Child Labor,Female,46-60,6168,5093,1075,5816,352
2008,Urban,Goa,Other Crimes,Corruption,Female,60+,8182,3597,4585,5599,2583
2007,Urban,Jharkhand,Property Crime,Theft,Male,31-45,9535,13,9522,6864,2671
2008,Rural,Haryana,Crime Against Women,Molestation,Female,0-12,2530,2089,441,2460,70
2007,Rural,Karnataka,Crime Against Men,Murder,Female,31-45,1855,91,1764,416,1439
2005,Urban,Assam,Crime Against Women,Domestic Violence,Male,46-60,2487,1119,1368,1704,783
2008,Urban,Kerala,Crime Against Children,Trafficking,Female,0-12,3957,314,3643,2746,1211
2003,Rural,Madhya Pradesh,Crime Against Children,Child Abuse,Female,60+,2839,1516,1323,1698,1141
2010,Rural,Arunachal Pradesh,Crime Against Men,Assault,Female,46-60,1297,981,316,1100,197
2004,Rural,Odisha,Crime Against Children,Child Labor,Male,0-12,6986,6957,29,6974,12
2002,Rural,Meghalaya,Property Crime,Vandalism,Female,46-60,3271,313,2958,2475,796
2001,Urban,Karnataka,Property Crime,Theft,Female,0-12,3315,1004,2311,2293,1022
2009,Urban,Telangana,Property Crime,Arson,Male,31-45,3983,2444,1539,2884,1099
2002,Rural,Jammu & Kashmir,Crime Against Women,Domestic Violence,Male,0-12,189,129,60,183,6
2005,Rural,Andhra Pradesh,Property Crime,Vandalism,Male,18-30,202,107,95,201,1
2005,Rural,West Bengal,Property Crime,Burglary,Male,46-60,3405,2630,775,2903,502
2005,Urban,Andhra Pradesh,Crime Against Men,Murder,Male,46-60,8808,1303,7505,2858,5950
2004,Urban,Uttarakhand,Property Crime,Theft,Female,0-12,2893,377,2516,2813,80
2009,Urban,Uttarakhand,Crime Against Men,Assault,Male,46-60,6055,3393,2662,5573,482
2004,Rural,Goa,Crime Against Women,Molestation,Male,31-45,812,355,457,492,320
2007,Rural,West Bengal,Crime Against Women,Molestation,Male,0-12,1770,980,790,1310,460
2003,Rural,Himachal Pradesh,Other Crimes,Drug Offense,Male,46-60,3376,2858,518,2980,396
2005,Urban,Uttar Pradesh,Crime Against Children,Kidnapping,Female,60+,9829,2851,6978,2879,6950
2002,Rural,Jammu & Kashmir,Crime Against Women,Molestation,Male,18-30,1589,1354,235,1403,186
2010,Rural,Goa,Crime Against Children,Trafficking,Male,31-45,1777,1341,436,1633,144
2001,Rural,Maharashtra,Crime Against Men,Murder,Male,13-17,2167,611,1556,1683,484
2006,Urban,Sikkim,Crime Against Men,Extortion,Female,13-17,4585,196,4389,716,3869
2004,Urban,Himachal Pradesh,Crime Against Men,Murder,Male,60+,7421,4722,2699,6540,881
2001,Urban,Odisha,Property Crime,Vandalism,Female,60+,9227,7176,2051,7931,1296
2003,Urban,Jharkhand,Other Crimes,Fraud,Male,46-60,3202,775,2427,2106,1096
2008,Rural,Jharkhand,Crime Against Women,Dowry Deaths,Female,0-12,4747,1972,2775,2944,1803
2006,Urban,Assam,Property Crime,Burglary,Female,0-12,9927,8103,1824,8132,1795
2004,Rural,Delhi,Crime Against Women,Domestic Violence,Male,60+,5475,3228,2247,4759,716
2008,Rural,Himachal Pradesh,Crime Against Men,Murder,Male,46-60,1584,1444,140,1524,60
2009,Rural,Uttar Pradesh,Other Crimes,Fraud,Female,46-60,5853,862,4991,919,4934
2008,Urban,Bihar,Crime Against Women,Domestic Violence,Female,46-60,7851,6275,1576,6538,1313
2004,Rural,Assam,Crime Against Children,Child Abuse,Female,31-45,1518,1240,278,1323,195
2010,Urban,Kerala,Crime Against Women,Molestation,Female,46-60,8109,4511,3598,7005,1104
2003,Rural,Haryana,Crime Against Children,Child Abuse,Male,31-45,5536,435,5101,2826,2710
2006,Urban,Andhra Pradesh,Crime Against Children,Trafficking,Female,46-60,7606,1147,6459,1947,5659
2005,Urban,Himachal Pradesh,Property Crime,Theft,Male,18-30,305,162,143,200,105
2010,Urban,Goa,Other Crimes,Fraud,Male,31-45,9659,4318,5341,8063,1596
2004,Urban,Maharashtra,Crime Against Children,Child Abuse,Male,46-60,9814,3335,6479,6134,3680
2006,Rural,Assam,Crime Against Children,Kidnapping,Male,60+,2061,131,1930,1433,628
2006,Urban,Punjab,Crime Against Children,Child Abuse,Male,31-45,7350,749,6601,940,6410
2010,Rural,Sikkim,Crime Against Women,Dowry Deaths,Male,46-60,7303,1712,5591,6604,699
2006,Rural,Bihar,Crime Against Men,Robbery,Female,46-60,8042,511,7531,5830,2212
2004,Urban,Mizoram,Property Crime,Arson,Male,31-45,7650,802,6848,4994,2656
2010,Urban,Jharkhand,Crime Against Women,Rape,Female,0-12,6946,4187,2759,4499,2447
2004,Rural,Gujarat,Property Crime,Burglary,Male,13-17,3841,1600,2241,2522,1319
2009,Rural,Arunachal Pradesh,Crime Against Children,Child Abuse,Male,13-17,3309,1979,1330,3167,142
2009,Urban,Sikkim,Property Crime,Arson,Female,46-60,3306,580,2726,1479,1827
2005,Rural,Himachal Pradesh,Crime Against Women,Dowry Deaths,Female,18-30,2217,907,1310,1324,893
2010,Urban,Maharashtra,Crime Against Men,Assault,Female,0-12,6654,42,6612,3815,2839
2007,Rural,Assam,Other Crimes,Corruption,Male,46-60,174,100,74,130,44
2001,Urban,Chhattisgarh,Crime Against Children,Child Labor,Male,46-60,767,19,748,300,467
2003,Rural,Arunachal Pradesh,Crime Against Men,Robbery,Male,46-60,8303,1206,7097,4846,3457
2003,Urban,Andhra Pradesh,Crime Against Children,Child Abuse,Female,31-45,2859,627,2232,1721,1138
2003,Urban,Manipur,Property Crime,Burglary,Male,60+,3501,2984,517,3354,147
2004,Rural,West Bengal,Property Crime,Arson,Male,18-30,1328,639,689,1063,265
2008,Rural,Manipur,Crime Against Women,Dowry Deaths,Male,60+,7612,1557,6055,5114,2498
2004,Rural,Delhi,Property Crime,Burglary,Male,31-45,4109,3747,362,3769,340
2002,Urban,Karnataka,Property Crime,Theft,Male,13-17,678,429,249,492,186
2006,Rural,Rajasthan,Crime Against Women,Molestation,Female,46-60,4697,3768,929,4316,381
2007,Rural,Tamil Nadu,Crime Against Men,Assault,Male,46-60,6032,921,5111,1211,4821
2008,Urban,Telangana,Crime Against Children,Kidnapping,Female,31-45,5532,5297,235,5313,219
2005,Rural,Punjab,Property Crime,Vandalism,Female,60+,9074,1833,7241,8179,895
2006,Rural,Assam,Crime Against Men,Assault,Female,31-45,7917,2649,5268,4529,3388
2001,Urban,Mizoram,Crime Against Children,Trafficking,Male,0-12,1657,1374,283,1584,73
2005,Rural,Nagaland,Other Crimes,Drug Offense,Female,0-12,9266,8308,958,8596,670
2004,Urban,Rajasthan,Property Crime,Theft,Female,46-60,9645,1885,7760,7931,1714
2007,Rural,Chhattisgarh,Crime Against Men,Murder,Female,18-30,7979,4159,3820,7275,704
2010,Urban,Gujarat,Crime Against Children,Kidnapping,Male,18-30,4684,3383,1301,3473,1211
2002,Rural,Meghalaya,Crime Against Men,Extortion,Male,46-60,777,177,600,208,569
2002,Rural,Karnataka,Crime Against Men,Assault,Male,46-60,9885,9136,749,9563,322
2009,Rural,Bihar,Crime Against Men,Assault,Female,60+,9235,1649,7586,6251,2984
2006,Rural,Haryana,Crime Against Women,Rape,Female,13-17,2036,1729,307,1817,219
2007,Urban,Telangana,Crime Against Women,Domestic Violence,Female,0-12,9111,3395,5716,7738,1373
2009,Urban,Chhattisgarh,Crime Against Children,Child Abuse,Female,0-12,2081,1202,879,1413,668
2001,Rural,Andhra Pradesh,Property Crime,Burglary,Female,0-12,8689,7676,1013,7751,938
2005,Urban,Mizoram,Other Crimes,Drug Offense,Female,13-17,7242,5041,2201,5407,1835
2003,Urban,Assam,Property Crime,Arson,Male,60+,8871,4065,4806,4543,4328
2002,Rural,Madhya Pradesh,Crime Against Men,Extortion,Male,13-17,3901,98,3803,1483,2418
2007,Urban,Jammu & Kashmir,Crime Against Children,Child Labor,Female,31-45,1471,501,970,725,746
2009,Rural,Tripura,Crime Against Children,Kidnapping,Male,18-30,9940,6018,3922,7816,2124
2009,Urban,Kerala,Other Crimes,Fraud,Male,46-60,8261,244,8017,958,7303
2007,Urban,Karnataka,Crime Against Women,Domestic Violence,Male,13-17,8421,2369,6052,3564,4857
2002,Urban,Jharkhand,Crime Against Women,Domestic Violence,Female,18-30,4460,3125,1335,3174,1286
2006,Urban,Goa,Other Crimes,Corruption,Male,31-45,2776,2149,627,2668,108
2001,Urban,Meghalaya,Crime Against Men,Robbery,Male,46-60,5162,4574,588,5126,36
2005,Rural,Manipur,Property Crime,Burglary,Male,31-45,6902,1921,4981,4255,2647
2001,Urban,Odisha,Property Crime,Theft,Female,18-30,2022,73,1949,714,1308
2002,Rural,Uttar Pradesh,Crime Against Men,Robbery,Female,0-12,626,595,31,605,21
2010,Rural,Chhattisgarh,Crime Against Children,Child Labor,Male,13-17,5676,3607,2069,4431,1245
2004,Rural,Chhattisgarh,Crime Against Men,Robbery,Male,18-30,4593,4377,216,4533,60
2006,Urban,Maharashtra,Crime Against Women,Domestic Violence,Female,31-45,643,58,585,166,477
2009,Urban,Himachal Pradesh,Other Crimes,Corruption,Female,0-12,4148,148,4000,1738,2410
2006,Urban,Manipur,Crime Against Men,Murder,Female,31-45,3986,1278,2708,2280,1706
2010,Urban,Chhattisgarh,Crime Against Women,Dowry Deaths,Male,60+,8676,1062,7614,6575,2101
2005,Urban,Maharashtra,Property Crime,Burglary,Male,31-45,951,394,557,717,234
2008,Rural,Arunachal Pradesh,Crime Against Men,Extortion,Male,46-60,2190,1562,628,1984,206
2002,Rural,Delhi,Crime Against Women,Dowry Deaths,Male,31-45,2938,104,2834,749,2189
2001,Urban,Karnataka,Property Crime,Arson,Male,13-17,7023,6577,446,6784,239
2006,Rural,Tripura,Other Crimes,Cyber Crime,Female,31-45,4790,2786,2004,4208,582
2007,Rural,Delhi,Other Crimes,Corruption,Female,46-60,9876,8548,1328,9030,846
2005,Rural,Jharkhand,Property Crime,Vandalism,Female,46-60,7564,761,6803,1717,5847
2002,Rural,Bihar,Crime Against Women,Rape,Male,46-60,7924,5190,2734,7203,721
2010,Urban,Jammu & Kashmir,Property Crime,Arson,Female,13-17,5060,2877,2183,2877,2183
2003,Urban,Meghalaya,Property Crime,Theft,Female,18-30,4560,481,4079,1223,3337
2002,Rural,Telangana,Crime Against Women,Molestation,Female,60+,480,398,82,426,54
2007,Rural,Arunachal Pradesh,Property Crime,Theft,Male,18-30,4955,2517,2438,3366,1589
2004,Rural,Punjab,Crime Against Women,Molestation,Male,60+,5537,4637,900,4968,569
2002,Urban,Jammu & Kashmir,Crime Against Women,Dowry Deaths,Male,60+,6658,4285,2373,4561,2097
2005,Rural,Punjab,Other Crimes,Cyber Crime,Male,13-17,7179,3127,4052,5877,1302
2001,Urban,Rajasthan,Crime Against Women,Molestation,Male,0-12,9695,8117,1578,8902,793
2002,Rural,Gujarat,Crime Against Men,Assault,Male,46-60,5471,2513,2958,5398,73
2003,Rural,Uttarakhand,Crime Against Children,Child Labor,Male,18-30,3553,16,3537,3191,362
2006,Urban,Delhi,Crime Against Children,Child Labor,Female,31-45,6930,5381,1549,5689,1241
2001,Rural,Tamil Nadu,Crime Against Children,Child Abuse,Female,31-45,4195,3998,197,4026,169
2005,Rural,Sikkim,Crime Against Men,Murder,Female,60+,6562,5054,1508,5763,799
2004,Rural,Andhra Pradesh,Other Crimes,Cyber Crime,Female,31-45,1439,1024,415,1091,348
2010,Urban,Chhattisgarh,Other Crimes,Drug Offense,Male,31-45,3386,3334,52,3369,17
2002,Rural,Uttar Pradesh,Other Crimes,Cyber Crime,Female,31-45,1526,1013,513,1274,252
2002,Rural,Kerala,Crime Against Women,Dowry Deaths,Male,60+,9546,4819,4727,8393,1153
2008,Rural,Nagaland,Property Crime,Theft,Male,60+,8339,1254,7085,3317,5022
2009,Urban,Karnataka,Property Crime,Theft,Male,31-45,480,325,155,419,61
2004,Urban,Mizoram,Other Crimes,Drug Offense,Male,46-60,3759,2769,990,3139,620
2004,Rural,Chhattisgarh,Crime Against Men,Extortion,Male,46-60,3393,1252,2141,1454,1939
2005,Urban,Uttarakhand,Other Crimes,Corruption,Female,60+,1360,119,1241,749,611
2004,Rural,Uttar Pradesh,Crime Against Children,Kidnapping,Female,60+,8575,344,8231,2574,6001
2005,Rural,Telangana,Other Crimes,Corruption,Female,0-12,8222,812,7410,3835,4387
2007,Urban,Rajasthan,Property Crime,Vandalism,Male,31-45,4282,949,3333,3800,482
2005,Urban,Maharashtra,Crime Against Men,Extortion,Male,46-60,2067,168,1899,339,1728
2007,Urban,Assam,Crime Against Children,Kidnapping,Female,60+,3722,3110,612,3334,388
2002,Rural,Mizoram,Property Crime,Arson,Male,0-12,8636,3487,5149,7374,1262
2009,Rural,West Bengal,Other Crimes,Drug Offense,Male,18-30,3069,2483,586,2545,524
2006,Rural,Uttar Pradesh,Crime Against Children,Trafficking,Female,60+,2774,837,1937,1438,1336
2007,Urban,Uttar Pradesh,Property Crime,Theft,Female,18-30,2329,921,1408,1960,369
2010,Urban,Nagaland,Crime Against Children,Child Labor,Female,60+,5846,363,5483,927,4919
2009,Rural,Assam,Property Crime,Theft,Female,60+,517,242,275,361,156
2001,Rural,Assam,Other Crimes,Corruption,Male,31-45,7274,6772,502,6944,330
2006,Rural,Sikkim,Crime Against Women,Molestation,Female,31-45,3106,376,2730,885,2221
2004,Rural,Karnataka,Crime Against Men,Extortion,Female,31-45,9850,9798,52,9833,17
2004,Urban,Jharkhand,Crime Against Women,Rape,Male,18-30,4834,3982,852,4315,519
2005,Rural,Jammu & Kashmir,Crime Against Children,Kidnapping,Female,60+,8577,3420,5157,7387,1190
2004,Urban,Tripura,Crime Against Women,Molestation,Female,13-17,5308,1901,3407,2134,3174
2004,Rural,Manipur,Crime Against Children,Trafficking,Female,18-30,1810,597,1213,912,898
2009,Rural,Kerala,Crime Against Women,Molestation,Male,18-30,6820,1882,4938,6073,747
2007,Rural,Manipur,Crime Against Men,Robbery,Female,46-60,1512,1347,165,1404,108
2006,Rural,Jammu & Kashmir,Crime Against Men,Assault,Female,18-30,3008,1153,1855,1939,1069
2008,Rural,Assam,Property Crime,Arson,Male,18-30,5756,4676,1080,4947,809
2009,Urban,Rajasthan,Crime Against Men,Assault,Male,60+,3964,2339,1625,3072,892
2002,Rural,Assam,Property Crime,Vandalism,Male,46-60,5376,2914,2462,3187,2189
2003,Rural,Andhra Pradesh,Crime Against Women,Domestic Violence,Male,0-12,9979,4521,5458,6568,3411
2006,Rural,Jharkhand,Crime Against Women,Rape,Male,31-45,6011,82,5929,1334,4677
2010,Urban,Goa,Property Crime,Theft,Female,60+,1776,1240,536,1614,162
2010,Urban,Jharkhand,Crime Against Men,Extortion,Female,60+,4919,1513,3406,1866,3053
2009,Urban,Nagaland,Crime Against Women,Rape,Female,0-12,8678,4546,4132,5198,3480
2008,Rural,Goa,Other Crimes,Fraud,Female,18-30,1527,1162,365,1299,228
2004,Rural,Punjab,Other Crimes,Cyber Crime,Female,60+,8533,3010,5523,5177,3356
2008,Rural,Karnataka,Property Crime,Burglary,Male,46-60,61,32,29,60,1
2009,Rural,Assam,Crime Against Children,Kidnapping,Female,46-60,4780,2599,2181,3684,1096
2002,Urban,Chhattisgarh,Crime Against Men,Murder,Female,13-17,3546,2172,1374,3408,138
2003,Rural,Assam,Other Crimes,Fraud,Female,60+,7778,3871,3907,5427,2351
2001,Urban,Delhi,Property Crime,Vandalism,Male,31-45,7983,923,7060,1605,6378
2003,Rural,Kerala,Other Crimes,Fraud,Male,46-60,1043,660,383,1009,34
2009,Rural,Madhya Pradesh,Other Crimes,Fraud,Female,46-60,6264,2256,4008,2393,3871
2008,Rural,Mizoram,Crime Against Men,Robbery,Female,0-12,688,452,236,530,158
2002,Rural,Jammu & Kashmir,Crime Against Women,Molestation,Male,0-12,8258,3637,4621,5610,2648
2006,Rural,Madhya Pradesh,Crime Against Children,Child Labor,Female,13-17,7518,2765,4753,5793,1725
2003,Urban,Gujarat,Crime Against Men,Murder,Female,31-45,3545,2955,590,3524,21
2009,Urban,Gujarat,Property Crime,Theft,Female,31-45,4261,279,3982,906,3355
2008,Rural,Sikkim,Crime Against Children,Kidnapping,Male,31-45,2100,77,2023,1127,973
2006,Rural,Nagaland,Property Crime,Theft,Male,18-30,3876,1945,1931,2272,1604
2001,Rural,Himachal Pradesh,Property Crime,Theft,Female,13-17,653,288,365,540,113
2010,Urban,Jharkhand,Property Crime,Burglary,Female,60+,2595,1448,1147,1492,1103
2005,Urban,Arunachal Pradesh,Crime Against Men,Robbery,Female,31-45,2521,546,1975,1089,1432
2010,Rural,Telangana,Property Crime,Burglary,Male,46-60,151,85,66,123,28
2008,Urban,Kerala,Crime Against Women,Rape,Male,0-12,4966,3739,1227,3842,1124
2010,Rural,Andhra Pradesh,Other Crimes,Drug Offense,Female,18-30,3842,360,3482,875,2967
2007,Urban,Odisha,Crime Against Women,Domestic Violence,Female,18-30,8006,792,7214,7931,75
2009,Urban,Tamil Nadu,Crime Against Children,Kidnapping,Female,13-17,64,50,14,55,9
2008,Urban,Kerala,Crime Against Men,Robbery,Female,13-17,8143,703,7440,4075,4068
2007,Urban,Arunachal Pradesh,Crime Against Men,Murder,Male,31-45,6477,4869,1608,6287,190
2001,Urban,Rajasthan,Crime Against Men,Extortion,Male,31-45,8976,313,8663,4625,4351
2003,Urban,Meghalaya,Crime Against Children,Trafficking,Male,46-60,9691,2729,6962,4881,4810
2003,Rural,Manipur,Other Crimes,Corruption,Male,60+,1563,309,1254,1189,374
2005,Rural,Tamil Nadu,Crime Against Children,Child Labor,Male,46-60,4252,416,3836,1765,2487
2007,Urban,Nagaland,Other Crimes,Corruption,Female,0-12,4008,2536,1472,3007,1001
2003,Urban,Assam,Other Crimes,Fraud,Female,46-60,2582,1621,961,1627,955
2007,Urban,Delhi,Crime Against Women,Rape,Male,31-45,722,499,223,679,43
2010,Urban,Meghalaya,Other Crimes,Cyber Crime,Female,31-45,8163,2504,5659,2561,5602
2009,Rural,Madhya Pradesh,Other Crimes,Corruption,Male,0-12,1890,1759,131,1784,106
2002,Urban,Delhi,Crime Against Women,Rape,Male,18-30,6614,2972,3642,3458,3156
2008,Urban,Gujarat,Other Crimes,Cyber Crime,Female,13-17,1597,459,1138,1319,278
2007,Rural,Sikkim,Crime Against Women,Dowry Deaths,Male,18-30,7147,2084,5063,4843,2304
2009,Urban,Himachal Pradesh,Other Crimes,Corruption,Male,60+,3324,1606,1718,2309,1015
2008,Rural,Himachal Pradesh,Crime Against Children,Kidnapping,Female,0-12,6902,1404,5498,4217,2685
2006,Rural,Mizoram,Property Crime,Burglary,Female,18-30,8070,4867,3203,6846,1224
2002,Rural,Mizoram,Crime Against Men,Extortion,Female,60+,4648,3577,1071,3589,1059
2010,Rural,Tripura,Crime Against Women,Molestation,Male,0-12,1984,413,1571,1826,158
2003,Rural,Manipur,Other Crimes,Fraud,Female,60+,895,394,501,590,305
2007,Urban,Rajasthan,Crime Against Children,Child Labor,Male,18-30,441,148,293,406,35
2010,Urban,Gujarat,Crime Against Women,Molestation,Female,18-30,449,14,435,255,194
2007,Rural,Rajasthan,Crime Against Women,Molestation,Male,60+,4629,2237,2392,4374,255
2002,Rural,Tamil Nadu,Crime Against Children,Kidnapping,Female,18-30,6551,274,6277,1997,4554
2002,Rural,West Bengal,Crime Against Women,Domestic Violence,Female,31-45,6829,4571,2258,5425,1404
2004,Rural,Bihar,Crime Against Women,Dowry Deaths,Male,0-12,2990,1492,1498,2013,977
2004,Rural,Andhra Pradesh,Crime Against Children,Kidnapping,Female,18-30,9516,153,9363,3934,5582
2004,Rural,Tamil Nadu,Other Crimes,Cyber Crime,Male,18-30,4301,2979,1322,3706,595
2007,Rural,Himachal Pradesh,Property Crime,Theft,Female,18-30,3492,491,3001,1173,2319
2008,Urban,Jharkhand,Crime Against Women,Domestic Violence,Male,31-45,1868,1779,89,1794,74
2004,Urban,Tripura,Property Crime,Arson,Male,18-30,1031,811,220,932,99
2002,Rural,Uttarakhand,Crime Against Children,Trafficking,Male,18-30,75,38,37,67,8
2003,Urban,Nagaland,Other Crimes,Corruption,Female,18-30,2565,2253,312,2531,34
2007,Rural,Chhattisgarh,Crime Against Children,Child Abuse,Male,13-17,6938,5184,1754,6552,386
2007,Urban,Tamil Nadu,Crime Against Children,Child Abuse,Male,60+,8335,3250,5085,7187,1148
2003,Urban,Jharkhand,Crime Against Women,Rape,Male,31-45,6317,2500,3817,2525,3792
2007,Urban,Bihar,Crime Against Women,Molestation,Female,0-12,4900,1476,3424,3432,1468
2006,Rural,Chhattisgarh,Other Crimes,Cyber Crime,Male,60+,1411,434,977,519,892
2001,Urban,Chhattisgarh,Crime Against Women,Molestation,Male,13-17,2374,1635,739,2013,361
2001,Urban,Punjab,Crime Against Women,Molestation,Female,46-60,9405,3518,5887,4861,4544
2008,Urban,Jharkhand,Crime Against Women,Dowry Deaths,Male,60+,4409,3338,1071,3585,824
2001,Urban,Uttarakhand,Other Crimes,Cyber Crime,Male,13-17,6497,4332,2165,4401,2096
2007,Urban,Delhi,Property Crime,Burglary,Male,18-30,9847,8954,893,9484,363
2003,Rural,Uttarakhand,Other Crimes,Cyber Crime,Male,60+,603,181,422,410,193
2004,Urban,Manipur,Crime Against Children,Child Labor,Male,13-17,9853,9219,634,9834,19
2004,Urban,Uttar Pradesh,Crime Against Children,Child Abuse,Male,13-17,7687,4509,3178,6536,1151
2008,Rural,Goa,Other Crimes,Cyber Crime,Male,13-17,7759,1347,6412,3671,4088
2007,Urban,Uttar Pradesh,Property Crime,Burglary,Female,0-12,1024,155,869,869,155
2005,Urban,Tamil Nadu,Crime Against Men,Assault,Male,60+,2047,1212,835,1680,367
2008,Rural,West Bengal,Crime Against Children,Child Abuse,Female,18-30,7623,7205,418,7337,286
2007,Urban,Jammu & Kashmir,Crime Against Men,Extortion,Male,46-60,4386,1263,3123,1291,3095
2001,Rural,Tamil Nadu,Crime Against Women,Rape,Female,0-12,1718,37,1681,889,829
2007,Rural,Tripura,Crime Against Men,Robbery,Female,13-17,7734,4382,3352,5503,2231
2008,Urban,Haryana,Crime Against Children,Kidnapping,Female,0-12,2977,1784,1193,2755,222
2010,Rural,Goa,Crime Against Children,Child Labor,Female,31-45,603,315,288,464,139
2002,Rural,Karnataka,Crime Against Children,Child Abuse,Female,60+,9008,1013,7995,2708,6300
2004,Rural,Haryana,Crime Against Men,Murder,Male,13-17,6520,4206,2314,5677,843
2007,Rural,Bihar,Crime Against Children,Child Labor,Female,18-30,1748,693,1055,962,786
2009,Urban,Jharkhand,Crime Against Men,Assault,Male,0-12,9895,9465,430,9710,185
2007,Urban,Goa,Property Crime,Arson,Male,0-12,8052,2277,5775,3252,4800
2003,Urban,Delhi,Crime Against Men,Extortion,Male,13-17,5777,1072,4705,4368,1409
2007,Urban,Sikkim,Crime Against Men,Assault,Female,46-60,4260,1551,2709,3368,892
2002,Rural,Uttarakhand,Property Crime,Arson,Female,13-17,668,118,550,561,107
2008,Rural,Bihar,Property Crime,Burglary,Female,18-30,8642,6612,2030,7566,1076
2006,Urban,Bihar,Crime Against Men,Murder,Female,60+,4725,2301,2424,2983,1742
2008,Rural,West Bengal,Crime Against Men,Extortion,Male,18-30,2128,2128,0,2128,0
2008,Urban,Nagaland,Other Crimes,Cyber Crime,Female,31-45,2107,1105,1002,2041,66
2007,Urban,Tripura,Other Crimes,Fraud,Male,13-17,982,414,568,680,302
2002,Rural,West Bengal,Crime Against Children,Child Labor,Male,60+,2421,1582,839,2087,334
2001,Rural,Uttar Pradesh,Property Crime,Theft,Female,13-17,4811,1912,2899,2158,2653
2009,Urban,Sikkim,Crime Against Women,Domestic Violence,Female,31-45,6036,4025,2011,5321,715
2001,Rural,Bihar,Property Crime,Arson,Female,60+,7335,4347,2988,6538,797
2010,Rural,Madhya Pradesh,Other Crimes,Corruption,Female,18-30,7177,372,6805,6339,838
2001,Rural,Jharkhand,Crime Against Children,Child Abuse,Female,60+,3105,1582,1523,2857,248
2008,Rural,Maharashtra,Crime Against Women,Rape,Male,46-60,9029,2536,6493,8756,273
2009,Rural,Manipur,Property Crime,Theft,Male,60+,6170,1771,4399,2574,3596
2001,Urban,Kerala,Crime Against Children,Trafficking,Female,60+,5896,424,5472,929,4967
2010,Urban,Kerala,Other Crimes,Fraud,Male,18-30,8839,4366,4473,8344,495
2002,Rural,Manipur,Property Crime,Vandalism,Male,60+,7878,5532,2346,7745,133
2004,Rural,Bihar,Crime Against Men,Robbery,Male,18-30,3593,651,2942,1729,1864
2003,Urban,Tripura,Other Crimes,Drug Offense,Female,13-17,5995,3033,2962,4559,1436
2009,Urban,Karnataka,Property Crime,Arson,Female,31-45,734,682,52,689,45
2001,Rural,Bihar,Crime Against Children,Child Labor,Female,0-12,5786,4238,1548,5706,80
2002,Rural,Arunachal Pradesh,Crime Against Men,Extortion,Female,60+,364,272,92,323,41
2002,Urban,Jammu & Kashmir,Crime Against Men,Murder,Male,31-45,3079,287,2792,2393,686
2005,Urban,Mizoram,Other Crimes,Corruption,Female,46-60,2960,1937,1023,2828,132
2010,Urban,Himachal Pradesh,Crime Against Children,Child Labor,Male,46-60,955,276,679,288,667
2010,Rural,Haryana,Crime Against Men,Robbery,Male,18-30,6166,5982,184,5994,172
2006,Rural,Delhi,Other Crimes,Drug Offense,Male,60+,1148,1091,57,1144,4
2006,Rural,West Bengal,Crime Against Women,Dowry Deaths,Male,13-17,6432,1021,5411,1866,4566
2004,Rural,Kerala,Crime Against Men,Extortion,Female,0-12,3899,3711,188,3779,120
2007,Rural,Madhya Pradesh,Crime Against Children,Kidnapping,Male,46-60,9050,8674,376,8962,88
2001,Urban,Sikkim,Property Crime,Theft,Female,18-30,9855,5986,3869,8441,1414
2004,Rural,Tamil Nadu,Other Crimes,Corruption,Male,46-60,7098,1957,5141,6206,892
2010,Urban,Rajasthan,Crime Against Women,Rape,Female,31-45,7878,456,7422,5128,2750
2008,Urban,Delhi,Property Crime,Vandalism,Female,13-17,2947,2583,364,2779,168
2005,Rural,Sikkim,Crime Against Men,Extortion,Male,60+,2340,1111,1229,1871,469
2002,Urban,Arunachal Pradesh,Crime Against Children,Child Abuse,Female,60+,2730,404,2326,1553,1177
2010,Urban,Haryana,Crime Against Men,Murder,Male,13-17,1417,947,470,1337,80
2009,Urban,Assam,Other Crimes,Fraud,Female,18-30,2949,705,2244,2868,81
2008,Urban,Delhi,Crime Against Men,Assault,Male,0-12,5953,574,5379,1685,4268
2009,Urban,West Bengal,Crime Against Children,Child Abuse,Female,60+,1838,998,840,1648,190
2001,Rural,Kerala,Crime Against Women,Rape,Female,18-30,902,385,517,688,214
2004,Urban,Kerala,Other Crimes,Drug Offense,Female,46-60,9827,1196,8631,6349,3478
2007,Urban,Mizoram,Crime Against Men,Extortion,Male,46-60,6870,3032,3838,4743,2127
2003,Urban,Bihar,Crime Against Children,Trafficking,Male,60+,938,666,272,912,26
2002,Rural,Kerala,Crime Against Men,Murder,Female,60+,8129,6440,1689,6610,1519
2003,Urban,Himachal Pradesh,Crime Against Women,Molestation,Male,31-45,7616,3864,3752,5779,1837
2007,Urban,West Bengal,Property Crime,Vandalism,Male,60+,2940,2821,119,2898,42
2007,Rural,Jammu & Kashmir,Crime Against Women,Molestation,Male,46-60,9941,5360,4581,5527,4414
2006,Rural,West Bengal,Crime Against Children,Kidnapping,Male,18-30,7955,2548,5407,5358,2597
2005,Rural,West Bengal,Property Crime,Burglary,Female,46-60,8368,7748,620,7935,433
2002,Rural,Punjab,Other Crimes,Corruption,Male,60+,8478,1459,7019,3881,4597
2007,Rural,Kerala,Crime Against Children,Kidnapping,Female,18-30,4766,1456,3310,1869,2897
2007,Rural,Gujarat,Property Crime,Arson,Female,31-45,6036,5213,823,5253,783
2003,Urban,Haryana,Crime Against Women,Molestation,Female,18-30,9081,1849,7232,7091,1990
2010,Rural,Maharashtra,Property Crime,Arson,Female,0-12,7740,5853,1887,5881,1859
2006,Urban,Kerala,Other Crimes,Drug Offense,Male,18-30,7746,4968,2778,7126,620
2001,Rural,Goa,Crime Against Men,Murder,Male,18-30,164,48,116,57,107
2001,Urban,Bihar,Crime Against Men,Assault,Male,13-17,3162,2875,287,2898,264
2004,Rural,Karnataka,Property Crime,Theft,Male,0-12,738,322,416,522,216
2001,Urban,West Bengal,Crime Against Children,Child Labor,Female,13-17,5761,2027,3734,5736,25
2007,Rural,Telangana,Crime Against Children,Child Labor,Female,60+,469,407,62,429,40
2001,Urban,Odisha,Property Crime,Burglary,Male,31-45,9162,3502,5660,4207,4955
2008,Rural,Gujarat,Crime Against Men,Murder,Male,18-30,3519,3477,42,3504,15
2001,Urban,Jharkhand,Crime Against Children,Child Labor,Female,0-12,2970,2214,756,2832,138
2009,Rural,Meghalaya,Crime Against Children,Trafficking,Female,31-45,5578,1040,4538,1915,3663
2007,Urban,Rajasthan,Property Crime,Arson,Female,31-45,3495,774,2721,1633,1862
2003,Urban,Punjab,Crime Against Children,Child Abuse,Male,0-12,7331,174,7157,3069,4262
2001,Rural,Kerala,Crime Against Children,Kidnapping,Male,46-60,787,587,200,587,200
2002,Urban,Delhi,Crime Against Women,Domestic Violence,Female,46-60,4374,3868,506,3955,419
2004,Rural,Maharashtra,Crime Against Women,Dowry Deaths,Female,13-17,4240,1683,2557,3727,513
2001,Rural,Arunachal Pradesh,Crime Against Women,Dowry Deaths,Female,13-17,1352,480,872,673,679
2003,Rural,Tripura,Other Crimes,Fraud,Female,13-17,955,703,252,944,11
2010,Rural,Delhi,Other Crimes,Corruption,Female,31-45,6179,5525,654,5562,617
2005,Rural,Uttar Pradesh,Crime Against Women,Molestation,Female,18-30,4071,2042,2029,3306,765
2010,Urban,Punjab,Other Crimes,Cyber Crime,Female,0-12,8963,1511,7452,3696,5267
2006,Urban,Goa,Crime Against Women,Rape,Male,46-60,1679,209,1470,1087,592
2001,Urban,Himachal Pradesh,Crime Against Men,Extortion,Male,18-30,4161,3847,314,3976,185
2001,Urban,Haryana,Other Crimes,Corruption,Male,46-60,1449,1252,197,1363,86
2004,Urban,Karnataka,Other Crimes,Drug Offense,Female,0-12,1015,792,223,938,77
2004,Rural,Madhya Pradesh,Crime Against Children,Child Abuse,Male,31-45,7220,3711,3509,6162,1058
2010,Urban,Bihar,Other Crimes,Drug Offense,Female,13-17,5585,4636,949,5124,461
2002,Urban,Meghalaya,Crime Against Men,Robbery,Male,31-45,3063,2612,451,2750,313
2004,Urban,Tripura,Crime Against Women,Rape,Female,46-60,6982,1190,5792,3427,3555
2010,Rural,Assam,Property Crime,Arson,Female,0-12,7871,7338,533,7476,395
2003,Rural,Telangana,Crime Against Women,Domestic Violence,Female,60+,9240,5632,3608,8817,423
2003,Urban,Goa,Crime Against Women,Domestic Violence,Female,60+,8531,4827,3704,7305,1226
2002,Rural,Mizoram,Crime Against Men,Robbery,Female,0-12,8951,7541,1410,8112,839
2004,Rural,Karnataka,Property Crime,Arson,Female,46-60,5944,2016,3928,2692,3252
2005,Rural,Assam,Crime Against Men,Murder,Female,0-12,5309,2292,3017,4785,524
2004,Rural,Rajasthan,Crime Against Children,Trafficking,Female,18-30,4246,1239,3007,2635,1611
2002,Urban,Nagaland,Crime Against Children,Kidnapping,Female,46-60,4625,1352,3273,2210,2415
2002,Rural,Jharkhand,Other Crimes,Fraud,Female,31-45,4373,1124,3249,4138,235
2001,Rural,Andhra Pradesh,Other Crimes,Corruption,Male,46-60,4113,823,3290,2020,2093
2007,Rural,Assam,Other Crimes,Fraud,Female,60+,1749,955,794,975,774
2005,Rural,Jammu & Kashmir,Crime Against Women,Domestic Violence,Male,13-17,5921,5368,553,5442,479
2007,Urban,Maharashtra,Crime Against Children,Child Abuse,Female,0-12,4491,774,3717,3590,901
2007,Rural,Uttar Pradesh,Crime Against Men,Assault,Male,31-45,5359,3533,1826,4451,908
2006,Urban,Goa,Crime Against Children,Kidnapping,Female,18-30,8443,3381,5062,3417,5026
2005,Urban,Himachal Pradesh,Property Crime,Burglary,Male,60+,3489,3192,297,3277,212
2003,Urban,Tripura,Other Crimes,Drug Offense,Female,31-45,7265,5586,1679,6468,797
2006,Rural,Arunachal Pradesh,Crime Against Men,Extortion,Female,60+,3804,757,3047,2836,968
2001,Urban,Madhya Pradesh,Crime Against Children,Trafficking,Male,13-17,5716,3701,2015,5304,412
2001,Rural,Manipur,Other Crimes,Drug Offense,Male,46-60,3379,365,3014,2853,526
2009,Urban,Delhi,Other Crimes,Corruption,Female,18-30,6193,2002,4191,3390,2803
2006,Rural,Andhra Pradesh,Crime Against Men,Extortion,Female,18-30,755,652,103,691,64
2007,Urban,Odisha,Crime Against Women,Dowry Deaths,Male,18-30,9125,1620,7505,6959,2166
2001,Rural,Uttar Pradesh,Crime Against Men,Assault,Male,13-17,6465,5845,620,5868,597
2007,Rural,West Bengal,Property Crime,Burglary,Male,0-12,2641,200,2441,995,1646
2003,Rural,Karnataka,Property Crime,Arson,Female,46-60,6118,745,5373,3422,2696
2001,Urban,Kerala,Crime Against Men,Robbery,Male,18-30,5349,1855,3494,2832,2517
2009,Rural,Rajasthan,Other Crimes,Drug Offense,Female,0-12,5419,5188,231,5254,165
2007,Urban,Karnataka,Crime Against Children,Kidnapping,Female,60+,5048,2975,2073,3451,1597
2007,Rural,Haryana,Crime Against Men,Extortion,Male,46-60,1376,1183,193,1310,66
2003,Urban,Sikkim,Crime Against Children,Child Labor,Female,13-17,1859,672,1187,1269,590
2009,Rural,Manipur,Crime Against Men,Murder,Male,13-17,7812,6577,1235,6957,855
2009,Rural,Jammu & Kashmir,Crime Against Men,Robbery,Male,18-30,8979,488,8491,7293,1686
2002,Urban,Madhya Pradesh,Property Crime,Burglary,Female,31-45,3585,1173,2412,3142,443
2003,Urban,Himachal Pradesh,Other Crimes,Cyber Crime,Male,18-30,3163,1452,1711,2298,865
2005,Rural,Kerala,Crime Against Men,Assault,Male,13-17,6884,264,6620,6136,748
2001,Urban,Meghalaya,Crime Against Children,Child Labor,Male,46-60,4512,1257,3255,2847,1665
2007,Urban,Punjab,Crime Against Children,Child Labor,Female,13-17,4376,1775,2601,3481,895
2001,Rural,Odisha,Crime Against Women,Domestic Violence,Male,31-45,2963,516,2447,2511,452
2008,Rural,Madhya Pradesh,Crime Against Children,Kidnapping,Female,60+,7290,5695,1595,5909,1381
2003,Rural,Kerala,Crime Against Women,Rape,Male,46-60,3761,1590,2171,1779,1982
2005,Urban,Madhya Pradesh,Property Crime,Theft,Male,46-60,8410,5166,3244,7812,598
2003,Rural,Bihar,Crime Against Children,Child Abuse,Female,13-17,2524,823,1701,2354,170
2005,Rural,Meghalaya,Property Crime,Vandalism,Female,46-60,5335,2834,2501,3981,1354
2003,Rural,Uttarakhand,Crime Against Women,Rape,Female,31-45,829,623,206,692,137
2009,Urban,Assam,Other Crimes,Fraud,Female,60+,730,190,540,461,269
2003,Urban,Jammu & Kashmir,Crime Against Women,Rape,Female,18-30,6339,2675,3664,3385,2954
2005,Urban,Tamil Nadu,Other Crimes,Cyber Crime,Male,60+,7109,4115,2994,6326,783
2009,Rural,Mizoram,Crime Against Children,Trafficking,Male,60+,8099,4801,3298,5900,2199
2008,Urban,Himachal Pradesh,Other Crimes,Corruption,Female,46-60,3282,3122,160,3223,59
2009,Urban,Nagaland,Crime Against Children,Kidnapping,Female,60+,4010,1441,2569,3025,985
2004,Rural,Uttarakhand,Other Crimes,Corruption,Male,0-12,7089,6863,226,6948,141
2006,Rural,Tripura,Crime Against Men,Murder,Male,0-12,616,615,1,616,0
2010,Rural,Arunachal Pradesh,Other Crimes,Corruption,Male,46-60,8755,2700,6055,4476,4279
2007,Rural,Andhra Pradesh,Crime Against Children,Child Abuse,Female,0-12,1119,973,146,1087,32
2005,Rural,Andhra Pradesh,Crime Against Women,Molestation,Male,31-45,2683,615,2068,1382,1301
2006,Rural,Punjab,Property Crime,Theft,Male,46-60,5217,585,4632,4171,1046
2010,Urban,Uttar Pradesh,Crime Against Women,Rape,Female,18-30,9744,3265,6479,6323,3421
2001,Urban,Jammu & Kashmir,Other Crimes,Fraud,Female,18-30,9435,343,9092,5310,4125
2001,Urban,Punjab,Crime Against Men,Murder,Male,46-60,3205,270,2935,647,2558
2009,Rural,Haryana,Property Crime,Theft,Male,13-17,9919,400,9519,3577,6342
2004,Urban,Maharashtra,Crime Against Children,Child Labor,Female,18-30,5045,3480,1565,4105,940
2002,Rural,West Bengal,Crime Against Women,Rape,Male,13-17,9767,101,9666,7338,2429
2002,Rural,Madhya Pradesh,Other Crimes,Cyber Crime,Male,31-45,5268,3135,2133,3979,1289
2009,Rural,Karnataka,Crime Against Men,Assault,Female,18-30,992,787,205,956,36
2001,Rural,Odisha,Property Crime,Arson,Male,31-45,6672,1289,5383,1658,5014
2002,Rural,Nagaland,Property Crime,Burglary,Male,31-45,5925,3646,2279,5050,875
2003,Rural,Nagaland,Crime Against Women,Domestic Violence,Female,13-17,2783,1751,1032,2406,377
2008,Rural,Tamil Nadu,Crime Against Children,Trafficking,Female,13-17,871,123,748,295,576
2003,Urban,Rajasthan,Crime Against Children,Child Abuse,Female,31-45,5713,3419,2294,5092,621
2001,Rural,Karnataka,Property Crime,Theft,Female,46-60,7179,3814,3365,5974,1205
2007,Rural,Karnataka,Property Crime,Theft,Female,46-60,370,226,144,246,124
2007,Urban,Manipur,Other Crimes,Corruption,Female,46-60,3544,3292,252,3382,162
2006,Urban,Goa,Crime Against Women,Rape,Female,13-17,1040,520,520,1007,33
2007,Rural,Arunachal Pradesh,Other Crimes,Fraud,Male,60+,9078,3465,5613,5054,4024
2003,Rural,Gujarat,Crime Against Women,Dowry Deaths,Female,31-45,7117,5738,1379,6740,377
2002,Rural,Uttar Pradesh,Crime Against Men,Murder,Female,13-17,5824,3941,1883,4949,875
2010,Urban,Delhi,Property Crime,Theft,Female,60+,1887,579,1308,1716,171
2010,Rural,Delhi,Crime Against Women,Rape,Male,13-17,9033,4158,4875,6907,2126
2003,Rural,Tamil Nadu,Crime Against Children,Trafficking,Male,60+,6224,1490,4734,5381,843
2008,Rural,Kerala,Crime Against Men,Murder,Male,13-17,6346,5631,715,5955,391
2005,Urban,Sikkim,Crime Against Children,Kidnapping,Female,13-17,8194,4157,4037,5203,2991
2002,Urban,Jammu & Kashmir,Crime Against Women,Molestation,Female,31-45,9573,8166,1407,8194,1379
2002,Urban,Bihar,Crime Against Children,Child Labor,Male,13-17,6614,6075,539,6121,493
2006,Rural,Tripura,Property Crime,Arson,Male,60+,1398,1261,137,1290,108
2008,Urban,Odisha,Crime Against Women,Domestic Violence,Female,13-17,9866,8064,1802,8449,1417
2009,Urban,Bihar,Crime Against Children,Kidnapping,Male,18-30,7167,3534,3633,4345,2822
2007,Urban,Meghalaya,Crime Against Children,Child Labor,Female,46-60,8531,5796,2735,7449,1082
2005,Urban,Goa,Property Crime,Vandalism,Female,0-12,3872,911,2961,1962,1910
2008,Urban,Odisha,Other Crimes,Cyber Crime,Male,18-30,8275,4212,4063,5212,3063
2003,Urban,Kerala,Other Crimes,Drug Offense,Female,0-12,648,10,638,506,142
2001,Urban,Assam,Crime Against Children,Kidnapping,Female,18-30,911,243,668,603,308
2003,Rural,Odisha,Crime Against Women,Rape,Female,31-45,9974,9513,461,9562,412
2005,Rural,West Bengal,Crime Against Men,Robbery,Male,0-12,2779,2774,5,2776,3
2010,Urban,Andhra Pradesh,Crime Against Children,Child Labor,Female,46-60,611,312,299,520,91
2008,Rural,Tamil Nadu,Property Crime,Arson,Female,31-45,828,356,472,560,268
2005,Rural,Madhya Pradesh,Crime Against Men,Assault,Female,0-12,7746,347,7399,7735,11
2006,Rural,Odisha,Crime Against Children,Kidnapping,Female,13-17,3287,2128,1159,2667,620
2010,Urban,Kerala,Crime Against Women,Domestic Violence,Female,13-17,541,199,342,387,154
2004,Rural,Uttarakhand,Other Crimes,Cyber Crime,Male,31-45,2680,1556,1124,1883,797
2002,Urban,Nagaland,Other Crimes,Cyber Crime,Male,31-45,3577,432,3145,1245,2332
2007,Urban,Jharkhand,Crime Against Men,Murder,Female,31-45,4744,4078,666,4471,273
2003,Rural,Andhra Pradesh,Property Crime,Arson,Male,46-60,7119,1797,5322,4553,2566
2002,Urban,Tamil Nadu,Crime Against Women,Domestic Violence,Female,13-17,6394,5471,923,6199,195
2009,Urban,Arunachal Pradesh,Property Crime,Burglary,Female,13-17,5628,392,5236,2993,2635
2006,Rural,Punjab,Crime Against Children,Kidnapping,Female,46-60,3472,1233,2239,2547,925
2007,Urban,Odisha,Crime Against Women,Rape,Male,18-30,8699,1521,7178,4905,3794
2010,Rural,Himachal Pradesh,Other Crimes,Cyber Crime,Male,46-60,9342,8952,390,9332,10
2008,Rural,Odisha,Crime Against Children,Child Abuse,Female,0-12,7440,3327,4113,4674,2766
2008,Urban,Chhattisgarh,Other Crimes,Drug Offense,Male,46-60,4344,2962,1382,3236,1108
2001,Rural,Uttar Pradesh,Property Crime,Arson,Male,13-17,4754,3439,1315,4187,567
2001,Urban,Andhra Pradesh,Other Crimes,Fraud,Male,18-30,939,579,360,706,233
2007,Rural,Tamil Nadu,Crime Against Men,Extortion,Male,46-60,8126,3713,4413,7984,142
2008,Rural,Uttar Pradesh,Crime Against Men,Murder,Female,31-45,3467,1249,2218,2840,627
2010,Urban,Uttar Pradesh,Property Crime,Theft,Male,31-45,5702,5032,670,5236,466
2005,Rural,Tripura,Other Crimes,Fraud,Female,18-30,7769,4390,3379,6187,1582
2003,Urban,Sikkim,Crime Against Women,Dowry Deaths,Male,18-30,2889,775,2114,1060,1829
2010,Urban,Kerala,Crime Against Women,Molestation,Male,31-45,9759,2785,6974,7471,2288
2008,Rural,Jammu & Kashmir,Crime Against Men,Murder,Male,46-60,1081,375,706,520,561
2009,Urban,Delhi,Property Crime,Vandalism,Female,46-60,2928,811,2117,917,2011
2005,Urban,Rajasthan,Crime Against Men,Extortion,Male,31-45,104,77,27,83,21
2001,Urban,Andhra Pradesh,Crime Against Children,Kidnapping,Male,18-30,2858,2119,739,2151,707
2005,Rural,Odisha,Crime Against Children,Trafficking,Female,46-60,757,278,479,739,18
2002,Urban,Punjab,Property Crime,Theft,Male,60+,4116,629,3487,3669,447
2003,Urban,Arunachal Pradesh,Other Crimes,Drug Offense,Male,13-17,9770,6429,3341,9543,227
2009,Urban,Himachal Pradesh,Property Crime,Arson,Female,31-45,2381,1345,1036,1571,810
2001,Rural,Mizoram,Property Crime,Theft,Male,46-60,7916,6138,1778,6760,1156
2009,Urban,Meghalaya,Other Crimes,Corruption,Male,60+,3214,2666,548,3094,120
2009,Urban,Goa,Property Crime,Theft,Female,18-30,5092,1175,3917,4175,917
2008,Rural,Tripura,Property Crime,Vandalism,Female,13-17,5526,1541,3985,2436,3090
2002,Urban,Haryana,Crime Against Women,Molestation,Female,46-60,8247,3443,4804,4555,3692
2007,Urban,Punjab,Property Crime,Theft,Female,46-60,8060,7779,281,8041,19
2008,Urban,Tripura,Property Crime,Arson,Male,0-12,7118,5832,1286,5889,1229
2007,Urban,Punjab,Crime Against Women,Rape,Female,46-60,1095,5,1090,349,746
2002,Urban,Maharashtra,Property Crime,Theft,Male,18-30,7446,6300,1146,6378,1068
2010,Urban,Tripura,Crime Against Men,Extortion,Male,60+,6436,796,5640,6418,18
2007,Urban,Uttar Pradesh,Property Crime,Arson,Female,60+,9774,9331,443,9512,262
2006,Urban,Chhattisgarh,Crime Against Men,Robbery,Female,31-45,1201,486,715,577,624
2002,Urban,Gujarat,Crime Against Women,Rape,Female,46-60,6857,2463,4394,2519,4338
2001,Rural,West Bengal,Crime Against Women,Molestation,Male,0-12,6556,5495,1061,5708,848
2003,Urban,Tamil Nadu,Crime Against Women,Molestation,Female,0-12,3688,2069,1619,3616,72
2002,Urban,Haryana,Crime Against Men,Assault,Female,18-30,2624,1142,1482,1526,1098
2009,Rural,Madhya Pradesh,Crime Against Men,Assault,Female,18-30,8924,14,8910,1007,7917
2008,Rural,Manipur,Property Crime,Burglary,Male,0-12,5240,888,4352,2438,2802
2010,Rural,Maharashtra,Crime Against Men,Extortion,Male,60+,1245,18,1227,730,515
2003,Urban,Sikkim,Crime Against Children,Child Labor,Female,31-45,4737,218,4519,3427,1310
2003,Rural,Madhya Pradesh,Property Crime,Burglary,Male,60+,6684,5731,953,6060,624
2004,Urban,Tripura,Crime Against Men,Assault,Female,13-17,9082,3425,5657,6522,2560
2004,Rural,Odisha,Other Crimes,Drug Offense,Female,31-45,8605,3644,4961,7804,801
2003,Urban,Mizoram,Crime Against Men,Extortion,Male,60+,9817,1391,8426,6952,2865
2002,Rural,Arunachal Pradesh,Other Crimes,Cyber Crime,Female,60+,1061,312,749,602,459
2010,Urban,Telangana,Crime Against Women,Dowry Deaths,Male,60+,6304,1594,4710,6191,113
2002,Rural,Madhya Pradesh,Other Crimes,Fraud,Female,18-30,2093,1330,763,1418,675
2008,Urban,Haryana,Crime Against Men,Murder,Female,60+,1773,1740,33,1764,9
2003,Rural,Sikkim,Other Crimes,Cyber Crime,Female,13-17,3256,826,2430,2095,1161
2003,Rural,Mizoram,Crime Against Men,Robbery,Female,31-45,1044,921,123,1040,4
2010,Urban,Kerala,Crime Against Children,Trafficking,Male,31-45,2606,768,1838,1773,833
2003,Urban,Meghalaya,Other Crimes,Fraud,Female,60+,5590,2177,3413,2253,3337
2009,Urban,Sikkim,Crime Against Children,Kidnapping,Female,46-60,2279,1483,796,1797,482
2008,Urban,Goa,Crime Against Children,Child Abuse,Female,18-30,1878,1667,211,1720,158
2007,Urban,Manipur,Other Crimes,Fraud,Female,0-12,3902,3581,321,3860,42
2008,Rural,Goa,Crime Against Women,Domestic Violence,Male,60+,6617,829,5788,5159,1458
2005,Urban,Goa,Crime Against Men,Robbery,Female,46-60,8360,3486,4874,7985,375
2009,Rural,Tamil Nadu,Other Crimes,Fraud,Male,60+,5981,3732,2249,5439,542
2004,Rural,Assam,Crime Against Children,Child Labor,Female,60+,3374,347,3027,847,2527
2002,Urban,Tamil Nadu,Other Crimes,Fraud,Female,0-12,3127,3037,90,3064,63
2009,Urban,Meghalaya,Crime Against Children,Child Abuse,Male,31-45,7986,5642,2344,7639,347
2003,Urban,Maharashtra,Other Crimes,Cyber Crime,Female,13-17,3937,3093,844,3295,642
2009,Rural,Jammu & Kashmir,Other Crimes,Drug Offense,Female,13-17,5244,3195,2049,4598,646
2005,Urban,Punjab,Property Crime,Vandalism,Female,31-45,959,645,314,748,211
2010,Urban,Sikkim,Crime Against Men,Assault,Male,0-12,6702,3416,3286,4576,2126
2006,Rural,Tamil Nadu,Crime Against Children,Kidnapping,Male,46-60,9320,4471,4849,7147,2173
2001,Urban,Tamil Nadu,Crime Against Children,Child Labor,Female,31-45,7543,1752,5791,4962,2581
2010,Rural,Nagaland,Crime Against Men,Murder,Female,18-30,1632,265,1367,1101,531
2009,Rural,Andhra Pradesh,Crime Against Men,Murder,Male,13-17,5502,1963,3539,2097,3405
2005,Rural,Andhra Pradesh,Crime Against Men,Extortion,Female,13-17,5172,59,5113,2755,2417
2003,Urban,Chhattisgarh,Property Crime,Burglary,Male,31-45,3908,2710,1198,2796,1112
2001,Rural,Nagaland,Crime Against Women,Dowry Deaths,Female,60+,5351,1045,4306,2160,3191
2008,Urban,Assam,Crime Against Children,Trafficking,Male,0-12,9645,6003,3642,6598,3047
2007,Rural,Bihar,Property Crime,Arson,Female,31-45,4010,1694,2316,3610,400
2003,Rural,Delhi,Crime Against Women,Rape,Male,60+,2238,85,2153,397,1841
2006,Rural,Delhi,Crime Against Women,Domestic Violence,Female,18-30,2922,1367,1555,2664,258
2010,Rural,Karnataka,Crime Against Men,Extortion,Female,13-17,6984,230,6754,4959,2025
2010,Rural,Punjab,Other Crimes,Drug Offense,Male,31-45,2245,1735,510,2035,210
2002,Urban,Bihar,Crime Against Children,Child Abuse,Female,13-17,8826,2585,6241,6760,2066
2001,Rural,Andhra Pradesh,Other Crimes,Fraud,Female,13-17,7663,1246,6417,5749,1914
2002,Rural,Kerala,Crime Against Men,Assault,Male,13-17,861,722,139,815,46
2008,Rural,Punjab,Crime Against Women,Dowry Deaths,Female,0-12,2574,2240,334,2541,33
2001,Rural,Andhra Pradesh,Crime Against Women,Dowry Deaths,Female,0-12,7848,1504,6344,6267,1581
2007,Rural,Goa,Crime Against Men,Extortion,Male,31-45,2324,204,2120,1675,649
2005,Rural,Punjab,Property Crime,Arson,Female,46-60,1196,1122,74,1184,12
2004,Urban,Madhya Pradesh,Crime Against Children,Kidnapping,Male,18-30,3254,865,2389,2840,414
2005,Urban,Bihar,Other Crimes,Corruption,Male,60+,7949,1506,6443,6051,1898
2010,Urban,Meghalaya,Crime Against Children,Trafficking,Male,46-60,5593,3739,1854,5173,420
2009,Rural,Madhya Pradesh,Crime Against Children,Child Abuse,Female,13-17,8466,8006,460,8435,31
2004,Rural,Madhya Pradesh,Crime Against Children,Child Labor,Male,31-45,8486,774,7712,2996,5490
2002,Rural,Delhi,Crime Against Men,Extortion,Female,13-17,5560,2328,3232,4663,897
2006,Rural,Himachal Pradesh,Other Crimes,Corruption,Male,18-30,817,757,60,771,46
2003,Urban,Delhi,Other Crimes,Corruption,Male,31-45,8946,3739,5207,8553,393
2004,Rural,Uttar Pradesh,Other Crimes,Cyber Crime,Male,60+,3711,2301,1410,2822,889
2007,Urban,Mizoram,Crime Against Children,Kidnapping,Female,60+,9646,5891,3755,9400,246
2008,Rural,Tamil Nadu,Crime Against Children,Child Abuse,Female,18-30,3062,1256,1806,1409,1653
2005,Urban,Karnataka,Crime Against Women,Molestation,Male,13-17,1420,1088,332,1183,237
2010,Urban,Rajasthan,Crime Against Women,Rape,Female,60+,6684,4032,2652,5084,1600
2001,Urban,Meghalaya,Property Crime,Theft,Female,31-45,3602,1808,1794,3411,191
2007,Urban,Telangana,Crime Against Children,Child Abuse,Male,31-45,241,173,68,234,7
2009,Rural,Chhattisgarh,Other Crimes,Cyber Crime,Female,13-17,4814,4584,230,4813,1
2004,Rural,Gujarat,Other Crimes,Corruption,Female,60+,9964,6858,3106,9725,239
2004,Rural,Uttarakhand,Crime Against Men,Robbery,Male,31-45,4391,3659,732,3986,405
2009,Urban,Goa,Crime Against Women,Rape,Female,0-12,8958,2528,6430,3243,5715
2003,Rural,Kerala,Crime Against Women,Molestation,Male,31-45,4223,18,4205,1482,2741
2010,Urban,Uttar Pradesh,Crime Against Women,Rape,Male,46-60,8613,3187,5426,3776,4837
2002,Urban,Haryana,Other Crimes,Cyber Crime,Male,60+,9430,2470,6960,8122,1308
2005,Rural,Karnataka,Property Crime,Burglary,Female,18-30,3463,322,3141,3201,262
2005,Urban,Manipur,Crime Against Women,Rape,Female,13-17,8480,3018,5462,5631,2849
2007,Urban,Himachal Pradesh,Crime Against Women,Rape,Male,13-17,3610,133,3477,1028,2582
2003,Rural,Nagaland,Crime Against Women,Rape,Female,46-60,4071,716,3355,2271,1800
2003,Rural,Odisha,Crime Against Children,Kidnapping,Male,0-12,3682,2607,1075,2657,1025
2004,Urban,Maharashtra,Crime Against Men,Robbery,Male,46-60,2949,800,2149,1410,1539
2010,Rural,Punjab,Crime Against Women,Dowry Deaths,Female,46-60,370,174,196,357,13
2007,Urban,Kerala,Crime Against Men,Assault,Female,31-45,7018,5260,1758,5565,1453
2010,Urban,Sikkim,Other Crimes,Fraud,Male,46-60,2250,866,1384,1041,1209
2002,Rural,Uttarakhand,Crime Against Women,Dowry Deaths,Female,46-60,1929,1759,170,1899,30
2003,Rural,Telangana,Other Crimes,Fraud,Female,46-60,8179,3825,4354,3962,4217
2002,Rural,Bihar,Crime Against Children,Trafficking,Female,46-60,2513,1953,560,2299,214
2004,Rural,Manipur,Crime Against Children,Child Abuse,Female,46-60,8051,7378,673,7412,639
2008,Urban,Haryana,Other Crimes,Fraud,Male,46-60,9809,6396,3413,6413,3396
2003,Rural,Delhi,Crime Against Men,Robbery,Male,31-45,7159,4578,2581,6530,629
2006,Rural,Telangana,Crime Against Women,Dowry Deaths,Male,31-45,1125,230,895,534,591
2009,Urban,Nagaland,Other Crimes,Corruption,Female,31-45,306,155,151,237,69
2005,Urban,Karnataka,Other Crimes,Cyber Crime,Male,0-12,6286,3812,2474,6249,37
2010,Urban,Nagaland,Other Crimes,Corruption,Male,18-30,4021,2353,1668,2741,1280
2004,Rural,Chhattisgarh,Crime Against Women,Rape,Male,13-17,6308,2651,3657,4871,1437
2005,Urban,Jharkhand,Property Crime,Burglary,Female,0-12,1849,780,1069,1361,488
2005,Urban,Nagaland,Other Crimes,Fraud,Female,60+,6524,5018,1506,5272,1252
2010,Rural,Uttarakhand,Other Crimes,Drug Offense,Male,31-45,2389,808,1581,1536,853
2006,Rural,Jammu & Kashmir,Crime Against Children,Child Labor,Female,60+,1693,1620,73,1641,52
2008,Rural,West Bengal,Crime Against Children,Child Abuse,Female,60+,8143,7520,623,7941,202
2009,Urban,Kerala,Other Crimes,Fraud,Female,18-30,557,40,517,347,210
2005,Urban,Jharkhand,Other Crimes,Corruption,Female,31-45,2249,1181,1068,1964,285
2010,Urban,Punjab,Other Crimes,Cyber Crime,Male,18-30,1830,1641,189,1764,66
2006,Urban,Rajasthan,Other Crimes,Corruption,Male,13-17,525,262,263,484,41
2006,Urban,Arunachal Pradesh,Property Crime,Vandalism,Female,13-17,2962,509,2453,2609,353
2010,Urban,Delhi,Property Crime,Arson,Male,0-12,3169,522,2647,1498,1671
2008,Rural,West Bengal,Crime Against Women,Rape,Male,60+,1981,692,1289,714,1267
2010,Urban,Bihar,Crime Against Women,Rape,Female,31-45,876,202,674,273,603
2005,Rural,Delhi,Crime Against Children,Trafficking,Male,60+,2950,2646,304,2770,180
2009,Rural,Gujarat,Property Crime,Arson,Male,46-60,2272,908,1364,1416,856
2001,Rural,Manipur,Other Crimes,Drug Offense,Male,31-45,1834,294,1540,519,1315
2008,Rural,Telangana,Crime Against Children,Kidnapping,Female,60+,3147,2838,309,2875,272
2007,Rural,Rajasthan,Other Crimes,Cyber Crime,Female,18-30,891,434,457,863,28
2010,Rural,Sikkim,Property Crime,Vandalism,Female,0-12,2556,2420,136,2506,50
2008,Urban,Bihar,Crime Against Children,Child Abuse,Male,46-60,8456,6025,2431,7097,1359
2009,Urban,Telangana,Crime Against Men,Robbery,Male,31-45,8586,8334,252,8444,142
2007,Rural,Kerala,Crime Against Men,Extortion,Female,31-45,6203,2296,3907,3023,3180
2004,Rural,Uttarakhand,Crime Against Men,Extortion,Male,31-45,1524,1235,289,1290,234
2010,Urban,Meghalaya,Crime Against Children,Kidnapping,Male,0-12,3990,3395,595,3568,422
2009,Urban,Rajasthan,Crime Against Children,Child Abuse,Male,18-30,2376,1903,473,1940,436
2005,Urban,Odisha,Crime Against Women,Dowry Deaths,Male,60+,6529,2054,4475,2711,3818
2006,Rural,Assam,Property Crime,Vandalism,Male,0-12,6224,2830,3394,6066,158
2002,Urban,Meghalaya,Crime Against Women,Domestic Violence,Male,13-17,103,60,43,72,31
2008,Urban,Goa,Crime Against Children,Child Abuse,Male,31-45,6129,5424,705,5867,262
2001,Rural,Jammu & Kashmir,Crime Against Men,Extortion,Female,0-12,7712,3017,4695,5401,2311
2004,Rural,Haryana,Other Crimes,Cyber Crime,Female,46-60,1654,354,1300,1391,263
2003,Rural,Chhattisgarh,Property Crime,Burglary,Male,60+,4995,3770,1225,4814,181
2010,Rural,Maharashtra,Property Crime,Burglary,Male,0-12,9526,4502,5024,8892,634
2002,Rural,Uttarakhand,Property Crime,Theft,Male,31-45,7372,7342,30,7344,28
2002,Urban,Himachal Pradesh,Crime Against Men,Murder,Female,0-12,1660,1126,534,1245,415
2006,Urban,Nagaland,Crime Against Men,Murder,Male,46-60,651,111,540,314,337
2005,Rural,Odisha,Property Crime,Arson,Female,60+,1657,802,855,984,673
2010,Rural,Maharashtra,Crime Against Men,Assault,Male,0-12,3151,1265,1886,2622,529
2004,Rural,Karnataka,Other Crimes,Cyber Crime,Female,60+,977,92,885,854,123
2007,Urban,Karnataka,Crime Against Women,Dowry Deaths,Male,18-30,6309,582,5727,3164,3145
2010,Rural,Kerala,Crime Against Children,Child Abuse,Male,46-60,5863,1431,4432,3471,2392
2009,Urban,Bihar,Other Crimes,Fraud,Male,46-60,9666,4261,5405,6621,3045
2001,Rural,West Bengal,Property Crime,Burglary,Female,60+,8025,2744,5281,4071,3954
2001,Rural,Kerala,Crime Against Women,Dowry Deaths,Female,46-60,1061,221,840,473,588
2001,Rural,Maharashtra,Crime Against Women,Rape,Male,18-30,9083,2580,6503,8740,343
2005,Urban,Manipur,Other Crimes,Corruption,Male,18-30,7986,5125,2861,7082,904
2010,Urban,Delhi,Crime Against Children,Trafficking,Female,31-45,9285,480,8805,8445,840
2002,Urban,Madhya Pradesh,Crime Against Men,Extortion,Female,0-12,3427,2079,1348,2975,452
2008,Urban,Haryana,Crime Against Women,Molestation,Female,0-12,4034,2719,1315,3535,499
2009,Rural,Bihar,Crime Against Men,Extortion,Female,31-45,3823,379,3444,3358,465
2003,Urban,Rajasthan,Other Crimes,Fraud,Male,0-12,5197,3159,2038,4580,617
2006,Rural,Madhya Pradesh,Property Crime,Vandalism,Male,0-12,4722,620,4102,2756,1966
2001,Urban,Haryana,Crime Against Women,Rape,Male,18-30,6879,2527,4352,4789,2090
2010,Urban,Odisha,Crime Against Children,Kidnapping,Female,0-12,3612,3049,563,3316,296
2005,Urban,Telangana,Crime Against Children,Kidnapping,Male,0-12,1707,354,1353,553,1154
2006,Urban,Karnataka,Property Crime,Burglary,Male,18-30,7344,504,6840,4926,2418
2008,Rural,Madhya Pradesh,Property Crime,Burglary,Male,13-17,1249,561,688,622,627
2002,Urban,West Bengal,Crime Against Children,Trafficking,Female,46-60,4202,349,3853,873,3329
2002,Rural,Bihar,Crime Against Men,Murder,Female,18-30,4676,3368,1308,3795,881
2006,Rural,West Bengal,Other Crimes,Cyber Crime,Female,0-12,7182,321,6861,4996,2186
2006,Urban,Sikkim,Property Crime,Arson,Female,18-30,8810,8200,610,8274,536
2001,Rural,Tripura,Crime Against Children,Child Abuse,Female,60+,7381,3759,3622,4069,3312
2008,Rural,Punjab,Crime Against Men,Assault,Male,31-45,5354,1863,3491,3310,2044
2006,Urban,Maharashtra,Crime Against Children,Trafficking,Female,18-30,432,130,302,269,163
2003,Urban,Uttar Pradesh,Crime Against Children,Child Labor,Female,46-60,2619,1255,1364,2041,578
2008,Rural,Goa,Property Crime,Vandalism,Female,18-30,7880,7665,215,7835,45
2009,Urban,Uttarakhand,Other Crimes,Fraud,Female,0-12,8086,1729,6357,7648,438
2003,Urban,Arunachal Pradesh,Other Crimes,Drug Offense,Female,31-45,4350,3750,600,4113,237
2003,Rural,Jharkhand,Crime Against Men,Robbery,Male,60+,4980,1587,3393,2360,2620
2008,Rural,Gujarat,Crime Against Children,Kidnapping,Female,60+,6900,2187,4713,2935,3965
2005,Urban,Maharashtra,Crime Against Women,Rape,Male,13-17,8473,4894,3579,8185,288
2001,Urban,Karnataka,Other Crimes,Fraud,Female,31-45,1405,810,595,1246,159
2008,Urban,Uttar Pradesh,Crime Against Children,Child Labor,Female,0-12,3679,3006,673,3417,262
2009,Urban,Tamil Nadu,Crime Against Children,Kidnapping,Male,18-30,7483,5507,1976,6971,512
2002,Rural,Assam,Crime Against Men,Extortion,Female,46-60,7105,1077,6028,4956,2149
2005,Rural,Delhi,Crime Against Children,Trafficking,Female,0-12,8377,8156,221,8232,145
2008,Rural,Manipur,Property Crime,Vandalism,Female,60+,3876,1091,2785,3162,714
2001,Rural,Himachal Pradesh,Crime Against Men,Murder,Female,13-17,8139,6981,1158,8065,74
2002,Rural,Rajasthan,Property Crime,Burglary,Male,18-30,6602,3395,3207,4551,2051
2004,Urban,Goa,Crime Against Men,Assault,Male,46-60,8057,3470,4587,8006,51
2008,Urban,Mizoram,Crime Against Children,Child Labor,Female,13-17,1706,44,1662,1265,441
2009,Rural,Bihar,Other Crimes,Cyber Crime,Male,18-30,8993,3460,5533,7703,1290
2008,Rural,Rajasthan,Crime Against Women,Molestation,Female,18-30,3360,791,2569,2768,592
2009,Urban,Odisha,Crime Against Men,Assault,Female,13-17,3742,3633,109,3642,100
2006,Urban,Arunachal Pradesh,Crime Against Women,Molestation,Male,31-45,6433,2910,3523,4468,1965
2009,Rural,West Bengal,Other Crimes,Cyber Crime,Male,0-12,5890,5766,124,5880,10
2002,Urban,Manipur,Crime Against Men,Assault,Male,13-17,1399,1362,37,1396,3
2010,Urban,Meghalaya,Crime Against Men,Murder,Male,31-45,1791,466,1325,613,1178
2001,Urban,Nagaland,Crime Against Men,Murder,Female,31-45,5633,5064,569,5308,325
2004,Urban,Maharashtra,Property Crime,Arson,Male,13-17,771,703,68,769,2
2001,Urban,Haryana,Crime Against Men,Robbery,Female,18-30,4813,3770,1043,3856,957
2001,Rural,Telangana,Crime Against Women,Rape,Female,13-17,4778,1888,2890,2770,2008
2007,Urban,Arunachal Pradesh,Crime Against Women,Domestic Violence,Male,31-45,3467,1189,2278,2769,698
2008,Rural,Madhya Pradesh,Property Crime,Arson,Female,13-17,3149,3062,87,3077,72
2006,Rural,Meghalaya,Other Crimes,Corruption,Male,60+,9842,1151,8691,8570,1272
2008,Urban,West Bengal,Other Crimes,Corruption,Female,31-45,9242,888,8354,7329,1913
2002,Rural,Karnataka,Crime Against Children,Trafficking,Male,60+,4512,4471,41,4484,28
2006,Rural,Goa,Other Crimes,Corruption,Female,18-30,649,405,244,415,234
2009,Urban,Sikkim,Other Crimes,Corruption,Female,60+,609,83,526,348,261
2005,Urban,Bihar,Crime Against Women,Dowry Deaths,Female,31-45,5907,1458,4449,4287,1620
2008,Urban,Gujarat,Crime Against Women,Domestic Violence,Female,0-12,2659,1796,863,1972,687
2007,Urban,West Bengal,Property Crime,Vandalism,Male,18-30,5771,3390,2381,4208,1563
2004,Rural,Uttar Pradesh,Property Crime,Arson,Female,18-30,4135,1172,2963,3493,642
2009,Rural,Himachal Pradesh,Crime Against Men,Extortion,Male,60+,6264,3512,2752,4943,1321
2007,Urban,Andhra Pradesh,Crime Against Men,Extortion,Female,60+,396,79,317,172,224
2007,Urban,Manipur,Property Crime,Arson,Female,0-12,9513,2281,7232,4178,5335
2007,Urban,Sikkim,Other Crimes,Fraud,Male,31-45,1374,1342,32,1366,8
2003,Urban,Rajasthan,Crime Against Men,Murder,Female,0-12,6859,202,6657,5745,1114
2002,Urban,Assam,Property Crime,Burglary,Female,46-60,7027,1222,5805,4258,2769
2006,Urban,Uttar Pradesh,Other Crimes,Corruption,Female,13-17,5778,3852,1926,5232,546
2006,Urban,Uttar Pradesh,Crime Against Children,Child Abuse,Female,0-12,4353,2150,2203,3333,1020
2005,Urban,Andhra Pradesh,Crime Against Children,Child Abuse,Male,0-12,7349,4384,2965,4985,2364
2005,Rural,Maharashtra,Property Crime,Theft,Female,0-12,6685,1367,5318,5354,1331
2006,Rural,Mizoram,Crime Against Men,Robbery,Female,46-60,9202,8595,607,8683,519
2002,Rural,Uttarakhand,Other Crimes,Fraud,Male,0-12,3882,3395,487,3492,390
2009,Urban,Gujarat,Crime Against Men,Extortion,Female,31-45,7339,6429,910,6508,831
2001,Urban,Odisha,Crime Against Women,Rape,Male,46-60,1648,1552,96,1583,65
2001,Urban,Sikkim,Crime Against Men,Murder,Male,0-12,1584,178,1406,1228,356
2002,Rural,West Bengal,Crime Against Women,Domestic Violence,Male,13-17,8550,8370,180,8510,40
2009,Rural,Himachal Pradesh,Crime Against Children,Child Labor,Male,60+,1637,550,1087,737,900
2009,Rural,Meghalaya,Crime Against Women,Dowry Deaths,Female,31-45,3006,661,2345,1599,1407
2009,Urban,Tripura,Property Crime,Arson,Female,0-12,3605,723,2882,2973,632
2009,Rural,Odisha,Crime Against Men,Extortion,Female,60+,9842,7530,2312,9302,540
2009,Rural,Delhi,Property Crime,Arson,Male,18-30,5245,4010,1235,4431,814
2010,Rural,Andhra Pradesh,Other Crimes,Fraud,Male,0-12,9653,7464,2189,7536,2117
2005,Rural,Uttar Pradesh,Crime Against Children,Child Abuse,Female,60+,6344,1994,4350,3169,3175
2002,Rural,Nagaland,Property Crime,Vandalism,Male,18-30,717,220,497,484,233
2002,Urban,Uttar Pradesh,Other Crimes,Corruption,Male,31-45,2502,1979,523,2259,243
2005,Rural,Tripura,Property Crime,Theft,Female,31-45,8060,2658,5402,7929,131
2010,Urban,Chhattisgarh,Crime Against Men,Extortion,Male,31-45,2144,629,1515,1134,1010
2007,Urban,Punjab,Crime Against Men,Extortion,Female,0-12,4099,3671,428,3678,421
2002,Urban,Bihar,Crime Against Children,Trafficking,Female,60+,7804,926,6878,7470,334
2010,Urban,Nagaland,Crime Against Children,Trafficking,Female,46-60,1651,159,1492,670,981
2008,Urban,Maharashtra,Crime Against Women,Domestic Violence,Male,31-45,2439,76,2363,399,2040
2001,Rural,Bihar,Other Crimes,Corruption,Female,31-45,7630,4600,3030,7017,613
2010,Rural,Haryana,Crime Against Men,Murder,Female,18-30,2384,2112,272,2153,231
2002,Rural,Jammu & Kashmir,Crime Against Children,Child Abuse,Male,60+,5242,2991,2251,4994,248
2001,Urban,Tripura,Other Crimes,Corruption,Female,31-45,5518,3214,2304,4168,1350
2009,Urban,Maharashtra,Other Crimes,Fraud,Female,60+,8310,2868,5442,4269,4041
2005,Urban,Goa,Crime Against Children,Trafficking,Male,18-30,430,422,8,427,3
2002,Rural,Punjab,Crime Against Men,Murder,Female,13-17,3618,2518,1100,2587,1031
2003,Rural,Sikkim,Crime Against Men,Extortion,Female,46-60,7710,5782,1928,5913,1797
2004,Urban,Gujarat,Crime Against Men,Extortion,Male,18-30,785,221,564,594,191
2008,Rural,Mizoram,Crime Against Children,Child Labor,Male,13-17,5195,4988,207,5059,136
2009,Rural,Haryana,Crime Against Children,Child Abuse,Male,0-12,8429,5121,3308,6644,1785
2009,Rural,Telangana,Property Crime,Theft,Male,13-17,3099,2733,366,2917,182
2005,Rural,Meghalaya,Property Crime,Burglary,Male,13-17,1281,448,833,1028,253
2001,Rural,Arunachal Pradesh,Crime Against Men,Murder,Female,18-30,5705,648,5057,696,5009
2003,Rural,Delhi,Other Crimes,Fraud,Male,0-12,7073,5166,1907,5847,1226
2003,Urban,Telangana,Crime Against Women,Domestic Violence,Female,18-30,8204,547,7657,1288,6916
2002,Urban,Tripura,Crime Against Men,Robbery,Male,0-12,1677,357,1320,1171,506
2007,Urban,Rajasthan,Crime Against Men,Extortion,Female,60+,5331,471,4860,3099,2232
2010,Rural,Arunachal Pradesh,Crime Against Women,Molestation,Female,46-60,8780,6093,2687,8242,538
2006,Urban,Madhya Pradesh,Other Crimes,Drug Offense,Male,46-60,6139,4090,2049,5823,316
2010,Rural,Karnataka,Crime Against Women,Domestic Violence,Male,31-45,6259,2741,3518,4339,1920
2010,Urban,Delhi,Crime Against Women,Rape,Female,0-12,949,740,209,882,67
2004,Urban,Rajasthan,Property Crime,Burglary,Female,60+,6688,5771,917,6159,529
2004,Urban,Maharashtra,Other Crimes,Cyber Crime,Female,60+,7784,2078,5706,7389,395
2006,Urban,Kerala,Crime Against Children,Child Labor,Male,0-12,6737,3990,2747,6262,475
2001,Urban,Himachal Pradesh,Property Crime,Theft,Male,0-12,8100,3519,4581,8003,97
2008,Rural,Telangana,Crime Against Men,Extortion,Male,46-60,5809,2044,3765,2538,3271
2007,Rural,Haryana,Other Crimes,Cyber Crime,Male,46-60,3268,1885,1383,2787,481
2003,Urban,Manipur,Other Crimes,Fraud,Male,13-17,3590,1531,2059,2115,1475
2010,Rural,Telangana,Property Crime,Theft,Female,46-60,6436,2794,3642,4621,1815
2004,Urban,Gujarat,Crime Against Women,Dowry Deaths,Male,46-60,1554,525,1029,1320,234
2005,Rural,Tripura,Crime Against Children,Child Labor,Female,13-17,8472,3145,5327,8446,26
2008,Urban,Madhya Pradesh,Other Crimes,Corruption,Male,31-45,4035,751,3284,3464,571
2006,Rural,Sikkim,Property Crime,Arson,Male,31-45,5418,3964,1454,4483,935
2002,Urban,Madhya Pradesh,Property Crime,Vandalism,Male,46-60,7451,7418,33,7427,24
2004,Urban,Tamil Nadu,Crime Against Men,Robbery,Male,13-17,7635,3902,3733,6368,1267
2003,Rural,Uttarakhand,Crime Against Children,Child Labor,Female,18-30,9790,6551,3239,8355,1435
2007,Urban,Delhi,Crime Against Children,Kidnapping,Male,0-12,472,290,182,444,28
2009,Urban,Himachal Pradesh,Crime Against Men,Extortion,Male,46-60,2846,511,2335,948,1898
2004,Rural,Mizoram,Crime Against Men,Murder,Male,13-17,4919,1784,3135,4838,81
2005,Urban,Jammu & Kashmir,Crime Against Children,Kidnapping,Female,31-45,9779,8440,1339,8789,990
2001,Urban,Nagaland,Crime Against Children,Child Abuse,Male,18-30,8312,7336,976,8030,282
2006,Rural,Telangana,Crime Against Women,Molestation,Female,18-30,9053,6331,2722,7814,1239
2005,Urban,Manipur,Other Crimes,Drug Offense,Female,60+,9800,9171,629,9722,78
2008,Urban,Jharkhand,Crime Against Women,Rape,Female,60+,2619,2471,148,2615,4
2010,Urban,Manipur,Crime Against Men,Robbery,Female,31-45,4191,3119,1072,3756,435
2007,Urban,Maharashtra,Property Crime,Arson,Female,0-12,5082,1169,3913,4638,444
2005,Rural,Jammu & Kashmir,Property Crime,Theft,Female,0-12,8704,700,8004,4233,4471
2008,Urban,Haryana,Other Crimes,Cyber Crime,Male,0-12,3965,3463,502,3545,420
2009,Rural,Jharkhand,Other Crimes,Cyber Crime,Female,60+,8427,2956,5471,7721,706
2007,Urban,Uttarakhand,Other Crimes,Cyber Crime,Male,60+,2683,1616,1067,2526,157
2007,Rural,Tamil Nadu,Crime Against Children,Kidnapping,Female,0-12,398,27,371,371,27
2003,Urban,Jammu & Kashmir,Other Crimes,Drug Offense,Male,0-12,5929,1233,4696,2155,3774
2010,Rural,Haryana,Crime Against Men,Murder,Female,31-45,2738,1550,1188,1690,1048
2009,Rural,Haryana,Property Crime,Theft,Female,13-17,540,79,461,402,138
2009,Rural,Uttar Pradesh,Crime Against Children,Kidnapping,Male,18-30,262,47,215,87,175
2005,Urban,Telangana,Property Crime,Vandalism,Female,31-45,8181,5385,2796,7560,621
2005,Urban,Manipur,Property Crime,Arson,Female,18-30,4668,4418,250,4650,18
2007,Rural,Andhra Pradesh,Crime Against Children,Trafficking,Male,13-17,266,39,227,250,16
2001,Rural,Telangana,Crime Against Women,Molestation,Male,31-45,1541,509,1032,825,716
2001,Rural,West Bengal,Crime Against Children,Child Abuse,Male,0-12,1785,311,1474,1199,586
2004,Rural,Maharashtra,Crime Against Children,Child Abuse,Female,31-45,7922,285,7637,3319,4603
2010,Rural,Himachal Pradesh,Other Crimes,Drug Offense,Male,13-17,1925,1182,743,1536,389
2004,Urban,Haryana,Crime Against Children,Child Labor,Male,46-60,1316,648,668,977,339
2002,Rural,Uttarakhand,Crime Against Men,Extortion,Female,13-17,2331,745,1586,1151,1180
2007,Urban,Andhra Pradesh,Property Crime,Theft,Female,60+,5320,738,4582,2841,2479
2001,Urban,Chhattisgarh,Property Crime,Burglary,Female,13-17,4603,2553,2050,2784,1819
2007,Rural,Chhattisgarh,Property Crime,Arson,Female,18-30,459,95,364,106,353
2008,Urban,Maharashtra,Crime Against Children,Kidnapping,Male,18-30,7101,1700,5401,3348,3753
2010,Rural,Bihar,Crime Against Children,Trafficking,Male,60+,3744,761,2983,3082,662
2005,Urban,Meghalaya,Crime Against Children,Trafficking,Female,46-60,3686,1956,1730,2164,1522
2006,Rural,Meghalaya,Property Crime,Arson,Male,13-17,5553,1946,3607,4166,1387
2001,Urban,Madhya Pradesh,Other Crimes,Fraud,Female,46-60,1497,317,1180,779,718
2003,Urban,West Bengal,Other Crimes,Fraud,Male,18-30,2276,1878,398,1965,311
2001,Rural,Meghalaya,Crime Against Women,Dowry Deaths,Male,31-45,1035,203,832,766,269
2005,Rural,Jammu & Kashmir,Crime Against Men,Robbery,Female,13-17,9814,1236,8578,9174,640
2005,Rural,Tripura,Crime Against Women,Rape,Female,0-12,1364,1093,271,1227,137
2010,Urban,Maharashtra,Crime Against Women,Domestic Violence,Female,13-17,3907,2784,1123,3111,796
2005,Urban,Mizoram,Crime Against Women,Dowry Deaths,Female,18-30,446,158,288,213,233
2001,Rural,Rajasthan,Other Crimes,Drug Offense,Female,60+,7104,4391,2713,5447,1657
2003,Urban,Tripura,Property Crime,Burglary,Female,60+,6918,2925,3993,5157,1761
2001,Rural,Bihar,Property Crime,Theft,Male,31-45,1848,1539,309,1766,82
2001,Rural,Gujarat,Other Crimes,Drug Offense,Male,46-60,4836,2439,2397,2550,2286
2009,Urban,Jharkhand,Crime Against Children,Trafficking,Female,18-30,8369,805,7564,6516,1853
2006,Rural,Maharashtra,Crime Against Women,Molestation,Male,18-30,4443,3840,603,3850,593
2007,Rural,West Bengal,Property Crime,Arson,Female,46-60,3369,1219,2150,3354,15
2007,Urban,West Bengal,Crime Against Women,Dowry Deaths,Female,60+,1878,191,1687,702,1176
2009,Urban,Sikkim,Crime Against Men,Extortion,Female,18-30,8086,7030,1056,7250,836
2002,Urban,Chhattisgarh,Crime Against Women,Dowry Deaths,Female,18-30,7770,7180,590,7614,156
2001,Urban,Tripura,Crime Against Children,Child Labor,Female,60+,3208,1459,1749,2255,953
2004,Urban,Rajasthan,Crime Against Men,Robbery,Female,13-17,1571,810,761,910,661
2005,Urban,Sikkim,Property Crime,Burglary,Male,46-60,811,647,164,773,38
2003,Urban,Tripura,Property Crime,Burglary,Male,0-12,8240,5829,2411,7141,1099
2010,Urban,Jharkhand,Crime Against Women,Molestation,Male,46-60,9499,3625,5874,4622,4877
2005,Rural,Andhra Pradesh,Crime Against Children,Child Labor,Female,31-45,5319,2564,2755,4113,1206
2007,Urban,Assam,Other Crimes,Cyber Crime,Female,46-60,8933,7559,1374,8335,598
2008,Rural,Odisha,Crime Against Women,Molestation,Female,13-17,2728,754,1974,1261,1467
2009,Urban,Goa,Crime Against Children,Child Abuse,Female,31-45,9129,3480,5649,7722,1407
2001,Rural,Uttarakhand,Property Crime,Vandalism,Female,46-60,6798,3522,3276,5088,1710
2002,Urban,Karnataka,Property Crime,Arson,Male,13-17,5290,1990,3300,4293,997
2003,Rural,Maharashtra,Property Crime,Arson,Male,46-60,6079,5921,158,6046,33
2005,Rural,Kerala,Crime Against Men,Extortion,Male,18-30,1160,12,1148,826,334
2007,Urban,Jammu & Kashmir,Crime Against Men,Robbery,Female,60+,3101,1725,1376,2145,956
2007,Urban,Goa,Crime Against Children,Trafficking,Male,13-17,3274,1956,1318,2405,869
2005,Rural,Assam,Crime Against Men,Robbery,Male,0-12,2611,682,1929,1935,676
2003,Rural,Andhra Pradesh,Property Crime,Arson,Female,13-17,3292,2706,586,2786,506
2010,Urban,Bihar,Crime Against Men,Extortion,Female,13-17,4119,2297,1822,2533,1586
2002,Urban,Maharashtra,Crime Against Children,Child Labor,Female,46-60,5951,5423,528,5490,461
2004,Rural,Madhya Pradesh,Other Crimes,Drug Offense,Male,60+,9703,7854,1849,8732,971
2001,Urban,Delhi,Crime Against Children,Child Abuse,Female,46-60,8224,3342,4882,6315,1909
2006,Urban,Uttarakhand,Crime Against Children,Child Labor,Female,31-45,6167,5943,224,6024,143
2010,Urban,Arunachal Pradesh,Other Crimes,Fraud,Female,0-12,5230,2342,2888,4445,785
2006,Urban,Uttar Pradesh,Crime Against Men,Assault,Male,13-17,4513,1048,3465,4458,55
2007,Rural,Kerala,Property Crime,Theft,Male,46-60,2703,833,1870,1465,1238
2010,Rural,Nagaland,Other Crimes,Cyber Crime,Male,31-45,8008,2817,5191,4581,3427
2008,Urban,Andhra Pradesh,Crime Against Women,Dowry Deaths,Male,46-60,9202,9092,110,9095,107
2008,Urban,Tripura,Property Crime,Arson,Male,13-17,6138,6129,9,6131,7
2001,Rural,Jammu & Kashmir,Other Crimes,Fraud,Female,46-60,5981,4260,1721,4366,1615
2002,Rural,Nagaland,Property Crime,Arson,Female,60+,5413,924,4489,2495,2918
2003,Rural,Mizoram,Other Crimes,Fraud,Female,13-17,5587,2036,3551,3103,2484
2005,Rural,Telangana,Crime Against Men,Robbery,Female,60+,8466,1353,7113,5842,2624
2005,Rural,West Bengal,Crime Against Women,Molestation,Female,0-12,7092,3426,3666,5870,1222
2008,Rural,Goa,Property Crime,Arson,Female,60+,6558,5503,1055,5933,625
2001,Rural,Rajasthan,Crime Against Women,Dowry Deaths,Female,46-60,5819,1516,4303,4709,1110
2006,Rural,Uttarakhand,Crime Against Women,Dowry Deaths,Male,18-30,8410,2108,6302,4758,3652
2003,Urban,Haryana,Crime Against Children,Trafficking,Male,18-30,2361,1029,1332,1211,1150
2006,Urban,Goa,Property Crime,Vandalism,Male,31-45,7213,5495,1718,5577,1636
2004,Urban,Kerala,Other Crimes,Corruption,Male,0-12,3679,2939,740,3502,177
2001,Rural,Delhi,Crime Against Men,Murder,Female,46-60,1246,591,655,809,437
2008,Rural,Arunachal Pradesh,Crime Against Women,Rape,Male,18-30,9193,3977,5216,8286,907
2002,Urban,Chhattisgarh,Crime Against Men,Murder,Male,46-60,8929,8798,131,8841,88
2008,Urban,Arunachal Pradesh,Crime Against Children,Kidnapping,Female,0-12,2559,1224,1335,1339,1220
2009,Urban,Telangana,Crime Against Men,Murder,Male,46-60,2374,1733,641,2132,242
2010,Rural,Nagaland,Crime Against Women,Domestic Violence,Female,18-30,3994,2488,1506,3390,604
2001,Urban,Uttar Pradesh,Crime Against Women,Domestic Violence,Male,60+,652,134,518,368,284
2009,Urban,Maharashtra,Crime Against Children,Kidnapping,Male,13-17,4424,1302,3122,3153,1271
2006,Rural,Haryana,Crime Against Children,Kidnapping,Male,46-60,1549,164,1385,901,648
2002,Urban,Uttar Pradesh,Other Crimes,Cyber Crime,Male,0-12,8606,7358,1248,7960,646
2008,Urban,Maharashtra,Crime Against Women,Molestation,Female,0-12,1915,416,1499,1307,608
2007,Urban,Karnataka,Property Crime,Arson,Female,13-17,3495,874,2621,1991,1504
2008,Urban,Goa,Crime Against Children,Child Abuse,Female,31-45,6901,6410,491,6443,458
2009,Urban,Tamil Nadu,Other Crimes,Corruption,Female,46-60,8974,688,8286,717,8257
2010,Urban,Meghalaya,Property Crime,Burglary,Male,0-12,7058,676,6382,3279,3779
2003,Rural,Telangana,Crime Against Women,Rape,Male,46-60,5496,849,4647,4496,1000
2001,Urban,Maharashtra,Other Crimes,Fraud,Male,13-17,9346,8103,1243,8548,798
2004,Rural,Chhattisgarh,Other Crimes,Fraud,Male,31-45,268,204,64,210,58
2005,Rural,Goa,Crime Against Men,Robbery,Male,18-30,3980,3902,78,3969,11
2009,Rural,Chhattisgarh,Crime Against Children,Child Abuse,Male,0-12,4732,1609,3123,3108,1624
2006,Rural,Delhi,Other Crimes,Cyber Crime,Male,18-30,769,558,211,643,126
2010,Rural,Haryana,Crime Against Men,Murder,Female,60+,56,13,43,54,2
2005,Urban,Tripura,Crime Against Men,Assault,Female,46-60,6411,1998,4413,2456,3955
2004,Rural,Madhya Pradesh,Crime Against Women,Molestation,Male,13-17,9664,9601,63,9659,5
2001,Urban,Meghalaya,Other Crimes,Cyber Crime,Female,0-12,5143,2693,2450,2867,2276
2010,Urban,Uttar Pradesh,Other Crimes,Drug Offense,Male,18-30,7720,1481,6239,7422,298
2006,Rural,Himachal Pradesh,Property Crime,Burglary,Male,46-60,9683,2131,7552,3189,6494
2004,Urban,Haryana,Other Crimes,Cyber Crime,Male,31-45,5787,471,5316,3805,1982
2007,Rural,Uttar Pradesh,Other Crimes,Cyber Crime,Female,13-17,3234,840,2394,1603,1631
2002,Urban,Manipur,Other Crimes,Drug Offense,Male,46-60,1321,927,394,987,334
2010,Rural,Jharkhand,Crime Against Children,Kidnapping,Female,13-17,4044,2525,1519,2810,1234
2008,Urban,Karnataka,Crime Against Children,Kidnapping,Female,31-45,3235,1076,2159,2829,406
2009,Urban,Jharkhand,Crime Against Children,Kidnapping,Female,31-45,6070,1774,4296,3414,2656
2003,Urban,Punjab,Crime Against Children,Child Labor,Male,46-60,7266,2029,5237,4523,2743
2001,Rural,Uttarakhand,Other Crimes,Cyber Crime,Male,46-60,3663,1691,1972,2309,1354
2004,Rural,Andhra Pradesh,Property Crime,Theft,Female,18-30,1402,1122,280,1185,217
2009,Rural,Delhi,Property Crime,Arson,Male,18-30,224,216,8,216,8
2002,Urban,Uttarakhand,Crime Against Men,Murder,Female,18-30,3984,1358,2626,3723,261
2002,Urban,Rajasthan,Crime Against Men,Extortion,Female,46-60,1218,896,322,905,313
2004,Rural,Kerala,Crime Against Children,Kidnapping,Female,31-45,8201,6961,1240,8145,56
2001,Rural,Meghalaya,Crime Against Men,Murder,Male,13-17,5087,2855,2232,4198,889
2008,Urban,Gujarat,Crime Against Men,Robbery,Female,31-45,3088,2075,1013,2331,757
2003,Urban,Kerala,Other Crimes,Corruption,Female,46-60,1962,1526,436,1758,204
2003,Urban,Assam,Crime Against Women,Dowry Deaths,Male,46-60,1829,31,1798,527,1302
2008,Rural,Gujarat,Crime Against Women,Rape,Male,31-45,6600,151,6449,553,6047
2008,Urban,Kerala,Crime Against Men,Extortion,Male,31-45,6270,1563,4707,4362,1908
2002,Urban,Tripura,Crime Against Women,Molestation,Female,13-17,4359,364,3995,936,3423
2001,Urban,Mizoram,Crime Against Men,Assault,Female,18-30,5828,3590,2238,5559,269
2010,Rural,Chhattisgarh,Crime Against Children,Child Labor,Female,46-60,4467,487,3980,1896,2571
2005,Urban,Goa,Crime Against Women,Domestic Violence,Male,60+,1452,1094,358,1340,112
2001,Rural,Nagaland,Crime Against Children,Child Labor,Female,0-12,9194,3341,5853,5330,3864
2006,Urban,Karnataka,Crime Against Men,Murder,Male,46-60,9830,4520,5310,9713,117
2003,Urban,Punjab,Other Crimes,Drug Offense,Male,18-30,1590,1121,469,1297,293
2001,Rural,Madhya Pradesh,Crime Against Women,Domestic Violence,Male,18-30,4215,751,3464,4072,143
2005,Urban,Rajasthan,Crime Against Women,Dowry Deaths,Male,0-12,4412,1807,2605,3656,756
2006,Rural,Assam,Crime Against Women,Domestic Violence,Female,0-12,9579,4245,5334,5780,3799
2009,Urban,Karnataka,Crime Against Children,Child Abuse,Male,0-12,1068,901,167,1022,46
2010,Rural,Arunachal Pradesh,Crime Against Men,Extortion,Female,31-45,182,98,84,126,56
2001,Rural,Assam,Crime Against Men,Assault,Female,13-17,3911,2770,1141,2954,957
2001,Urban,Gujarat,Crime Against Women,Dowry Deaths,Male,18-30,4031,739,3292,1548,2483
2007,Rural,Uttarakhand,Crime Against Women,Domestic Violence,Male,0-12,8317,474,7843,1937,6380
2003,Urban,Maharashtra,Crime Against Men,Extortion,Female,18-30,4705,2160,2545,2961,1744
2008,Urban,Odisha,Crime Against Children,Child Abuse,Female,13-17,4909,411,4498,696,4213
2002,Urban,Bihar,Property Crime,Arson,Female,31-45,1477,937,540,1323,154
2009,Rural,West Bengal,Property Crime,Theft,Male,60+,5895,4641,1254,4785,1110
2008,Urban,West Bengal,Other Crimes,Fraud,Female,13-17,3129,3087,42,3108,21
2001,Rural,Mizoram,Crime Against Children,Child Labor,Female,18-30,8651,1379,7272,4269,4382
2010,Rural,Jharkhand,Crime Against Children,Child Abuse,Male,13-17,8328,3217,5111,3283,5045
2002,Rural,Tamil Nadu,Crime Against Women,Dowry Deaths,Male,0-12,2565,2200,365,2250,315
2010,Rural,Tamil Nadu,Other Crimes,Cyber Crime,Male,31-45,3209,1462,1747,1787,1422
2009,Urban,Himachal Pradesh,Other Crimes,Fraud,Female,0-12,8414,2386,6028,3973,4441
2005,Rural,Sikkim,Crime Against Women,Domestic Violence,Female,0-12,5450,287,5163,3378,2072
2003,Rural,Sikkim,Crime Against Women,Rape,Female,31-45,7996,593,7403,4030,3966
2003,Rural,Jammu & Kashmir,Other Crimes,Fraud,Male,13-17,9843,105,9738,1392,8451
2002,Rural,Madhya Pradesh,Crime Against Men,Murder,Male,31-45,7992,5321,2671,5924,2068
2006,Rural,Arunachal Pradesh,Crime Against Children,Child Abuse,Female,60+,2750,2733,17,2748,2
2002,Urban,Uttarakhand,Crime Against Children,Kidnapping,Female,0-12,5713,4328,1385,4571,1142
2007,Rural,Manipur,Crime Against Children,Kidnapping,Female,18-30,319,33,286,118,201
2003,Rural,Uttarakhand,Crime Against Women,Domestic Violence,Female,0-12,257,95,162,177,80
2008,Urban,Meghalaya,Crime Against Children,Child Abuse,Female,46-60,1757,212,1545,1183,574
2002,Rural,Jammu & Kashmir,Property Crime,Arson,Female,46-60,6008,4729,1279,4732,1276
2004,Rural,Madhya Pradesh,Property Crime,Vandalism,Female,13-17,1554,676,878,916,638
2002,Rural,Punjab,Crime Against Children,Kidnapping,Male,60+,2367,53,2314,1563,804
2006,Rural,Meghalaya,Other Crimes,Fraud,Male,0-12,8895,2481,6414,2957,5938
2002,Urban,Assam,Crime Against Men,Assault,Female,31-45,596,117,479,258,338
2005,Rural,Chhattisgarh,Other Crimes,Corruption,Female,31-45,6064,3057,3007,5258,806
2001,Rural,Himachal Pradesh,Crime Against Children,Trafficking,Female,13-17,9337,2400,6937,7805,1532
2004,Rural,Rajasthan,Crime Against Children,Kidnapping,Male,46-60,9991,477,9514,7400,2591
2010,Urban,Manipur,Crime Against Children,Child Labor,Female,31-45,5554,4580,974,5000,554
2001,Rural,Bihar,Crime Against Men,Extortion,Female,60+,3485,9,3476,1716,1769
2005,Urban,West Bengal,Other Crimes,Cyber Crime,Female,18-30,2713,1076,1637,1674,1039
2005,Rural,Manipur,Crime Against Women,Rape,Female,60+,8967,1319,7648,7169,1798
2009,Urban,Arunachal Pradesh,Property Crime,Arson,Female,46-60,5100,4551,549,4937,163
2008,Rural,Telangana,Crime Against Women,Molestation,Male,46-60,7303,4213,3090,5614,1689
2005,Urban,Telangana,Crime Against Children,Child Abuse,Female,13-17,691,151,540,575,116
2006,Rural,Arunachal Pradesh,Crime Against Men,Robbery,Male,60+,6698,2218,4480,6398,300
2010,Urban,Assam,Crime Against Women,Rape,Female,60+,455,317,138,336,119
2003,Urban,Nagaland,Property Crime,Arson,Female,13-17,9180,1275,7905,2164,7016
2010,Rural,Karnataka,Property Crime,Vandalism,Female,13-17,3520,2927,593,2992,528
2001,Urban,Jammu & Kashmir,Other Crimes,Drug Offense,Female,46-60,2968,1605,1363,2514,454
2004,Urban,Sikkim,Crime Against Children,Trafficking,Male,46-60,9494,4629,4865,8208,1286
2005,Urban,Andhra Pradesh,Other Crimes,Cyber Crime,Female,18-30,7616,915,6701,2765,4851
2002,Urban,Madhya Pradesh,Other Crimes,Cyber Crime,Female,46-60,6338,5410,928,5951,387
2005,Urban,Odisha,Crime Against Children,Trafficking,Female,46-60,9926,5929,3997,7748,2178
2010,Rural,Sikkim,Crime Against Women,Dowry Deaths,Male,31-45,3033,2644,389,2995,38
2002,Rural,Goa,Crime Against Children,Child Abuse,Male,18-30,4004,3156,848,3959,45
2009,Rural,Tamil Nadu,Crime Against Women,Molestation,Female,18-30,912,665,247,754,158
2001,Rural,Punjab,Other Crimes,Cyber Crime,Male,60+,5564,3322,2242,4393,1171
2003,Rural,Manipur,Crime Against Men,Murder,Male,13-17,1308,808,500,1057,251
2004,Urban,West Bengal,Property Crime,Theft,Male,46-60,7526,6173,1353,7063,463
2002,Urban,Madhya Pradesh,Crime Against Children,Child Labor,Male,60+,2993,301,2692,520,2473
2007,Urban,Himachal Pradesh,Crime Against Men,Murder,Male,13-17,8401,3662,4739,7749,652
2009,Rural,Nagaland,Other Crimes,Fraud,Female,13-17,4573,166,4407,781,3792
2004,Rural,Kerala,Property Crime,Theft,Female,31-45,357,294,63,305,52
2002,Rural,Madhya Pradesh,Crime Against Men,Assault,Male,0-12,4877,1588,3289,2894,1983
2004,Urban,Punjab,Other Crimes,Fraud,Male,0-12,3585,1495,2090,3117,468
2001,Rural,Manipur,Crime Against Children,Child Labor,Male,60+,6618,1397,5221,2632,3986
2007,Urban,Arunachal Pradesh,Property Crime,Burglary,Female,31-45,5414,473,4941,1238,4176
2006,Rural,Rajasthan,Crime Against Women,Domestic Violence,Female,18-30,2026,568,1458,1875,151
2002,Rural,Himachal Pradesh,Crime Against Children,Child Abuse,Female,31-45,6485,1391,5094,2500,3985
2005,Rural,Chhattisgarh,Other Crimes,Corruption,Male,31-45,917,502,415,779,138
2009,Urban,Delhi,Crime Against Men,Extortion,Female,46-60,6864,4679,2185,5042,1822
2006,Rural,Uttar Pradesh,Crime Against Children,Trafficking,Male,18-30,9658,1948,7710,5587,4071
2003,Rural,Bihar,Crime Against Children,Child Abuse,Female,31-45,4944,476,4468,4483,461
2002,Rural,Punjab,Other Crimes,Corruption,Male,46-60,8424,4767,3657,7149,1275
2003,Rural,Delhi,Crime Against Men,Extortion,Male,18-30,4233,1018,3215,3073,1160
2009,Urban,Haryana,Crime Against Children,Child Labor,Male,46-60,1616,1036,580,1221,395
2007,Rural,Haryana,Crime Against Children,Child Labor,Female,60+,4889,3473,1416,4345,544
2009,Rural,Rajasthan,Other Crimes,Fraud,Female,46-60,8506,6888,1618,7527,979
2002,Urban,Mizoram,Property Crime,Theft,Female,46-60,2658,351,2307,1796,862
2003,Rural,Bihar,Property Crime,Burglary,Male,13-17,3872,55,3817,1517,2355
2008,Urban,Meghalaya,Crime Against Children,Child Labor,Male,60+,4933,2890,2043,4444,489
2003,Urban,Punjab,Crime Against Men,Assault,Male,0-12,7982,808,7174,1645,6337
2004,Rural,Haryana,Crime Against Children,Trafficking,Male,46-60,4613,1722,2891,1998,2615
2005,Urban,Chhattisgarh,Crime Against Children,Trafficking,Female,0-12,2363,2313,50,2335,28
2006,Rural,Gujarat,Crime Against Women,Dowry Deaths,Female,18-30,6359,3302,3057,5372,987
2006,Rural,Sikkim,Other Crimes,Cyber Crime,Male,0-12,8528,3349,5179,4124,4404
2009,Rural,Rajasthan,Crime Against Children,Trafficking,Male,31-45,6661,833,5828,989,5672
2002,Rural,Tripura,Other Crimes,Drug Offense,Male,13-17,2531,1835,696,2401,130
2002,Rural,Madhya Pradesh,Other Crimes,Drug Offense,Female,60+,8094,2642,5452,6858,1236
2008,Rural,Uttarakhand,Crime Against Children,Child Labor,Male,46-60,2800,586,2214,2770,30
2008,Urban,Assam,Crime Against Women,Dowry Deaths,Female,0-12,8059,6744,1315,7411,648
2006,Urban,Meghalaya,Crime Against Men,Assault,Female,0-12,2893,1730,1163,2081,812
2005,Urban,Nagaland,Property Crime,Burglary,Male,13-17,8763,8580,183,8709,54
2010,Urban,Rajasthan,Crime Against Men,Murder,Male,18-30,8931,447,8484,5165,3766
2001,Urban,Meghalaya,Property Crime,Vandalism,Female,18-30,6394,1155,5239,3175,3219
2010,Rural,Madhya Pradesh,Crime Against Men,Murder,Female,46-60,3789,3163,626,3452,337
2009,Urban,Gujarat,Crime Against Men,Extortion,Female,0-12,6561,1066,5495,1863,4698
2009,Rural,Meghalaya,Other Crimes,Fraud,Male,46-60,309,283,26,299,10
2008,Urban,Karnataka,Crime Against Children,Kidnapping,Male,46-60,9994,6549,3445,9383,611
2003,Rural,Maharashtra,Property Crime,Burglary,Male,31-45,4902,4541,361,4604,298
2007,Urban,Karnataka,Crime Against Women,Domestic Violence,Male,18-30,3590,2977,613,3365,225
2001,Urban,Goa,Crime Against Children,Kidnapping,Male,13-17,6913,5721,1192,6401,512
2010,Rural,Assam,Other Crimes,Drug Offense,Male,60+,3646,3309,337,3478,168
2001,Rural,Uttar Pradesh,Property Crime,Vandalism,Male,31-45,5149,2104,3045,2368,2781
2001,Rural,Meghalaya,Crime Against Men,Robbery,Male,18-30,1716,723,993,859,857
2003,Urban,Goa,Crime Against Men,Robbery,Male,13-17,940,877,63,917,23
2007,Urban,Meghalaya,Crime Against Women,Dowry Deaths,Male,31-45,6169,1136,5033,3310,2859
2007,Rural,Manipur,Crime Against Women,Molestation,Female,0-12,5759,14,5745,3520,2239
2005,Urban,Punjab,Other Crimes,Corruption,Female,13-17,2982,1442,1540,1734,1248
2005,Urban,Rajasthan,Other Crimes,Drug Offense,Female,46-60,7186,3012,4174,6819,367
2008,Urban,Manipur,Property Crime,Theft,Male,13-17,938,16,922,738,200
2008,Urban,Jammu & Kashmir,Crime Against Women,Dowry Deaths,Male,0-12,862,236,626,803,59
2007,Rural,Madhya Pradesh,Other Crimes,Drug Offense,Female,0-12,6901,5801,1100,6762,139
2005,Rural,Gujarat,Crime Against Children,Trafficking,Male,13-17,6984,3786,3198,6551,433
2001,Urban,Madhya Pradesh,Property Crime,Burglary,Female,18-30,3491,1834,1657,2509,982
2004,Urban,Manipur,Crime Against Children,Child Abuse,Female,60+,6626,708,5918,5804,822
2002,Urban,Jammu & Kashmir,Crime Against Children,Trafficking,Male,13-17,3537,2378,1159,2772,765
2009,Urban,Assam,Crime Against Children,Child Labor,Female,60+,3588,1434,2154,2663,925
2010,Rural,Assam,Crime Against Children,Trafficking,Male,18-30,8838,7033,1805,7557,1281
2002,Rural,Himachal Pradesh,Crime Against Children,Child Labor,Male,18-30,2262,1729,533,2181,81
2007,Rural,Punjab,Property Crime,Vandalism,Female,18-30,3804,1101,2703,1972,1832
2009,Rural,Manipur,Crime Against Children,Trafficking,Male,0-12,3825,919,2906,2177,1648
2009,Rural,Mizoram,Property Crime,Arson,Female,60+,8265,3915,4350,4919,3346
2010,Urban,Rajasthan,Other Crimes,Fraud,Male,60+,88,1,87,3,85
2004,Urban,Kerala,Crime Against Men,Murder,Female,18-30,253,236,17,236,17
2006,Urban,Manipur,Property Crime,Vandalism,Female,13-17,8231,585,7646,2692,5539
2005,Rural,Himachal Pradesh,Other Crimes,Drug Offense,Female,18-30,6066,5995,71,6002,64
2005,Rural,Nagaland,Crime Against Men,Robbery,Male,18-30,3463,108,3355,1753,1710
2007,Urban,Chhattisgarh,Property Crime,Vandalism,Male,46-60,680,146,534,529,151
2009,Rural,Jharkhand,Other Crimes,Cyber Crime,Female,60+,8269,1234,7035,7527,742
2007,Urban,Tripura,Crime Against Children,Kidnapping,Male,60+,1521,235,1286,1131,390
2008,Rural,Jharkhand,Property Crime,Arson,Female,13-17,2644,2245,399,2322,322
2009,Rural,Karnataka,Crime Against Children,Trafficking,Female,31-45,3255,2214,1041,2998,257
2003,Rural,Bihar,Property Crime,Theft,Male,13-17,4465,398,4067,4271,194
2007,Urban,Telangana,Property Crime,Arson,Male,46-60,8731,2403,6328,7829,902
2003,Rural,Punjab,Property Crime,Theft,Male,46-60,523,491,32,505,18
2009,Urban,Odisha,Other Crimes,Fraud,Female,46-60,9572,8846,726,9074,498
2001,Rural,Karnataka,Crime Against Children,Child Abuse,Female,60+,4668,61,4607,1630,3038
2005,Urban,Odisha,Crime Against Men,Extortion,Female,18-30,8660,714,7946,4422,4238
2004,Urban,Karnataka,Crime Against Women,Rape,Male,18-30,5263,480,4783,4108,1155
2009,Urban,Manipur,Crime Against Men,Assault,Male,18-30,5123,2212,2911,3525,1598
2004,Urban,Meghalaya,Crime Against Children,Trafficking,Male,0-12,6500,5965,535,6405,95
2002,Urban,Punjab,Property Crime,Vandalism,Male,18-30,934,634,300,728,206
2008,Rural,Haryana,Crime Against Women,Molestation,Male,60+,4312,3837,475,3894,418
2010,Urban,Maharashtra,Crime Against Children,Child Labor,Male,46-60,3952,1853,2099,3498,454
2003,Rural,Bihar,Crime Against Children,Child Abuse,Male,46-60,5216,2533,2683,3364,1852
2002,Rural,Arunachal Pradesh,Crime Against Children,Trafficking,Female,31-45,4734,3962,772,4425,309
2003,Urban,Tamil Nadu,Crime Against Children,Trafficking,Male,46-60,3175,1328,1847,1950,1225
2006,Rural,Maharashtra,Other Crimes,Cyber Crime,Female,0-12,1986,1191,795,1544,442
2002,Urban,Tamil Nadu,Other Crimes,Drug Offense,Female,18-30,3510,276,3234,1773,1737
2004,Rural,Andhra Pradesh,Property Crime,Vandalism,Female,13-17,6860,2429,4431,5959,901
2005,Rural,Tamil Nadu,Other Crimes,Cyber Crime,Female,31-45,6344,1240,5104,3943,2401
2008,Rural,Chhattisgarh,Crime Against Men,Extortion,Male,0-12,1459,423,1036,452,1007
2010,Rural,Jharkhand,Other Crimes,Cyber Crime,Female,13-17,8468,3265,5203,7166,1302
2008,Urban,Jharkhand,Crime Against Women,Molestation,Female,60+,7575,7529,46,7529,46
2010,Urban,Odisha,Crime Against Women,Molestation,Female,0-12,320,37,283,123,197
2001,Urban,Gujarat,Crime Against Men,Murder,Male,46-60,6063,4864,1199,5591,472
2010,Urban,Gujarat,Other Crimes,Fraud,Female,18-30,3683,3024,659,3162,521
2003,Urban,Chhattisgarh,Other Crimes,Cyber Crime,Male,18-30,5281,3643,1638,4058,1223
2005,Urban,Andhra Pradesh,Crime Against Men,Assault,Male,60+,2896,1238,1658,1506,1390
2006,Urban,Madhya Pradesh,Other Crimes,Drug Offense,Male,46-60,6544,905,5639,2491,4053
2010,Rural,Rajasthan,Property Crime,Theft,Male,0-12,5724,3099,2625,4785,939
2010,Rural,Gujarat,Crime Against Women,Dowry Deaths,Male,60+,7689,2177,5512,3377,4312
2001,Rural,Delhi,Crime Against Women,Molestation,Female,13-17,9784,3004,6780,3756,6028
2003,Rural,Himachal Pradesh,Property Crime,Vandalism,Female,31-45,938,821,117,879,59
2007,Rural,Goa,Other Crimes,Cyber Crime,Female,31-45,4490,136,4354,1163,3327
2006,Urban,Uttar Pradesh,Other Crimes,Fraud,Male,0-12,5056,4703,353,4753,303
2007,Rural,Uttar Pradesh,Crime Against Women,Domestic Violence,Male,13-17,6675,1845,4830,5855,820
2002,Urban,Tripura,Crime Against Men,Murder,Male,31-45,7914,2894,5020,3858,4056
2009,Urban,Jharkhand,Crime Against Men,Murder,Male,46-60,9156,2803,6353,7875,1281
2004,Rural,Tamil Nadu,Crime Against Children,Child Abuse,Female,13-17,1386,480,906,540,846
2008,Rural,Nagaland,Other Crimes,Corruption,Male,18-30,574,482,92,554,20
2002,Urban,Tripura,Property Crime,Theft,Male,31-45,3616,3431,185,3593,23
2004,Urban,Uttar Pradesh,Crime Against Women,Rape,Male,46-60,7093,5105,1988,5859,1234
2005,Urban,Chhattisgarh,Crime Against Children,Child Abuse,Male,31-45,1218,945,273,1023,195
2005,Urban,West Bengal,Crime Against Children,Child Abuse,Female,31-45,8913,4106,4807,4205,4708
2001,Urban,Sikkim,Crime Against Children,Child Abuse,Male,0-12,509,245,264,341,168
2003,Rural,Delhi,Crime Against Women,Rape,Male,60+,6420,2293,4127,4049,2371
2001,Rural,West Bengal,Crime Against Women,Domestic Violence,Male,60+,1193,16,1177,733,460
2001,Rural,Meghalaya,Property Crime,Theft,Male,18-30,5502,4283,1219,4422,1080
2005,Urban,Karnataka,Property Crime,Vandalism,Male,0-12,6132,2292,3840,3774,2358
2006,Urban,Himachal Pradesh,Crime Against Men,Extortion,Male,60+,161,98,63,149,12
2001,Rural,Sikkim,Crime Against Men,Murder,Female,13-17,8597,2133,6464,5076,3521
2010,Rural,Chhattisgarh,Crime Against Men,Extortion,Female,18-30,2583,305,2278,2050,533
2008,Urban,Madhya Pradesh,Crime Against Women,Rape,Female,60+,5408,890,4518,3018,2390
2002,Rural,Jharkhand,Other Crimes,Fraud,Male,18-30,1805,452,1353,1709,96
2005,Urban,Gujarat,Crime Against Children,Child Abuse,Female,0-12,8969,5422,3547,7559,1410
2001,Rural,Delhi,Other Crimes,Fraud,Male,46-60,3407,441,2966,2138,1269
2007,Rural,Maharashtra,Crime Against Children,Child Abuse,Female,18-30,6666,5322,1344,6224,442
2003,Urban,Delhi,Property Crime,Arson,Female,13-17,3454,1467,1987,1997,1457
2005,Rural,Uttarakhand,Other Crimes,Corruption,Male,18-30,7588,4802,2786,6650,938
2004,Urban,Gujarat,Crime Against Men,Robbery,Male,46-60,9012,4610,4402,8914,98
2003,Urban,Himachal Pradesh,Crime Against Women,Domestic Violence,Female,60+,6433,1875,4558,3261,3172
2003,Rural,Mizoram,Crime Against Women,Dowry Deaths,Male,13-17,4946,2872,2074,3043,1903
2002,Rural,West Bengal,Property Crime,Burglary,Male,13-17,2589,367,2222,714,1875
2001,Rural,Uttarakhand,Crime Against Women,Domestic Violence,Female,0-12,6367,2388,3979,4181,2186
2008,Urban,Gujarat,Crime Against Men,Assault,Male,46-60,4310,2662,1648,3550,760
2003,Rural,Karnataka,Crime Against Women,Rape,Female,46-60,1311,544,767,1297,14
2003,Urban,Bihar,Property Crime,Vandalism,Female,0-12,4455,685,3770,3347,1108
2009,Rural,Kerala,Other Crimes,Drug Offense,Male,0-12,3670,785,2885,1314,2356
2005,Rural,Arunachal Pradesh,Property Crime,Arson,Female,0-12,7419,6872,547,7142,277
2001,Rural,Himachal Pradesh,Other Crimes,Corruption,Male,0-12,3118,1753,1365,2007,1111
2002,Urban,Haryana,Crime Against Men,Extortion,Female,60+,5161,604,4557,845,4316
2008,Rural,Arunachal Pradesh,Crime Against Women,Dowry Deaths,Female,0-12,387,285,102,329,58
2003,Rural,Bihar,Other Crimes,Cyber Crime,Female,13-17,2151,1257,894,1929,222
2002,Rural,Karnataka,Crime Against Women,Dowry Deaths,Male,60+,6131,1758,4373,3085,3046
2002,Rural,Andhra Pradesh,Crime Against Men,Murder,Female,60+,8082,7695,387,7800,282
2010,Rural,Odisha,Crime Against Women,Molestation,Female,31-45,7854,6214,1640,7561,293
2007,Urban,Delhi,Crime Against Men,Murder,Male,18-30,1738,581,1157,1077,661
2010,Urban,Gujarat,Crime Against Men,Assault,Male,13-17,2791,2119,672,2121,670
2007,Rural,Jharkhand,Crime Against Children,Kidnapping,Male,0-12,8508,4059,4449,7671,837
2003,Urban,Rajasthan,Property Crime,Theft,Male,18-30,1100,292,808,577,523
2008,Rural,Gujarat,Other Crimes,Corruption,Female,0-12,3065,1205,1860,1225,1840
2001,Urban,Mizoram,Property Crime,Theft,Female,46-60,3232,3047,185,3066,166
2002,Urban,Sikkim,Crime Against Women,Rape,Female,18-30,2547,1925,622,2223,324
2010,Rural,Nagaland,Crime Against Women,Domestic Violence,Male,31-45,6378,1356,5022,4606,1772
2002,Urban,Rajasthan,Crime Against Children,Child Abuse,Male,0-12,8173,6208,1965,6275,1898
2001,Urban,Punjab,Crime Against Men,Extortion,Female,0-12,7000,1782,5218,6579,421
2002,Urban,Uttarakhand,Crime Against Children,Child Abuse,Male,31-45,9602,2289,7313,8242,1360
2010,Rural,Kerala,Crime Against Children,Child Abuse,Female,60+,2537,1606,931,1862,675
2006,Urban,Punjab,Crime Against Children,Trafficking,Female,18-30,4280,3553,727,4240,40
2009,Rural,Himachal Pradesh,Crime Against Women,Domestic Violence,Female,31-45,340,31,309,259,81
2010,Rural,Karnataka,Property Crime,Burglary,Male,13-17,8979,8742,237,8889,90
2003,Urban,Mizoram,Property Crime,Vandalism,Male,18-30,5425,5291,134,5351,74
2005,Rural,Assam,Other Crimes,Drug Offense,Female,31-45,1234,732,502,848,386
2009,Urban,Assam,Property Crime,Arson,Female,0-12,5006,1294,3712,2579,2427
2003,Rural,Jharkhand,Crime Against Children,Child Labor,Female,0-12,1251,151,1100,415,836
2005,Rural,Arunachal Pradesh,Crime Against Men,Extortion,Male,0-12,6082,35,6047,4077,2005
2004,Urban,Tripura,Property Crime,Burglary,Male,31-45,2061,515,1546,1526,535
2004,Urban,Madhya Pradesh,Property Crime,Arson,Male,46-60,9545,3987,5558,7717,1828
2009,Rural,Chhattisgarh,Other Crimes,Cyber Crime,Female,60+,6102,1968,4134,5906,196
2008,Rural,Haryana,Crime Against Men,Assault,Male,31-45,5931,3161,2770,3490,2441
2005,Rural,Haryana,Other Crimes,Corruption,Male,18-30,9654,504,9150,9508,146
2002,Urban,Punjab,Crime Against Children,Trafficking,Male,13-17,1664,393,1271,956,708
2008,Urban,Bihar,Crime Against Men,Assault,Female,46-60,9434,3633,5801,6286,3148
2004,Rural,Jammu & Kashmir,Property Crime,Vandalism,Female,18-30,5414,2056,3358,3053,2361
2002,Rural,Odisha,Crime Against Men,Murder,Male,60+,4277,2658,1619,4152,125
2008,Rural,Andhra Pradesh,Other Crimes,Fraud,Female,46-60,6576,1520,5056,2669,3907
2006,Urban,Tripura,Crime Against Children,Kidnapping,Male,13-17,8632,1087,7545,5108,3524
2008,Rural,Arunachal Pradesh,Crime Against Men,Robbery,Male,46-60,993,141,852,486,507
2007,Rural,Maharashtra,Crime Against Women,Rape,Male,31-45,5033,1771,3262,2779,2254
2001,Rural,Gujarat,Crime Against Children,Trafficking,Male,18-30,4557,805,3752,3580,977
2007,Urban,Jharkhand,Crime Against Children,Child Abuse,Female,18-30,4266,2164,2102,3184,1082
2001,Urban,West Bengal,Crime Against Children,Child Labor,Female,13-17,8693,445,8248,4178,4515
2002,Rural,Manipur,Crime Against Men,Extortion,Male,31-45,7463,7209,254,7265,198
2006,Urban,Tamil Nadu,Property Crime,Burglary,Male,46-60,5767,2870,2897,2955,2812
2008,Urban,Uttarakhand,Crime Against Women,Domestic Violence,Male,0-12,6750,3945,2805,4941,1809
2008,Urban,Goa,Crime Against Men,Assault,Male,18-30,4986,3223,1763,4157,829
2010,Urban,Gujarat,Crime Against Men,Assault,Female,0-12,917,414,503,454,463
2002,Urban,Telangana,Crime Against Men,Murder,Female,13-17,2699,2328,371,2460,239
2005,Urban,Uttarakhand,Other Crimes,Fraud,Female,13-17,7534,419,7115,6137,1397
2001,Urban,Tamil Nadu,Other Crimes,Fraud,Male,0-12,7853,6508,1345,7789,64
2002,Urban,Chhattisgarh,Crime Against Children,Child Labor,Male,0-12,2583,863,1720,2297,286
2008,Rural,Tamil Nadu,Property Crime,Burglary,Male,31-45,5152,755,4397,1626,3526
2009,Rural,Haryana,Crime Against Women,Molestation,Female,60+,2195,297,1898,941,1254
2006,Urban,Meghalaya,Crime Against Children,Child Abuse,Male,31-45,5126,4315,811,4681,445
2003,Rural,Delhi,Crime Against Men,Robbery,Male,60+,135,72,63,90,45
2007,Rural,Manipur,Crime Against Children,Kidnapping,Male,0-12,5187,2901,2286,3931,1256
2009,Rural,Chhattisgarh,Property Crime,Vandalism,Female,18-30,6622,3295,3327,6227,395
2005,Urban,Madhya Pradesh,Other Crimes,Cyber Crime,Male,0-12,4288,3750,538,3935,353
2006,Urban,Jammu & Kashmir,Crime Against Children,Trafficking,Male,0-12,2445,2120,325,2378,67
2006,Rural,Meghalaya,Other Crimes,Fraud,Male,46-60,5725,5079,646,5552,173
2008,Rural,Goa,Crime Against Children,Child Abuse,Female,60+,7486,4422,3064,4859,2627
2007,Rural,Goa,Crime Against Children,Child Labor,Female,0-12,7532,5771,1761,7122,410
2008,Rural,Tamil Nadu,Property Crime,Arson,Female,13-17,1301,1225,76,1278,23
2009,Rural,Andhra Pradesh,Property Crime,Burglary,Female,18-30,2799,526,2273,685,2114
2001,Urban,Kerala,Property Crime,Burglary,Male,18-30,8926,1413,7513,6951,1975
2007,Rural,Haryana,Crime Against Women,Domestic Violence,Male,60+,9356,6871,2485,7440,1916
2004,Rural,Telangana,Crime Against Women,Dowry Deaths,Female,60+,9001,3412,5589,4781,4220
2003,Urban,Karnataka,Crime Against Women,Domestic Violence,Male,46-60,7987,4803,3184,7064,923
2001,Rural,Maharashtra,Property Crime,Arson,Female,13-17,7421,6863,558,7278,143
2010,Urban,Punjab,Crime Against Women,Rape,Male,60+,9879,5889,3990,9484,395
2003,Urban,Delhi,Crime Against Men,Extortion,Female,60+,6850,131,6719,3819,3031
2005,Urban,Rajasthan,Crime Against Children,Child Abuse,Male,60+,2716,1390,1326,2403,313
2001,Rural,Rajasthan,Property Crime,Vandalism,Female,18-30,6297,2126,4171,2184,4113
2008,Urban,Jharkhand,Crime Against Men,Extortion,Male,46-60,5044,2379,2665,2781,2263
2002,Urban,Haryana,Property Crime,Burglary,Male,13-17,5278,2840,2438,3099,2179
2006,Urban,Uttar Pradesh,Property Crime,Burglary,Male,31-45,6626,1539,5087,4581,2045
2002,Rural,Punjab,Crime Against Women,Molestation,Male,60+,5863,4026,1837,5700,163
2003,Rural,Andhra Pradesh,Crime Against Children,Kidnapping,Female,18-30,8590,3567,5023,6423,2167
2005,Rural,Delhi,Crime Against Men,Extortion,Male,60+,5480,3095,2385,3991,1489
2008,Urban,Himachal Pradesh,Crime Against Men,Assault,Female,13-17,7121,6463,658,6751,370
2009,Rural,Tripura,Crime Against Children,Child Abuse,Female,31-45,1310,60,1250,985,325
2003,Rural,Tamil Nadu,Other Crimes,Cyber Crime,Female,31-45,5205,705,4500,2384,2821
2006,Urban,Sikkim,Crime Against Children,Trafficking,Male,13-17,9347,146,9201,3436,5911
2002,Urban,Bihar,Crime Against Children,Child Labor,Female,60+,5005,1902,3103,2207,2798
2006,Rural,Jammu & Kashmir,Property Crime,Burglary,Female,46-60,4019,78,3941,4006,13
2002,Urban,Mizoram,Property Crime,Vandalism,Female,60+,9753,7724,2029,7880,1873
2001,Rural,Assam,Property Crime,Vandalism,Male,46-60,484,295,189,309,175
2008,Urban,Meghalaya,Other Crimes,Cyber Crime,Male,13-17,8428,5144,3284,6971,1457
2005,Rural,Delhi,Other Crimes,Cyber Crime,Male,31-45,1946,1916,30,1936,10
2010,Urban,Jammu & Kashmir,Crime Against Children,Child Labor,Female,13-17,2646,2460,186,2633,13
2007,Urban,Manipur,Crime Against Men,Extortion,Male,46-60,1708,1471,237,1528,180
2008,Rural,Jharkhand,Property Crime,Vandalism,Female,60+,8125,5573,2552,5582,2543
2001,Rural,Andhra Pradesh,Other Crimes,Corruption,Female,46-60,8446,4975,3471,8182,264
2001,Rural,Arunachal Pradesh,Property Crime,Burglary,Female,18-30,2418,672,1746,2028,390
2005,Rural,Gujarat,Crime Against Men,Extortion,Female,46-60,920,601,319,778,142
2002,Rural,West Bengal,Crime Against Children,Child Labor,Female,0-12,600,421,179,451,149
2010,Urban,Tripura,Crime Against Children,Kidnapping,Female,31-45,2495,561,1934,1776,719
2001,Rural,Rajasthan,Property Crime,Burglary,Female,60+,4233,1901,2332,4211,22
2009,Urban,Andhra Pradesh,Crime Against Women,Molestation,Female,46-60,6603,5176,1427,5318,1285
2010,Rural,Haryana,Property Crime,Vandalism,Female,46-60,765,1,764,468,297
2007,Urban,Arunachal Pradesh,Property Crime,Theft,Male,60+,1757,573,1184,595,1162
2003,Urban,Andhra Pradesh,Other Crimes,Drug Offense,Female,18-30,6397,3840,2557,4624,1773
2005,Urban,Rajasthan,Crime Against Women,Domestic Violence,Male,60+,9514,2071,7443,6590,2924
2002,Urban,Telangana,Crime Against Women,Rape,Female,46-60,7273,4802,2471,6696,577
2004,Rural,Jammu & Kashmir,Other Crimes,Corruption,Female,18-30,858,248,610,399,459
2007,Rural,Chhattisgarh,Crime Against Women,Domestic Violence,Male,18-30,5967,384,5583,2829,3138
2003,Rural,Delhi,Crime Against Men,Extortion,Male,60+,6599,3705,2894,6060,539
2008,Urban,Rajasthan,Other Crimes,Drug Offense,Male,0-12,6389,2795,3594,5954,435
2006,Urban,Goa,Crime Against Children,Child Abuse,Male,46-60,4541,3789,752,4111,430
2006,Rural,Punjab,Property Crime,Vandalism,Male,0-12,6200,3049,3151,5655,545
2003,Rural,Sikkim,Crime Against Men,Extortion,Female,0-12,2096,1551,545,1972,124
2005,Rural,Haryana,Property Crime,Arson,Female,60+,9842,63,9779,63,9779
2007,Urban,Chhattisgarh,Crime Against Women,Molestation,Male,31-45,2667,1269,1398,2005,662
2002,Rural,Arunachal Pradesh,Crime Against Children,Child Abuse,Female,46-60,5311,772,4539,2414,2897
2004,Urban,Manipur,Property Crime,Arson,Female,18-30,1309,88,1221,682,627
2008,Urban,Bihar,Crime Against Men,Extortion,Male,18-30,4380,3052,1328,3344,1036
2001,Urban,Maharashtra,Crime Against Women,Dowry Deaths,Female,13-17,9988,9153,835,9316,672
2009,Urban,Tripura,Crime Against Women,Molestation,Female,0-12,6948,5077,1871,5473,1475
2009,Urban,Arunachal Pradesh,Crime Against Men,Assault,Male,18-30,2031,40,1991,1514,517
2010,Urban,Uttarakhand,Crime Against Children,Kidnapping,Male,60+,6135,1411,4724,2970,3165
2006,Urban,Madhya Pradesh,Crime Against Women,Rape,Male,0-12,9726,2985,6741,7393,2333
2008,Rural,Kerala,Property Crime,Theft,Female,31-45,3289,2240,1049,3257,32
2005,Rural,Telangana,Crime Against Children,Child Labor,Male,31-45,3292,348,2944,3093,199
2007,Urban,Manipur,Crime Against Women,Rape,Female,18-30,1095,565,530,990,105
2009,Rural,Gujarat,Crime Against Children,Child Abuse,Female,31-45,7714,306,7408,2636,5078
2004,Urban,Nagaland,Other Crimes,Corruption,Female,60+,2396,152,2244,196,2200
2004,Rural,Bihar,Crime Against Children,Child Abuse,Male,18-30,7577,15,7562,4508,3069
2010,Rural,Punjab,Crime Against Men,Robbery,Female,46-60,3893,1656,2237,2970,923
2007,Rural,Uttarakhand,Crime Against Children,Child Labor,Male,13-17,1603,1260,343,1424,179
2010,Urban,Nagaland,Property Crime,Arson,Female,13-17,4835,1863,2972,3860,975
2008,Urban,Tripura,Crime Against Women,Molestation,Female,13-17,699,293,406,402,297
2002,Urban,Maharashtra,Property Crime,Burglary,Male,46-60,3738,2209,1529,2491,1247
2006,Urban,Nagaland,Other Crimes,Cyber Crime,Male,13-17,7118,1266,5852,1317,5801
2003,Rural,Odisha,Property Crime,Theft,Male,13-17,3761,3687,74,3705,56
2001,Rural,Gujarat,Other Crimes,Drug Offense,Female,13-17,7070,2181,4889,2557,4513
2006,Urban,Odisha,Crime Against Children,Trafficking,Female,18-30,8883,6531,2352,8311,572
2005,Rural,Meghalaya,Crime Against Women,Molestation,Male,46-60,7557,7038,519,7242,315
2005,Rural,Manipur,Property Crime,Theft,Female,18-30,3781,1964,1817,2220,1561
2005,Urban,Uttarakhand,Crime Against Children,Child Labor,Male,60+,8341,1125,7216,3401,4940
2008,Urban,Manipur,Crime Against Children,Trafficking,Female,13-17,1848,1108,740,1412,436
2001,Urban,Madhya Pradesh,Other Crimes,Cyber Crime,Male,31-45,8809,6729,2080,6971,1838
2008,Urban,Tamil Nadu,Crime Against Men,Robbery,Female,46-60,6314,465,5849,4705,1609
2010,Rural,Meghalaya,Other Crimes,Corruption,Male,46-60,4563,4301,262,4431,132
2003,Rural,Tripura,Crime Against Children,Kidnapping,Female,31-45,3368,1419,1949,3051,317
2008,Urban,Haryana,Other Crimes,Drug Offense,Female,0-12,492,330,162,438,54
2003,Rural,Punjab,Crime Against Men,Robbery,Male,0-12,4168,2147,2021,2298,1870
2004,Rural,West Bengal,Other Crimes,Cyber Crime,Male,0-12,9060,960,8100,3745,5315
2009,Urban,Madhya Pradesh,Crime Against Children,Trafficking,Male,13-17,4078,2458,1620,3081,997
2004,Urban,Goa,Property Crime,Theft,Female,46-60,4490,270,4220,2585,1905
2004,Rural,Manipur,Other Crimes,Cyber Crime,Female,0-12,4673,3970,703,4537,136
2007,Urban,Assam,Crime Against Men,Robbery,Male,13-17,3334,2761,573,3307,27
2004,Urban,Punjab,Other Crimes,Fraud,Female,31-45,5981,806,5175,1336,4645
2004,Rural,Tamil Nadu,Property Crime,Burglary,Male,46-60,384,151,233,305,79
2001,Urban,Sikkim,Other Crimes,Fraud,Female,18-30,496,223,273,377,119
2010,Urban,Madhya Pradesh,Property Crime,Burglary,Female,18-30,6192,440,5752,5273,919
2007,Rural,Madhya Pradesh,Crime Against Women,Domestic Violence,Male,46-60,7452,1403,6049,5425,2027
2009,Urban,Goa,Other Crimes,Cyber Crime,Female,60+,5899,4080,1819,5634,265
2005,Rural,Tamil Nadu,Crime Against Women,Domestic Violence,Female,0-12,8537,3937,4600,6198,2339
2010,Urban,Gujarat,Crime Against Children,Trafficking,Female,0-12,2087,22,2065,1631,456
2008,Rural,Assam,Crime Against Children,Child Labor,Female,46-60,1030,560,470,903,127
2002,Urban,Goa,Crime Against Women,Molestation,Female,18-30,5360,744,4616,2935,2425
2010,Urban,Jharkhand,Crime Against Women,Rape,Male,46-60,6275,1443,4832,1524,4751
2008,Rural,Chhattisgarh,Other Crimes,Drug Offense,Male,46-60,4425,1234,3191,4166,259
2004,Rural,Himachal Pradesh,Crime Against Men,Murder,Male,60+,5766,2123,3643,5415,351
2001,Urban,West Bengal,Crime Against Women,Domestic Violence,Female,31-45,2590,1442,1148,2094,496
2003,Rural,Jammu & Kashmir,Crime Against Children,Trafficking,Female,18-30,7274,5112,2162,5371,1903
2002,Urban,Rajasthan,Crime Against Women,Domestic Violence,Female,13-17,3742,776,2966,2948,794
2004,Rural,Maharashtra,Crime Against Men,Extortion,Male,31-45,2455,1701,754,1769,686
2004,Rural,Assam,Crime Against Women,Dowry Deaths,Male,18-30,343,111,232,186,157
2004,Urban,Gujarat,Other Crimes,Drug Offense,Female,31-45,7796,4926,2870,5539,2257
2005,Rural,Himachal Pradesh,Property Crime,Theft,Male,60+,1804,350,1454,1800,4
2006,Urban,Tamil Nadu,Crime Against Women,Domestic Violence,Female,60+,1386,1269,117,1381,5
2008,Rural,Manipur,Crime Against Children,Kidnapping,Male,13-17,6280,720,5560,2951,3329
2004,Urban,West Bengal,Crime Against Children,Trafficking,Male,46-60,9804,1033,8771,6452,3352
2002,Urban,Karnataka,Property Crime,Vandalism,Male,13-17,5540,2641,2899,3329,2211
2009,Rural,Haryana,Crime Against Men,Murder,Female,13-17,6715,1383,5332,5679,1036
2005,Rural,Tamil Nadu,Crime Against Children,Trafficking,Male,60+,1353,102,1251,1203,150
2006,Rural,Andhra Pradesh,Other Crimes,Corruption,Male,60+,1665,1180,485,1521,144
2006,Urban,Punjab,Property Crime,Arson,Male,0-12,1913,280,1633,1116,797
2001,Rural,Odisha,Crime Against Men,Robbery,Female,18-30,3251,2781,470,2840,411
2004,Urban,Haryana,Crime Against Men,Murder,Female,60+,4997,2658,2339,3768,1229
2005,Urban,Rajasthan,Crime Against Men,Assault,Female,13-17,266,1,265,34,232
2010,Urban,Himachal Pradesh,Property Crime,Arson,Male,31-45,3073,487,2586,2665,408
2008,Urban,Madhya Pradesh,Other Crimes,Drug Offense,Male,60+,6599,937,5662,2562,4037
2002,Urban,Gujarat,Property Crime,Burglary,Female,31-45,1992,825,1167,887,1105
2003,Rural,Gujarat,Crime Against Women,Dowry Deaths,Female,0-12,1858,949,909,1329,529
2010,Urban,Karnataka,Crime Against Women,Molestation,Male,18-30,3417,2240,1177,2606,811
2009,Rural,Karnataka,Crime Against Women,Domestic Violence,Female,46-60,625,159,466,290,335
2006,Rural,Manipur,Crime Against Women,Dowry Deaths,Male,18-30,4849,3684,1165,4571,278
2006,Urban,Himachal Pradesh,Crime Against Women,Rape,Male,60+,7270,4712,2558,6389,881
2001,Urban,Telangana,Crime Against Women,Rape,Female,0-12,8621,5238,3383,5879,2742
2006,Urban,Nagaland,Crime Against Men,Assault,Female,13-17,4941,4680,261,4749,192
2007,Rural,Punjab,Property Crime,Burglary,Female,18-30,9048,6549,2499,7098,1950
2007,Urban,West Bengal,Crime Against Children,Child Abuse,Male,31-45,3835,2095,1740,2192,1643
2006,Urban,Sikkim,Crime Against Women,Rape,Female,13-17,6603,853,5750,901,5702
2009,Urban,Jammu & Kashmir,Crime Against Children,Trafficking,Male,46-60,5095,858,4237,2071,3024
2001,Urban,Sikkim,Crime Against Women,Molestation,Male,46-60,6141,368,5773,5363,778
2002,Rural,Himachal Pradesh,Other Crimes,Drug Offense,Male,60+,1044,483,561,907,137
2010,Rural,Karnataka,Crime Against Women,Rape,Male,31-45,9140,8438,702,8445,695
2009,Urban,Rajasthan,Crime Against Men,Assault,Male,18-30,2034,1268,766,1972,62
2004,Urban,Arunachal Pradesh,Property Crime,Theft,Female,60+,9714,1055,8659,8231,1483
2009,Rural,Jharkhand,Crime Against Women,Dowry Deaths,Female,60+,6035,2487,3548,4212,1823
2010,Urban,Bihar,Property Crime,Arson,Female,13-17,9227,2616,6611,2889,6338
2002,Urban,Mizoram,Crime Against Men,Robbery,Female,13-17,3442,3353,89,3368,74
2002,Rural,Meghalaya,Crime Against Men,Assault,Male,31-45,5626,229,5397,931,4695
2007,Urban,Maharashtra,Crime Against Men,Assault,Male,18-30,7150,6101,1049,7142,8
2001,Rural,Karnataka,Crime Against Children,Child Abuse,Male,31-45,855,725,130,800,55
2006,Rural,Mizoram,Crime Against Children,Child Labor,Female,31-45,705,572,133,701,4
2002,Rural,Meghalaya,Crime Against Men,Robbery,Male,0-12,7409,1751,5658,2906,4503
2006,Rural,Tamil Nadu,Other Crimes,Corruption,Female,60+,4023,985,3038,1602,2421
2009,Urban,Telangana,Property Crime,Arson,Male,18-30,4064,2476,1588,2840,1224
2005,Urban,Jammu & Kashmir,Other Crimes,Cyber Crime,Female,0-12,507,451,56,489,18
2005,Urban,Andhra Pradesh,Crime Against Women,Domestic Violence,Male,46-60,8768,221,8547,8540,228
2006,Rural,Maharashtra,Crime Against Women,Domestic Violence,Female,13-17,6250,5740,510,5941,309
2008,Urban,Uttarakhand,Property Crime,Theft,Male,60+,1656,948,708,1090,566
2008,Urban,Assam,Property Crime,Vandalism,Male,18-30,7157,7066,91,7115,42
2002,Rural,Jammu & Kashmir,Crime Against Men,Murder,Female,13-17,7414,6395,1019,6566,848
2006,Rural,Maharashtra,Crime Against Children,Child Abuse,Female,46-60,7662,4536,3126,6656,1006
2009,Urban,Assam,Property Crime,Burglary,Male,13-17,2433,997,1436,1975,458
2001,Rural,Kerala,Property Crime,Theft,Male,60+,5266,5021,245,5206,60
2005,Rural,Delhi,Other Crimes,Fraud,Male,18-30,3255,2907,348,2984,271
2008,Rural,Jammu & Kashmir,Crime Against Men,Robbery,Male,13-17,4940,3971,969,4546,394
2009,Urban,Goa,Crime Against Children,Child Labor,Female,18-30,4634,3915,719,4294,340
2004,Rural,Goa,Property Crime,Theft,Male,60+,6909,2290,4619,6731,178
2006,Urban,Sikkim,Crime Against Women,Domestic Violence,Female,18-30,4909,1836,3073,1945,2964
2007,Rural,Telangana,Crime Against Men,Extortion,Male,18-30,2288,56,2232,964,1324
2010,Rural,Himachal Pradesh,Crime Against Men,Extortion,Male,60+,5459,3985,1474,5394,65
2001,Urban,Kerala,Property Crime,Arson,Male,0-12,8484,4554,3930,8018,466
2003,Rural,Assam,Crime Against Children,Trafficking,Male,13-17,1754,1415,339,1731,23
2003,Rural,Gujarat,Crime Against Women,Domestic Violence,Female,18-30,2311,1192,1119,1485,826
2008,Urban,Punjab,Crime Against Women,Rape,Female,46-60,5211,697,4514,1337,3874
2003,Rural,Karnataka,Crime Against Women,Rape,Male,0-12,540,29,511,62,478
2006,Rural,West Bengal,Crime Against Men,Robbery,Female,60+,1936,1346,590,1608,328
2004,Rural,Telangana,Crime Against Children,Kidnapping,Male,60+,3474,2009,1465,2486,988
2002,Urban,Delhi,Crime Against Women,Domestic Violence,Male,60+,5286,3167,2119,4167,1119
2010,Rural,Goa,Property Crime,Arson,Female,18-30,8876,7478,1398,8134,742
2002,Urban,Odisha,Crime Against Women,Rape,Female,31-45,952,678,274,695,257
2006,Rural,Tripura,Crime Against Men,Assault,Female,18-30,9593,4043,5550,8113,1480
2005,Rural,Meghalaya,Property Crime,Burglary,Male,60+,2820,2607,213,2773,47
2001,Rural,Mizoram,Property Crime,Arson,Male,0-12,8473,8265,208,8444,29
2010,Urban,Gujarat,Crime Against Children,Child Abuse,Male,18-30,4585,2758,1827,4095,490
2003,Rural,Meghalaya,Other Crimes,Cyber Crime,Female,0-12,210,6,204,122,88
2005,Rural,Telangana,Crime Against Men,Robbery,Male,18-30,6578,3540,3038,4219,2359
2006,Urban,Haryana,Crime Against Women,Rape,Male,0-12,5350,1037,4313,3266,2084
2009,Rural,Punjab,Crime Against Children,Kidnapping,Male,18-30,5588,5164,424,5377,211
2003,Urban,Tripura,Other Crimes,Fraud,Male,13-17,3997,613,3384,3612,385
2001,Urban,Assam,Crime Against Women,Domestic Violence,Female,18-30,8115,4104,4011,7685,430
2010,Urban,Rajasthan,Crime Against Women,Dowry Deaths,Female,46-60,2292,1685,607,1990,302
2007,Rural,Andhra Pradesh,Crime Against Women,Domestic Violence,Male,60+,9319,4286,5033,7955,1364
2005,Rural,Mizoram,Crime Against Women,Rape,Male,0-12,6027,4987,1040,5526,501
2002,Rural,Rajasthan,Property Crime,Vandalism,Female,0-12,9724,1518,8206,3484,6240
2009,Rural,Delhi,Other Crimes,Corruption,Male,46-60,4651,106,4545,3124,1527
2004,Urban,Uttarakhand,Other Crimes,Corruption,Male,46-60,1786,262,1524,1366,420
2001,Rural,Mizoram,Property Crime,Vandalism,Male,0-12,487,402,85,478,9
2002,Rural,Odisha,Property Crime,Theft,Female,31-45,287,149,138,258,29
2002,Rural,Gujarat,Other Crimes,Drug Offense,Female,31-45,3386,2370,1016,2742,644
2003,Rural,Meghalaya,Property Crime,Burglary,Female,0-12,6246,3448,2798,4375,1871
2005,Urban,Andhra Pradesh,Other Crimes,Cyber Crime,Female,18-30,1423,1098,325,1273,150
2007,Rural,Rajasthan,Crime Against Children,Child Labor,Female,60+,187,172,15,178,9
2001,Urban,Karnataka,Crime Against Children,Trafficking,Male,60+,7968,2462,5506,5529,2439
2010,Rural,Meghalaya,Crime Against Women,Dowry Deaths,Female,0-12,8102,6100,2002,7180,922
2007,Rural,Delhi,Crime Against Women,Rape,Female,0-12,5510,4055,1455,4761,749
2008,Urban,Nagaland,Other Crimes,Drug Offense,Female,13-17,7830,419,7411,2205,5625
2006,Rural,Tripura,Property Crime,Arson,Male,46-60,316,69,247,105,211
2006,Urban,Rajasthan,Other Crimes,Fraud,Male,60+,1876,979,897,1870,6
2006,Urban,Karnataka,Crime Against Children,Trafficking,Male,0-12,4866,3349,1517,3995,871
2003,Urban,Goa,Crime Against Women,Rape,Female,13-17,1131,727,404,936,195
2004,Urban,Telangana,Crime Against Men,Murder,Male,13-17,2215,762,1453,880,1335
2001,Rural,Karnataka,Crime Against Men,Extortion,Female,18-30,649,350,299,482,167
2005,Urban,Gujarat,Crime Against Children,Kidnapping,Male,31-45,8294,2642,5652,6785,1509
2007,Urban,Tamil Nadu,Other Crimes,Drug Offense,Female,18-30,517,223,294,383,134
2008,Rural,Meghalaya,Crime Against Children,Trafficking,Male,18-30,5861,1033,4828,2060,3801
2008,Rural,Manipur,Property Crime,Burglary,Female,18-30,461,215,246,369,92
2004,Rural,Meghalaya,Property Crime,Theft,Female,60+,1709,1704,5,1709,0
2004,Urban,Chhattisgarh,Crime Against Children,Kidnapping,Male,60+,8285,1495,6790,8006,279
2007,Rural,Gujarat,Other Crimes,Corruption,Male,46-60,9980,7380,2600,9505,475
2006,Urban,Telangana,Crime Against Women,Rape,Male,18-30,3861,1339,2522,1702,2159
2009,Rural,Telangana,Crime Against Men,Robbery,Male,13-17,1588,127,1461,337,1251
2010,Rural,Tripura,Property Crime,Burglary,Male,31-45,9300,3757,5543,7036,2264
2007,Urban,Uttar Pradesh,Crime Against Children,Trafficking,Female,60+,7297,1089,6208,4830,2467
2010,Urban,Rajasthan,Crime Against Women,Dowry Deaths,Female,60+,7233,643,6590,6644,589
2004,Urban,Jharkhand,Crime Against Children,Child Labor,Male,0-12,8954,3440,5514,4707,4247
2009,Rural,West Bengal,Property Crime,Burglary,Female,0-12,8590,3440,5150,5912,2678
2003,Rural,Himachal Pradesh,Crime Against Men,Extortion,Female,0-12,3138,1201,1937,2118,1020
2004,Urban,Gujarat,Crime Against Women,Dowry Deaths,Female,18-30,7730,7078,652,7544,186
2010,Rural,Sikkim,Property Crime,Theft,Female,46-60,4004,1868,2136,3835,169
2002,Rural,Haryana,Other Crimes,Corruption,Male,31-45,938,221,717,612,326
2007,Rural,Andhra Pradesh,Crime Against Women,Rape,Male,13-17,9741,1192,8549,8436,1305
2007,Rural,Delhi,Other Crimes,Drug Offense,Male,60+,4368,1059,3309,3083,1285
2001,Rural,Jammu & Kashmir,Crime Against Women,Molestation,Female,13-17,1374,166,1208,1222,152
2004,Rural,Bihar,Crime Against Children,Child Abuse,Male,0-12,6538,2367,4171,6017,521
2005,Rural,Delhi,Property Crime,Theft,Female,18-30,8946,1091,7855,5090,3856
2005,Urban,Jharkhand,Property Crime,Vandalism,Male,31-45,7855,7348,507,7421,434
2008,Urban,Maharashtra,Crime Against Children,Child Labor,Female,0-12,4377,476,3901,1400,2977
2005,Urban,Tamil Nadu,Crime Against Children,Child Abuse,Female,13-17,4265,2164,2101,3483,782
2009,Urban,Rajasthan,Crime Against Men,Assault,Male,31-45,3111,2069,1042,2581,530
2003,Rural,Himachal Pradesh,Crime Against Men,Assault,Male,0-12,907,654,253,723,184
2006,Rural,Telangana,Property Crime,Arson,Male,60+,1651,1584,67,1611,40
2009,Rural,West Bengal,Crime Against Children,Trafficking,Male,0-12,4492,1941,2551,4428,64
2008,Urban,Manipur,Crime Against Women,Rape,Female,60+,7433,7228,205,7293,140
2004,Urban,Meghalaya,Crime Against Women,Rape,Female,46-60,7230,1927,5303,5437,1793
2007,Urban,Andhra Pradesh,Other Crimes,Corruption,Male,60+,1122,384,738,798,324
2008,Urban,Punjab,Crime Against Children,Trafficking,Female,60+,5939,1551,4388,4456,1483
2002,Urban,Karnataka,Other Crimes,Drug Offense,Female,31-45,7933,840,7093,6428,1505
2002,Urban,Delhi,Other Crimes,Corruption,Male,13-17,3083,1086,1997,2401,682
2003,Rural,Andhra Pradesh,Crime Against Children,Child Abuse,Female,60+,1889,476,1413,935,954
2010,Rural,Madhya Pradesh,Crime Against Women,Domestic Violence,Male,31-45,4030,2236,1794,3706,324
2003,Rural,Punjab,Crime Against Men,Robbery,Male,18-30,446,66,380,313,133
2005,Rural,Karnataka,Crime Against Women,Molestation,Male,18-30,5528,1409,4119,1561,3967
2003,Rural,Assam,Property Crime,Burglary,Male,46-60,1682,1253,429,1580,102
2006,Rural,Tripura,Property Crime,Burglary,Female,46-60,1729,50,1679,1021,708
2003,Urban,Odisha,Crime Against Women,Dowry Deaths,Female,60+,4293,197,4096,3324,969
2006,Urban,Telangana,Crime Against Men,Extortion,Female,60+,8654,1809,6845,3076,5578
2001,Urban,Kerala,Crime Against Women,Domestic Violence,Male,13-17,3130,2718,412,2954,176
2004,Rural,Andhra Pradesh,Other Crimes,Corruption,Female,60+,3745,2590,1155,2798,947
2001,Urban,Haryana,Other Crimes,Cyber Crime,Male,13-17,8779,1475,7304,5165,3614
2006,Rural,Andhra Pradesh,Crime Against Children,Child Abuse,Female,0-12,1263,78,1185,882,381
2010,Rural,Tamil Nadu,Other Crimes,Cyber Crime,Female,13-17,9677,6297,3380,9520,157
2005,Urban,Rajasthan,Crime Against Men,Assault,Male,0-12,8315,6061,2254,6937,1378
2007,Rural,Delhi,Crime Against Men,Extortion,Female,31-45,5181,3854,1327,4350,831
2006,Urban,Tamil Nadu,Property Crime,Arson,Female,0-12,6191,3747,2444,4080,2111
2002,Urban,Sikkim,Other Crimes,Fraud,Female,46-60,7800,2385,5415,3423,4377
2002,Urban,Tripura,Property Crime,Arson,Female,13-17,6174,3577,2597,5684,490
2010,Rural,Sikkim,Crime Against Men,Extortion,Male,13-17,5458,3450,2008,4553,905
2006,Rural,Arunachal Pradesh,Other Crimes,Corruption,Male,13-17,3725,651,3074,3355,370
2005,Urban,Bihar,Crime Against Women,Dowry Deaths,Female,31-45,2964,2262,702,2938,26
2003,Rural,Sikkim,Other Crimes,Drug Offense,Female,31-45,7643,2410,5233,3138,4505
2003,Urban,Uttarakhand,Crime Against Children,Kidnapping,Female,31-45,5205,47,5158,1128,4077
2010,Urban,Telangana,Property Crime,Arson,Female,13-17,9363,6361,3002,7417,1946
2005,Urban,Odisha,Crime Against Men,Murder,Male,31-45,7879,6968,911,7582,297
2005,Urban,Punjab,Crime Against Women,Rape,Female,13-17,7760,5662,2098,6387,1373
2006,Rural,Haryana,Other Crimes,Drug Offense,Male,31-45,5021,4574,447,4596,425
2006,Rural,Rajasthan,Crime Against Women,Dowry Deaths,Female,31-45,9131,2705,6426,6670,2461
2005,Rural,West Bengal,Crime Against Women,Rape,Female,46-60,9988,9224,764,9866,122
2007,Urban,Odisha,Property Crime,Arson,Male,46-60,8687,5199,3488,7271,1416
2003,Rural,Kerala,Crime Against Men,Assault,Female,0-12,8295,1465,6830,4349,3946
2007,Rural,West Bengal,Crime Against Children,Kidnapping,Female,60+,7385,3166,4219,4077,3308
2003,Urban,Delhi,Crime Against Men,Assault,Female,0-12,1205,802,403,999,206
2010,Rural,Manipur,Other Crimes,Corruption,Male,13-17,5997,4032,1965,4828,1169
2008,Urban,Karnataka,Property Crime,Arson,Female,31-45,8298,296,8002,3840,4458
2004,Urban,Uttarakhand,Crime Against Women,Molestation,Male,46-60,2556,1616,940,2425,131
2006,Urban,Jammu & Kashmir,Crime Against Children,Trafficking,Male,60+,5350,570,4780,1957,3393
2006,Urban,Meghalaya,Crime Against Men,Robbery,Male,0-12,2341,368,1973,2145,196
2003,Urban,Manipur,Property Crime,Theft,Male,31-45,9053,4424,4629,7818,1235
2008,Urban,Tripura,Crime Against Children,Kidnapping,Female,31-45,7913,3089,4824,5867,2046
2009,Rural,Andhra Pradesh,Other Crimes,Corruption,Male,60+,8248,5737,2511,8225,23
2008,Rural,Arunachal Pradesh,Crime Against Children,Child Labor,Female,13-17,2660,399,2261,1743,917
2007,Rural,Assam,Property Crime,Burglary,Male,46-60,9066,4632,4434,6104,2962
2003,Rural,Madhya Pradesh,Property Crime,Theft,Male,0-12,2317,1004,1313,1663,654
2004,Rural,Maharashtra,Property Crime,Theft,Male,46-60,9479,1373,8106,7413,2066
2001,Rural,Punjab,Property Crime,Theft,Male,60+,2443,655,1788,1622,821
2004,Urban,Jharkhand,Crime Against Men,Robbery,Male,18-30,591,284,307,414,177
2008,Rural,Uttarakhand,Other Crimes,Drug Offense,Male,46-60,9628,1326,8302,5911,3717
2010,Rural,Karnataka,Crime Against Women,Molestation,Female,60+,4728,1326,3402,3553,1175
2003,Urban,Tamil Nadu,Crime Against Children,Kidnapping,Female,0-12,1432,1388,44,1397,35
2005,Rural,Himachal Pradesh,Crime Against Men,Extortion,Male,31-45,6778,2242,4536,6079,699
2003,Urban,West Bengal,Other Crimes,Corruption,Male,46-60,1784,828,956,1655,129
2006,Rural,Sikkim,Crime Against Children,Kidnapping,Male,31-45,3602,3299,303,3343,259
2005,Urban,Himachal Pradesh,Property Crime,Burglary,Male,46-60,6943,1186,5757,3089,3854
2002,Rural,Delhi,Crime Against Children,Kidnapping,Female,46-60,6917,1928,4989,3474,3443
2010,Rural,Telangana,Crime Against Men,Extortion,Female,60+,5758,4982,776,5229,529
2007,Urban,Tripura,Property Crime,Vandalism,Male,46-60,7229,1053,6176,4336,2893
2008,Rural,Haryana,Property Crime,Arson,Male,60+,4973,1080,3893,1846,3127
2003,Rural,Karnataka,Property Crime,Vandalism,Male,46-60,6684,5912,772,6349,335
2008,Rural,West Bengal,Property Crime,Arson,Male,31-45,3400,88,3312,2722,678
2010,Urban,Himachal Pradesh,Crime Against Women,Dowry Deaths,Female,60+,8908,3257,5651,5634,3274
2003,Urban,Mizoram,Other Crimes,Corruption,Male,60+,4999,2849,2150,3982,1017
2003,Urban,Assam,Crime Against Children,Child Labor,Female,0-12,364,188,176,259,105
2009,Rural,Himachal Pradesh,Crime Against Women,Rape,Female,18-30,9540,1770,7770,3520,6020
2006,Urban,Tripura,Crime Against Men,Assault,Male,31-45,5488,4559,929,5318,170
2001,Rural,Assam,Property Crime,Vandalism,Male,60+,2835,697,2138,872,1963
2009,Rural,Jharkhand,Crime Against Men,Murder,Male,18-30,9656,7943,1713,8111,1545
2007,Urban,West Bengal,Crime Against Men,Extortion,Female,31-45,547,169,378,343,204
2010,Urban,Kerala,Property Crime,Burglary,Male,13-17,4445,461,3984,3400,1045
2005,Urban,Jharkhand,Crime Against Children,Trafficking,Male,31-45,6078,4032,2046,5267,811
2006,Rural,Andhra Pradesh,Crime Against Men,Assault,Male,31-45,4810,3570,1240,3800,1010
2006,Rural,Mizoram,Other Crimes,Cyber Crime,Male,13-17,4043,834,3209,2752,1291
2009,Rural,West Bengal,Crime Against Men,Extortion,Female,18-30,463,98,365,225,238
2004,Rural,Maharashtra,Crime Against Women,Rape,Male,0-12,4299,2855,1444,3910,389
2009,Urban,Punjab,Crime Against Women,Domestic Violence,Male,46-60,8144,7592,552,8114,30
2008,Urban,Bihar,Crime Against Men,Extortion,Female,18-30,3779,3121,658,3336,443
2006,Rural,West Bengal,Property Crime,Arson,Female,0-12,6599,4868,1731,6535,64
2008,Rural,Tripura,Crime Against Women,Dowry Deaths,Female,0-12,6541,428,6113,2377,4164
2008,Urban,Haryana,Crime Against Children,Child Labor,Male,31-45,8471,2647,5824,7319,1152
2007,Rural,Gujarat,Other Crimes,Fraud,Male,31-45,6858,3654,3204,4550,2308
2009,Urban,Punjab,Crime Against Women,Molestation,Female,60+,3437,3022,415,3389,48
2003,Urban,Chhattisgarh,Crime Against Children,Trafficking,Female,13-17,4012,2866,1146,3839,173
2002,Urban,Karnataka,Other Crimes,Drug Offense,Male,0-12,5169,3045,2124,5159,10
2010,Urban,Jammu & Kashmir,Crime Against Men,Extortion,Male,46-60,4673,4223,450,4304,369
2008,Rural,Kerala,Property Crime,Vandalism,Male,46-60,6085,2469,3616,2677,3408
2007,Rural,Uttarakhand,Property Crime,Burglary,Female,31-45,1598,935,663,1509,89
2005,Rural,Delhi,Other Crimes,Corruption,Male,18-30,2466,782,1684,900,1566
2005,Rural,Jammu & Kashmir,Crime Against Children,Child Labor,Male,31-45,5965,4499,1466,4818,1147
2002,Urban,Arunachal Pradesh,Other Crimes,Drug Offense,Male,46-60,5968,5416,552,5955,13
2007,Rural,Madhya Pradesh,Other Crimes,Corruption,Male,13-17,2328,1816,512,1861,467
2003,Urban,Tamil Nadu,Crime Against Men,Extortion,Female,13-17,7483,5557,1926,6506,977
2004,Rural,Jammu & Kashmir,Crime Against Children,Child Abuse,Male,13-17,6899,2516,4383,5577,1322
2005,Urban,Jammu & Kashmir,Property Crime,Burglary,Male,13-17,1940,342,1598,585,1355
2001,Urban,Meghalaya,Crime Against Women,Dowry Deaths,Male,46-60,4623,239,4384,4322,301
2001,Rural,Bihar,Other Crimes,Corruption,Male,13-17,1438,389,1049,673,765
2001,Urban,Kerala,Crime Against Children,Child Labor,Male,0-12,2339,1168,1171,2177,162
2007,Urban,Madhya Pradesh,Property Crime,Arson,Female,0-12,8468,5789,2679,7248,1220
2004,Urban,Karnataka,Crime Against Women,Rape,Male,18-30,9496,7408,2088,8698,798
2008,Urban,Nagaland,Crime Against Children,Child Abuse,Male,13-17,8890,412,8478,6197,2693
2004,Urban,Himachal Pradesh,Property Crime,Vandalism,Male,60+,9050,6277,2773,6301,2749
2008,Rural,Bihar,Property Crime,Burglary,Female,46-60,5050,4311,739,4333,717
2008,Urban,Punjab,Crime Against Men,Murder,Female,13-17,9672,3233,6439,8127,1545
2010,Urban,Haryana,Other Crimes,Cyber Crime,Female,31-45,9423,1444,7979,2269,7154
2007,Urban,Andhra Pradesh,Crime Against Men,Assault,Male,46-60,5823,2021,3802,5650,173
2009,Urban,Sikkim,Crime Against Men,Murder,Male,31-45,8549,4264,4285,6199,2350
2008,Urban,Meghalaya,Crime Against Men,Murder,Male,13-17,1004,547,457,646,358
2005,Urban,Telangana,Other Crimes,Corruption,Female,46-60,7560,1926,5634,2275,5285
2004,Rural,Maharashtra,Crime Against Men,Assault,Male,13-17,8165,5037,3128,6029,2136
2006,Rural,Tripura,Crime Against Men,Assault,Female,60+,4744,1847,2897,3319,1425
2003,Rural,Kerala,Crime Against Children,Trafficking,Female,46-60,8298,6182,2116,7143,1155
2003,Rural,Chhattisgarh,Crime Against Women,Domestic Violence,Male,18-30,1177,567,610,865,312
2006,Urban,West Bengal,Property Crime,Vandalism,Male,0-12,7588,157,7431,7287,301
2006,Urban,Mizoram,Crime Against Children,Trafficking,Male,0-12,5858,2273,3585,3058,2800
2005,Urban,Uttar Pradesh,Crime Against Children,Child Labor,Male,60+,214,176,38,188,26
2006,Urban,Andhra Pradesh,Property Crime,Theft,Male,13-17,7792,6225,1567,7249,543
2002,Urban,Maharashtra,Other Crimes,Fraud,Female,18-30,9496,3302,6194,4409,5087
2002,Urban,Karnataka,Crime Against Men,Robbery,Female,46-60,4831,1695,3136,3477,1354
2003,Rural,West Bengal,Crime Against Children,Trafficking,Female,46-60,6242,3323,2919,5471,771
2007,Urban,Arunachal Pradesh,Crime Against Men,Assault,Male,60+,1750,1732,18,1742,8
2009,Rural,Punjab,Crime Against Men,Assault,Female,0-12,8427,5432,2995,7059,1368
2002,Urban,Madhya Pradesh,Crime Against Men,Extortion,Male,13-17,2780,24,2756,2287,493
2006,Rural,Gujarat,Other Crimes,Corruption,Male,31-45,6412,1236,5176,3551,2861
2005,Urban,Nagaland,Property Crime,Theft,Male,18-30,1289,128,1161,378,911
2004,Urban,Rajasthan,Property Crime,Theft,Female,46-60,6856,1423,5433,2320,4536
2001,Urban,Goa,Other Crimes,Drug Offense,Female,46-60,6780,2917,3863,5034,1746
2005,Rural,Chhattisgarh,Property Crime,Arson,Female,60+,896,492,404,521,375
2004,Urban,Mizoram,Other Crimes,Cyber Crime,Female,18-30,5332,2581,2751,4606,726
2004,Rural,Rajasthan,Crime Against Children,Trafficking,Female,31-45,6383,750,5633,3121,3262
2001,Urban,Uttar Pradesh,Other Crimes,Corruption,Female,13-17,669,137,532,170,499
2005,Rural,Manipur,Property Crime,Arson,Female,60+,3999,3428,571,3514,485
2008,Urban,Kerala,Property Crime,Vandalism,Female,60+,789,262,527,423,366
2005,Rural,Nagaland,Crime Against Children,Trafficking,Male,31-45,6673,533,6140,4222,2451
2005,Urban,Karnataka,Crime Against Women,Rape,Female,18-30,9135,3353,5782,4847,4288
2008,Urban,Himachal Pradesh,Crime Against Men,Murder,Female,0-12,1732,821,911,1543,189
2003,Rural,Gujarat,Crime Against Women,Rape,Male,18-30,7526,3608,3918,6519,1007
2006,Rural,Haryana,Other Crimes,Corruption,Male,46-60,4206,2483,1723,2710,1496
2001,Urban,Assam,Crime Against Women,Domestic Violence,Female,46-60,7651,1921,5730,5722,1929
2007,Rural,Rajasthan,Other Crimes,Cyber Crime,Female,13-17,5251,1724,3527,3770,1481
2001,Urban,West Bengal,Crime Against Children,Kidnapping,Female,13-17,123,13,110,51,72
2009,Rural,Kerala,Crime Against Women,Dowry Deaths,Female,46-60,3217,1932,1285,3158,59
2004,Urban,Tamil Nadu,Crime Against Men,Extortion,Female,13-17,251,57,194,108,143
2001,Urban,Tamil Nadu,Property Crime,Arson,Female,0-12,6705,1333,5372,1992,4713
2007,Rural,Punjab,Crime Against Women,Rape,Female,0-12,5424,2140,3284,3499,1925
2003,Urban,Kerala,Other Crimes,Drug Offense,Female,18-30,5212,3820,1392,5049,163
2007,Urban,Chhattisgarh,Property Crime,Burglary,Male,46-60,494,357,137,482,12
2007,Urban,Sikkim,Crime Against Men,Robbery,Male,31-45,3131,868,2263,1426,1705
2005,Rural,Manipur,Crime Against Men,Extortion,Male,46-60,481,379,102,426,55
2006,Rural,Odisha,Crime Against Men,Murder,Male,46-60,1514,1163,351,1181,333
2003,Urban,West Bengal,Crime Against Men,Extortion,Male,31-45,9145,2133,7012,2516,6629
2009,Rural,Mizoram,Other Crimes,Cyber Crime,Female,60+,6589,6510,79,6587,2
2005,Urban,West Bengal,Crime Against Women,Molestation,Female,18-30,7640,5292,2348,6119,1521
2002,Urban,Uttarakhand,Crime Against Children,Kidnapping,Male,13-17,1866,755,1111,1407,459
2002,Urban,Mizoram,Other Crimes,Cyber Crime,Female,18-30,4381,2834,1547,3196,1185
2006,Rural,West Bengal,Crime Against Women,Domestic Violence,Male,0-12,4314,1180,3134,1236,3078
2004,Urban,Tamil Nadu,Crime Against Women,Molestation,Female,60+,5591,2364,3227,2833,2758
2001,Urban,Delhi,Other Crimes,Fraud,Female,60+,2543,955,1588,2201,342
2007,Urban,Maharashtra,Crime Against Women,Domestic Violence,Female,0-12,227,57,170,126,101
2010,Rural,Meghalaya,Property Crime,Vandalism,Male,0-12,6565,5641,924,5911,654
2006,Rural,Delhi,Crime Against Children,Child Labor,Male,13-17,8820,7740,1080,8296,524
2003,Urban,Karnataka,Crime Against Women,Rape,Male,46-60,8558,3714,4844,7974,584
2006,Urban,Bihar,Property Crime,Theft,Male,0-12,6492,1511,4981,4663,1829
2009,Rural,Mizoram,Other Crimes,Fraud,Male,13-17,6177,3070,3107,3874,2303
2002,Urban,Sikkim,Property Crime,Burglary,Male,46-60,2746,2432,314,2501,245
2010,Rural,Uttar Pradesh,Crime Against Men,Assault,Female,13-17,7391,6289,1102,7183,208
2002,Urban,Arunachal Pradesh,Crime Against Women,Molestation,Male,60+,1505,1161,344,1291,214
2007,Rural,West Bengal,Crime Against Women,Rape,Male,13-17,6035,180,5855,1602,4433
2005,Urban,Chhattisgarh,Crime Against Women,Dowry Deaths,Female,0-12,514,385,129,425,89
2006,Rural,Jammu & Kashmir,Crime Against Women,Domestic Violence,Male,31-45,9803,3287,6516,4013,5790
2009,Urban,Jammu & Kashmir,Crime Against Men,Murder,Male,18-30,2057,1527,530,1930,127
2002,Rural,Jammu & Kashmir,Crime Against Children,Child Labor,Female,31-45,1735,1025,710,1381,354
2001,Rural,Tamil Nadu,Crime Against Men,Robbery,Female,46-60,3041,3017,24,3027,14
2001,Urban,Andhra Pradesh,Crime Against Children,Child Labor,Female,0-12,2740,2079,661,2403,337
2002,Urban,Delhi,Crime Against Children,Kidnapping,Female,0-12,6534,4855,1679,4981,1553
2002,Rural,Chhattisgarh,Other Crimes,Cyber Crime,Female,13-17,4524,1092,3432,1989,2535
2009,Rural,Haryana,Crime Against Men,Murder,Male,46-60,5806,2871,2935,2910,2896
2006,Rural,Jammu & Kashmir,Crime Against Women,Molestation,Female,18-30,4030,1865,2165,2600,1430
2005,Urban,Goa,Crime Against Women,Dowry Deaths,Male,18-30,9858,471,9387,6053,3805
2006,Urban,Andhra Pradesh,Crime Against Men,Murder,Female,18-30,7185,660,6525,4308,2877
2006,Rural,Jammu & Kashmir,Other Crimes,Cyber Crime,Male,0-12,4436,1293,3143,2780,1656
2004,Rural,Jharkhand,Crime Against Children,Trafficking,Female,31-45,8160,865,7295,2109,6051
2002,Rural,Assam,Property Crime,Vandalism,Male,31-45,9452,4602,4850,8354,1098
2005,Urban,Rajasthan,Crime Against Children,Trafficking,Male,60+,749,275,474,600,149
2003,Urban,Jammu & Kashmir,Property Crime,Burglary,Male,60+,6603,1328,5275,4534,2069
2006,Urban,Delhi,Other Crimes,Cyber Crime,Male,46-60,7276,1313,5963,4796,2480
2010,Rural,Madhya Pradesh,Crime Against Women,Dowry Deaths,Male,0-12,2628,985,1643,1884,744
2006,Urban,Manipur,Crime Against Children,Child Labor,Female,60+,4988,4459,529,4757,231
2010,Rural,Uttarakhand,Property Crime,Vandalism,Female,31-45,8536,7431,1105,8098,438
2002,Urban,Arunachal Pradesh,Crime Against Women,Dowry Deaths,Female,18-30,6699,5587,1112,5701,998
2007,Rural,Bihar,Crime Against Men,Assault,Female,13-17,9779,183,9596,2196,7583
2004,Rural,Tripura,Crime Against Women,Domestic Violence,Male,13-17,9048,687,8361,2383,6665
2004,Urban,Uttarakhand,Property Crime,Vandalism,Male,13-17,609,444,165,498,111
2002,Urban,Rajasthan,Crime Against Men,Extortion,Male,0-12,7321,5274,2047,6126,1195
2001,Rural,Uttarakhand,Crime Against Women,Molestation,Male,60+,619,78,541,396,223
2001,Rural,Jammu & Kashmir,Other Crimes,Fraud,Female,13-17,1793,1389,404,1630,163
2006,Rural,Telangana,Other Crimes,Drug Offense,Male,13-17,1102,440,662,517,585
2007,Rural,Maharashtra,Crime Against Women,Dowry Deaths,Male,0-12,8952,924,8028,4134,4818
2003,Urban,Bihar,Crime Against Men,Robbery,Female,13-17,9058,8130,928,8132,926
2003,Rural,Meghalaya,Crime Against Children,Child Labor,Male,18-30,3990,3680,310,3895,95
2009,Urban,West Bengal,Other Crimes,Drug Offense,Male,13-17,7240,7061,179,7188,52
2007,Rural,Uttarakhand,Crime Against Children,Child Abuse,Male,0-12,5216,4277,939,4510,706
2010,Rural,Manipur,Crime Against Children,Child Labor,Male,60+,2178,175,2003,669,1509
2009,Urban,Himachal Pradesh,Crime Against Men,Assault,Male,13-17,1386,1263,123,1288,98
2001,Urban,Rajasthan,Crime Against Children,Child Abuse,Female,60+,1020,852,168,957,63
2004,Urban,Tripura,Crime Against Women,Rape,Male,18-30,4910,3174,1736,3431,1479
2002,Rural,Bihar,Crime Against Women,Molestation,Male,46-60,1376,470,906,908,468
2009,Urban,Arunachal Pradesh,Crime Against Women,Rape,Female,0-12,4178,3200,978,3877,301
2010,Urban,Mizoram,Crime Against Men,Robbery,Male,13-17,8651,1690,6961,8200,451
2003,Rural,Jharkhand,Crime Against Men,Robbery,Male,60+,151,15,136,110,41
2002,Urban,Rajasthan,Crime Against Men,Extortion,Male,0-12,9875,7478,2397,9338,537
2006,Urban,Assam,Crime Against Women,Rape,Female,60+,7185,5427,1758,5934,1251
2002,Urban,Chhattisgarh,Crime Against Men,Extortion,Female,46-60,5743,5581,162,5601,142
2003,Rural,Meghalaya,Property Crime,Vandalism,Female,13-17,4296,4037,259,4080,216
2009,Urban,Uttarakhand,Other Crimes,Cyber Crime,Female,0-12,745,82,663,353,392
2006,Urban,Tamil Nadu,Crime Against Women,Dowry Deaths,Female,0-12,5564,2772,2792,5177,387
2003,Rural,Odisha,Crime Against Men,Extortion,Female,0-12,8916,7703,1213,8630,286
2008,Rural,Uttarakhand,Other Crimes,Cyber Crime,Male,13-17,5669,1289,4380,1561,4108
2010,Rural,Jammu & Kashmir,Property Crime,Burglary,Female,46-60,7963,3644,4319,4946,3017
2008,Urban,Bihar,Crime Against Children,Trafficking,Male,46-60,1234,407,827,997,237
2005,Rural,Delhi,Property Crime,Burglary,Female,31-45,2825,1560,1265,2427,398
2003,Urban,Nagaland,Crime Against Children,Kidnapping,Male,46-60,9140,8856,284,8892,248
2003,Rural,Goa,Other Crimes,Cyber Crime,Female,60+,8377,5580,2797,6923,1454
2009,Urban,Telangana,Property Crime,Burglary,Male,31-45,5393,3081,2312,3229,2164
2002,Urban,Karnataka,Crime Against Men,Extortion,Female,0-12,7897,1897,6000,2948,4949
2003,Urban,Meghalaya,Crime Against Women,Molestation,Female,13-17,9105,2813,6292,7387,1718
2006,Rural,Delhi,Crime Against Women,Rape,Female,18-30,7787,3114,4673,4299,3488
2009,Urban,Madhya Pradesh,Property Crime,Arson,Male,60+,490,282,208,337,153
2008,Urban,Rajasthan,Crime Against Children,Trafficking,Female,31-45,7820,5172,2648,6037,1783
2008,Urban,Rajasthan,Crime Against Women,Molestation,Male,0-12,6218,3530,2688,4658,1560
2006,Rural,Telangana,Crime Against Men,Murder,Male,13-17,540,409,131,478,62
2003,Urban,Telangana,Crime Against Children,Child Abuse,Female,13-17,5051,4073,978,4803,248
2001,Urban,Sikkim,Crime Against Children,Trafficking,Male,31-45,7382,2789,4593,6535,847
2010,Urban,Karnataka,Other Crimes,Fraud,Male,13-17,6251,1899,4352,5938,313
2006,Rural,Goa,Crime Against Women,Molestation,Male,31-45,8041,6875,1166,8018,23
2010,Urban,Manipur,Property Crime,Vandalism,Male,60+,1635,207,1428,722,913
2005,Rural,Karnataka,Crime Against Women,Rape,Female,60+,1513,1023,490,1112,401
2001,Urban,Meghalaya,Crime Against Children,Trafficking,Male,13-17,5646,3699,1947,4832,814
2006,Urban,Kerala,Crime Against Women,Domestic Violence,Male,0-12,3443,2926,517,3390,53
2006,Rural,Meghalaya,Property Crime,Burglary,Male,0-12,2915,53,2862,1278,1637
2004,Urban,Himachal Pradesh,Property Crime,Vandalism,Male,13-17,1028,312,716,718,310
2008,Rural,Sikkim,Crime Against Men,Assault,Female,31-45,3814,2,3812,3542,272
2008,Urban,Uttar Pradesh,Crime Against Children,Kidnapping,Male,60+,6465,378,6087,6087,378
2006,Rural,Uttarakhand,Crime Against Women,Rape,Female,60+,4928,4511,417,4732,196
2008,Urban,Punjab,Crime Against Men,Murder,Male,13-17,5863,5735,128,5737,126
2004,Rural,Karnataka,Property Crime,Burglary,Male,18-30,681,201,480,336,345
2004,Urban,Arunachal Pradesh,Crime Against Women,Dowry Deaths,Female,60+,5461,841,4620,5015,446
2006,Rural,Mizoram,Property Crime,Burglary,Female,18-30,7169,1746,5423,4931,2238
2008,Rural,Goa,Crime Against Women,Rape,Male,60+,8837,5483,3354,8082,755
2004,Rural,Gujarat,Crime Against Men,Assault,Female,31-45,3331,191,3140,1606,1725
2010,Urban,Bihar,Property Crime,Burglary,Female,60+,6500,407,6093,5659,841
2005,Urban,Bihar,Crime Against Men,Extortion,Female,46-60,6353,5963,390,6351,2
2006,Urban,Jammu & Kashmir,Crime Against Men,Robbery,Male,60+,430,373,57,423,7
2008,Rural,Uttar Pradesh,Other Crimes,Corruption,Female,46-60,3552,869,2683,3128,424
2008,Rural,Arunachal Pradesh,Property Crime,Theft,Male,31-45,7659,3167,4492,6507,1152
2009,Rural,Gujarat,Crime Against Men,Robbery,Female,0-12,1047,741,306,775,272
2008,Rural,Goa,Crime Against Men,Extortion,Male,60+,5356,4380,976,5220,136
2001,Rural,Maharashtra,Crime Against Men,Robbery,Male,0-12,2541,458,2083,1982,559
2010,Rural,Karnataka,Crime Against Women,Domestic Violence,Male,46-60,2449,1516,933,1937,512
2001,Rural,Uttar Pradesh,Crime Against Women,Domestic Violence,Male,0-12,6000,4302,1698,5018,982
2006,Urban,Meghalaya,Property Crime,Arson,Female,46-60,1765,309,1456,1478,287
2001,Rural,Meghalaya,Crime Against Women,Domestic Violence,Female,60+,7435,5542,1893,7400,35
2008,Rural,Tripura,Crime Against Men,Robbery,Female,18-30,421,372,49,374,47
2006,Rural,Goa,Other Crimes,Corruption,Male,13-17,7259,4594,2665,7212,47
2004,Urban,Maharashtra,Crime Against Women,Molestation,Female,0-12,1133,1103,30,1124,9
2001,Urban,Bihar,Other Crimes,Corruption,Female,18-30,4025,1925,2100,2191,1834
2003,Urban,Sikkim,Property Crime,Vandalism,Male,46-60,331,320,11,323,8
2007,Urban,Goa,Other Crimes,Cyber Crime,Male,13-17,4067,2478,1589,2647,1420
2004,Rural,Karnataka,Crime Against Children,Child Labor,Female,46-60,2595,2490,105,2570,25
2007,Urban,Maharashtra,Crime Against Women,Rape,Female,13-17,710,613,97,681,29
2009,Urban,Tripura,Property Crime,Burglary,Female,18-30,2028,1192,836,1268,760
2003,Urban,Jharkhand,Property Crime,Theft,Male,13-17,4790,1139,3651,2626,2164
2007,Rural,Madhya Pradesh,Crime Against Women,Dowry Deaths,Female,18-30,8278,7809,469,8232,46
2009,Rural,Tripura,Crime Against Children,Child Labor,Female,13-17,2517,2438,79,2483,34
2007,Rural,Himachal Pradesh,Other Crimes,Fraud,Female,46-60,6131,5263,868,5659,472
2008,Rural,Uttar Pradesh,Other Crimes,Cyber Crime,Female,31-45,3267,1243,2024,2240,1027
2009,Rural,Bihar,Crime Against Women,Dowry Deaths,Male,60+,2615,2023,592,2548,67
2002,Urban,Nagaland,Crime Against Children,Trafficking,Male,18-30,2764,1943,821,2017,747
2010,Urban,Andhra Pradesh,Property Crime,Vandalism,Male,60+,5732,1519,4213,4302,1430
2004,Rural,Manipur,Property Crime,Vandalism,Male,60+,2000,818,1182,1638,362
2004,Rural,Madhya Pradesh,Crime Against Children,Child Labor,Female,13-17,4625,326,4299,1403,3222
2004,Rural,Gujarat,Crime Against Women,Domestic Violence,Male,46-60,4930,866,4064,4676,254
2006,Rural,Delhi,Property Crime,Theft,Male,46-60,2351,1799,552,1869,482
2010,Urban,Arunachal Pradesh,Property Crime,Burglary,Female,13-17,5525,3705,1820,4009,1516
2004,Urban,Goa,Other Crimes,Cyber Crime,Male,18-30,2861,847,2014,2544,317
2003,Urban,Punjab,Crime Against Men,Extortion,Male,60+,3784,3586,198,3745,39
2006,Urban,Chhattisgarh,Crime Against Women,Domestic Violence,Female,31-45,6637,1921,4716,3735,2902
2003,Rural,Karnataka,Crime Against Women,Molestation,Male,18-30,9273,4032,5241,7369,1904
2005,Urban,Nagaland,Crime Against Women,Rape,Female,60+,8043,5765,2278,6755,1288
2002,Rural,Telangana,Crime Against Women,Rape,Male,13-17,3098,3063,35,3083,15
2001,Rural,Manipur,Other Crimes,Corruption,Male,60+,7264,1019,6245,2623,4641
2009,Rural,Arunachal Pradesh,Crime Against Men,Assault,Female,60+,7608,1761,5847,3681,3927
2006,Urban,Telangana,Crime Against Men,Murder,Male,0-12,5172,976,4196,1571,3601
2010,Urban,Rajasthan,Crime Against Women,Domestic Violence,Male,0-12,345,276,69,339,6
2007,Urban,Andhra Pradesh,Crime Against Women,Rape,Female,46-60,4631,2244,2387,2282,2349
2002,Urban,Haryana,Crime Against Women,Dowry Deaths,Male,18-30,4275,2997,1278,3264,1011
2010,Rural,Karnataka,Crime Against Children,Trafficking,Female,46-60,3060,1308,1752,1380,1680
2007,Urban,Gujarat,Other Crimes,Drug Offense,Female,46-60,9283,9262,21,9270,13
2006,Rural,Punjab,Crime Against Men,Murder,Female,60+,617,358,259,360,257
2007,Urban,Kerala,Property Crime,Theft,Male,13-17,8894,3323,5571,4294,4600
2004,Rural,Assam,Property Crime,Vandalism,Male,18-30,9049,5771,3278,7896,1153
2005,Rural,West Bengal,Crime Against Women,Rape,Male,31-45,2520,2470,50,2475,45
2007,Urban,Uttar Pradesh,Other Crimes,Cyber Crime,Female,13-17,3902,2336,1566,3234,668
2001,Rural,Madhya Pradesh,Crime Against Men,Robbery,Female,0-12,5584,2332,3252,3495,2089
2002,Rural,Arunachal Pradesh,Crime Against Men,Assault,Male,0-12,125,108,17,122,3
2007,Rural,Rajasthan,Crime Against Men,Extortion,Female,0-12,9690,1062,8628,3557,6133
2007,Rural,Jharkhand,Crime Against Women,Domestic Violence,Female,60+,4425,2277,2148,3304,1121
2003,Rural,Jammu & Kashmir,Property Crime,Burglary,Male,0-12,9944,171,9773,1925,8019
2004,Rural,Uttar Pradesh,Property Crime,Vandalism,Male,13-17,7632,3115,4517,5207,2425
2007,Rural,Tripura,Property Crime,Arson,Female,18-30,5548,4233,1315,5298,250
2006,Urban,Uttar Pradesh,Property Crime,Arson,Female,18-30,9669,5830,3839,9629,40
2007,Rural,Mizoram,Property Crime,Burglary,Female,31-45,6328,3411,2917,4692,1636
2008,Urban,Karnataka,Crime Against Men,Assault,Female,31-45,2027,703,1324,1552,475
2010,Urban,Manipur,Property Crime,Burglary,Male,46-60,5228,3012,2216,4507,721
2007,Rural,Haryana,Other Crimes,Fraud,Female,0-12,5916,4794,1122,5019,897
2008,Urban,Tamil Nadu,Property Crime,Arson,Male,60+,3934,2703,1231,3077,857
2009,Urban,Maharashtra,Crime Against Children,Kidnapping,Female,18-30,3936,144,3792,3081,855
2009,Rural,Uttarakhand,Property Crime,Vandalism,Female,18-30,8157,7388,769,7478,679
2010,Urban,Karnataka,Crime Against Women,Dowry Deaths,Male,18-30,6981,5354,1627,5502,1479
2009,Urban,West Bengal,Crime Against Men,Murder,Female,0-12,3013,400,2613,1525,1488
2002,Rural,Nagaland,Property Crime,Arson,Male,46-60,3223,2956,267,3164,59
2001,Rural,Karnataka,Other Crimes,Corruption,Female,46-60,3047,267,2780,480,2567
2003,Rural,Nagaland,Crime Against Women,Molestation,Female,46-60,358,125,233,135,223
2005,Rural,Nagaland,Crime Against Women,Rape,Female,18-30,8824,2812,6012,7733,1091
2008,Urban,Jharkhand,Other Crimes,Cyber Crime,Male,0-12,223,109,114,185,38
2003,Rural,Goa,Other Crimes,Cyber Crime,Female,13-17,667,575,92,612,55
2010,Rural,Gujarat,Other Crimes,Fraud,Male,18-30,1150,206,944,430,720
2006,Rural,Karnataka,Other Crimes,Fraud,Male,0-12,2212,1548,664,1561,651
2004,Rural,Bihar,Other Crimes,Fraud,Female,31-45,3034,1868,1166,2733,301
2006,Urban,Tamil Nadu,Crime Against Women,Rape,Female,31-45,307,103,204,105,202
2005,Rural,Chhattisgarh,Other Crimes,Fraud,Male,13-17,6658,3310,3348,5273,1385
2005,Rural,Assam,Crime Against Men,Assault,Male,46-60,718,561,157,637,81
2002,Rural,Assam,Crime Against Women,Dowry Deaths,Male,13-17,9241,7523,1718,8135,1106
2009,Rural,Uttarakhand,Crime Against Men,Robbery,Female,60+,740,92,648,385,355
2003,Urban,Nagaland,Property Crime,Vandalism,Male,60+,2661,758,1903,1601,1060
2001,Urban,West Bengal,Property Crime,Vandalism,Male,0-12,2436,2236,200,2296,140
2010,Urban,Jharkhand,Property Crime,Burglary,Male,0-12,3939,302,3637,2303,1636
2010,Urban,Delhi,Property Crime,Arson,Male,18-30,5993,2777,3216,4848,1145
2006,Rural,Chhattisgarh,Crime Against Men,Extortion,Female,13-17,4233,3877,356,4214,19
2002,Urban,Jammu & Kashmir,Crime Against Children,Child Labor,Male,0-12,8632,4460,4172,5231,3401
2008,Urban,Odisha,Crime Against Men,Murder,Female,31-45,2355,983,1372,1583,772
2001,Rural,Uttar Pradesh,Crime Against Women,Domestic Violence,Female,60+,424,216,208,222,202
2010,Rural,Telangana,Other Crimes,Drug Offense,Male,31-45,4086,3713,373,3854,232
2005,Rural,West Bengal,Crime Against Women,Dowry Deaths,Female,60+,4789,4157,632,4316,473
2010,Rural,Sikkim,Other Crimes,Cyber Crime,Male,60+,6244,3376,2868,4335,1909
2007,Urban,Meghalaya,Other Crimes,Drug Offense,Male,46-60,3770,3277,493,3616,154
2002,Urban,Meghalaya,Other Crimes,Cyber Crime,Female,46-60,828,292,536,609,219
2007,Rural,Manipur,Crime Against Men,Assault,Female,13-17,8595,5559,3036,7229,1366
2002,Rural,Uttarakhand,Crime Against Men,Robbery,Female,60+,9093,6343,2750,8590,503
2001,Urban,Maharashtra,Crime Against Children,Child Abuse,Male,13-17,3151,504,2647,1337,1814
2005,Urban,Himachal Pradesh,Crime Against Men,Murder,Female,0-12,6288,3173,3115,5814,474
2009,Rural,Punjab,Crime Against Children,Child Abuse,Male,60+,5026,4544,482,4886,140
2006,Urban,Madhya Pradesh,Crime Against Children,Child Labor,Female,60+,8262,4005,4257,7802,460
2010,Urban,Mizoram,Property Crime,Burglary,Male,13-17,553,334,219,464,89
2010,Urban,Arunachal Pradesh,Crime Against Children,Child Labor,Female,18-30,7161,6125,1036,6728,433
2003,Rural,Uttarakhand,Crime Against Men,Murder,Female,13-17,3477,2123,1354,3258,219
2008,Urban,Punjab,Property Crime,Theft,Female,18-30,88,85,3,87,1
2006,Rural,Haryana,Crime Against Women,Domestic Violence,Male,31-45,8640,1496,7144,5044,3596
2005,Rural,Mizoram,Crime Against Women,Molestation,Male,0-12,6840,3038,3802,6242,598
2010,Rural,Delhi,Crime Against Women,Molestation,Male,18-30,7739,7708,31,7733,6
2003,Urban,Uttarakhand,Crime Against Children,Child Abuse,Male,13-17,8270,4985,3285,5789,2481
2007,Urban,Delhi,Other Crimes,Corruption,Male,18-30,6072,111,5961,4495,1577
2008,Rural,Uttarakhand,Crime Against Men,Robbery,Female,0-12,763,430,333,644,119
2005,Rural,Karnataka,Property Crime,Burglary,Male,31-45,4306,3817,489,4138,168
2002,Rural,Assam,Other Crimes,Cyber Crime,Female,13-17,5771,3180,2591,3647,2124
2006,Urban,Gujarat,Crime Against Women,Domestic Violence,Female,46-60,4739,2785,1954,3171,1568
2006,Rural,West Bengal,Crime Against Women,Dowry Deaths,Male,13-17,3795,504,3291,1975,1820
2003,Urban,Nagaland,Crime Against Men,Extortion,Male,13-17,5808,1464,4344,2045,3763
2006,Urban,Tripura,Crime Against Children,Child Abuse,Male,60+,8850,5698,3152,7712,1138
2003,Rural,Tripura,Property Crime,Burglary,Female,0-12,4002,2875,1127,2936,1066
2003,Urban,Arunachal Pradesh,Crime Against Men,Extortion,Male,46-60,9545,6,9539,5867,3678
2004,Rural,Maharashtra,Property Crime,Arson,Male,31-45,1445,1234,211,1398,47
2001,Urban,Punjab,Crime Against Women,Molestation,Female,13-17,3916,3640,276,3647,269
2003,Urban,Gujarat,Other Crimes,Corruption,Female,31-45,9846,6759,3087,8797,1049
2006,Rural,Himachal Pradesh,Crime Against Children,Child Abuse,Female,31-45,2809,520,2289,2647,162
2008,Rural,Jharkhand,Other Crimes,Cyber Crime,Female,0-12,2463,49,2414,1500,963
2006,Rural,Bihar,Other Crimes,Drug Offense,Female,18-30,8883,6830,2053,8817,66
2003,Urban,Andhra Pradesh,Property Crime,Arson,Male,18-30,196,52,144,80,116
2004,Rural,Chhattisgarh,Crime Against Men,Assault,Female,46-60,6102,5382,720,5770,332
2006,Rural,Kerala,Crime Against Men,Assault,Male,46-60,4469,3537,932,4263,206
2002,Urban,Tamil Nadu,Crime Against Children,Child Abuse,Male,13-17,4511,1439,3072,2667,1844
2002,Rural,Uttar Pradesh,Crime Against Children,Child Labor,Male,18-30,3510,815,2695,1787,1723
2009,Rural,Jharkhand,Other Crimes,Corruption,Male,0-12,6888,1701,5187,2240,4648
2010,Rural,Maharashtra,Crime Against Men,Robbery,Male,0-12,4684,422,4262,4181,503
2004,Rural,West Bengal,Crime Against Women,Molestation,Male,18-30,1651,187,1464,1212,439
2005,Rural,Jharkhand,Other Crimes,Corruption,Male,31-45,9280,457,8823,9036,244
2003,Rural,Punjab,Crime Against Men,Assault,Female,31-45,2318,1061,1257,1510,808
2005,Rural,Nagaland,Crime Against Women,Molestation,Female,18-30,9362,843,8519,5535,3827
2010,Rural,Gujarat,Crime Against Men,Assault,Female,31-45,3738,1593,2145,3081,657
2002,Urban,Tripura,Crime Against Men,Murder,Male,18-30,1613,283,1330,286,1327
2002,Rural,Uttar Pradesh,Other Crimes,Fraud,Female,60+,7782,2130,5652,4390,3392
2006,Urban,Jharkhand,Crime Against Women,Domestic Violence,Female,13-17,2205,1074,1131,1435,770
2009,Urban,Haryana,Crime Against Men,Extortion,Female,46-60,8789,7384,1405,8091,698
2001,Rural,Himachal Pradesh,Other Crimes,Corruption,Male,0-12,7018,2412,4606,6426,592
2005,Urban,Tripura,Other Crimes,Cyber Crime,Female,60+,7797,6910,887,7687,110
2005,Urban,Sikkim,Crime Against Women,Dowry Deaths,Male,13-17,7459,2599,4860,6175,1284
2006,Rural,Goa,Property Crime,Vandalism,Female,18-30,1858,1081,777,1703,155
2001,Rural,Jharkhand,Crime Against Women,Rape,Female,18-30,5107,1843,3264,2353,2754
2006,Rural,Arunachal Pradesh,Property Crime,Vandalism,Female,60+,729,693,36,725,4
2009,Urban,Assam,Property Crime,Vandalism,Male,13-17,2624,1109,1515,2351,273
2002,Rural,Assam,Crime Against Children,Trafficking,Female,18-30,9705,2113,7592,8330,1375
2003,Rural,Gujarat,Crime Against Men,Robbery,Female,46-60,3003,1903,1100,2969,34
2006,Urban,Mizoram,Crime Against Women,Molestation,Female,13-17,2623,616,2007,1929,694
2001,Rural,Nagaland,Crime Against Men,Robbery,Female,60+,5329,42,5287,3811,1518
2004,Rural,Delhi,Crime Against Women,Rape,Male,60+,179,131,48,135,44
2003,Urban,Rajasthan,Crime Against Children,Child Abuse,Female,13-17,3875,3435,440,3590,285
2007,Urban,Bihar,Crime Against Women,Dowry Deaths,Male,18-30,3784,762,3022,3339,445
2003,Rural,Uttarakhand,Property Crime,Theft,Male,31-45,353,234,119,315,38
2010,Rural,Goa,Crime Against Men,Murder,Male,31-45,2266,107,2159,367,1899
2005,Rural,Jharkhand,Property Crime,Burglary,Male,31-45,8269,1670,6599,4159,4110
2008,Urban,Uttar Pradesh,Crime Against Children,Trafficking,Female,31-45,1165,950,215,998,167
2004,Rural,Madhya Pradesh,Crime Against Children,Child Abuse,Female,60+,8926,3107,5819,5627,3299
2004,Rural,Assam,Crime Against Children,Trafficking,Male,0-12,6586,945,5641,1714,4872
2008,Rural,Telangana,Property Crime,Arson,Male,18-30,4322,2481,1841,3383,939
2008,Urban,Chhattisgarh,Crime Against Children,Trafficking,Male,18-30,1221,51,1170,470,751
2005,Rural,Gujarat,Crime Against Women,Domestic Violence,Female,60+,4952,3073,1879,4402,550
2003,Urban,Haryana,Property Crime,Arson,Male,60+,5713,402,5311,831,4882
2001,Urban,Punjab,Other Crimes,Cyber Crime,Female,46-60,9413,7949,1464,8049,1364
2008,Rural,Madhya Pradesh,Property Crime,Vandalism,Female,31-45,4819,3766,1053,4169,650
2008,Urban,Karnataka,Crime Against Women,Molestation,Female,46-60,7049,4587,2462,6899,150
2006,Urban,Bihar,Crime Against Children,Child Abuse,Male,18-30,6719,4297,2422,4822,1897
2003,Urban,Haryana,Crime Against Women,Molestation,Male,46-60,9848,2169,7679,8654,1194
2002,Rural,Haryana,Crime Against Men,Robbery,Male,46-60,1987,1639,348,1973,14
2010,Urban,Assam,Crime Against Men,Assault,Male,0-12,4085,2633,1452,3635,450
2001,Urban,Uttarakhand,Property Crime,Vandalism,Male,60+,8320,5139,3181,5162,3158
2003,Rural,Assam,Crime Against Women,Domestic Violence,Male,31-45,6033,4475,1558,5748,285
2009,Rural,Bihar,Crime Against Men,Extortion,Male,18-30,6411,108,6303,5203,1208
2006,Urban,Manipur,Property Crime,Theft,Female,31-45,7530,5572,1958,6264,1266
2010,Urban,Himachal Pradesh,Crime Against Women,Molestation,Male,18-30,1904,700,1204,956,948
2008,Rural,Andhra Pradesh,Crime Against Women,Dowry Deaths,Male,46-60,8396,7280,1116,8038,358
2010,Urban,Manipur,Crime Against Women,Rape,Female,0-12,7663,140,7523,4547,3116
2005,Urban,Telangana,Other Crimes,Fraud,Female,60+,2016,587,1429,1847,169
2006,Rural,Tamil Nadu,Crime Against Children,Child Abuse,Male,0-12,2223,1531,692,1903,320
2002,Urban,Himachal Pradesh,Crime Against Children,Trafficking,Male,46-60,4984,1438,3546,3255,1729
2008,Rural,Jharkhand,Property Crime,Theft,Female,60+,7841,685,7156,1516,6325
2008,Rural,Telangana,Crime Against Men,Robbery,Male,60+,8887,3544,5343,4669,4218
2006,Rural,Arunachal Pradesh,Crime Against Children,Kidnapping,Female,46-60,8278,887,7391,7137,1141
2004,Urban,Bihar,Crime Against Women,Rape,Female,13-17,8108,1398,6710,1853,6255
2001,Urban,Uttar Pradesh,Other Crimes,Cyber Crime,Male,18-30,4566,847,3719,1956,2610
2004,Rural,Andhra Pradesh,Property Crime,Burglary,Male,46-60,8661,797,7864,7841,820
2006,Rural,Jharkhand,Property Crime,Arson,Female,60+,6383,2090,4293,4354,2029
2007,Rural,Odisha,Property Crime,Arson,Male,13-17,4197,2061,2136,3608,589
2002,Urban,Gujarat,Property Crime,Theft,Female,0-12,245,38,207,39,206
2002,Urban,Punjab,Property Crime,Burglary,Male,13-17,4898,1947,2951,1990,2908
2002,Urban,Bihar,Property Crime,Burglary,Female,31-45,3066,2131,935,2370,696
2005,Urban,Jharkhand,Property Crime,Burglary,Male,31-45,2699,1039,1660,1382,1317
2006,Urban,Nagaland,Crime Against Women,Molestation,Male,18-30,656,203,453,367,289
2004,Urban,Bihar,Crime Against Women,Molestation,Female,60+,1177,745,432,1004,173
2002,Urban,Uttarakhand,Property Crime,Theft,Female,13-17,4180,56,4124,2101,2079
2004,Rural,Telangana,Other Crimes,Fraud,Female,0-12,9004,7184,1820,7534,1470
2002,Rural,Chhattisgarh,Other Crimes,Drug Offense,Male,13-17,3027,2477,550,2865,162
2009,Rural,Tamil Nadu,Property Crime,Burglary,Female,60+,6312,5507,805,5808,504
2010,Urban,Mizoram,Crime Against Children,Child Labor,Female,60+,8302,8022,280,8266,36
2004,Rural,Goa,Crime Against Women,Rape,Female,18-30,9610,6030,3580,6603,3007
2001,Rural,Gujarat,Property Crime,Arson,Male,18-30,5446,1847,3599,3844,1602
2002,Rural,Haryana,Other Crimes,Fraud,Male,46-60,717,697,20,698,19
2006,Urban,Arunachal Pradesh,Other Crimes,Cyber Crime,Female,60+,5946,1615,4331,3207,2739
2002,Urban,Jammu & Kashmir,Crime Against Men,Murder,Female,60+,4314,3307,1007,3887,427
2006,Rural,Arunachal Pradesh,Property Crime,Arson,Female,31-45,9221,5011,4210,5815,3406
2001,Urban,Uttar Pradesh,Crime Against Children,Child Labor,Male,46-60,5948,3745,2203,4736,1212
2008,Urban,Nagaland,Crime Against Men,Murder,Male,60+,6329,3187,3142,3650,2679
2003,Urban,Himachal Pradesh,Property Crime,Arson,Male,18-30,1298,909,389,979,319
2004,Rural,Maharashtra,Crime Against Men,Extortion,Female,13-17,7946,7137,809,7330,616
2002,Rural,Tripura,Crime Against Children,Trafficking,Female,0-12,2270,1414,856,1542,728
2004,Rural,Haryana,Crime Against Men,Extortion,Male,18-30,9241,5364,3877,6348,2893
2006,Urban,Tripura,Other Crimes,Drug Offense,Male,31-45,4886,510,4376,619,4267
2002,Rural,Himachal Pradesh,Property Crime,Vandalism,Female,0-12,9525,7997,1528,8423,1102
2006,Urban,Meghalaya,Crime Against Children,Child Labor,Male,13-17,1050,452,598,482,568
2006,Urban,Gujarat,Property Crime,Arson,Male,46-60,9192,1987,7205,4973,4219
2008,Rural,Delhi,Crime Against Women,Rape,Male,18-30,8216,2765,5451,6772,1444
2008,Rural,Uttar Pradesh,Crime Against Children,Trafficking,Female,18-30,8023,6000,2023,6468,1555
2002,Rural,Gujarat,Crime Against Children,Child Abuse,Female,46-60,1150,33,1117,41,1109
2008,Rural,West Bengal,Crime Against Men,Murder,Female,18-30,2167,720,1447,1034,1133
2007,Urban,Sikkim,Other Crimes,Corruption,Male,0-12,9470,3048,6422,6124,3346
2003,Rural,West Bengal,Crime Against Men,Extortion,Male,13-17,8767,8654,113,8670,97
2006,Urban,Chhattisgarh,Property Crime,Vandalism,Female,31-45,5424,746,4678,1067,4357
2005,Rural,Uttarakhand,Other Crimes,Fraud,Female,0-12,2208,139,2069,2153,55
2008,Rural,Uttar Pradesh,Other Crimes,Drug Offense,Male,60+,7310,2745,4565,5286,2024
2007,Urban,Karnataka,Property Crime,Theft,Female,0-12,5333,1145,4188,1336,3997
2004,Rural,Tripura,Crime Against Women,Domestic Violence,Male,46-60,1424,1383,41,1391,33
2009,Urban,Meghalaya,Property Crime,Vandalism,Female,0-12,5172,4240,932,5088,84
2006,Rural,Goa,Property Crime,Vandalism,Female,46-60,6865,66,6799,4969,1896
2005,Rural,Telangana,Crime Against Children,Child Abuse,Male,46-60,6240,5415,825,5467,773
2002,Rural,Arunachal Pradesh,Crime Against Women,Rape,Female,31-45,8246,6680,1566,7699,547
2004,Rural,Telangana,Property Crime,Theft,Female,18-30,8872,370,8502,504,8368
2004,Urban,Kerala,Crime Against Women,Dowry Deaths,Male,60+,4886,1153,3733,4371,515
2001,Rural,West Bengal,Crime Against Women,Dowry Deaths,Male,60+,8315,3894,4421,5405,2910
2002,Urban,West Bengal,Property Crime,Burglary,Male,0-12,2455,2098,357,2364,91
2002,Rural,Haryana,Other Crimes,Cyber Crime,Female,60+,8707,2247,6460,6372,2335
2004,Urban,Assam,Crime Against Women,Domestic Violence,Male,60+,1626,1368,258,1613,13
2007,Rural,Uttarakhand,Crime Against Men,Robbery,Male,0-12,5623,3226,2397,4859,764
2004,Rural,Bihar,Crime Against Women,Molestation,Male,0-12,1444,1226,218,1300,144
2001,Urban,Uttar Pradesh,Crime Against Men,Assault,Male,13-17,3433,374,3059,1580,1853
2007,Rural,Punjab,Property Crime,Vandalism,Female,31-45,2009,1953,56,1966,43
2010,Urban,Punjab,Crime Against Men,Assault,Female,31-45,3208,2146,1062,2211,997
2004,Rural,Haryana,Property Crime,Theft,Male,0-12,6401,2846,3555,4215,2186
2004,Urban,Maharashtra,Property Crime,Arson,Male,31-45,7632,682,6950,3773,3859
2005,Rural,Sikkim,Other Crimes,Cyber Crime,Male,46-60,7506,2127,5379,3096,4410
2010,Urban,Arunachal Pradesh,Crime Against Men,Robbery,Male,0-12,3136,2484,652,2909,227
2002,Rural,Chhattisgarh,Property Crime,Burglary,Female,0-12,7734,7116,618,7374,360
2001,Rural,Jammu & Kashmir,Crime Against Women,Dowry Deaths,Female,18-30,351,324,27,325,26
2008,Rural,Andhra Pradesh,Property Crime,Theft,Female,13-17,8494,7478,1016,7655,839
2010,Urban,Bihar,Crime Against Men,Assault,Female,46-60,3778,3454,324,3629,149
2004,Rural,Chhattisgarh,Property Crime,Burglary,Female,60+,1158,431,727,769,389
2004,Rural,Andhra Pradesh,Property Crime,Theft,Female,0-12,2001,360,1641,796,1205
2004,Rural,Meghalaya,Crime Against Men,Murder,Male,60+,5096,1583,3513,4226,870
2003,Urban,Uttarakhand,Other Crimes,Drug Offense,Female,18-30,7724,932,6792,4274,3450
2007,Rural,West Bengal,Crime Against Women,Rape,Male,31-45,5516,3401,2115,4591,925
2005,Urban,Odisha,Other Crimes,Fraud,Female,13-17,3395,2180,1215,2851,544
2001,Rural,Manipur,Other Crimes,Drug Offense,Male,13-17,3531,1299,2232,2687,844
2004,Rural,West Bengal,Crime Against Women,Dowry Deaths,Male,46-60,6332,451,5881,3212,3120
2009,Urban,Madhya Pradesh,Crime Against Women,Domestic Violence,Female,46-60,3741,255,3486,2837,904
2005,Urban,Mizoram,Crime Against Women,Rape,Female,46-60,7562,1096,6466,2176,5386
2005,Rural,Assam,Crime Against Children,Kidnapping,Male,0-12,867,655,212,828,39
2002,Urban,Goa,Other Crimes,Fraud,Male,13-17,7908,2638,5270,3818,4090
2009,Urban,Rajasthan,Crime Against Men,Murder,Female,18-30,542,48,494,241,301
2007,Urban,Gujarat,Property Crime,Theft,Female,31-45,1304,800,504,918,386
2010,Urban,West Bengal,Crime Against Women,Molestation,Male,60+,8271,3723,4548,6264,2007
2006,Urban,Chhattisgarh,Property Crime,Burglary,Female,31-45,8704,7857,847,8704,0
2002,Urban,Haryana,Crime Against Men,Murder,Female,0-12,6370,4486,1884,5201,1169
2002,Rural,West Bengal,Property Crime,Vandalism,Female,46-60,9465,5378,4087,7425,2040
2004,Urban,Telangana,Other Crimes,Cyber Crime,Female,13-17,6937,6032,905,6837,100
2005,Rural,Odisha,Property Crime,Arson,Female,46-60,357,51,306,151,206
2005,Urban,Uttarakhand,Crime Against Women,Molestation,Female,31-45,1180,109,1071,529,651
2002,Rural,Kerala,Property Crime,Burglary,Female,18-30,9739,3007,6732,4591,5148
2008,Urban,Uttarakhand,Crime Against Children,Child Abuse,Male,60+,3638,1917,1721,3321,317
2003,Urban,West Bengal,Crime Against Women,Domestic Violence,Female,0-12,4048,1679,2369,1929,2119
2008,Urban,Himachal Pradesh,Other Crimes,Corruption,Female,60+,1310,657,653,1025,285
2002,Rural,Jammu & Kashmir,Crime Against Men,Murder,Female,31-45,1635,596,1039,1166,469
2006,Urban,Madhya Pradesh,Other Crimes,Corruption,Female,46-60,8323,1231,7092,3099,5224
2003,Rural,Goa,Crime Against Women,Domestic Violence,Male,13-17,3920,544,3376,1511,2409
2001,Urban,Gujarat,Other Crimes,Fraud,Male,13-17,2271,1277,994,1942,329
2008,Rural,Mizoram,Crime Against Men,Assault,Male,18-30,2956,1373,1583,2696,260
2007,Rural,Uttarakhand,Property Crime,Theft,Female,0-12,7806,7292,514,7570,236
2002,Urban,Himachal Pradesh,Crime Against Children,Kidnapping,Male,60+,4177,1771,2406,4055,122
2001,Urban,Andhra Pradesh,Crime Against Women,Rape,Male,18-30,3005,2166,839,2907,98
2007,Urban,Arunachal Pradesh,Crime Against Men,Assault,Male,13-17,5675,4896,779,4953,722
2003,Urban,Assam,Property Crime,Arson,Male,13-17,1200,833,367,985,215
2009,Urban,Himachal Pradesh,Property Crime,Theft,Female,0-12,550,203,347,405,145
2006,Rural,Jharkhand,Property Crime,Arson,Male,13-17,6294,5930,364,6152,142
2007,Rural,Nagaland,Crime Against Women,Dowry Deaths,Male,46-60,2786,320,2466,1445,1341
2008,Rural,Nagaland,Property Crime,Burglary,Female,13-17,5256,3385,1871,4488,768
2003,Urban,Chhattisgarh,Crime Against Men,Robbery,Male,60+,9302,4724,4578,6806,2496
2004,Rural,Telangana,Crime Against Men,Robbery,Male,18-30,5476,2396,3080,4315,1161
2003,Urban,Madhya Pradesh,Crime Against Women,Molestation,Male,18-30,4636,765,3871,1681,2955
2004,Urban,Manipur,Crime Against Women,Domestic Violence,Female,13-17,1756,899,857,1676,80
2009,Rural,Maharashtra,Crime Against Men,Assault,Male,31-45,4314,1328,2986,4060,254
2006,Urban,Bihar,Property Crime,Arson,Male,46-60,5865,1085,4780,5651,214
2001,Rural,Mizoram,Property Crime,Theft,Female,0-12,2867,2332,535,2455,412
2005,Urban,Tamil Nadu,Crime Against Children,Trafficking,Male,46-60,3472,1227,2245,3099,373
2003,Rural,Manipur,Crime Against Men,Robbery,Male,31-45,9006,6534,2472,6874,2132
2002,Urban,Kerala,Crime Against Women,Molestation,Female,31-45,4763,3464,1299,4535,228
2001,Urban,Telangana,Property Crime,Burglary,Male,0-12,7262,5853,1409,5884,1378
2006,Rural,Maharashtra,Crime Against Children,Child Labor,Female,46-60,4019,3521,498,3967,52
2006,Urban,Meghalaya,Crime Against Women,Molestation,Male,18-30,1944,638,1306,1482,462
2005,Rural,Chhattisgarh,Crime Against Children,Child Labor,Male,13-17,9244,8101,1143,8821,423
2002,Urban,West Bengal,Other Crimes,Drug Offense,Female,60+,9432,9395,37,9403,29
2001,Rural,Kerala,Crime Against Women,Domestic Violence,Male,13-17,7350,2838,4512,4256,3094
2002,Rural,Andhra Pradesh,Crime Against Children,Kidnapping,Female,46-60,3831,2878,953,3273,558
2009,Urban,Karnataka,Crime Against Children,Kidnapping,Male,18-30,7311,6733,578,7208,103
2007,Rural,Haryana,Property Crime,Theft,Male,60+,5707,5119,588,5157,550
2002,Rural,Arunachal Pradesh,Property Crime,Burglary,Female,0-12,5876,970,4906,4286,1590
2009,Urban,Kerala,Other Crimes,Corruption,Male,0-12,6245,3752,2493,3928,2317
2004,Urban,Chhattisgarh,Crime Against Children,Child Labor,Female,31-45,1585,969,616,1013,572
2003,Rural,Haryana,Property Crime,Theft,Male,0-12,6474,48,6426,3083,3391
2007,Urban,Sikkim,Crime Against Children,Kidnapping,Female,0-12,6528,2138,4390,2225,4303
2008,Rural,Haryana,Crime Against Children,Child Abuse,Female,18-30,8724,4577,4147,8534,190
2004,Rural,Telangana,Other Crimes,Corruption,Male,31-45,5491,3764,1727,4587,904
2002,Urban,Delhi,Crime Against Children,Kidnapping,Male,18-30,9419,4501,4918,8702,717
2005,Urban,Himachal Pradesh,Other Crimes,Cyber Crime,Female,31-45,897,412,485,456,441
2005,Rural,Uttar Pradesh,Crime Against Children,Kidnapping,Female,46-60,251,62,189,126,125
2010,Urban,Jammu & Kashmir,Crime Against Children,Kidnapping,Female,0-12,8879,7492,1387,7914,965
2007,Rural,Delhi,Crime Against Men,Assault,Male,60+,8629,249,8380,269,8360
2007,Rural,Chhattisgarh,Crime Against Men,Murder,Female,31-45,7526,5521,2005,7049,477
2009,Rural,Jammu & Kashmir,Crime Against Women,Domestic Violence,Male,60+,5546,2580,2966,3362,2184
2005,Urban,Uttarakhand,Crime Against Women,Dowry Deaths,Male,0-12,6100,876,5224,3169,2931
2008,Rural,Sikkim,Crime Against Men,Assault,Male,31-45,2748,2673,75,2723,25
2009,Urban,Andhra Pradesh,Crime Against Children,Child Abuse,Female,60+,2444,2166,278,2176,268
2010,Rural,Punjab,Other Crimes,Cyber Crime,Male,60+,1641,1612,29,1612,29
2006,Urban,Karnataka,Property Crime,Vandalism,Female,18-30,5510,3637,1873,5478,32
2006,Urban,Haryana,Other Crimes,Fraud,Female,31-45,2759,434,2325,1807,952
2006,Rural,Tamil Nadu,Other Crimes,Fraud,Male,13-17,6299,4579,1720,5527,772
2003,Rural,Assam,Property Crime,Burglary,Female,46-60,2124,523,1601,985,1139
2003,Urban,West Bengal,Crime Against Men,Murder,Male,31-45,2973,2708,265,2816,157
2004,Rural,Mizoram,Other Crimes,Cyber Crime,Female,0-12,674,145,529,608,66
2004,Urban,Jammu & Kashmir,Property Crime,Theft,Female,13-17,2004,744,1260,1525,479
2006,Rural,Kerala,Crime Against Women,Molestation,Female,31-45,5547,532,5015,2119,3428
2001,Urban,Kerala,Crime Against Men,Murder,Male,18-30,4121,64,4057,2866,1255
2005,Rural,Uttarakhand,Property Crime,Arson,Female,13-17,5230,2343,2887,2469,2761
2007,Urban,Tamil Nadu,Crime Against Children,Child Abuse,Female,18-30,1521,1357,164,1473,48
2001,Rural,Bihar,Other Crimes,Fraud,Male,18-30,1562,1171,391,1357,205
2002,Rural,Odisha,Crime Against Women,Molestation,Female,60+,4651,981,3670,4426,225
2003,Rural,Gujarat,Crime Against Children,Trafficking,Male,31-45,3502,3267,235,3282,220
2002,Urban,Tripura,Crime Against Women,Molestation,Female,18-30,6764,3643,3121,4878,1886
2003,Rural,Sikkim,Crime Against Women,Molestation,Male,46-60,5621,2917,2704,3264,2357
2009,Rural,Tamil Nadu,Property Crime,Burglary,Male,0-12,5340,5266,74,5310,30
2001,Rural,Uttar Pradesh,Other Crimes,Drug Offense,Male,46-60,5603,3895,1708,5187,416
2006,Urban,Telangana,Property Crime,Vandalism,Female,31-45,228,3,225,107,121
2009,Urban,Delhi,Crime Against Men,Robbery,Female,13-17,1075,168,907,485,590
2010,Rural,Tripura,Property Crime,Burglary,Female,13-17,1008,0,1008,502,506
2002,Urban,Andhra Pradesh,Crime Against Men,Extortion,Female,31-45,5832,5829,3,5830,2
2001,Rural,Karnataka,Crime Against Children,Child Abuse,Male,13-17,9933,1292,8641,1763,8170
2001,Urban,Haryana,Crime Against Men,Murder,Male,60+,5174,4193,981,4999,175
2008,Urban,Chhattisgarh,Crime Against Men,Robbery,Male,18-30,5306,4609,697,4660,646
2004,Urban,Karnataka,Property Crime,Vandalism,Male,46-60,4429,1857,2572,2505,1924
2002,Urban,Telangana,Property Crime,Burglary,Female,60+,2560,1264,1296,1674,886
2005,Urban,Jharkhand,Property Crime,Arson,Male,60+,8980,6404,2576,6826,2154
2003,Urban,Uttar Pradesh,Property Crime,Burglary,Female,31-45,7048,5900,1148,5925,1123
2001,Urban,Andhra Pradesh,Crime Against Children,Kidnapping,Male,0-12,8394,6823,1571,8100,294
2008,Urban,Manipur,Crime Against Children,Trafficking,Male,0-12,9760,5858,3902,6534,3226
2007,Urban,Mizoram,Crime Against Men,Robbery,Male,60+,7879,5416,2463,5719,2160
2010,Urban,Nagaland,Other Crimes,Drug Offense,Male,0-12,7982,1456,6526,3281,4701
2002,Urban,Uttar Pradesh,Other Crimes,Corruption,Male,13-17,8428,542,7886,1130,7298
2009,Urban,Rajasthan,Crime Against Men,Extortion,Male,46-60,3434,1745,1689,2512,922
2005,Rural,Andhra Pradesh,Crime Against Women,Dowry Deaths,Male,31-45,6925,3756,3169,5265,1660
2004,Urban,Chhattisgarh,Property Crime,Vandalism,Male,0-12,6210,902,5308,2682,3528
2002,Urban,Telangana,Other Crimes,Drug Offense,Male,18-30,4781,2409,2372,4141,640
2003,Rural,Arunachal Pradesh,Crime Against Children,Trafficking,Male,46-60,1897,69,1828,614,1283
2010,Rural,Himachal Pradesh,Crime Against Children,Child Abuse,Female,0-12,8341,5813,2528,7165,1176
2008,Rural,Punjab,Other Crimes,Cyber Crime,Female,31-45,2189,1957,232,2161,28
2009,Urban,Chhattisgarh,Crime Against Children,Child Labor,Female,60+,5339,1179,4160,1692,3647
2001,Urban,Delhi,Other Crimes,Fraud,Male,46-60,1118,738,380,975,143
2002,Rural,Arunachal Pradesh,Crime Against Men,Robbery,Male,0-12,9465,4604,4861,8230,1235
2005,Rural,Nagaland,Property Crime,Vandalism,Female,0-12,4235,4108,127,4110,125
2009,Rural,Punjab,Property Crime,Theft,Male,0-12,9053,4198,4855,6373,2680
2009,Rural,Madhya Pradesh,Other Crimes,Cyber Crime,Male,13-17,3420,1759,1661,2945,475
2007,Urban,Telangana,Crime Against Women,Domestic Violence,Female,46-60,9216,661,8555,2373,6843
2008,Urban,Sikkim,Property Crime,Burglary,Male,18-30,4398,3863,535,4337,61
2005,Rural,Maharashtra,Property Crime,Arson,Female,31-45,9721,953,8768,7699,2022
2006,Urban,Himachal Pradesh,Property Crime,Arson,Male,18-30,3616,3290,326,3472,144
2006,Urban,Odisha,Crime Against Women,Molestation,Male,46-60,1983,669,1314,1523,460
2006,Rural,Chhattisgarh,Property Crime,Theft,Female,60+,4575,3407,1168,4476,99
2007,Urban,Goa,Property Crime,Vandalism,Female,31-45,1704,752,952,1453,251
2001,Urban,Kerala,Other Crimes,Corruption,Female,31-45,6321,4142,2179,5177,1144
2002,Rural,Rajasthan,Crime Against Women,Domestic Violence,Male,31-45,6158,461,5697,1176,4982
2004,Rural,Telangana,Crime Against Women,Molestation,Female,60+,1363,665,698,869,494
2009,Rural,Gujarat,Crime Against Men,Murder,Male,18-30,4346,4027,319,4269,77
2008,Rural,Rajasthan,Crime Against Men,Extortion,Female,31-45,1307,255,1052,773,534
2010,Urban,Rajasthan,Crime Against Children,Child Abuse,Female,0-12,9619,7419,2200,8364,1255
2009,Urban,Bihar,Other Crimes,Drug Offense,Female,0-12,7676,3110,4566,6915,761
2004,Rural,Uttarakhand,Crime Against Men,Murder,Female,46-60,6749,5084,1665,5178,1571
2006,Urban,Mizoram,Other Crimes,Fraud,Male,13-17,4222,619,3603,3861,361
2007,Rural,Mizoram,Other Crimes,Corruption,Female,18-30,1065,119,946,435,630
2005,Urban,Tamil Nadu,Crime Against Men,Assault,Female,18-30,8760,5296,3464,6835,1925
2007,Urban,Mizoram,Other Crimes,Corruption,Male,0-12,4584,1985,2599,3857,727
2006,Rural,Mizoram,Property Crime,Burglary,Male,13-17,1492,310,1182,1102,390
2001,Rural,Uttarakhand,Crime Against Women,Dowry Deaths,Female,46-60,581,97,484,321,260
2003,Rural,Jammu & Kashmir,Property Crime,Arson,Female,31-45,5470,2500,2970,4913,557
2008,Rural,Punjab,Other Crimes,Fraud,Female,18-30,1920,1850,70,1868,52
2009,Rural,Odisha,Other Crimes,Drug Offense,Male,46-60,1905,535,1370,710,1195
2010,Urban,Karnataka,Crime Against Children,Trafficking,Female,13-17,1872,979,893,1664,208
2007,Urban,Punjab,Crime Against Men,Murder,Female,60+,6013,1433,4580,3550,2463
2006,Rural,Jammu & Kashmir,Crime Against Children,Kidnapping,Female,31-45,2879,2634,245,2774,105
2002,Urban,Tamil Nadu,Crime Against Women,Rape,Female,18-30,8500,2365,6135,3055,5445
2002,Urban,Mizoram,Property Crime,Vandalism,Female,46-60,748,484,264,686,62
2010,Urban,Manipur,Crime Against Children,Child Abuse,Female,60+,1989,251,1738,1165,824
2005,Urban,Telangana,Crime Against Men,Robbery,Male,46-60,440,150,290,434,6
2009,Urban,Punjab,Crime Against Men,Extortion,Female,18-30,4073,2437,1636,2979,1094
2009,Urban,Nagaland,Crime Against Children,Kidnapping,Female,60+,922,633,289,905,17
2002,Rural,Delhi,Crime Against Men,Assault,Male,13-17,3828,3469,359,3493,335
2008,Urban,Assam,Property Crime,Arson,Female,60+,9204,2690,6514,6624,2580
2004,Rural,Himachal Pradesh,Crime Against Women,Molestation,Female,13-17,4217,1455,2762,2294,1923
2004,Rural,Tamil Nadu,Crime Against Men,Extortion,Male,31-45,3940,1913,2027,2013,1927
2009,Urban,Kerala,Crime Against Women,Molestation,Female,0-12,412,217,195,323,89
2001,Urban,Assam,Other Crimes,Drug Offense,Female,31-45,206,53,153,197,9
2007,Urban,Punjab,Other Crimes,Corruption,Female,0-12,2820,2714,106,2802,18
2001,Rural,Manipur,Property Crime,Theft,Female,0-12,5615,2599,3016,3997,1618
2006,Urban,Mizoram,Crime Against Women,Rape,Male,0-12,9356,1589,7767,4018,5338
2004,Rural,Jammu & Kashmir,Other Crimes,Fraud,Female,31-45,5377,666,4711,4815,562
2001,Urban,Himachal Pradesh,Crime Against Children,Trafficking,Female,18-30,7877,7677,200,7837,40
2002,Urban,Uttar Pradesh,Crime Against Men,Assault,Female,0-12,8695,2768,5927,3009,5686
2006,Rural,Madhya Pradesh,Property Crime,Arson,Female,60+,3724,3285,439,3435,289
2003,Urban,Sikkim,Crime Against Children,Trafficking,Female,46-60,3186,616,2570,2710,476
2010,Rural,Madhya Pradesh,Crime Against Children,Kidnapping,Male,0-12,2535,2310,225,2393,142
2006,Urban,Sikkim,Crime Against Men,Murder,Male,46-60,9736,8913,823,9679,57
2004,Rural,Manipur,Crime Against Children,Child Abuse,Female,0-12,4262,218,4044,1424,2838
2006,Urban,Kerala,Crime Against Men,Murder,Male,31-45,7746,2684,5062,3789,3957
2006,Rural,Haryana,Crime Against Men,Murder,Female,46-60,4805,2019,2786,4651,154
2010,Rural,Himachal Pradesh,Crime Against Men,Murder,Male,60+,2409,571,1838,926,1483
2005,Urban,Karnataka,Property Crime,Vandalism,Male,18-30,2152,707,1445,1876,276
2006,Urban,Meghalaya,Crime Against Women,Molestation,Male,0-12,1358,608,750,1169,189
2002,Rural,Gujarat,Property Crime,Arson,Female,13-17,5823,844,4979,1289,4534
2005,Urban,Goa,Property Crime,Burglary,Female,46-60,8291,6606,1685,6738,1553
2008,Rural,Rajasthan,Crime Against Men,Extortion,Female,31-45,2462,589,1873,1723,739
2004,Urban,Assam,Property Crime,Vandalism,Female,31-45,2219,1830,389,1855,364
2008,Urban,Jammu & Kashmir,Crime Against Children,Child Labor,Female,60+,3541,2519,1022,2670,871
2002,Urban,Haryana,Crime Against Children,Kidnapping,Male,18-30,813,767,46,781,32
2004,Rural,Chhattisgarh,Crime Against Women,Rape,Male,18-30,1554,393,1161,1522,32
2003,Urban,Sikkim,Crime Against Women,Domestic Violence,Male,0-12,7217,180,7037,3139,4078
2005,Rural,Karnataka,Property Crime,Arson,Male,60+,2282,376,1906,1613,669
2002,Rural,Kerala,Property Crime,Arson,Female,13-17,7100,6350,750,6549,551
2002,Urban,Madhya Pradesh,Crime Against Women,Domestic Violence,Male,18-30,8621,1779,6842,6052,2569
2003,Rural,Kerala,Crime Against Men,Assault,Male,31-45,6406,3205,3201,4865,1541
2007,Rural,Tamil Nadu,Crime Against Women,Domestic Violence,Female,0-12,9632,9504,128,9612,20
2010,Urban,Telangana,Crime Against Women,Molestation,Male,46-60,3739,1199,2540,1381,2358
2006,Rural,Himachal Pradesh,Property Crime,Burglary,Male,46-60,5667,97,5570,3799,1868
2009,Rural,Kerala,Other Crimes,Corruption,Male,18-30,6267,4283,1984,5783,484
2010,Urban,Rajasthan,Property Crime,Burglary,Male,46-60,354,255,99,266,88
2003,Urban,Manipur,Crime Against Men,Extortion,Male,60+,3049,2234,815,2597,452
2007,Urban,Karnataka,Crime Against Women,Dowry Deaths,Female,13-17,3509,2662,847,3290,219
2007,Rural,Assam,Crime Against Women,Domestic Violence,Male,18-30,3997,3393,604,3935,62
2010,Urban,Rajasthan,Property Crime,Arson,Female,31-45,5567,204,5363,4880,687
2009,Urban,Nagaland,Other Crimes,Drug Offense,Female,46-60,468,61,407,282,186
2004,Rural,West Bengal,Other Crimes,Corruption,Male,60+,3852,1682,2170,1930,1922
2002,Urban,Meghalaya,Crime Against Men,Extortion,Female,31-45,4541,2124,2417,3095,1446
2008,Rural,Goa,Other Crimes,Drug Offense,Male,60+,2837,847,1990,1912,925
2009,Urban,Sikkim,Other Crimes,Fraud,Male,0-12,2291,290,2001,2228,63
2006,Rural,Goa,Crime Against Women,Dowry Deaths,Female,60+,8006,1884,6122,6537,1469
2002,Urban,Chhattisgarh,Crime Against Women,Domestic Violence,Female,13-17,452,280,172,452,0
2001,Urban,Odisha,Property Crime,Vandalism,Female,0-12,5239,1590,3649,3038,2201
2008,Rural,Delhi,Crime Against Men,Assault,Female,13-17,7264,2131,5133,4631,2633
2006,Urban,Rajasthan,Property Crime,Vandalism,Female,18-30,7020,5925,1095,6672,348
2006,Rural,Punjab,Property Crime,Burglary,Female,46-60,4407,3036,1371,3490,917
2007,Urban,Odisha,Other Crimes,Cyber Crime,Female,31-45,6276,5303,973,6225,51
2005,Rural,Nagaland,Property Crime,Arson,Male,31-45,7926,3667,4259,5100,2826
2009,Rural,Himachal Pradesh,Crime Against Women,Dowry Deaths,Female,18-30,5342,310,5032,1402,3940
2003,Rural,Mizoram,Property Crime,Vandalism,Male,0-12,1055,425,630,1055,0
2006,Urban,Madhya Pradesh,Other Crimes,Drug Offense,Female,60+,2531,610,1921,2471,60
2006,Urban,Madhya Pradesh,Crime Against Men,Murder,Male,13-17,4971,603,4368,3312,1659
2009,Rural,Sikkim,Crime Against Men,Robbery,Female,31-45,8925,4055,4870,6534,2391
2003,Rural,Nagaland,Crime Against Children,Child Abuse,Male,31-45,9477,509,8968,7575,1902
2004,Rural,Gujarat,Crime Against Women,Dowry Deaths,Female,46-60,8550,8407,143,8460,90
2008,Rural,Uttarakhand,Crime Against Women,Rape,Male,31-45,501,164,337,267,234
2008,Rural,Punjab,Property Crime,Vandalism,Male,46-60,8860,4776,4084,4800,4060
2004,Urban,Himachal Pradesh,Crime Against Men,Extortion,Male,0-12,2035,475,1560,949,1086
2008,Urban,Arunachal Pradesh,Property Crime,Theft,Female,13-17,6729,3524,3205,4173,2556
2001,Rural,West Bengal,Crime Against Men,Extortion,Male,60+,8708,3258,5450,5673,3035
2002,Rural,Bihar,Crime Against Women,Rape,Male,0-12,1357,1163,194,1313,44
2007,Urban,Tamil Nadu,Property Crime,Theft,Female,0-12,5674,5236,438,5464,210
2007,Rural,Karnataka,Crime Against Men,Extortion,Female,60+,5556,3571,1985,4251,1305
2010,Urban,Rajasthan,Other Crimes,Drug Offense,Female,60+,2390,1187,1203,2059,331
2004,Rural,Assam,Crime Against Men,Murder,Female,60+,4564,3189,1375,3442,1122
2007,Urban,Rajasthan,Other Crimes,Fraud,Female,18-30,2190,2136,54,2152,38
2006,Urban,Karnataka,Crime Against Men,Assault,Male,18-30,9216,8107,1109,8345,871
2002,Urban,Rajasthan,Other Crimes,Cyber Crime,Female,46-60,1605,1142,463,1232,373
2002,Urban,Maharashtra,Other Crimes,Drug Offense,Male,46-60,790,687,103,780,10
2004,Rural,Rajasthan,Property Crime,Vandalism,Male,60+,1585,1149,436,1334,251
2005,Urban,Jharkhand,Crime Against Children,Child Labor,Female,60+,6686,6473,213,6543,143
2009,Urban,Maharashtra,Crime Against Children,Child Labor,Male,46-60,9791,8483,1308,9028,763
2008,Rural,Punjab,Property Crime,Theft,Male,31-45,3928,1236,2692,1785,2143
2006,Urban,Tripura,Property Crime,Theft,Female,18-30,1165,402,763,520,645
2007,Urban,Tamil Nadu,Crime Against Men,Robbery,Male,60+,2621,2531,90,2574,47
2008,Urban,Bihar,Other Crimes,Corruption,Male,13-17,2201,215,1986,1885,316
2006,Rural,Madhya Pradesh,Other Crimes,Fraud,Female,46-60,4033,3549,484,3733,300
2007,Urban,Tamil Nadu,Other Crimes,Cyber Crime,Male,18-30,6278,3729,2549,4435,1843
2010,Rural,Madhya Pradesh,Crime Against Women,Rape,Male,46-60,4839,934,3905,3849,990
2004,Urban,Punjab,Crime Against Women,Dowry Deaths,Male,31-45,1571,490,1081,1486,85
2003,Urban,Rajasthan,Crime Against Children,Child Abuse,Male,0-12,502,416,86,416,86
2007,Rural,Meghalaya,Crime Against Women,Domestic Violence,Male,13-17,8508,2025,6483,6365,2143
2003,Rural,Goa,Other Crimes,Corruption,Male,18-30,7127,6132,995,6421,706
2005,Rural,Odisha,Other Crimes,Drug Offense,Male,46-60,6573,2317,4256,5849,724
2003,Urban,Sikkim,Property Crime,Burglary,Female,0-12,8112,4846,3266,4851,3261
2006,Rural,Tamil Nadu,Other Crimes,Drug Offense,Female,0-12,8078,623,7455,899,7179
2005,Urban,Jammu & Kashmir,Crime Against Men,Assault,Male,18-30,1385,401,984,1170,215
2003,Rural,Manipur,Crime Against Children,Child Labor,Male,31-45,8685,1204,7481,5244,3441
2001,Rural,Arunachal Pradesh,Other Crimes,Corruption,Female,13-17,7000,503,6497,6539,461
2008,Urban,Bihar,Crime Against Children,Trafficking,Female,0-12,7426,3689,3737,5548,1878
2010,Urban,Madhya Pradesh,Crime Against Men,Robbery,Male,60+,8112,7300,812,7973,139
2002,Rural,Andhra Pradesh,Crime Against Women,Domestic Violence,Female,60+,9558,3182,6376,4188,5370
2007,Urban,Jharkhand,Property Crime,Burglary,Male,60+,5195,3039,2156,5032,163
2010,Urban,Delhi,Crime Against Children,Child Abuse,Female,13-17,717,181,536,492,225
2004,Urban,Goa,Crime Against Men,Murder,Female,13-17,3947,1055,2892,1469,2478
2007,Urban,Andhra Pradesh,Other Crimes,Drug Offense,Male,18-30,9936,3963,5973,5912,4024
2007,Urban,Goa,Crime Against Children,Child Labor,Female,0-12,2422,1745,677,2415,7
2001,Urban,Gujarat,Crime Against Women,Dowry Deaths,Male,31-45,8567,124,8443,4153,4414
2004,Urban,Telangana,Other Crimes,Drug Offense,Male,31-45,5287,3126,2161,3188,2099
2004,Rural,Punjab,Crime Against Men,Extortion,Female,13-17,294,45,249,234,60
2006,Rural,Bihar,Other Crimes,Fraud,Female,46-60,9849,8360,1489,9768,81
2002,Rural,Rajasthan,Crime Against Men,Extortion,Male,46-60,7048,6574,474,6882,166
2010,Urban,Maharashtra,Property Crime,Arson,Male,60+,7309,1976,5333,6807,502
2002,Rural,Kerala,Crime Against Women,Rape,Female,60+,8426,6562,1864,6808,1618
2002,Rural,Goa,Crime Against Men,Assault,Male,0-12,163,43,120,120,43
2009,Urban,Punjab,Property Crime,Theft,Male,31-45,1704,1686,18,1696,8
2002,Urban,Bihar,Property Crime,Burglary,Female,46-60,3933,1766,2167,1926,2007
2008,Rural,Tamil Nadu,Crime Against Men,Assault,Female,18-30,404,2,402,132,272
2009,Rural,Madhya Pradesh,Other Crimes,Cyber Crime,Female,60+,7579,4418,3161,7300,279
2001,Rural,Tripura,Property Crime,Vandalism,Male,46-60,7923,2152,5771,7342,581
2002,Urban,Kerala,Property Crime,Vandalism,Female,13-17,8855,339,8516,5277,3578
2009,Rural,Assam,Other Crimes,Drug Offense,Male,60+,7022,712,6310,1058,5964
2008,Rural,Jammu & Kashmir,Crime Against Women,Molestation,Male,18-30,8380,6419,1961,6760,1620
2002,Urban,Kerala,Crime Against Men,Assault,Male,60+,125,112,13,123,2
2010,Rural,Tripura,Crime Against Children,Child Labor,Female,60+,1342,418,924,956,386
2009,Rural,Telangana,Other Crimes,Drug Offense,Male,13-17,4295,2166,2129,3872,423
2002,Urban,Uttar Pradesh,Property Crime,Burglary,Female,31-45,4346,1396,2950,4087,259
2002,Rural,Kerala,Crime Against Men,Assault,Male,60+,4567,966,3601,4013,554
2005,Urban,West Bengal,Property Crime,Theft,Male,18-30,6770,4490,2280,4666,2104
2001,Rural,Chhattisgarh,Crime Against Women,Dowry Deaths,Female,46-60,1469,137,1332,1008,461
2006,Urban,Goa,Crime Against Men,Robbery,Male,0-12,7348,2001,5347,5572,1776
2003,Urban,Tripura,Crime Against Children,Kidnapping,Male,60+,6811,5785,1026,6536,275
2008,Urban,Madhya Pradesh,Crime Against Women,Dowry Deaths,Male,13-17,4770,645,4125,4201,569
2008,Rural,Uttarakhand,Other Crimes,Drug Offense,Female,60+,5095,1795,3300,4309,786
2006,Rural,Andhra Pradesh,Other Crimes,Cyber Crime,Female,31-45,629,57,572,298,331
2007,Rural,Kerala,Crime Against Children,Trafficking,Female,18-30,6223,5328,895,5984,239
2008,Rural,Punjab,Crime Against Children,Child Labor,Male,13-17,5491,3134,2357,5153,338
2010,Rural,Jharkhand,Crime Against Women,Molestation,Male,60+,9780,6827,2953,9168,612
2009,Urban,Karnataka,Other Crimes,Fraud,Male,18-30,2882,1151,1731,1214,1668
2005,Urban,Karnataka,Crime Against Children,Child Abuse,Female,60+,4155,1463,2692,3130,1025
2008,Urban,Odisha,Crime Against Women,Domestic Violence,Female,46-60,7702,2971,4731,5331,2371
2001,Rural,Uttarakhand,Other Crimes,Cyber Crime,Female,13-17,6320,3866,2454,4262,2058
2002,Rural,Telangana,Crime Against Men,Assault,Female,0-12,4385,1094,3291,3084,1301
2003,Urban,Himachal Pradesh,Property Crime,Theft,Male,46-60,8637,8466,171,8562,75
2002,Urban,Tripura,Property Crime,Arson,Female,46-60,8818,120,8698,6171,2647
2004,Urban,Haryana,Crime Against Women,Molestation,Female,31-45,2926,1083,1843,1424,1502
2004,Urban,Uttar Pradesh,Crime Against Children,Child Abuse,Male,18-30,1594,1564,30,1590,4
2004,Rural,Punjab,Crime Against Children,Child Abuse,Male,60+,9979,509,9470,1231,8748
2001,Urban,Rajasthan,Crime Against Men,Robbery,Female,60+,7444,1589,5855,4090,3354
2008,Urban,Assam,Property Crime,Arson,Female,46-60,1678,6,1672,850,828
2004,Urban,Gujarat,Crime Against Children,Trafficking,Male,13-17,4256,885,3371,1658,2598
2007,Urban,Chhattisgarh,Other Crimes,Drug Offense,Male,46-60,8571,197,8374,5055,3516
2006,Rural,Arunachal Pradesh,Other Crimes,Drug Offense,Male,13-17,3530,117,3413,3284,246
2002,Urban,Nagaland,Crime Against Men,Assault,Male,31-45,7409,6996,413,7347,62
2004,Urban,Kerala,Crime Against Women,Domestic Violence,Female,31-45,7096,2257,4839,4125,2971
2002,Urban,Andhra Pradesh,Crime Against Men,Robbery,Male,13-17,4282,1743,2539,1861,2421
2007,Rural,Nagaland,Property Crime,Vandalism,Female,46-60,5552,2697,2855,3286,2266
2004,Rural,Odisha,Crime Against Women,Dowry Deaths,Male,0-12,1906,1407,499,1897,9
2004,Urban,Arunachal Pradesh,Property Crime,Theft,Female,18-30,915,96,819,843,72
2010,Urban,Chhattisgarh,Crime Against Women,Molestation,Female,46-60,7630,244,7386,474,7156
2003,Urban,Telangana,Crime Against Children,Child Abuse,Male,0-12,3531,275,3256,3254,277
2009,Rural,Chhattisgarh,Other Crimes,Corruption,Male,60+,2399,853,1546,1544,855
2009,Urban,West Bengal,Property Crime,Vandalism,Female,18-30,3984,3094,890,3346,638
2003,Urban,Punjab,Crime Against Children,Child Labor,Female,46-60,8169,3332,4837,6882,1287
2007,Urban,Assam,Crime Against Women,Molestation,Male,31-45,9564,6635,2929,7193,2371
2003,Rural,Meghalaya,Other Crimes,Fraud,Male,13-17,2783,2382,401,2624,159
2008,Rural,Telangana,Other Crimes,Drug Offense,Male,0-12,2187,683,1504,1386,801
2008,Urban,Uttarakhand,Crime Against Women,Dowry Deaths,Female,46-60,3222,2000,1222,2114,1108
2002,Rural,Delhi,Crime Against Children,Child Abuse,Female,46-60,8683,544,8139,2467,6216
2001,Rural,Goa,Crime Against Women,Dowry Deaths,Female,60+,7259,5288,1971,6170,1089
2001,Urban,Uttar Pradesh,Crime Against Men,Assault,Female,60+,5228,1022,4206,2044,3184
2002,Rural,West Bengal,Crime Against Men,Assault,Male,0-12,9339,6316,3023,7190,2149
2010,Rural,Assam,Other Crimes,Fraud,Female,46-60,605,359,246,545,60
2009,Urban,Jammu & Kashmir,Crime Against Women,Rape,Male,0-12,8403,6150,2253,8097,306
2004,Urban,Arunachal Pradesh,Property Crime,Vandalism,Female,18-30,8936,4059,4877,5402,3534
2004,Urban,Rajasthan,Property Crime,Vandalism,Male,31-45,8407,3678,4729,7552,855
2004,Rural,Maharashtra,Crime Against Children,Child Abuse,Male,0-12,2662,1072,1590,1819,843
2001,Urban,Nagaland,Property Crime,Burglary,Female,0-12,5424,1739,3685,3464,1960
2009,Rural,Karnataka,Property Crime,Burglary,Female,31-45,9591,6753,2838,7457,2134
2003,Urban,Goa,Crime Against Women,Rape,Female,60+,212,143,69,193,19
2008,Urban,Haryana,Crime Against Children,Child Labor,Female,60+,5074,3851,1223,4944,130
2009,Rural,Goa,Other Crimes,Drug Offense,Male,31-45,8644,5825,2819,7730,914
2010,Urban,Andhra Pradesh,Other Crimes,Fraud,Male,31-45,5658,5233,425,5500,158
2009,Rural,Chhattisgarh,Crime Against Men,Assault,Female,0-12,6459,4605,1854,5899,560
2010,Rural,Odisha,Other Crimes,Corruption,Female,18-30,2900,1597,1303,1795,1105
2003,Urban,Assam,Crime Against Children,Kidnapping,Female,60+,9596,1239,8357,1611,7985
2004,Urban,Karnataka,Property Crime,Burglary,Male,18-30,1637,609,1028,1574,63
2010,Urban,West Bengal,Crime Against Children,Kidnapping,Female,60+,8762,2699,6063,6649,2113
2008,Rural,Arunachal Pradesh,Crime Against Children,Child Abuse,Female,46-60,2364,421,1943,1987,377
2007,Urban,Uttar Pradesh,Crime Against Children,Child Abuse,Male,0-12,3160,480,2680,1515,1645
2007,Rural,Madhya Pradesh,Crime Against Women,Domestic Violence,Male,0-12,2485,2066,419,2188,297
2003,Rural,Karnataka,Crime Against Men,Robbery,Male,13-17,5868,1699,4169,2994,2874
2008,Rural,Andhra Pradesh,Crime Against Men,Murder,Male,13-17,3747,3042,705,3730,17
2008,Rural,Himachal Pradesh,Crime Against Children,Trafficking,Female,46-60,404,118,286,175,229
2010,Rural,Jharkhand,Crime Against Children,Kidnapping,Male,60+,9700,3187,6513,8045,1655
2004,Rural,Uttarakhand,Property Crime,Arson,Female,60+,4904,3368,1536,3519,1385
2003,Urban,Tamil Nadu,Property Crime,Theft,Male,31-45,1052,163,889,797,255
2005,Rural,Maharashtra,Property Crime,Theft,Female,0-12,3311,2766,545,2950,361
2003,Rural,Tripura,Other Crimes,Corruption,Male,46-60,1164,771,393,1143,21
2002,Urban,Bihar,Crime Against Women,Rape,Female,31-45,8387,3901,4486,6465,1922
2007,Rural,Meghalaya,Other Crimes,Fraud,Male,0-12,4166,921,3245,3175,991
2006,Urban,Maharashtra,Crime Against Women,Domestic Violence,Male,13-17,5773,19,5754,3875,1898
2008,Urban,Telangana,Crime Against Children,Child Labor,Female,31-45,455,218,237,298,157
2002,Urban,Kerala,Other Crimes,Cyber Crime,Female,0-12,9205,8209,996,9073,132
2008,Rural,Haryana,Other Crimes,Drug Offense,Male,18-30,1108,977,131,1029,79
2009,Urban,Kerala,Crime Against Children,Kidnapping,Female,0-12,3914,1449,2465,3832,82
2010,Urban,Kerala,Crime Against Women,Rape,Male,46-60,3465,1698,1767,2086,1379
2009,Rural,Gujarat,Property Crime,Vandalism,Male,0-12,4963,6,4957,251,4712
2006,Rural,Kerala,Property Crime,Vandalism,Female,0-12,8078,1441,6637,2235,5843
2006,Rural,Assam,Property Crime,Theft,Female,18-30,6267,4762,1505,5827,440
2008,Urban,Sikkim,Other Crimes,Fraud,Male,18-30,9610,452,9158,3435,6175
2001,Urban,Telangana,Crime Against Men,Murder,Male,13-17,3420,2691,729,2905,515
2006,Urban,Assam,Property Crime,Theft,Female,13-17,2849,1382,1467,2397,452
2006,Rural,Punjab,Crime Against Children,Kidnapping,Female,60+,2008,24,1984,945,1063
2008,Urban,Haryana,Crime Against Children,Child Abuse,Female,13-17,7537,2637,4900,5124,2413
2010,Rural,Assam,Crime Against Men,Robbery,Female,31-45,5719,1137,4582,2983,2736
2001,Rural,Maharashtra,Crime Against Men,Assault,Female,60+,3937,2357,1580,2380,1557
2005,Urban,Mizoram,Property Crime,Theft,Male,0-12,4567,1083,3484,1842,2725
2001,Rural,Haryana,Other Crimes,Fraud,Male,18-30,6461,3394,3067,4325,2136
2002,Urban,Punjab,Crime Against Men,Murder,Male,46-60,3646,624,3022,2445,1201
2004,Urban,Arunachal Pradesh,Property Crime,Vandalism,Female,46-60,8523,4407,4116,5443,3080
2005,Urban,Andhra Pradesh,Other Crimes,Drug Offense,Female,46-60,1734,1443,291,1539,195
2010,Urban,Madhya Pradesh,Property Crime,Vandalism,Female,0-12,9111,5435,3676,8271,840
2008,Rural,West Bengal,Crime Against Men,Assault,Male,60+,9554,5117,4437,8452,1102
2006,Urban,Kerala,Other Crimes,Fraud,Female,18-30,3881,856,3025,2915,966
2002,Rural,Maharashtra,Other Crimes,Fraud,Female,18-30,1288,1021,267,1277,11
2007,Urban,Tamil Nadu,Crime Against Children,Child Labor,Male,60+,4448,2152,2296,3758,690
2010,Urban,Tripura,Crime Against Women,Molestation,Male,46-60,3362,2648,714,3170,192
2010,Rural,Maharashtra,Crime Against Women,Domestic Violence,Male,0-12,9735,2643,7092,7499,2236
2010,Urban,Sikkim,Crime Against Women,Molestation,Female,46-60,3404,1087,2317,2494,910
2001,Urban,Manipur,Crime Against Children,Child Labor,Male,13-17,863,226,637,340,523
2004,Rural,Uttarakhand,Crime Against Women,Dowry Deaths,Male,31-45,2006,1945,61,1993,13
2010,Rural,Jammu & Kashmir,Crime Against Children,Kidnapping,Female,31-45,4926,3058,1868,4784,142
2009,Rural,Bihar,Property Crime,Burglary,Male,18-30,7197,5756,1441,5782,1415
2005,Urban,Kerala,Crime Against Men,Assault,Male,46-60,928,370,558,738,190
2001,Urban,Gujarat,Other Crimes,Cyber Crime,Female,46-60,3469,55,3414,635,2834
2003,Rural,Himachal Pradesh,Crime Against Men,Assault,Female,60+,9755,5435,4320,6052,3703
2002,Rural,Uttarakhand,Crime Against Men,Assault,Female,46-60,5585,4014,1571,5045,540
2010,Urban,Assam,Other Crimes,Fraud,Male,18-30,4351,934,3417,3838,513
2006,Rural,Goa,Other Crimes,Corruption,Male,13-17,4148,1419,2729,3694,454
2005,Urban,Meghalaya,Other Crimes,Cyber Crime,Female,46-60,247,153,94,227,20
2008,Rural,Bihar,Crime Against Men,Robbery,Male,18-30,8071,6269,1802,7726,345
2002,Rural,Assam,Crime Against Men,Murder,Male,18-30,637,445,192,559,78
2001,Rural,Jharkhand,Crime Against Children,Child Abuse,Male,13-17,5668,4575,1093,5426,242
2005,Urban,Himachal Pradesh,Property Crime,Burglary,Male,46-60,4097,94,4003,2709,1388
2001,Rural,Maharashtra,Property Crime,Burglary,Female,18-30,7976,5881,2095,6866,1110
2003,Rural,Tamil Nadu,Crime Against Women,Dowry Deaths,Female,46-60,2890,2578,312,2582,308
2010,Rural,Gujarat,Other Crimes,Corruption,Male,13-17,1006,682,324,758,248
2008,Rural,Tripura,Crime Against Children,Child Abuse,Male,18-30,591,89,502,415,176
2002,Urban,Bihar,Other Crimes,Fraud,Male,46-60,1148,549,599,1129,19
2010,Urban,Himachal Pradesh,Property Crime,Theft,Male,13-17,1560,891,669,1135,425
2008,Urban,Chhattisgarh,Other Crimes,Corruption,Female,31-45,1378,1192,186,1368,10
2010,Urban,Uttar Pradesh,Crime Against Children,Child Abuse,Male,60+,7322,4568,2754,7236,86
2003,Rural,Jharkhand,Other Crimes,Fraud,Male,13-17,5678,5372,306,5491,187
2004,Rural,Tripura,Property Crime,Vandalism,Male,13-17,890,60,830,402,488
2001,Urban,Rajasthan,Crime Against Women,Domestic Violence,Male,13-17,7262,4898,2364,6197,1065
2003,Urban,Karnataka,Property Crime,Theft,Female,31-45,2194,1780,414,2117,77
2004,Urban,Telangana,Crime Against Men,Murder,Male,13-17,6210,116,6094,1428,4782
2010,Rural,Uttar Pradesh,Property Crime,Arson,Male,31-45,4182,435,3747,612,3570
2004,Urban,Tripura,Other Crimes,Drug Offense,Female,60+,2750,1353,1397,2606,144
2005,Rural,Bihar,Other Crimes,Cyber Crime,Male,13-17,4500,3563,937,3957,543
2003,Rural,Tamil Nadu,Crime Against Women,Dowry Deaths,Male,13-17,7395,2837,4558,4936,2459
2010,Rural,Jharkhand,Crime Against Men,Assault,Female,31-45,5928,4727,1201,4979,949
2004,Urban,Madhya Pradesh,Property Crime,Vandalism,Male,60+,6470,2228,4242,3316,3154
2005,Urban,Karnataka,Crime Against Men,Robbery,Male,13-17,2823,1402,1421,1813,1010
2006,Rural,Punjab,Crime Against Children,Trafficking,Male,31-45,8509,403,8106,3899,4610
2004,Urban,Assam,Other Crimes,Corruption,Female,60+,918,170,748,693,225
2006,Rural,Bihar,Crime Against Women,Dowry Deaths,Male,46-60,5792,4350,1442,4969,823
2008,Urban,Meghalaya,Other Crimes,Cyber Crime,Female,60+,589,197,392,403,186
2010,Urban,Sikkim,Property Crime,Arson,Female,0-12,2148,2038,110,2100,48
2007,Urban,Karnataka,Other Crimes,Fraud,Male,18-30,2302,2087,215,2290,12
2006,Rural,Jharkhand,Property Crime,Vandalism,Female,13-17,2751,1704,1047,2635,116
2010,Urban,Himachal Pradesh,Crime Against Men,Extortion,Female,18-30,2229,851,1378,1877,352
2007,Rural,Himachal Pradesh,Crime Against Men,Murder,Female,60+,9957,8164,1793,9698,259
2003,Rural,Uttarakhand,Crime Against Women,Domestic Violence,Female,0-12,3326,1304,2022,2337,989
2008,Urban,Meghalaya,Crime Against Women,Molestation,Male,31-45,1688,953,735,1445,243
2010,Rural,Himachal Pradesh,Other Crimes,Drug Offense,Female,13-17,3578,402,3176,654,2924
2007,Rural,Jharkhand,Property Crime,Arson,Female,60+,9565,7457,2108,7644,1921
2007,Urban,Maharashtra,Property Crime,Theft,Female,0-12,7832,114,7718,5247,2585
2005,Rural,Himachal Pradesh,Crime Against Children,Trafficking,Male,0-12,9428,5670,3758,8771,657
2006,Urban,Tamil Nadu,Crime Against Women,Molestation,Male,0-12,2859,350,2509,439,2420
2005,Rural,West Bengal,Property Crime,Vandalism,Female,60+,7935,202,7733,7075,860
2004,Urban,Manipur,Crime Against Men,Extortion,Female,46-60,5219,1277,3942,1454,3765
2007,Rural,Andhra Pradesh,Crime Against Men,Robbery,Male,0-12,2199,989,1210,1760,439
2002,Urban,Meghalaya,Property Crime,Vandalism,Female,31-45,1633,924,709,1588,45
2010,Urban,Gujarat,Property Crime,Burglary,Female,31-45,336,266,70,316,20
2006,Urban,Karnataka,Other Crimes,Cyber Crime,Male,18-30,2540,1536,1004,1667,873
2002,Urban,Himachal Pradesh,Other Crimes,Corruption,Female,13-17,2504,1200,1304,2225,279
2007,Urban,Tripura,Other Crimes,Fraud,Male,60+,290,51,239,55,235
2001,Urban,West Bengal,Crime Against Women,Rape,Female,18-30,1750,1420,330,1551,199
2006,Urban,Nagaland,Crime Against Children,Child Labor,Male,18-30,6067,4564,1503,4586,1481
2002,Urban,Madhya Pradesh,Crime Against Women,Domestic Violence,Female,0-12,3827,2781,1046,3292,535
2005,Rural,Tamil Nadu,Crime Against Children,Child Labor,Female,31-45,5084,4675,409,5057,27
2010,Rural,Andhra Pradesh,Crime Against Women,Dowry Deaths,Male,18-30,3400,599,2801,1234,2166
2006,Rural,Assam,Crime Against Women,Domestic Violence,Female,60+,8793,1833,6960,7244,1549
2004,Urban,Punjab,Other Crimes,Fraud,Male,60+,3896,2893,1003,3152,744
2008,Urban,Chhattisgarh,Crime Against Women,Dowry Deaths,Male,46-60,2385,1543,842,1912,473
2008,Rural,Nagaland,Other Crimes,Fraud,Male,18-30,6299,4832,1467,6212,87
2010,Urban,Tamil Nadu,Crime Against Children,Trafficking,Male,60+,4622,3327,1295,4101,521
2008,Urban,Maharashtra,Crime Against Women,Domestic Violence,Male,18-30,2360,1307,1053,1912,448
2003,Rural,Madhya Pradesh,Crime Against Men,Murder,Female,31-45,6622,3513,3109,4153,2469
2003,Urban,Madhya Pradesh,Property Crime,Arson,Male,46-60,7058,2606,4452,3312,3746
2006,Rural,Tamil Nadu,Crime Against Women,Molestation,Female,0-12,6380,197,6183,5431,949
2007,Rural,Mizoram,Other Crimes,Fraud,Male,46-60,3829,1448,2381,2363,1466
2005,Rural,Gujarat,Other Crimes,Corruption,Female,60+,5422,3724,1698,4044,1378
2009,Rural,Madhya Pradesh,Crime Against Women,Molestation,Female,0-12,2349,2140,209,2202,147
2002,Urban,Tripura,Crime Against Children,Kidnapping,Male,31-45,1921,1311,610,1541,380
2003,Rural,Punjab,Other Crimes,Fraud,Female,18-30,8125,2323,5802,3168,4957
2006,Urban,Nagaland,Crime Against Women,Domestic Violence,Female,18-30,8149,2786,5363,7911,238
2006,Urban,Meghalaya,Property Crime,Vandalism,Male,31-45,7278,4795,2483,4870,2408
2007,Urban,Sikkim,Crime Against Men,Murder,Male,18-30,7361,1620,5741,6276,1085
2001,Urban,Arunachal Pradesh,Other Crimes,Corruption,Female,13-17,5293,749,4544,1118,4175
2003,Urban,Sikkim,Property Crime,Arson,Female,46-60,6660,6630,30,6653,7
2008,Rural,Uttar Pradesh,Property Crime,Burglary,Male,31-45,2701,2022,679,2387,314
2010,Rural,Sikkim,Property Crime,Vandalism,Male,60+,6367,295,6072,4890,1477
2008,Rural,Punjab,Crime Against Children,Trafficking,Male,60+,4394,715,3679,2871,1523
2008,Rural,Punjab,Crime Against Children,Kidnapping,Male,13-17,6446,4044,2402,5596,850
2002,Urban,Uttar Pradesh,Other Crimes,Cyber Crime,Male,13-17,2901,227,2674,1824,1077
2007,Rural,Madhya Pradesh,Crime Against Women,Molestation,Female,46-60,8219,4018,4201,4064,4155
2005,Urban,Rajasthan,Property Crime,Vandalism,Male,18-30,2772,2006,766,2534,238
2010,Rural,Madhya Pradesh,Crime Against Women,Dowry Deaths,Female,60+,4175,1344,2831,3839,336
2005,Urban,Jammu & Kashmir,Crime Against Men,Extortion,Female,13-17,6339,2304,4035,4743,1596
2001,Urban,Uttarakhand,Crime Against Women,Rape,Female,46-60,7518,5752,1766,6664,854
2001,Urban,Goa,Other Crimes,Fraud,Female,60+,7555,4299,3256,5682,1873
2006,Urban,Andhra Pradesh,Property Crime,Vandalism,Female,0-12,1461,739,722,798,663
2005,Urban,Rajasthan,Other Crimes,Cyber Crime,Female,31-45,2271,987,1284,1272,999
2006,Rural,Himachal Pradesh,Crime Against Men,Robbery,Female,13-17,1880,1831,49,1837,43
2006,Urban,Gujarat,Crime Against Men,Extortion,Male,60+,7779,4353,3426,6178,1601
2008,Urban,Himachal Pradesh,Crime Against Men,Assault,Male,31-45,8404,8194,210,8275,129
2009,Urban,Goa,Crime Against Women,Rape,Male,60+,6001,3218,2783,5377,624
2008,Rural,Sikkim,Property Crime,Vandalism,Male,13-17,7938,1790,6148,5446,2492
2004,Rural,West Bengal,Crime Against Women,Rape,Male,18-30,1845,1179,666,1447,398
2002,Urban,Tamil Nadu,Other Crimes,Cyber Crime,Male,0-12,6477,1863,4614,3853,2624
2010,Urban,Uttarakhand,Crime Against Children,Child Labor,Male,0-12,4447,2230,2217,3290,1157
2006,Urban,Tripura,Crime Against Women,Molestation,Male,60+,4819,1204,3615,3470,1349
2003,Rural,Jharkhand,Crime Against Women,Rape,Female,46-60,5295,4840,455,5122,173
2005,Rural,Himachal Pradesh,Crime Against Children,Child Labor,Male,60+,2236,30,2206,1774,462
2007,Urban,Rajasthan,Property Crime,Arson,Male,46-60,7437,4282,3155,5670,1767
2008,Rural,Telangana,Crime Against Women,Molestation,Male,60+,5883,61,5822,1827,4056
2004,Urban,Nagaland,Crime Against Men,Murder,Male,18-30,207,41,166,128,79
2009,Urban,Odisha,Crime Against Children,Trafficking,Female,18-30,7321,4268,3053,4272,3049
2008,Urban,Jammu & Kashmir,Property Crime,Arson,Female,0-12,6818,752,6066,5390,1428
2001,Rural,Assam,Other Crimes,Fraud,Male,60+,1950,557,1393,1233,717
2004,Rural,Himachal Pradesh,Crime Against Men,Murder,Female,46-60,1065,883,182,1021,44
2003,Urban,Goa,Crime Against Women,Domestic Violence,Male,18-30,9400,1317,8083,4087,5313
2003,Urban,Andhra Pradesh,Crime Against Women,Domestic Violence,Male,18-30,902,404,498,678,224
2009,Urban,Telangana,Crime Against Men,Assault,Female,13-17,2095,1860,235,2022,73
2004,Urban,Sikkim,Crime Against Children,Child Abuse,Male,0-12,2476,1038,1438,1639,837
2009,Urban,Haryana,Crime Against Children,Child Labor,Male,31-45,9701,4184,5517,8085,1616
2006,Urban,Maharashtra,Property Crime,Theft,Female,60+,7538,1767,5771,1990,5548
2001,Urban,Himachal Pradesh,Crime Against Women,Molestation,Male,0-12,2364,1689,675,2194,170
2009,Urban,Punjab,Crime Against Men,Assault,Male,60+,3035,951,2084,1108,1927
2005,Urban,Assam,Property Crime,Arson,Female,0-12,870,577,293,695,175
2005,Urban,Andhra Pradesh,Crime Against Children,Trafficking,Male,18-30,5909,2878,3031,2916,2993
2005,Rural,Arunachal Pradesh,Crime Against Children,Child Abuse,Male,0-12,9221,2919,6302,6037,3184
2007,Rural,Maharashtra,Property Crime,Vandalism,Female,0-12,9577,5161,4416,8776,801
2003,Urban,Gujarat,Crime Against Children,Kidnapping,Female,0-12,1569,85,1484,845,724
2005,Rural,Mizoram,Crime Against Children,Kidnapping,Male,31-45,2108,429,1679,525,1583
2001,Rural,Tamil Nadu,Crime Against Children,Child Abuse,Male,18-30,1098,862,236,1017,81
2010,Rural,Tripura,Other Crimes,Cyber Crime,Male,46-60,7654,180,7474,3338,4316
2004,Rural,Madhya Pradesh,Crime Against Men,Assault,Female,31-45,6962,5409,1553,5594,1368
2004,Rural,Chhattisgarh,Crime Against Men,Robbery,Male,46-60,1227,794,433,1163,64
2007,Urban,Punjab,Crime Against Women,Rape,Female,18-30,7954,7526,428,7797,157
2006,Urban,Odisha,Crime Against Children,Kidnapping,Female,18-30,8653,8037,616,8504,149
2001,Rural,Meghalaya,Crime Against Men,Murder,Male,46-60,6682,6224,458,6673,9
2001,Urban,Jharkhand,Property Crime,Vandalism,Male,46-60,5565,3889,1676,4022,1543
2009,Urban,Haryana,Other Crimes,Drug Offense,Female,31-45,2449,1320,1129,2020,429
2009,Urban,Uttarakhand,Property Crime,Arson,Male,60+,8921,6882,2039,8037,884
2007,Urban,Meghalaya,Crime Against Children,Trafficking,Male,46-60,5612,743,4869,5536,76
2010,Urban,Nagaland,Crime Against Women,Dowry Deaths,Female,18-30,8376,3867,4509,4570,3806
2005,Urban,Uttar Pradesh,Other Crimes,Fraud,Male,31-45,3963,3009,954,3854,109
2001,Urban,Kerala,Property Crime,Burglary,Male,31-45,1820,424,1396,1786,34
2007,Rural,Himachal Pradesh,Crime Against Men,Robbery,Male,60+,3203,2311,892,2716,487
2003,Urban,West Bengal,Other Crimes,Cyber Crime,Male,13-17,3946,974,2972,3389,557
2005,Urban,Uttarakhand,Other Crimes,Fraud,Female,18-30,3391,3185,206,3321,70
2002,Rural,Nagaland,Crime Against Men,Murder,Female,31-45,9281,4921,4360,5144,4137
2009,Rural,Gujarat,Crime Against Children,Child Labor,Male,60+,7216,6174,1042,6181,1035
2003,Urban,Arunachal Pradesh,Crime Against Women,Rape,Male,31-45,7892,1463,6429,1490,6402
2009,Rural,West Bengal,Crime Against Children,Child Labor,Female,0-12,3874,1569,2305,1966,1908
2006,Urban,West Bengal,Other Crimes,Drug Offense,Female,0-12,203,21,182,107,96
2010,Urban,Mizoram,Crime Against Women,Molestation,Male,0-12,2603,661,1942,1434,1169
2003,Rural,Punjab,Crime Against Men,Murder,Female,46-60,67,19,48,41,26
2003,Rural,Tamil Nadu,Property Crime,Vandalism,Female,60+,4398,4381,17,4395,3
2002,Rural,Nagaland,Property Crime,Vandalism,Male,0-12,7412,272,7140,1432,5980
2009,Urban,Telangana,Crime Against Children,Child Abuse,Female,0-12,3285,2820,465,3155,130
2001,Rural,Chhattisgarh,Property Crime,Theft,Male,18-30,4715,4669,46,4714,1
2003,Urban,Rajasthan,Crime Against Women,Domestic Violence,Male,46-60,4479,1026,3453,2919,1560
2010,Urban,Sikkim,Crime Against Women,Dowry Deaths,Female,18-30,2294,2137,157,2173,121
2001,Rural,Maharashtra,Property Crime,Burglary,Male,13-17,339,310,29,339,0
2002,Rural,Tripura,Crime Against Men,Extortion,Male,31-45,4434,1858,2576,3528,906
2005,Rural,Odisha,Crime Against Men,Robbery,Female,18-30,9321,7875,1446,8619,702
2010,Urban,West Bengal,Property Crime,Vandalism,Male,18-30,2907,506,2401,1053,1854
2004,Rural,Assam,Other Crimes,Cyber Crime,Male,18-30,2764,2405,359,2584,180
2007,Urban,Tripura,Crime Against Men,Assault,Male,0-12,1893,1630,263,1844,49
2001,Urban,Gujarat,Crime Against Women,Rape,Male,60+,5089,2372,2717,2513,2576
2010,Rural,Uttarakhand,Crime Against Children,Child Abuse,Male,46-60,6526,4904,1622,5147,1379
2009,Urban,Nagaland,Crime Against Children,Child Labor,Female,46-60,7673,6033,1640,6716,957
2009,Urban,Assam,Crime Against Children,Kidnapping,Male,0-12,4895,1485,3410,3581,1314
2006,Urban,Uttarakhand,Property Crime,Theft,Male,60+,5763,4037,1726,5285,478
2002,Rural,Odisha,Crime Against Men,Extortion,Female,60+,3739,2027,1712,2655,1084
2005,Urban,Nagaland,Other Crimes,Cyber Crime,Female,60+,5767,1461,4306,4913,854
2009,Rural,Uttar Pradesh,Crime Against Men,Assault,Female,18-30,4123,236,3887,3443,680
2006,Urban,Gujarat,Crime Against Women,Molestation,Male,18-30,8711,6986,1725,7658,1053
2005,Rural,Andhra Pradesh,Crime Against Women,Dowry Deaths,Female,46-60,533,93,440,448,85
2005,Rural,Uttar Pradesh,Crime Against Women,Dowry Deaths,Female,13-17,835,226,609,373,462
2003,Rural,Meghalaya,Crime Against Children,Child Abuse,Male,0-12,4664,2657,2007,4450,214
2004,Urban,Uttar Pradesh,Crime Against Women,Domestic Violence,Female,13-17,1959,60,1899,438,1521
2010,Rural,Bihar,Crime Against Children,Trafficking,Male,13-17,4438,2822,1616,3090,1348
2010,Rural,Goa,Crime Against Men,Assault,Female,18-30,1923,1323,600,1837,86
2007,Rural,Telangana,Crime Against Women,Rape,Female,46-60,8035,7992,43,8003,32
2004,Urban,Jharkhand,Property Crime,Theft,Male,60+,9521,7254,2267,8265,1256
2009,Rural,Uttarakhand,Crime Against Children,Trafficking,Female,31-45,1530,561,969,913,617
2005,Urban,Rajasthan,Crime Against Men,Extortion,Male,0-12,1753,833,920,846,907
2006,Urban,Bihar,Crime Against Children,Kidnapping,Male,60+,701,11,690,608,93
2008,Urban,Gujarat,Crime Against Women,Domestic Violence,Male,31-45,7067,2021,5046,6074,993
2005,Rural,Manipur,Crime Against Children,Child Abuse,Female,0-12,8413,2133,6280,2802,5611
2006,Urban,Chhattisgarh,Other Crimes,Drug Offense,Male,18-30,2497,1080,1417,2287,210
2008,Rural,Nagaland,Crime Against Women,Molestation,Male,18-30,8323,5229,3094,7026,1297
2004,Urban,Nagaland,Property Crime,Burglary,Male,18-30,5685,3749,1936,3768,1917
2001,Rural,Tamil Nadu,Crime Against Women,Rape,Male,13-17,789,24,765,52,737
2006,Urban,Bihar,Crime Against Children,Child Abuse,Male,0-12,930,792,138,840,90
2006,Rural,Maharashtra,Property Crime,Burglary,Male,18-30,9287,496,8791,2355,6932
2008,Rural,Goa,Crime Against Children,Trafficking,Female,46-60,7072,104,6968,4297,2775
2002,Urban,Manipur,Other Crimes,Drug Offense,Male,0-12,2627,1357,1270,1403,1224
2009,Rural,Goa,Other Crimes,Corruption,Female,60+,3721,836,2885,3069,652
2003,Rural,Kerala,Crime Against Children,Trafficking,Male,31-45,698,539,159,693,5
2002,Urban,Andhra Pradesh,Property Crime,Vandalism,Male,0-12,8119,5910,2209,7150,969
2003,Rural,Manipur,Crime Against Women,Rape,Female,46-60,4210,717,3493,2991,1219
2006,Rural,Mizoram,Crime Against Men,Assault,Male,60+,2292,1879,413,1911,381
2005,Rural,Delhi,Crime Against Children,Child Abuse,Male,46-60,5315,598,4717,1398,3917
2003,Rural,Arunachal Pradesh,Crime Against Men,Assault,Male,0-12,4221,1371,2850,3810,411
2006,Rural,Gujarat,Crime Against Children,Child Abuse,Male,0-12,6528,1650,4878,3245,3283
2004,Rural,Assam,Crime Against Children,Trafficking,Male,46-60,3345,656,2689,3285,60
2004,Urban,Gujarat,Property Crime,Vandalism,Male,31-45,2871,1610,1261,2607,264
2001,Urban,Andhra Pradesh,Crime Against Men,Murder,Female,31-45,1414,1346,68,1404,10
2003,Rural,Telangana,Crime Against Men,Assault,Female,0-12,9789,1088,8701,3446,6343
2005,Rural,Tamil Nadu,Crime Against Men,Robbery,Male,18-30,5821,2979,2842,4308,1513
2003,Urban,Bihar,Crime Against Women,Domestic Violence,Female,0-12,471,451,20,456,15
2004,Urban,Jammu & Kashmir,Crime Against Children,Child Abuse,Female,0-12,7664,5784,1880,6320,1344
2001,Rural,Sikkim,Property Crime,Theft,Female,0-12,9740,5723,4017,8643,1097
2006,Urban,Uttar Pradesh,Other Crimes,Drug Offense,Male,46-60,7296,4582,2714,6918,378
2010,Urban,Andhra Pradesh,Crime Against Men,Assault,Female,46-60,5777,5361,416,5511,266
2001,Rural,Karnataka,Crime Against Children,Child Labor,Male,31-45,1711,1358,353,1443,268
2010,Rural,Odisha,Other Crimes,Corruption,Male,60+,7117,1284,5833,6849,268
2003,Urban,Tamil Nadu,Crime Against Children,Kidnapping,Female,46-60,653,247,406,363,290
2005,Urban,Arunachal Pradesh,Crime Against Children,Kidnapping,Male,46-60,3892,2379,1513,3164,728
2001,Rural,Tamil Nadu,Other Crimes,Cyber Crime,Female,60+,8969,8969,0,8969,0
2008,Rural,Nagaland,Property Crime,Vandalism,Male,31-45,583,27,556,337,246
2002,Urban,Goa,Crime Against Children,Child Labor,Male,0-12,8618,6600,2018,7054,1564
2008,Rural,Jharkhand,Crime Against Children,Child Labor,Female,13-17,644,9,635,311,333
2007,Urban,Mizoram,Crime Against Men,Extortion,Male,60+,1125,412,713,656,469
2002,Rural,Uttarakhand,Other Crimes,Cyber Crime,Female,31-45,4703,3310,1393,3599,1104
2002,Rural,Tamil Nadu,Crime Against Men,Robbery,Female,31-45,7546,6012,1534,7112,434
2004,Urban,Karnataka,Other Crimes,Drug Offense,Female,0-12,1861,439,1422,777,1084
2008,Rural,Sikkim,Crime Against Children,Child Labor,Male,18-30,4880,2550,2330,4268,612
2007,Urban,Nagaland,Crime Against Children,Kidnapping,Female,31-45,1678,1619,59,1637,41
2010,Rural,Telangana,Crime Against Men,Extortion,Female,18-30,2870,410,2460,1027,1843
2004,Rural,Uttarakhand,Property Crime,Arson,Female,31-45,8947,3042,5905,5584,3363
2009,Urban,Chhattisgarh,Crime Against Women,Rape,Male,31-45,7477,2479,4998,6211,1266
2005,Rural,Assam,Crime Against Children,Child Abuse,Male,60+,2160,1817,343,1864,296
2007,Rural,Karnataka,Property Crime,Burglary,Female,31-45,4473,553,3920,1087,3386
2006,Rural,Andhra Pradesh,Crime Against Men,Extortion,Male,0-12,9459,4733,4726,8493,966
2002,Urban,Andhra Pradesh,Crime Against Men,Murder,Female,13-17,3697,848,2849,1535,2162
2009,Urban,Goa,Property Crime,Arson,Male,0-12,7826,4181,3645,4503,3323
2004,Urban,Sikkim,Crime Against Children,Trafficking,Male,31-45,2706,2588,118,2686,20
2001,Urban,Bihar,Property Crime,Arson,Male,31-45,2906,803,2103,1140,1766
2009,Urban,Odisha,Property Crime,Burglary,Female,0-12,2632,144,2488,1908,724
2010,Rural,Tamil Nadu,Crime Against Children,Kidnapping,Male,31-45,7772,4619,3153,5055,2717
2005,Rural,Maharashtra,Property Crime,Arson,Male,31-45,1345,698,647,1074,271
2008,Rural,Maharashtra,Crime Against Children,Kidnapping,Female,18-30,727,299,428,484,243
2008,Urban,Uttarakhand,Crime Against Women,Molestation,Male,46-60,4726,1034,3692,2701,2025
2004,Rural,Rajasthan,Crime Against Men,Robbery,Female,60+,7783,7482,301,7769,14
2006,Urban,Andhra Pradesh,Crime Against Men,Robbery,Female,13-17,6508,1663,4845,3861,2647
2001,Urban,Delhi,Crime Against Men,Murder,Female,0-12,856,193,663,228,628
2003,Urban,Tamil Nadu,Crime Against Men,Assault,Female,18-30,2743,1809,934,1890,853
2009,Urban,Uttarakhand,Other Crimes,Cyber Crime,Female,60+,2905,1022,1883,1430,1475
2007,Rural,Tamil Nadu,Other Crimes,Fraud,Female,18-30,5333,1554,3779,2502,2831
2005,Urban,Kerala,Crime Against Women,Rape,Female,60+,7123,1187,5936,1470,5653
2006,Urban,Karnataka,Crime Against Children,Kidnapping,Male,13-17,8299,4429,3870,8068,231
2003,Rural,Jharkhand,Crime Against Women,Molestation,Male,13-17,9948,6270,3678,9178,770
2003,Urban,Telangana,Crime Against Children,Trafficking,Female,18-30,9482,569,8913,1165,8317
2009,Rural,Punjab,Crime Against Women,Domestic Violence,Female,60+,4728,3214,1514,4256,472
2003,Rural,Tripura,Other Crimes,Cyber Crime,Female,13-17,3851,1325,2526,1356,2495
2003,Rural,West Bengal,Property Crime,Theft,Male,18-30,5702,5019,683,5304,398
2006,Rural,Uttar Pradesh,Crime Against Women,Domestic Violence,Male,13-17,961,213,748,786,175
2006,Rural,Rajasthan,Property Crime,Arson,Male,0-12,449,274,175,346,103
2010,Rural,Sikkim,Property Crime,Arson,Female,13-17,5152,4843,309,4946,206
2001,Urban,Maharashtra,Crime Against Women,Rape,Male,13-17,8854,3056,5798,3796,5058
2001,Urban,Kerala,Crime Against Children,Trafficking,Female,13-17,3258,2021,1237,2971,287
2001,Rural,Nagaland,Crime Against Children,Kidnapping,Male,46-60,8913,2571,6342,5146,3767
2002,Urban,Karnataka,Crime Against Women,Dowry Deaths,Male,0-12,2210,957,1253,1839,371
2002,Rural,Gujarat,Property Crime,Theft,Male,46-60,6788,2450,4338,5230,1558
2006,Urban,Jharkhand,Crime Against Women,Dowry Deaths,Male,13-17,7252,3930,3322,4331,2921
2002,Urban,Bihar,Property Crime,Vandalism,Female,31-45,3725,3367,358,3555,170
2008,Urban,Andhra Pradesh,Property Crime,Vandalism,Male,60+,2192,1364,828,1761,431
2001,Rural,Chhattisgarh,Crime Against Women,Domestic Violence,Male,0-12,7711,3298,4413,6008,1703
2005,Rural,Jammu & Kashmir,Crime Against Women,Molestation,Female,46-60,7501,6756,745,7468,33
2001,Urban,Madhya Pradesh,Other Crimes,Corruption,Female,18-30,9334,7120,2214,7628,1706
2009,Urban,Karnataka,Crime Against Children,Trafficking,Male,46-60,56,52,4,52,4
2003,Rural,Jharkhand,Crime Against Women,Molestation,Female,0-12,1598,408,1190,1090,508
2010,Urban,Assam,Other Crimes,Corruption,Female,31-45,9779,8125,1654,9080,699
2008,Urban,Delhi,Crime Against Children,Kidnapping,Female,46-60,2263,166,2097,856,1407
2005,Urban,Uttar Pradesh,Crime Against Women,Molestation,Male,0-12,8595,2016,6579,2205,6390
2002,Rural,Karnataka,Crime Against Women,Domestic Violence,Male,46-60,9799,2495,7304,6123,3676
2003,Rural,Tamil Nadu,Other Crimes,Corruption,Male,18-30,9699,2008,7691,7349,2350
2005,Rural,Nagaland,Property Crime,Arson,Male,46-60,2896,2466,430,2736,160
2002,Urban,Gujarat,Other Crimes,Fraud,Female,46-60,591,34,557,75,516
2003,Urban,Jharkhand,Crime Against Women,Rape,Female,13-17,904,484,420,899,5
2003,Rural,Manipur,Other Crimes,Corruption,Female,31-45,8078,5722,2356,7935,143
2007,Urban,Tamil Nadu,Other Crimes,Fraud,Female,13-17,3050,1058,1992,1213,1837
2002,Urban,Kerala,Property Crime,Theft,Male,0-12,2524,1342,1182,1910,614
2002,Urban,Manipur,Other Crimes,Cyber Crime,Female,13-17,953,335,618,445,508
2004,Urban,Andhra Pradesh,Crime Against Children,Trafficking,Male,0-12,4942,158,4784,3278,1664
2009,Rural,Madhya Pradesh,Crime Against Women,Molestation,Male,46-60,6666,5516,1150,6283,383
2001,Urban,Himachal Pradesh,Other Crimes,Corruption,Female,18-30,8246,1160,7086,1256,6990
2006,Rural,Rajasthan,Crime Against Women,Dowry Deaths,Female,0-12,6029,1151,4878,2361,3668
2006,Rural,Gujarat,Crime Against Women,Dowry Deaths,Female,46-60,5051,924,4127,2646,2405
2007,Urban,Bihar,Crime Against Children,Trafficking,Female,18-30,9863,4220,5643,5393,4470
2005,Urban,Telangana,Property Crime,Burglary,Male,31-45,6834,3215,3619,3243,3591
2006,Rural,Manipur,Crime Against Men,Robbery,Female,31-45,4880,2634,2246,4645,235
2002,Rural,Chhattisgarh,Property Crime,Theft,Female,31-45,4498,1070,3428,1194,3304
2008,Rural,Delhi,Property Crime,Vandalism,Male,18-30,561,431,130,473,88
2005,Rural,Haryana,Crime Against Children,Child Abuse,Female,13-17,8822,4613,4209,7256,1566
2002,Rural,West Bengal,Crime Against Men,Assault,Male,46-60,6852,560,6292,766,6086
2007,Urban,Nagaland,Crime Against Men,Assault,Male,13-17,427,74,353,128,299
2005,Urban,West Bengal,Property Crime,Theft,Male,60+,552,95,457,253,299
2010,Rural,Gujarat,Other Crimes,Fraud,Male,31-45,4345,3987,358,4182,163
2010,Rural,Bihar,Property Crime,Theft,Female,31-45,461,315,146,350,111
2004,Rural,Madhya Pradesh,Crime Against Women,Rape,Female,46-60,2157,1058,1099,1138,1019
2002,Rural,Jammu & Kashmir,Crime Against Children,Child Labor,Male,31-45,9182,8640,542,9129,53
2004,Rural,Meghalaya,Property Crime,Theft,Male,18-30,7293,5963,1330,6950,343
2005,Rural,Bihar,Crime Against Children,Child Abuse,Male,60+,9174,1966,7208,3245,5929
2007,Urban,Jharkhand,Crime Against Men,Robbery,Male,0-12,8018,3406,4612,5202,2816
2006,Rural,Andhra Pradesh,Other Crimes,Fraud,Male,0-12,4140,3269,871,3568,572
2007,Urban,Karnataka,Crime Against Men,Extortion,Male,18-30,2563,2335,228,2472,91
2005,Rural,Arunachal Pradesh,Other Crimes,Corruption,Female,0-12,3089,2799,290,2948,141
2003,Rural,Jammu & Kashmir,Property Crime,Theft,Male,13-17,7430,1185,6245,4067,3363
2006,Urban,Mizoram,Property Crime,Arson,Female,31-45,9795,1824,7971,5457,4338
2008,Rural,Kerala,Other Crimes,Cyber Crime,Male,60+,4356,1121,3235,2183,2173
2001,Urban,Himachal Pradesh,Other Crimes,Cyber Crime,Female,13-17,9168,8477,691,9129,39
2006,Rural,Uttarakhand,Property Crime,Theft,Male,13-17,4851,2776,2075,3106,1745
2001,Rural,Meghalaya,Crime Against Children,Child Abuse,Female,18-30,6079,1815,4264,4919,1160
2007,Urban,Odisha,Other Crimes,Corruption,Male,0-12,7100,4293,2807,4752,2348
2008,Rural,Haryana,Crime Against Men,Robbery,Female,60+,3641,3311,330,3342,299
2001,Urban,Andhra Pradesh,Crime Against Children,Trafficking,Male,0-12,1226,942,284,1193,33
2003,Rural,Telangana,Crime Against Women,Rape,Female,13-17,5828,2805,3023,3807,2021
2010,Rural,Bihar,Property Crime,Burglary,Male,0-12,452,316,136,342,110
2009,Urban,Assam,Crime Against Men,Assault,Female,18-30,9942,2231,7711,9305,637
2010,Urban,Arunachal Pradesh,Crime Against Children,Trafficking,Male,60+,3161,832,2329,2523,638
2004,Rural,Delhi,Property Crime,Arson,Female,60+,6914,26,6888,5124,1790
2004,Urban,Karnataka,Crime Against Women,Domestic Violence,Female,31-45,5831,554,5277,5096,735
2007,Urban,West Bengal,Crime Against Women,Molestation,Female,0-12,7406,7015,391,7228,178
2002,Rural,Odisha,Crime Against Men,Robbery,Female,31-45,3462,948,2514,2973,489
2004,Urban,Sikkim,Crime Against Men,Robbery,Female,31-45,5390,4238,1152,4584,806
2003,Rural,Assam,Property Crime,Vandalism,Male,13-17,7340,4457,2883,7248,92
2001,Urban,West Bengal,Property Crime,Vandalism,Female,18-30,2240,1722,518,1810,430
2003,Rural,Jharkhand,Crime Against Women,Rape,Male,46-60,8903,6057,2846,6248,2655
2010,Rural,Telangana,Other Crimes,Cyber Crime,Male,31-45,4802,1331,3471,1873,2929
2008,Rural,Madhya Pradesh,Property Crime,Theft,Female,18-30,1681,235,1446,552,1129
2005,Rural,West Bengal,Other Crimes,Drug Offense,Female,0-12,9179,7117,2062,7707,1472
2008,Urban,Jammu & Kashmir,Other Crimes,Fraud,Female,0-12,5879,16,5863,3540,2339
2006,Urban,Tripura,Crime Against Women,Rape,Male,31-45,4203,887,3316,2267,1936
2007,Urban,Mizoram,Property Crime,Vandalism,Male,31-45,5830,4113,1717,4427,1403
2003,Urban,Meghalaya,Crime Against Children,Trafficking,Female,46-60,4130,2268,1862,3575,555
2007,Urban,Karnataka,Crime Against Men,Robbery,Male,31-45,6311,726,5585,3209,3102
2008,Urban,Odisha,Crime Against Women,Rape,Male,46-60,4535,2690,1845,3116,1419
2005,Urban,Kerala,Crime Against Children,Kidnapping,Female,31-45,4744,1691,3053,2586,2158
2010,Urban,Rajasthan,Property Crime,Theft,Male,0-12,8050,3961,4089,7271,779
2008,Urban,Gujarat,Crime Against Children,Trafficking,Female,31-45,8718,665,8053,1862,6856
2005,Rural,Goa,Other Crimes,Corruption,Female,13-17,8420,3992,4428,7793,627
2007,Urban,Jammu & Kashmir,Crime Against Children,Kidnapping,Female,0-12,1526,972,554,1144,382
2008,Urban,Sikkim,Crime Against Women,Rape,Male,60+,4880,3478,1402,4611,269
2010,Urban,West Bengal,Crime Against Men,Extortion,Female,46-60,9731,8354,1377,8744,987
2004,Rural,Meghalaya,Crime Against Men,Extortion,Male,46-60,6254,5776,478,5827,427
2003,Rural,Goa,Crime Against Children,Child Labor,Male,0-12,3345,3023,322,3238,107
2005,Rural,Madhya Pradesh,Crime Against Children,Kidnapping,Male,31-45,8562,6033,2529,7169,1393
2006,Rural,Tripura,Crime Against Children,Child Labor,Male,18-30,2827,625,2202,2439,388
2008,Rural,Jammu & Kashmir,Property Crime,Arson,Male,0-12,6862,3149,3713,4684,2178
2004,Rural,Andhra Pradesh,Other Crimes,Cyber Crime,Female,31-45,6310,5869,441,6304,6
2005,Rural,Manipur,Crime Against Women,Rape,Female,46-60,4306,3978,328,4076,230
2005,Urban,Madhya Pradesh,Crime Against Men,Extortion,Female,0-12,3152,793,2359,2706,446
2002,Urban,Haryana,Other Crimes,Cyber Crime,Male,60+,3665,1864,1801,2873,792
2009,Urban,Arunachal Pradesh,Crime Against Men,Assault,Female,18-30,9625,5611,4014,8030,1595
2010,Urban,Assam,Property Crime,Theft,Male,60+,5342,1853,3489,2066,3276
2002,Urban,Karnataka,Crime Against Men,Robbery,Male,13-17,2468,1418,1050,1912,556
2006,Rural,Meghalaya,Crime Against Men,Murder,Female,46-60,7988,4783,3205,6686,1302
2009,Urban,West Bengal,Crime Against Women,Rape,Male,0-12,4231,2551,1680,3031,1200
2007,Urban,Uttar Pradesh,Crime Against Men,Assault,Female,0-12,8965,936,8029,8456,509
2006,Urban,Tamil Nadu,Crime Against Children,Child Labor,Male,60+,1350,685,665,739,611
2003,Urban,Mizoram,Crime Against Children,Kidnapping,Female,0-12,6685,1189,5496,5287,1398
2002,Rural,Arunachal Pradesh,Crime Against Men,Murder,Female,18-30,7369,1453,5916,7051,318
2008,Urban,Nagaland,Crime Against Women,Rape,Male,31-45,8366,2181,6185,6204,2162
2006,Rural,Uttar Pradesh,Property Crime,Burglary,Female,0-12,2519,1095,1424,1222,1297
2002,Urban,Telangana,Crime Against Children,Trafficking,Male,31-45,1362,643,719,1213,149
2002,Rural,Arunachal Pradesh,Crime Against Men,Assault,Male,46-60,6209,4226,1983,4489,1720
2002,Rural,Goa,Other Crimes,Cyber Crime,Male,60+,312,145,167,156,156
2004,Urban,Himachal Pradesh,Crime Against Men,Assault,Female,18-30,8313,3986,4327,7842,471
2005,Rural,Maharashtra,Crime Against Children,Trafficking,Female,13-17,7483,2521,4962,4905,2578
2002,Urban,Bihar,Crime Against Children,Child Abuse,Female,46-60,2832,1756,1076,2132,700
2009,Rural,Madhya Pradesh,Crime Against Children,Child Abuse,Male,31-45,9745,1547,8198,4890,4855
2003,Urban,Jharkhand,Crime Against Children,Kidnapping,Male,13-17,631,188,443,240,391
2004,Urban,Delhi,Crime Against Men,Extortion,Male,0-12,3663,959,2704,964,2699
2006,Urban,Meghalaya,Property Crime,Burglary,Male,60+,1833,1646,187,1702,131
2007,Urban,Telangana,Property Crime,Arson,Female,13-17,6466,4123,2343,5874,592
2008,Urban,Karnataka,Crime Against Men,Assault,Male,46-60,3663,2836,827,3382,281
2006,Rural,Haryana,Crime Against Women,Domestic Violence,Female,60+,3574,2646,928,3365,209
2008,Urban,Odisha,Crime Against Men,Assault,Female,18-30,1150,870,280,946,204
2003,Urban,Assam,Other Crimes,Cyber Crime,Male,18-30,8350,4417,3933,6626,1724
2010,Urban,Tripura,Crime Against Children,Trafficking,Male,60+,5554,1097,4457,2240,3314
2005,Urban,Uttar Pradesh,Other Crimes,Corruption,Male,13-17,6053,1737,4316,3250,2803
2002,Rural,Mizoram,Other Crimes,Corruption,Male,31-45,1172,633,539,826,346
2001,Rural,Nagaland,Property Crime,Burglary,Male,46-60,6163,3569,2594,4119,2044
2007,Urban,Nagaland,Property Crime,Burglary,Female,13-17,5479,3824,1655,3930,1549
2003,Rural,Mizoram,Property Crime,Burglary,Female,60+,7643,724,6919,911,6732
2008,Urban,Tripura,Crime Against Children,Child Labor,Male,13-17,8264,2472,5792,6209,2055
2004,Urban,Himachal Pradesh,Crime Against Women,Dowry Deaths,Male,18-30,2144,677,1467,1018,1126
2005,Rural,Assam,Crime Against Women,Rape,Female,0-12,404,303,101,303,101
2003,Rural,Sikkim,Crime Against Women,Molestation,Female,46-60,7511,1878,5633,7012,499
2006,Rural,Manipur,Property Crime,Theft,Female,13-17,4556,2075,2481,4092,464
2006,Urban,Jammu & Kashmir,Crime Against Women,Molestation,Female,31-45,8805,5595,3210,7852,953
2005,Urban,Andhra Pradesh,Crime Against Women,Molestation,Male,60+,4351,509,3842,1551,2800
2010,Rural,Andhra Pradesh,Property Crime,Theft,Male,0-12,307,197,110,239,68
2008,Urban,Bihar,Property Crime,Burglary,Female,60+,6907,6448,459,6584,323
2002,Rural,West Bengal,Crime Against Women,Domestic Violence,Female,60+,4052,1767,2285,2722,1330
2005,Rural,Rajasthan,Other Crimes,Fraud,Female,18-30,2948,1784,1164,1960,988
2010,Urban,Chhattisgarh,Other Crimes,Drug Offense,Male,0-12,5668,2289,3379,3557,2111
2007,Urban,Uttar Pradesh,Crime Against Men,Robbery,Male,46-60,7189,1836,5353,5974,1215
2007,Rural,Uttar Pradesh,Crime Against Men,Robbery,Female,46-60,6182,3926,2256,5787,395
2008,Rural,Kerala,Crime Against Women,Domestic Violence,Male,46-60,6407,3707,2700,5913,494
2003,Urban,Meghalaya,Crime Against Women,Dowry Deaths,Male,46-60,8687,4031,4656,5457,3230
2005,Urban,Rajasthan,Other Crimes,Drug Offense,Female,13-17,6075,4117,1958,4980,1095
2006,Rural,Tripura,Crime Against Men,Assault,Male,18-30,1450,260,1190,1314,136
2007,Urban,Chhattisgarh,Property Crime,Theft,Female,13-17,7736,2068,5668,5157,2579
2001,Rural,Nagaland,Crime Against Children,Child Abuse,Male,46-60,9371,2820,6551,5885,3486
2001,Urban,Sikkim,Crime Against Men,Extortion,Male,13-17,6895,1330,5565,5799,1096
2006,Rural,Nagaland,Crime Against Children,Trafficking,Female,60+,8924,1592,7332,1980,6944
2004,Urban,Tamil Nadu,Property Crime,Burglary,Female,18-30,1062,245,817,806,256
2005,Rural,Haryana,Crime Against Men,Murder,Male,0-12,357,13,344,91,266
2003,Urban,Meghalaya,Crime Against Children,Trafficking,Male,31-45,2864,1641,1223,2203,661
2002,Urban,Himachal Pradesh,Crime Against Women,Domestic Violence,Male,13-17,9876,6333,3543,7863,2013
2002,Rural,Jharkhand,Other Crimes,Fraud,Male,13-17,7525,4502,3023,6115,1410
2005,Urban,Haryana,Property Crime,Burglary,Male,60+,1130,315,815,1032,98
2003,Urban,Rajasthan,Property Crime,Theft,Male,13-17,4431,680,3751,3898,533
2003,Urban,Manipur,Crime Against Children,Kidnapping,Female,0-12,9330,794,8536,8421,909
2008,Rural,Tamil Nadu,Other Crimes,Fraud,Male,46-60,4276,3287,989,3601,675
2001,Rural,Bihar,Crime Against Women,Rape,Male,18-30,3205,1687,1518,3103,102
2006,Urban,West Bengal,Property Crime,Vandalism,Male,46-60,4979,1903,3076,3341,1638
2009,Urban,Sikkim,Crime Against Women,Rape,Male,0-12,9024,507,8517,6379,2645
2003,Rural,Andhra Pradesh,Crime Against Women,Domestic Violence,Female,13-17,5296,3322,1974,3463,1833
2003,Urban,Himachal Pradesh,Property Crime,Arson,Male,0-12,339,315,24,334,5
2007,Rural,Meghalaya,Other Crimes,Drug Offense,Male,0-12,2606,459,2147,2211,395
2006,Urban,Delhi,Other Crimes,Corruption,Female,0-12,8179,3923,4256,5679,2500
2010,Rural,Telangana,Crime Against Children,Child Abuse,Female,46-60,6473,2293,4180,5151,1322
2001,Urban,Andhra Pradesh,Crime Against Children,Child Abuse,Male,18-30,9423,8554,869,8664,759
2001,Rural,Haryana,Other Crimes,Corruption,Female,13-17,5210,1293,3917,2042,3168
2008,Rural,Gujarat,Crime Against Women,Dowry Deaths,Male,46-60,6733,680,6053,5556,1177
2006,Urban,Jharkhand,Property Crime,Arson,Female,60+,6559,947,5612,1494,5065
2005,Rural,Madhya Pradesh,Crime Against Men,Assault,Female,60+,4405,4206,199,4240,165
2003,Urban,Nagaland,Crime Against Children,Child Abuse,Female,0-12,7957,2145,5812,3113,4844
2002,Urban,Rajasthan,Crime Against Men,Murder,Female,46-60,7326,5438,1888,5965,1361
2009,Urban,Punjab,Other Crimes,Cyber Crime,Male,0-12,5679,4114,1565,5181,498
2010,Urban,Delhi,Crime Against Men,Assault,Female,13-17,6339,6297,42,6333,6
2003,Urban,Delhi,Crime Against Men,Assault,Male,46-60,7610,3316,4294,5717,1893
2006,Rural,Andhra Pradesh,Property Crime,Theft,Male,13-17,6060,4099,1961,4534,1526
2004,Rural,Andhra Pradesh,Property Crime,Arson,Female,60+,4328,947,3381,3126,1202
2004,Urban,Telangana,Crime Against Women,Molestation,Female,0-12,8473,1357,7116,2478,5995
2006,Rural,Tripura,Other Crimes,Corruption,Female,60+,7220,128,7092,982,6238
2002,Rural,Jammu & Kashmir,Other Crimes,Corruption,Female,60+,1881,850,1031,1692,189
2001,Urban,Delhi,Crime Against Men,Murder,Female,31-45,599,484,115,486,113
2005,Urban,Gujarat,Crime Against Women,Dowry Deaths,Male,46-60,4276,4172,104,4268,8
2009,Urban,Tripura,Property Crime,Vandalism,Male,0-12,6041,5122,919,5480,561
2009,Urban,Jharkhand,Crime Against Men,Robbery,Female,13-17,3105,681,2424,2433,672
2006,Rural,Maharashtra,Crime Against Men,Extortion,Male,60+,4863,3706,1157,3981,882
2010,Rural,Punjab,Property Crime,Theft,Female,31-45,8682,1329,7353,2666,6016
2003,Urban,Goa,Crime Against Children,Child Abuse,Female,13-17,7408,3254,4154,6933,475
2002,Urban,Jharkhand,Other Crimes,Drug Offense,Female,18-30,7076,3235,3841,6331,745
2003,Rural,Uttarakhand,Crime Against Children,Child Labor,Male,31-45,2027,876,1151,1214,813
2001,Rural,Kerala,Crime Against Men,Murder,Female,60+,8311,8104,207,8269,42
2005,Rural,Kerala,Other Crimes,Fraud,Female,0-12,8719,3084,5635,3871,4848
2001,Rural,Maharashtra,Other Crimes,Corruption,Female,60+,2837,1804,1033,2255,582
2004,Urban,Maharashtra,Crime Against Women,Dowry Deaths,Male,0-12,8925,5947,2978,5959,2966
2009,Rural,Punjab,Other Crimes,Fraud,Female,60+,248,38,210,96,152
2001,Rural,Manipur,Other Crimes,Fraud,Male,60+,1695,103,1592,252,1443
2001,Urban,Meghalaya,Other Crimes,Drug Offense,Male,60+,7148,4426,2722,6641,507
2007,Rural,Himachal Pradesh,Other Crimes,Drug Offense,Female,46-60,1368,793,575,910,458
2005,Rural,Uttar Pradesh,Other Crimes,Drug Offense,Male,46-60,401,51,350,156,245
2004,Urban,Madhya Pradesh,Crime Against Children,Child Labor,Male,46-60,352,81,271,306,46
2010,Urban,Delhi,Crime Against Women,Dowry Deaths,Female,31-45,6538,2453,4085,3123,3415
2004,Urban,Haryana,Crime Against Women,Rape,Male,0-12,9237,7504,1733,8126,1111
2003,Urban,Rajasthan,Property Crime,Vandalism,Male,46-60,7801,1590,6211,2480,5321
2003,Urban,Punjab,Property Crime,Vandalism,Female,13-17,2622,1484,1138,2021,601
2008,Rural,West Bengal,Crime Against Men,Robbery,Female,31-45,9998,2005,7993,9833,165
2002,Urban,Rajasthan,Crime Against Men,Robbery,Female,18-30,1520,1424,96,1488,32
2008,Rural,Rajasthan,Property Crime,Theft,Male,31-45,8408,4277,4131,4601,3807
2002,Rural,Gujarat,Other Crimes,Corruption,Female,13-17,480,378,102,438,42
2002,Rural,Jammu & Kashmir,Crime Against Children,Child Labor,Male,46-60,243,15,228,114,129
2007,Urban,Jharkhand,Crime Against Women,Molestation,Female,13-17,8698,3691,5007,7776,922
2001,Rural,Delhi,Crime Against Women,Dowry Deaths,Female,0-12,9009,41,8968,4500,4509
2008,Rural,Sikkim,Crime Against Men,Assault,Male,46-60,3778,3673,105,3682,96
2001,Rural,Meghalaya,Crime Against Children,Kidnapping,Male,31-45,3284,1394,1890,3259,25
2009,Urban,Haryana,Property Crime,Theft,Male,0-12,9420,3534,5886,4205,5215
2002,Rural,Bihar,Property Crime,Vandalism,Male,60+,5681,4231,1450,4608,1073
2009,Rural,Karnataka,Property Crime,Arson,Female,18-30,7308,6869,439,7298,10
2005,Rural,Tripura,Other Crimes,Fraud,Male,0-12,1765,996,769,1473,292
2006,Rural,Meghalaya,Crime Against Women,Rape,Male,60+,3155,2811,344,2911,244
2005,Rural,Maharashtra,Crime Against Women,Dowry Deaths,Female,60+,9173,5670,3503,6826,2347
2001,Rural,Jammu & Kashmir,Other Crimes,Drug Offense,Female,31-45,4339,3576,763,4290,49
2009,Rural,Jharkhand,Crime Against Women,Molestation,Female,31-45,6929,2976,3953,5267,1662
2010,Rural,Uttar Pradesh,Property Crime,Arson,Male,31-45,4483,1644,2839,2236,2247
2005,Urban,Delhi,Crime Against Children,Kidnapping,Female,31-45,3854,1881,1973,2730,1124
2003,Rural,Jammu & Kashmir,Property Crime,Theft,Male,60+,8629,3787,4842,4738,3891
2008,Urban,Jammu & Kashmir,Crime Against Men,Robbery,Female,31-45,8030,7794,236,7890,140
2001,Rural,Andhra Pradesh,Crime Against Children,Kidnapping,Female,60+,2160,1727,433,2105,55
2008,Rural,Gujarat,Crime Against Children,Kidnapping,Female,31-45,8688,8652,36,8657,31
2005,Rural,Tripura,Crime Against Men,Assault,Male,31-45,84,38,46,52,32
2010,Rural,Goa,Property Crime,Vandalism,Female,46-60,1845,1266,579,1341,504
2002,Rural,Arunachal Pradesh,Property Crime,Arson,Female,13-17,2259,1232,1027,1575,684
2006,Urban,Punjab,Crime Against Men,Extortion,Male,60+,4567,4251,316,4343,224
2007,Rural,Nagaland,Crime Against Women,Rape,Male,31-45,733,492,241,530,203
2009,Rural,West Bengal,Crime Against Men,Assault,Female,13-17,9727,8724,1003,9528,199
2007,Urban,Maharashtra,Property Crime,Arson,Male,46-60,5584,5155,429,5442,142
2007,Urban,Punjab,Crime Against Children,Child Labor,Female,31-45,6666,4523,2143,5530,1136
2010,Urban,Assam,Property Crime,Burglary,Male,13-17,56,27,29,56,0
2009,Rural,Delhi,Crime Against Men,Assault,Female,18-30,757,732,25,743,14
2002,Urban,Uttar Pradesh,Other Crimes,Fraud,Male,18-30,5142,105,5037,4371,771
2010,Urban,Manipur,Crime Against Women,Domestic Violence,Female,13-17,7260,5493,1767,6842,418
2007,Rural,Telangana,Other Crimes,Fraud,Female,46-60,578,256,322,554,24
2008,Urban,Chhattisgarh,Crime Against Children,Child Abuse,Female,46-60,8759,3682,5077,7587,1172
2004,Rural,Andhra Pradesh,Crime Against Women,Dowry Deaths,Female,46-60,5021,448,4573,610,4411
2006,Rural,Sikkim,Crime Against Men,Robbery,Female,31-45,3350,2878,472,3079,271
2002,Rural,Andhra Pradesh,Other Crimes,Corruption,Male,31-45,5159,3820,1339,4287,872
2002,Rural,Tamil Nadu,Crime Against Men,Assault,Male,60+,3064,31,3033,1568,1496
2010,Urban,Madhya Pradesh,Other Crimes,Fraud,Female,13-17,3471,1286,2185,2897,574
2007,Urban,Goa,Crime Against Children,Kidnapping,Male,18-30,3069,2973,96,3044,25
2010,Urban,Bihar,Crime Against Children,Child Labor,Male,13-17,2263,573,1690,1870,393
2006,Urban,Chhattisgarh,Other Crimes,Corruption,Male,31-45,4823,1797,3026,2120,2703
2006,Urban,Kerala,Other Crimes,Cyber Crime,Male,0-12,6327,1633,4694,4075,2252
2010,Urban,Assam,Crime Against Men,Robbery,Male,60+,8694,2627,6067,6781,1913
2001,Rural,Uttarakhand,Other Crimes,Corruption,Female,31-45,8629,7405,1224,8299,330
2009,Urban,Tamil Nadu,Other Crimes,Fraud,Male,60+,1043,50,993,673,370
2004,Rural,Nagaland,Crime Against Women,Rape,Male,46-60,4643,1003,3640,2269,2374
2001,Urban,Himachal Pradesh,Crime Against Women,Dowry Deaths,Male,31-45,8856,4816,4040,6962,1894
2006,Urban,Mizoram,Crime Against Children,Kidnapping,Male,31-45,5165,2974,2191,4499,666
2001,Urban,Goa,Other Crimes,Fraud,Female,31-45,7053,106,6947,644,6409
2001,Urban,Manipur,Property Crime,Arson,Female,13-17,2136,849,1287,1850,286
2001,Urban,Uttar Pradesh,Crime Against Children,Child Abuse,Female,0-12,2300,2146,154,2197,103
2005,Rural,Maharashtra,Crime Against Men,Murder,Female,46-60,442,61,381,265,177
2007,Rural,Arunachal Pradesh,Crime Against Children,Child Abuse,Female,0-12,9283,114,9169,5669,3614
2003,Urban,Rajasthan,Other Crimes,Cyber Crime,Female,46-60,6865,670,6195,1780,5085
2007,Rural,Haryana,Crime Against Men,Robbery,Male,31-45,6174,2641,3533,4255,1919
2009,Rural,West Bengal,Crime Against Children,Child Abuse,Male,46-60,9542,4665,4877,8281,1261
2008,Rural,Chhattisgarh,Property Crime,Arson,Male,18-30,7731,7298,433,7358,373
2004,Urban,Uttarakhand,Property Crime,Vandalism,Female,13-17,8873,3063,5810,8594,279
2010,Rural,Manipur,Other Crimes,Cyber Crime,Female,60+,3360,1734,1626,1875,1485
2004,Rural,Himachal Pradesh,Crime Against Women,Dowry Deaths,Female,46-60,2320,644,1676,911,1409
2003,Urban,Arunachal Pradesh,Crime Against Children,Trafficking,Male,60+,4339,3481,858,3678,661
2008,Rural,Delhi,Property Crime,Arson,Male,60+,9502,4665,4837,8544,958
2002,Rural,Haryana,Crime Against Children,Child Abuse,Male,13-17,821,675,146,697,124
2003,Rural,Manipur,Other Crimes,Drug Offense,Male,18-30,8306,7455,851,7713,593
2008,Urban,Jammu & Kashmir,Crime Against Children,Kidnapping,Female,31-45,9478,5613,3865,9228,250
2006,Rural,Arunachal Pradesh,Property Crime,Burglary,Female,13-17,7974,1283,6691,6889,1085
2001,Rural,Madhya Pradesh,Crime Against Women,Molestation,Female,18-30,8548,992,7556,1028,7520
2010,Rural,Karnataka,Other Crimes,Drug Offense,Female,18-30,8367,1936,6431,2504,5863
2001,Urban,Bihar,Other Crimes,Corruption,Male,18-30,5014,254,4760,639,4375
2006,Urban,Jammu & Kashmir,Crime Against Children,Kidnapping,Female,31-45,193,116,77,188,5
2003,Urban,Bihar,Other Crimes,Cyber Crime,Female,31-45,3460,2150,1310,2768,692
2002,Urban,West Bengal,Crime Against Men,Extortion,Male,31-45,8511,477,8034,2060,6451
2002,Rural,Madhya Pradesh,Crime Against Children,Child Abuse,Female,18-30,4304,2436,1868,2900,1404
2005,Rural,Tamil Nadu,Crime Against Men,Robbery,Female,0-12,8354,3617,4737,4196,4158
2001,Rural,Jharkhand,Crime Against Children,Trafficking,Male,31-45,5864,4476,1388,4590,1274
2001,Urban,Andhra Pradesh,Crime Against Children,Kidnapping,Female,46-60,235,137,98,235,0
2004,Urban,Uttarakhand,Crime Against Children,Child Abuse,Male,60+,8998,208,8790,5226,3772
2001,Rural,Punjab,Other Crimes,Corruption,Male,46-60,1304,985,319,1143,161
2008,Urban,Andhra Pradesh,Property Crime,Theft,Female,46-60,1789,1265,524,1634,155
2005,Urban,Mizoram,Crime Against Men,Assault,Female,31-45,8658,7127,1531,8391,267
2007,Urban,Tamil Nadu,Property Crime,Theft,Female,13-17,1279,275,1004,611,668
2002,Urban,Haryana,Other Crimes,Fraud,Male,46-60,6546,3839,2707,4607,1939
2001,Urban,Rajasthan,Crime Against Women,Dowry Deaths,Male,13-17,6893,2827,4066,4254,2639
2007,Urban,Mizoram,Other Crimes,Cyber Crime,Female,60+,3860,2759,1101,3828,32
2003,Rural,Bihar,Crime Against Women,Domestic Violence,Female,60+,7045,4130,2915,6670,375
2007,Urban,Jharkhand,Other Crimes,Drug Offense,Male,13-17,107,49,58,101,6
2005,Urban,Jharkhand,Crime Against Children,Kidnapping,Female,31-45,1265,370,895,501,764
2008,Rural,Madhya Pradesh,Other Crimes,Cyber Crime,Male,18-30,195,48,147,67,128
2006,Rural,Tamil Nadu,Other Crimes,Corruption,Male,46-60,2115,313,1802,1646,469
2001,Urban,Manipur,Other Crimes,Fraud,Female,0-12,4652,1702,2950,3344,1308
2002,Rural,Uttarakhand,Crime Against Children,Child Abuse,Male,46-60,1163,266,897,966,197
2010,Urban,Madhya Pradesh,Crime Against Women,Molestation,Female,0-12,6501,1434,5067,5836,665
2003,Rural,Haryana,Property Crime,Arson,Male,13-17,6702,814,5888,6626,76
2001,Urban,Rajasthan,Crime Against Children,Kidnapping,Female,0-12,1406,663,743,665,741
2004,Rural,Delhi,Crime Against Men,Robbery,Male,31-45,848,188,660,372,476
2003,Rural,Rajasthan,Crime Against Men,Robbery,Female,18-30,126,34,92,114,12
2010,Rural,Telangana,Property Crime,Vandalism,Male,0-12,4799,2154,2645,2849,1950
2002,Rural,Jammu & Kashmir,Property Crime,Vandalism,Female,60+,5066,944,4122,2280,2786
2007,Rural,Kerala,Crime Against Women,Rape,Female,0-12,5025,923,4102,3245,1780
2005,Urban,Telangana,Crime Against Men,Extortion,Female,13-17,472,251,221,424,48
2003,Rural,Delhi,Property Crime,Arson,Female,13-17,5633,2700,2933,3225,2408
2002,Urban,Andhra Pradesh,Crime Against Children,Kidnapping,Male,60+,6229,2128,4101,3258,2971
2002,Urban,Uttarakhand,Other Crimes,Cyber Crime,Male,46-60,4698,2627,2071,4067,631
2005,Urban,Sikkim,Other Crimes,Cyber Crime,Female,60+,9771,3993,5778,9099,672
2001,Rural,Himachal Pradesh,Crime Against Men,Murder,Male,46-60,1473,1275,198,1346,127
2009,Urban,Karnataka,Crime Against Children,Child Labor,Male,46-60,5175,379,4796,2439,2736
2007,Urban,Manipur,Crime Against Women,Rape,Male,46-60,8149,1022,7127,8015,134
2006,Rural,Nagaland,Crime Against Women,Domestic Violence,Female,18-30,4877,3482,1395,3696,1181
2003,Rural,Rajasthan,Other Crimes,Fraud,Female,31-45,2774,960,1814,2740,34
2006,Urban,Chhattisgarh,Property Crime,Vandalism,Female,0-12,4624,914,3710,1031,3593
2005,Rural,Himachal Pradesh,Property Crime,Theft,Female,13-17,1710,342,1368,1626,84
2003,Rural,Jharkhand,Property Crime,Arson,Female,31-45,8170,5646,2524,6018,2152
2006,Rural,Karnataka,Property Crime,Vandalism,Male,31-45,6550,6539,11,6541,9
2004,Rural,Tripura,Crime Against Women,Dowry Deaths,Male,0-12,1769,303,1466,1559,210
2005,Rural,Uttar Pradesh,Property Crime,Theft,Female,46-60,453,195,258,306,147
2003,Rural,Andhra Pradesh,Other Crimes,Drug Offense,Female,31-45,4948,494,4454,4082,866
2009,Urban,Mizoram,Other Crimes,Cyber Crime,Male,60+,4194,179,4015,1184,3010
2004,Rural,Jharkhand,Crime Against Men,Murder,Female,0-12,4104,1174,2930,2763,1341
2007,Urban,Odisha,Crime Against Men,Extortion,Female,60+,6485,1561,4924,1899,4586
2004,Rural,Meghalaya,Crime Against Women,Dowry Deaths,Male,13-17,3919,2773,1146,3213,706
2005,Urban,Mizoram,Other Crimes,Corruption,Male,0-12,8884,3336,5548,7649,1235
2006,Rural,Manipur,Crime Against Children,Child Abuse,Female,46-60,6027,3776,2251,4564,1463
2007,Rural,Maharashtra,Crime Against Men,Assault,Female,60+,5773,916,4857,2358,3415
2002,Rural,Jharkhand,Property Crime,Burglary,Female,60+,8078,1806,6272,7655,423
2008,Urban,Tripura,Crime Against Women,Rape,Male,0-12,6374,6104,270,6208,166
2005,Rural,Gujarat,Crime Against Children,Trafficking,Male,60+,6576,5136,1440,5864,712
2009,Urban,Meghalaya,Crime Against Women,Dowry Deaths,Female,0-12,6722,2836,3886,4111,2611
2007,Rural,Goa,Crime Against Women,Domestic Violence,Female,0-12,7866,7330,536,7659,207
2005,Rural,Tripura,Property Crime,Vandalism,Male,46-60,8581,5862,2719,8580,1
2009,Urban,Karnataka,Property Crime,Vandalism,Female,0-12,8892,4377,4515,7028,1864
2002,Urban,Nagaland,Crime Against Children,Trafficking,Female,60+,379,128,251,201,178
2008,Rural,Gujarat,Property Crime,Burglary,Male,0-12,6845,2045,4800,3587,3258
2009,Urban,Delhi,Other Crimes,Cyber Crime,Female,13-17,8437,6230,2207,7641,796
2003,Rural,Rajasthan,Property Crime,Vandalism,Female,46-60,9395,7061,2334,7175,2220
2010,Rural,Himachal Pradesh,Crime Against Children,Child Labor,Female,46-60,3930,1204,2726,2378,1552
2009,Urban,Arunachal Pradesh,Crime Against Women,Molestation,Female,18-30,4594,3282,1312,4509,85
2009,Urban,Arunachal Pradesh,Crime Against Men,Robbery,Male,13-17,2703,1789,914,2683,20
2002,Rural,Mizoram,Property Crime,Burglary,Male,31-45,4329,1295,3034,2868,1461
2004,Urban,Andhra Pradesh,Crime Against Women,Dowry Deaths,Female,60+,6567,6025,542,6557,10
2001,Rural,West Bengal,Crime Against Children,Kidnapping,Male,31-45,7924,848,7076,1454,6470
2003,Rural,Madhya Pradesh,Crime Against Women,Molestation,Male,46-60,6398,256,6142,1071,5327
2010,Urban,Himachal Pradesh,Property Crime,Arson,Male,18-30,4229,154,4075,425,3804
2007,Rural,Gujarat,Property Crime,Vandalism,Female,46-60,8231,2586,5645,5236,2995
2009,Rural,Telangana,Crime Against Children,Child Labor,Male,46-60,650,565,85,589,61
2005,Rural,Maharashtra,Crime Against Men,Assault,Male,18-30,5210,636,4574,4546,664
2008,Urban,Maharashtra,Other Crimes,Cyber Crime,Female,46-60,1899,218,1681,814,1085
2003,Rural,Meghalaya,Other Crimes,Drug Offense,Male,18-30,5401,1213,4188,4195,1206
2005,Urban,Gujarat,Other Crimes,Drug Offense,Male,0-12,8495,1374,7121,7770,725
2010,Rural,Andhra Pradesh,Property Crime,Arson,Male,31-45,3036,2763,273,2828,208
2002,Rural,Manipur,Crime Against Men,Extortion,Male,60+,1047,176,871,1031,16
2009,Urban,Jammu & Kashmir,Crime Against Children,Child Labor,Male,18-30,9283,7914,1369,9100,183
2003,Urban,Nagaland,Crime Against Women,Domestic Violence,Male,18-30,3142,317,2825,817,2325
2006,Rural,Arunachal Pradesh,Crime Against Children,Child Labor,Male,13-17,7156,4742,2414,5651,1505
2001,Rural,Punjab,Crime Against Children,Child Abuse,Male,18-30,8130,1126,7004,7358,772
2009,Rural,Assam,Other Crimes,Drug Offense,Male,60+,5034,1576,3458,1959,3075
2008,Rural,Kerala,Crime Against Children,Child Labor,Female,18-30,8449,6197,2252,8143,306
2010,Urban,Manipur,Crime Against Children,Kidnapping,Male,18-30,6717,2819,3898,2917,3800
2010,Urban,Karnataka,Crime Against Children,Kidnapping,Female,60+,4067,617,3450,3796,271
2003,Rural,Mizoram,Property Crime,Burglary,Male,31-45,3385,2705,680,3262,123
2003,Rural,Delhi,Crime Against Men,Murder,Male,13-17,2836,2631,205,2820,16
2009,Rural,Punjab,Other Crimes,Cyber Crime,Female,31-45,8599,349,8250,7257,1342
2001,Urban,Uttarakhand,Crime Against Women,Dowry Deaths,Female,60+,8274,6624,1650,6866,1408
2003,Urban,Andhra Pradesh,Property Crime,Vandalism,Male,60+,2311,470,1841,1637,674
2006,Urban,Arunachal Pradesh,Crime Against Children,Trafficking,Male,0-12,774,164,610,358,416
2005,Rural,Maharashtra,Other Crimes,Drug Offense,Female,18-30,8220,6165,2055,7299,921
2001,Urban,Assam,Crime Against Men,Murder,Male,60+,2442,1750,692,2083,359
2010,Rural,Karnataka,Crime Against Women,Dowry Deaths,Male,46-60,9278,7058,2220,7929,1349
2003,Rural,Bihar,Crime Against Women,Dowry Deaths,Male,18-30,5241,562,4679,4689,552
2003,Urban,Himachal Pradesh,Property Crime,Arson,Male,18-30,5604,3019,2585,3483,2121
2007,Rural,Bihar,Other Crimes,Drug Offense,Male,31-45,6659,4289,2370,4331,2328
2006,Rural,Tripura,Other Crimes,Drug Offense,Female,31-45,6645,5989,656,6568,77
2005,Rural,Karnataka,Crime Against Children,Child Labor,Female,0-12,7134,833,6301,7114,20
2007,Urban,Uttar Pradesh,Crime Against Children,Child Abuse,Male,0-12,2034,521,1513,1630,404
2005,Urban,Tripura,Property Crime,Theft,Male,46-60,2464,1025,1439,1094,1370
2001,Urban,Gujarat,Crime Against Children,Child Labor,Female,13-17,981,713,268,948,33
2005,Rural,Manipur,Crime Against Men,Murder,Female,13-17,9145,1906,7239,1914,7231
2001,Rural,West Bengal,Property Crime,Burglary,Male,46-60,1721,297,1424,1712,9
2008,Urban,Jharkhand,Crime Against Women,Molestation,Female,0-12,8619,7196,1423,7422,1197
2004,Urban,Punjab,Other Crimes,Corruption,Female,46-60,8619,4960,3659,5836,2783
2005,Rural,Delhi,Other Crimes,Fraud,Male,18-30,7605,2314,5291,6024,1581
2001,Rural,Haryana,Other Crimes,Fraud,Female,18-30,1246,881,365,908,338
2005,Rural,Uttarakhand,Crime Against Women,Domestic Violence,Male,13-17,8627,5487,3140,7894,733
2007,Urban,Jharkhand,Property Crime,Burglary,Female,31-45,3411,1897,1514,2357,1054
2005,Urban,Himachal Pradesh,Property Crime,Vandalism,Female,60+,4803,4343,460,4591,212
2006,Urban,Assam,Other Crimes,Fraud,Male,13-17,4515,2043,2472,3752,763
2009,Urban,Goa,Crime Against Children,Trafficking,Female,0-12,7196,5439,1757,6449,747
2007,Urban,Jammu & Kashmir,Crime Against Children,Child Abuse,Female,18-30,667,195,472,659,8
2006,Urban,Mizoram,Property Crime,Arson,Male,18-30,1501,1064,437,1185,316
2003,Urban,Rajasthan,Property Crime,Arson,Female,46-60,5094,22,5072,1913,3181
2006,Urban,Mizoram,Crime Against Men,Murder,Male,18-30,2529,223,2306,2235,294
2001,Urban,Chhattisgarh,Other Crimes,Corruption,Female,46-60,9500,6109,3391,8735,765
2001,Rural,Tamil Nadu,Other Crimes,Drug Offense,Female,13-17,6070,2,6068,2204,3866
2007,Urban,Uttar Pradesh,Property Crime,Arson,Male,18-30,2516,2342,174,2377,139
2006,Urban,Jammu & Kashmir,Crime Against Women,Domestic Violence,Female,0-12,5334,1809,3525,3096,2238
2001,Urban,Madhya Pradesh,Other Crimes,Cyber Crime,Male,60+,4245,2666,1579,3670,575
2001,Rural,Jammu & Kashmir,Property Crime,Vandalism,Female,60+,7698,4150,3548,6630,1068
2008,Urban,Chhattisgarh,Property Crime,Theft,Female,18-30,3344,3255,89,3300,44
2005,Urban,Maharashtra,Crime Against Children,Child Abuse,Male,60+,867,223,644,796,71
2007,Urban,Andhra Pradesh,Other Crimes,Fraud,Female,18-30,4694,1310,3384,2764,1930
2003,Rural,Meghalaya,Other Crimes,Corruption,Female,0-12,763,139,624,394,369
2006,Urban,Kerala,Crime Against Children,Child Abuse,Female,60+,7063,3162,3901,5666,1397
2007,Rural,Madhya Pradesh,Crime Against Men,Assault,Male,18-30,1216,651,565,1014,202
2003,Rural,West Bengal,Other Crimes,Fraud,Female,13-17,1778,1123,655,1320,458
2005,Rural,Sikkim,Other Crimes,Fraud,Female,60+,4174,2289,1885,2810,1364
2003,Rural,Meghalaya,Crime Against Men,Extortion,Female,46-60,5778,424,5354,2019,3759
2010,Rural,Andhra Pradesh,Other Crimes,Cyber Crime,Female,60+,4811,245,4566,1802,3009
2009,Rural,Karnataka,Other Crimes,Corruption,Female,46-60,1771,310,1461,1481,290
2004,Urban,Mizoram,Crime Against Men,Assault,Female,13-17,4378,367,4011,899,3479
2010,Urban,Punjab,Other Crimes,Corruption,Female,46-60,2716,1712,1004,1952,764
2009,Rural,Telangana,Crime Against Men,Murder,Female,46-60,6220,4633,1587,5836,384
2001,Rural,Nagaland,Crime Against Men,Murder,Female,46-60,780,18,762,22,758
2007,Rural,Jharkhand,Crime Against Men,Assault,Male,60+,9957,8388,1569,9013,944
2006,Rural,Telangana,Crime Against Men,Robbery,Male,31-45,3967,819,3148,1916,2051
2005,Urban,Bihar,Property Crime,Burglary,Male,13-17,5413,1473,3940,3062,2351
2008,Rural,Andhra Pradesh,Other Crimes,Fraud,Male,18-30,5013,4384,629,4687,326
2008,Urban,Tamil Nadu,Property Crime,Theft,Male,0-12,9137,8081,1056,9121,16
2003,Urban,Andhra Pradesh,Property Crime,Burglary,Female,18-30,2292,1416,876,1599,693
2009,Rural,Delhi,Crime Against Women,Dowry Deaths,Male,13-17,1237,122,1115,608,629
2005,Rural,Assam,Property Crime,Theft,Male,13-17,2932,1035,1897,1271,1661
2009,Urban,Rajasthan,Property Crime,Vandalism,Female,60+,5470,2383,3087,3348,2122
2008,Rural,Gujarat,Property Crime,Arson,Female,0-12,3645,3395,250,3492,153
2006,Rural,Chhattisgarh,Crime Against Men,Robbery,Male,46-60,9043,2667,6376,6756,2287
2009,Urban,Arunachal Pradesh,Property Crime,Burglary,Male,31-45,8892,675,8217,5922,2970
2008,Rural,Mizoram,Crime Against Women,Dowry Deaths,Female,31-45,1027,740,287,1025,2
2010,Urban,Uttar Pradesh,Crime Against Men,Assault,Female,31-45,4922,1709,3213,3345,1577
2005,Rural,Delhi,Property Crime,Burglary,Male,18-30,2838,2472,366,2499,339
2007,Urban,Punjab,Crime Against Children,Child Abuse,Male,13-17,5281,678,4603,2764,2517
2008,Urban,Haryana,Crime Against Men,Murder,Female,0-12,1120,845,275,983,137
2003,Urban,Rajasthan,Crime Against Children,Child Abuse,Male,46-60,5938,5592,346,5717,221
2007,Rural,West Bengal,Property Crime,Burglary,Male,0-12,5107,4244,863,4871,236
2010,Rural,Uttar Pradesh,Crime Against Children,Kidnapping,Female,18-30,4594,1880,2714,2652,1942
2005,Urban,Gujarat,Crime Against Women,Domestic Violence,Female,0-12,9122,3266,5856,8215,907
2008,Rural,Madhya Pradesh,Crime Against Children,Child Labor,Male,46-60,274,93,181,118,156
2004,Urban,Kerala,Other Crimes,Fraud,Male,13-17,4204,1546,2658,3431,773
2010,Urban,Rajasthan,Crime Against Women,Molestation,Female,46-60,9071,4972,4099,7583,1488
2005,Urban,Telangana,Other Crimes,Corruption,Female,13-17,6839,5275,1564,5909,930
2009,Urban,Rajasthan,Crime Against Men,Murder,Male,31-45,1688,934,754,1395,293
2003,Urban,Chhattisgarh,Property Crime,Burglary,Male,31-45,3255,75,3180,1024,2231
2001,Urban,Odisha,Other Crimes,Corruption,Male,0-12,4192,2397,1795,3831,361
2008,Urban,Uttarakhand,Crime Against Women,Dowry Deaths,Male,13-17,7278,247,7031,6771,507
2010,Rural,Kerala,Crime Against Women,Rape,Female,18-30,6391,1713,4678,4819,1572
2010,Rural,Tamil Nadu,Crime Against Women,Rape,Female,60+,1992,1223,769,1432,560
2002,Rural,Telangana,Crime Against Men,Murder,Male,60+,5457,3451,2006,3603,1854
2002,Urban,Nagaland,Crime Against Men,Robbery,Female,60+,5196,3191,2005,3801,1395
2008,Rural,Haryana,Other Crimes,Corruption,Male,18-30,6384,5785,599,5788,596
2003,Rural,Andhra Pradesh,Crime Against Men,Assault,Male,0-12,1837,555,1282,1782,55
2003,Rural,Jharkhand,Property Crime,Theft,Female,13-17,387,191,196,247,140
2008,Rural,Andhra Pradesh,Other Crimes,Drug Offense,Female,60+,1400,495,905,961,439
2009,Rural,Goa,Other Crimes,Cyber Crime,Male,60+,9332,8969,363,9002,330
2005,Urban,Jharkhand,Crime Against Men,Robbery,Female,13-17,9095,6605,2490,7678,1417
2003,Rural,Mizoram,Crime Against Men,Extortion,Male,60+,2749,1415,1334,1793,956
2008,Rural,Odisha,Property Crime,Arson,Male,13-17,6291,2838,3453,4064,2227
2010,Rural,Nagaland,Crime Against Women,Dowry Deaths,Male,13-17,4281,619,3662,2396,1885
2009,Rural,Tripura,Other Crimes,Fraud,Male,0-12,7289,4628,2661,6507,782
2008,Rural,Himachal Pradesh,Crime Against Men,Robbery,Female,46-60,4209,2234,1975,3668,541
2010,Urban,Gujarat,Crime Against Children,Kidnapping,Female,13-17,6431,4222,2209,4669,1762
2009,Urban,Jammu & Kashmir,Crime Against Children,Trafficking,Female,31-45,2984,1796,1188,2816,168
2009,Urban,Uttar Pradesh,Other Crimes,Fraud,Female,13-17,9745,2181,7564,4464,5281
2004,Rural,Tamil Nadu,Crime Against Children,Kidnapping,Male,0-12,1140,338,802,813,327
2009,Urban,Punjab,Crime Against Women,Domestic Violence,Female,18-30,9267,4831,4436,7170,2097
2010,Urban,Uttarakhand,Other Crimes,Cyber Crime,Female,13-17,9222,7412,1810,8438,784
2003,Urban,Kerala,Other Crimes,Drug Offense,Female,46-60,1659,123,1536,630,1029
2009,Rural,Nagaland,Crime Against Women,Molestation,Male,60+,483,125,358,178,305
2009,Urban,Meghalaya,Property Crime,Burglary,Male,46-60,3176,1679,1497,2216,960
2007,Urban,Delhi,Property Crime,Arson,Male,18-30,8727,1781,6946,6856,1871
2008,Rural,Uttar Pradesh,Property Crime,Vandalism,Male,60+,9286,352,8934,5015,4271
2009,Urban,Manipur,Other Crimes,Corruption,Female,46-60,5198,2172,3026,5123,75
2005,Rural,Mizoram,Property Crime,Arson,Male,0-12,4741,4170,571,4427,314
2001,Urban,Uttar Pradesh,Crime Against Children,Child Abuse,Female,60+,6229,450,5779,859,5370
2006,Urban,Madhya Pradesh,Property Crime,Theft,Male,60+,6823,1934,4889,4999,1824
2001,Urban,Tamil Nadu,Other Crimes,Fraud,Female,60+,256,184,72,199,57
2004,Urban,Assam,Property Crime,Vandalism,Female,31-45,1969,1957,12,1962,7
2010,Rural,Manipur,Crime Against Women,Dowry Deaths,Female,13-17,3489,2122,1367,3217,272
2008,Rural,Maharashtra,Crime Against Men,Extortion,Female,31-45,3570,720,2850,1947,1623
2005,Rural,Kerala,Other Crimes,Cyber Crime,Female,31-45,7009,5122,1887,6337,672
2008,Urban,Jharkhand,Other Crimes,Fraud,Male,18-30,9411,2534,6877,7925,1486
2006,Rural,Manipur,Other Crimes,Corruption,Female,46-60,1066,745,321,992,74
2005,Urban,West Bengal,Crime Against Children,Child Abuse,Female,46-60,2239,1894,345,1981,258
2008,Rural,Manipur,Crime Against Women,Rape,Female,31-45,800,598,202,725,75
2001,Urban,Sikkim,Crime Against Men,Robbery,Female,31-45,2048,1984,64,1995,53
2003,Urban,Tripura,Crime Against Men,Murder,Male,18-30,510,288,222,422,88
2005,Rural,Manipur,Crime Against Children,Trafficking,Male,0-12,6921,159,6762,2923,3998
2006,Urban,West Bengal,Other Crimes,Corruption,Male,0-12,7679,288,7391,1830,5849
2005,Rural,Chhattisgarh,Property Crime,Vandalism,Female,13-17,4561,3444,1117,3883,678
2003,Urban,Gujarat,Crime Against Children,Trafficking,Female,31-45,135,127,8,132,3
2007,Urban,Arunachal Pradesh,Crime Against Women,Molestation,Female,60+,5286,776,4510,4546,740
2007,Rural,Telangana,Crime Against Men,Murder,Male,13-17,62,17,45,22,40
2004,Rural,Haryana,Crime Against Women,Molestation,Male,0-12,5205,3191,2014,4682,523
2005,Rural,Tripura,Crime Against Men,Extortion,Female,31-45,3996,466,3530,2657,1339
2009,Urban,Assam,Crime Against Men,Murder,Male,13-17,3315,1570,1745,2402,913
2002,Rural,Andhra Pradesh,Other Crimes,Fraud,Female,31-45,8086,3802,4284,4639,3447
2001,Urban,Tripura,Crime Against Children,Kidnapping,Female,31-45,5204,681,4523,3551,1653
2010,Urban,Odisha,Crime Against Women,Dowry Deaths,Male,13-17,7516,3827,3689,6481,1035
2010,Rural,Meghalaya,Crime Against Women,Domestic Violence,Female,13-17,7690,4281,3409,7497,193
2003,Urban,Andhra Pradesh,Other Crimes,Cyber Crime,Male,18-30,4595,862,3733,3640,955
2008,Rural,Kerala,Crime Against Children,Trafficking,Female,13-17,8420,682,7738,8169,251
2002,Urban,Chhattisgarh,Other Crimes,Fraud,Male,46-60,6965,1003,5962,3580,3385
2010,Rural,Jammu & Kashmir,Other Crimes,Fraud,Male,0-12,4160,2849,1311,3094,1066
2008,Rural,Uttar Pradesh,Crime Against Women,Dowry Deaths,Male,18-30,5261,2622,2639,4459,802
2005,Urban,Tamil Nadu,Other Crimes,Cyber Crime,Male,13-17,9857,7795,2062,9020,837
2005,Rural,Mizoram,Crime Against Women,Molestation,Male,31-45,903,584,319,790,113
2008,Rural,Punjab,Other Crimes,Drug Offense,Female,18-30,4462,2545,1917,3033,1429
2008,Urban,Uttarakhand,Property Crime,Vandalism,Male,18-30,5104,176,4928,2111,2993
2009,Rural,Meghalaya,Other Crimes,Cyber Crime,Female,60+,4971,1991,2980,2321,2650
2008,Urban,Tamil Nadu,Property Crime,Theft,Male,31-45,6074,5949,125,5966,108
2010,Rural,Rajasthan,Property Crime,Burglary,Male,46-60,1911,583,1328,1118,793
2009,Urban,Uttar Pradesh,Crime Against Children,Child Labor,Female,18-30,5649,3270,2379,5103,546
2006,Urban,Meghalaya,Other Crimes,Fraud,Male,46-60,9886,5021,4865,9438,448
2010,Rural,Tamil Nadu,Other Crimes,Corruption,Female,13-17,3012,1238,1774,1604,1408
2008,Urban,Kerala,Crime Against Women,Domestic Violence,Female,31-45,2201,816,1385,1985,216
2002,Urban,Bihar,Property Crime,Vandalism,Male,46-60,9718,738,8980,1224,8494
2001,Urban,Jammu & Kashmir,Crime Against Men,Robbery,Male,31-45,580,568,12,568,12
2009,Rural,Assam,Other Crimes,Fraud,Male,31-45,9266,8799,467,9240,26
2007,Rural,Manipur,Property Crime,Theft,Male,0-12,823,724,99,775,48
2001,Rural,Himachal Pradesh,Property Crime,Theft,Female,18-30,7035,3488,3547,7023,12
2005,Rural,Haryana,Property Crime,Vandalism,Male,60+,1247,563,684,1081,166
2005,Rural,Haryana,Property Crime,Burglary,Female,60+,2432,27,2405,315,2117
2010,Urban,Uttar Pradesh,Property Crime,Arson,Male,0-12,2177,1978,199,1990,187
2010,Rural,Haryana,Other Crimes,Cyber Crime,Female,60+,6962,6165,797,6829,133
2003,Rural,Punjab,Crime Against Children,Trafficking,Female,18-30,5374,3087,2287,3516,1858
2005,Rural,Madhya Pradesh,Crime Against Children,Child Abuse,Female,60+,251,84,167,209,42
2009,Rural,Maharashtra,Crime Against Men,Murder,Male,13-17,5081,4768,313,4795,286
2002,Urban,Madhya Pradesh,Crime Against Men,Robbery,Male,0-12,5780,4982,798,5650,130
2009,Urban,Tripura,Other Crimes,Corruption,Female,13-17,2081,1637,444,2030,51
2007,Rural,Madhya Pradesh,Other Crimes,Fraud,Male,18-30,6770,6058,712,6543,227
2004,Urban,Arunachal Pradesh,Property Crime,Arson,Male,0-12,1918,1264,654,1407,511
2002,Rural,Goa,Property Crime,Burglary,Female,18-30,1823,697,1126,823,1000
2010,Rural,Goa,Other Crimes,Drug Offense,Male,46-60,9916,3746,6170,6030,3886
2004,Urban,Punjab,Property Crime,Arson,Female,18-30,1471,1386,85,1439,32
2010,Rural,Karnataka,Property Crime,Theft,Female,18-30,5908,1224,4684,1416,4492
2002,Urban,Sikkim,Crime Against Women,Domestic Violence,Male,18-30,7914,2026,5888,6666,1248
2006,Urban,Mizoram,Crime Against Women,Rape,Male,31-45,5854,3957,1897,4686,1168
2009,Rural,Bihar,Crime Against Men,Assault,Male,31-45,8582,1106,7476,4742,3840
2010,Rural,Jharkhand,Crime Against Children,Child Labor,Male,18-30,1642,1294,348,1387,255
2001,Urban,Mizoram,Crime Against Children,Child Abuse,Female,60+,6290,4718,1572,6224,66
2009,Urban,Gujarat,Crime Against Men,Murder,Male,0-12,2488,2363,125,2376,112
2005,Rural,Haryana,Crime Against Men,Robbery,Male,0-12,7584,3294,4290,4972,2612
2009,Urban,Chhattisgarh,Property Crime,Vandalism,Female,0-12,5806,3216,2590,4375,1431
2006,Rural,Uttarakhand,Crime Against Women,Rape,Male,18-30,9323,1478,7845,2346,6977
2004,Urban,Chhattisgarh,Property Crime,Theft,Female,60+,3673,1140,2533,1822,1851
2002,Urban,Goa,Other Crimes,Fraud,Female,60+,5059,418,4641,4894,165
2007,Urban,Odisha,Crime Against Men,Robbery,Male,60+,3802,687,3115,3750,52
2002,Rural,Haryana,Other Crimes,Fraud,Male,13-17,9649,4818,4831,4930,4719
2009,Urban,Chhattisgarh,Crime Against Women,Molestation,Male,0-12,3388,2238,1150,2249,1139
2003,Urban,Odisha,Property Crime,Theft,Male,13-17,6601,1117,5484,4378,2223
2006,Urban,Meghalaya,Crime Against Women,Dowry Deaths,Female,18-30,1858,1789,69,1846,12
2006,Urban,Maharashtra,Crime Against Men,Robbery,Female,46-60,4234,1598,2636,2286,1948
2008,Rural,Goa,Property Crime,Burglary,Male,60+,8203,5507,2696,6655,1548
2002,Rural,Gujarat,Crime Against Children,Trafficking,Female,18-30,8961,4435,4526,5819,3142
2006,Urban,Assam,Other Crimes,Drug Offense,Female,13-17,3738,3400,338,3705,33
2010,Rural,Sikkim,Crime Against Children,Child Abuse,Female,13-17,3145,886,2259,2796,349
2004,Rural,Odisha,Property Crime,Theft,Female,60+,4076,1640,2436,3122,954
2010,Urban,Jammu & Kashmir,Property Crime,Burglary,Female,0-12,6268,129,6139,6124,144
2005,Urban,Goa,Property Crime,Theft,Female,0-12,2016,1907,109,1925,91
2008,Urban,Rajasthan,Crime Against Children,Child Labor,Male,0-12,5970,3894,2076,5387,583
2002,Urban,Haryana,Crime Against Men,Assault,Female,46-60,7260,911,6349,6637,623
2006,Rural,Sikkim,Crime Against Women,Dowry Deaths,Male,31-45,8752,8204,548,8608,144
2001,Urban,Manipur,Property Crime,Vandalism,Male,18-30,5257,3414,1843,5106,151
2004,Urban,West Bengal,Crime Against Women,Dowry Deaths,Male,0-12,285,243,42,269,16
2003,Urban,Bihar,Crime Against Men,Robbery,Female,46-60,1612,12,1600,1609,3
2008,Rural,Madhya Pradesh,Crime Against Men,Extortion,Female,0-12,7835,1853,5982,6812,1023
2004,Urban,Odisha,Crime Against Children,Child Labor,Female,0-12,2535,323,2212,1998,537
2003,Rural,Haryana,Crime Against Women,Domestic Violence,Female,0-12,8976,2600,6376,3692,5284
2005,Urban,Himachal Pradesh,Other Crimes,Fraud,Male,18-30,9976,6179,3797,8300,1676
2002,Rural,Goa,Crime Against Children,Child Labor,Male,60+,3063,2350,713,2831,232
2002,Rural,Manipur,Crime Against Women,Rape,Female,13-17,7970,6629,1341,6993,977
2010,Rural,West Bengal,Crime Against Children,Child Abuse,Male,0-12,9272,9026,246,9065,207
2004,Urban,Uttar Pradesh,Other Crimes,Drug Offense,Female,31-45,5168,3502,1666,4680,488
2005,Rural,Manipur,Property Crime,Arson,Male,18-30,2221,286,1935,1896,325
2007,Rural,Chhattisgarh,Other Crimes,Corruption,Female,31-45,5591,4550,1041,4762,829
2004,Urban,Manipur,Property Crime,Arson,Male,31-45,3804,1671,2133,1732,2072
2008,Rural,Sikkim,Crime Against Men,Robbery,Male,18-30,9772,8594,1178,9674,98
2004,Rural,Uttarakhand,Crime Against Women,Molestation,Male,46-60,2417,2055,362,2306,111
2002,Urban,Manipur,Other Crimes,Drug Offense,Female,60+,7361,2348,5013,2759,4602
2006,Urban,Chhattisgarh,Crime Against Children,Child Abuse,Male,13-17,807,746,61,804,3
2001,Rural,Goa,Crime Against Children,Trafficking,Male,60+,5240,3890,1350,5143,97
2005,Rural,Rajasthan,Crime Against Men,Robbery,Female,13-17,7690,1290,6400,4945,2745
2003,Rural,Mizoram,Crime Against Women,Rape,Male,46-60,4427,2423,2004,3317,1110
2010,Urban,Andhra Pradesh,Crime Against Children,Child Abuse,Female,18-30,7843,497,7346,659,7184
2006,Urban,Punjab,Crime Against Women,Domestic Violence,Male,60+,1454,552,902,851,603
2002,Urban,Arunachal Pradesh,Crime Against Women,Dowry Deaths,Female,18-30,300,296,4,296,4
2007,Urban,Rajasthan,Property Crime,Vandalism,Female,13-17,9346,4047,5299,7357,1989
2007,Rural,Andhra Pradesh,Crime Against Children,Child Labor,Female,46-60,1113,81,1032,605,508
2005,Urban,Karnataka,Other Crimes,Corruption,Male,13-17,6379,4314,2065,5448,931
2001,Rural,Telangana,Crime Against Children,Trafficking,Male,18-30,9532,9324,208,9423,109
2006,Urban,Jammu & Kashmir,Property Crime,Theft,Male,13-17,1814,19,1795,1589,225
2010,Urban,Punjab,Other Crimes,Corruption,Male,46-60,8526,2155,6371,2912,5614
2008,Urban,Gujarat,Crime Against Women,Dowry Deaths,Male,0-12,9900,8786,1114,8974,926
2010,Urban,Manipur,Other Crimes,Drug Offense,Male,18-30,6731,444,6287,599,6132
2006,Urban,Bihar,Crime Against Men,Murder,Female,31-45,588,61,527,418,170
2006,Urban,Arunachal Pradesh,Crime Against Children,Trafficking,Male,0-12,8464,6711,1753,7521,943
2004,Rural,West Bengal,Crime Against Men,Robbery,Male,18-30,1289,798,491,1214,75
2001,Rural,Chhattisgarh,Property Crime,Arson,Female,46-60,2015,634,1381,1045,970
2008,Urban,Madhya Pradesh,Other Crimes,Drug Offense,Female,0-12,5827,4228,1599,5377,450
2004,Urban,Karnataka,Crime Against Children,Trafficking,Male,0-12,7139,5727,1412,6693,446
2006,Rural,Gujarat,Crime Against Men,Robbery,Female,0-12,333,307,26,326,7
2004,Urban,Madhya Pradesh,Crime Against Women,Dowry Deaths,Female,13-17,1591,423,1168,1227,364
2005,Urban,Nagaland,Crime Against Women,Domestic Violence,Male,0-12,3337,1426,1911,2012,1325
2006,Rural,Manipur,Crime Against Women,Domestic Violence,Female,60+,4529,1370,3159,2886,1643
2005,Rural,Nagaland,Crime Against Women,Dowry Deaths,Male,0-12,7798,1429,6369,3724,4074
2008,Rural,West Bengal,Crime Against Men,Extortion,Female,31-45,1218,94,1124,808,410
2002,Urban,Tamil Nadu,Crime Against Children,Kidnapping,Male,0-12,1790,1163,627,1223,567
2007,Urban,Jharkhand,Property Crime,Theft,Male,60+,1438,1098,340,1382,56
2010,Urban,Uttarakhand,Other Crimes,Drug Offense,Male,0-12,7347,4890,2457,6587,760
2009,Rural,Uttarakhand,Property Crime,Vandalism,Female,31-45,7445,2525,4920,6784,661
2006,Rural,Tripura,Property Crime,Vandalism,Female,31-45,2934,2272,662,2807,127
2003,Urban,Haryana,Crime Against Men,Assault,Male,18-30,3423,3123,300,3256,167
2010,Rural,Jharkhand,Crime Against Men,Extortion,Female,0-12,788,215,573,660,128
2008,Rural,Kerala,Crime Against Children,Trafficking,Female,0-12,6665,6501,164,6583,82
2004,Urban,Meghalaya,Crime Against Women,Domestic Violence,Male,60+,8469,6577,1892,7646,823
2007,Urban,Uttarakhand,Other Crimes,Corruption,Male,13-17,4861,2106,2755,4785,76
2008,Urban,Meghalaya,Other Crimes,Corruption,Male,31-45,7712,892,6820,1998,5714
2008,Urban,Odisha,Property Crime,Theft,Male,18-30,7297,6676,621,6858,439
2010,Rural,Mizoram,Crime Against Children,Trafficking,Male,60+,1220,482,738,861,359
2002,Rural,Goa,Crime Against Men,Assault,Male,60+,3930,3384,546,3731,199
2010,Rural,Nagaland,Property Crime,Burglary,Male,46-60,9187,1557,7630,8618,569
2010,Urban,Karnataka,Property Crime,Vandalism,Female,18-30,5304,3308,1996,4562,742
2010,Rural,West Bengal,Crime Against Women,Domestic Violence,Female,46-60,1854,108,1746,877,977
2007,Urban,Mizoram,Other Crimes,Fraud,Female,13-17,3747,2341,1406,3323,424
2006,Rural,Telangana,Property Crime,Arson,Female,0-12,3567,2833,734,3404,163
2006,Rural,Arunachal Pradesh,Crime Against Children,Child Abuse,Male,13-17,9223,2403,6820,7882,1341
2002,Rural,Tripura,Crime Against Children,Kidnapping,Male,60+,5859,4841,1018,5509,350
2010,Rural,Assam,Crime Against Men,Assault,Female,31-45,6705,104,6601,6038,667
2001,Urban,Bihar,Other Crimes,Drug Offense,Male,31-45,1931,528,1403,1032,899
2007,Urban,Haryana,Crime Against Women,Dowry Deaths,Male,60+,9711,7871,1840,8872,839
2005,Rural,Rajasthan,Other Crimes,Cyber Crime,Male,0-12,3467,2618,849,3087,380
2006,Rural,Delhi,Crime Against Children,Trafficking,Male,60+,1247,275,972,473,774
2007,Rural,Karnataka,Crime Against Women,Molestation,Female,60+,5115,120,4995,4397,718
2006,Rural,Arunachal Pradesh,Other Crimes,Cyber Crime,Male,60+,1801,74,1727,635,1166
2004,Rural,Uttarakhand,Crime Against Women,Molestation,Male,31-45,6787,3083,3704,4156,2631
2006,Rural,Mizoram,Crime Against Men,Murder,Male,0-12,3945,1270,2675,3579,366
2002,Urban,Jharkhand,Crime Against Men,Murder,Male,46-60,4091,3099,992,3597,494
2008,Rural,Odisha,Crime Against Women,Molestation,Female,13-17,1775,758,1017,1207,568
2003,Rural,Tamil Nadu,Other Crimes,Drug Offense,Female,31-45,9888,1300,8588,4299,5589
2004,Urban,Delhi,Property Crime,Theft,Female,0-12,6870,2031,4839,4560,2310
2004,Urban,Rajasthan,Property Crime,Vandalism,Male,46-60,9954,4930,5024,7758,2196
2001,Urban,Delhi,Crime Against Men,Robbery,Female,31-45,7165,533,6632,5697,1468
2008,Urban,Arunachal Pradesh,Crime Against Women,Dowry Deaths,Female,13-17,2127,1363,764,1698,429
2003,Rural,Madhya Pradesh,Crime Against Men,Extortion,Male,0-12,6617,3815,2802,4040,2577
2008,Urban,Himachal Pradesh,Other Crimes,Drug Offense,Male,60+,1809,430,1379,1721,88
2005,Rural,Tripura,Property Crime,Arson,Male,0-12,1855,1232,623,1805,50
2009,Urban,Gujarat,Other Crimes,Drug Offense,Male,46-60,6672,1990,4682,6509,163
2010,Rural,Karnataka,Crime Against Women,Domestic Violence,Female,0-12,6675,5646,1029,6126,549
2006,Rural,Andhra Pradesh,Crime Against Women,Dowry Deaths,Male,60+,4939,1254,3685,1963,2976
2005,Urban,Maharashtra,Property Crime,Vandalism,Female,0-12,6808,4658,2150,5943,865
2004,Rural,Delhi,Crime Against Women,Rape,Female,46-60,6240,5035,1205,5657,583
2010,Rural,Arunachal Pradesh,Property Crime,Arson,Female,46-60,6538,2623,3915,4535,2003
2010,Rural,Chhattisgarh,Other Crimes,Fraud,Female,31-45,218,139,79,183,35
2007,Urban,Mizoram,Crime Against Children,Child Labor,Male,0-12,867,446,421,613,254
2010,Urban,Maharashtra,Property Crime,Theft,Male,60+,4256,1476,2780,3373,883
2006,Rural,Mizoram,Property Crime,Vandalism,Male,31-45,6175,2594,3581,6001,174
2005,Urban,Tamil Nadu,Other Crimes,Drug Offense,Male,60+,8916,1633,7283,3556,5360
2006,Rural,Mizoram,Property Crime,Arson,Male,18-30,360,96,264,293,67
2010,Urban,Uttar Pradesh,Crime Against Men,Extortion,Female,13-17,3730,3542,188,3545,185
2009,Urban,Delhi,Crime Against Women,Molestation,Female,18-30,6053,419,5634,5946,107
2005,Urban,Gujarat,Property Crime,Burglary,Female,18-30,7269,4276,2993,5644,1625
2002,Rural,Karnataka,Crime Against Women,Dowry Deaths,Female,0-12,9917,2715,7202,7381,2536
2008,Urban,Uttarakhand,Crime Against Children,Child Labor,Female,0-12,4852,1976,2876,3539,1313
2005,Urban,Gujarat,Other Crimes,Corruption,Male,31-45,2414,1659,755,1745,669
2007,Urban,Telangana,Other Crimes,Drug Offense,Male,0-12,2137,2114,23,2127,10
2004,Urban,Nagaland,Crime Against Women,Dowry Deaths,Female,13-17,4471,4275,196,4278,193
2004,Rural,Manipur,Crime Against Men,Robbery,Female,46-60,9351,5058,4293,8279,1072
2005,Urban,Meghalaya,Crime Against Children,Kidnapping,Male,60+,4675,2953,1722,3363,1312
2008,Urban,Bihar,Other Crimes,Cyber Crime,Female,31-45,7424,838,6586,2140,5284
2005,Urban,Haryana,Crime Against Men,Extortion,Male,46-60,5107,2114,2993,2539,2568
2002,Rural,Uttarakhand,Crime Against Women,Molestation,Male,31-45,3863,1770,2093,2624,1239
2005,Urban,Kerala,Property Crime,Burglary,Male,0-12,3298,1690,1608,2525,773
2001,Rural,Mizoram,Crime Against Children,Child Labor,Male,46-60,4835,4399,436,4678,157
2010,Urban,Gujarat,Crime Against Women,Domestic Violence,Female,46-60,928,263,665,464,464
2008,Urban,Jammu & Kashmir,Other Crimes,Cyber Crime,Male,18-30,2301,860,1441,1450,851
2002,Urban,Uttarakhand,Crime Against Children,Trafficking,Male,60+,2278,430,1848,921,1357
2001,Rural,Kerala,Crime Against Men,Assault,Female,0-12,1612,896,716,1004,608
2002,Rural,Meghalaya,Other Crimes,Fraud,Male,18-30,5498,5100,398,5187,311
2001,Rural,Bihar,Other Crimes,Corruption,Female,13-17,7511,7169,342,7220,291
2010,Urban,Chhattisgarh,Crime Against Men,Robbery,Female,0-12,3546,849,2697,1754,1792
2002,Rural,Himachal Pradesh,Property Crime,Theft,Male,60+,808,581,227,598,210
2010,Rural,West Bengal,Crime Against Women,Molestation,Female,31-45,1734,1714,20,1715,19
2005,Urban,Goa,Crime Against Children,Trafficking,Male,0-12,9118,8640,478,8751,367
2010,Urban,Haryana,Other Crimes,Fraud,Male,0-12,7808,7096,712,7120,688
2001,Urban,Himachal Pradesh,Property Crime,Vandalism,Male,46-60,9799,5793,4006,6016,3783
2010,Urban,Uttar Pradesh,Other Crimes,Corruption,Female,18-30,4551,1041,3510,3733,818
2010,Rural,Maharashtra,Crime Against Women,Molestation,Female,0-12,8196,4131,4065,4420,3776
2008,Urban,Bihar,Other Crimes,Cyber Crime,Female,0-12,8953,6881,2072,8741,212
2006,Rural,Tripura,Crime Against Children,Child Labor,Male,46-60,6830,3060,3770,3123,3707
2009,Rural,Haryana,Other Crimes,Corruption,Male,46-60,3078,2158,920,2656,422
2001,Rural,Madhya Pradesh,Crime Against Men,Extortion,Male,13-17,2808,2400,408,2539,269
2004,Rural,Gujarat,Crime Against Men,Robbery,Male,46-60,2534,1149,1385,2309,225
2010,Urban,Gujarat,Other Crimes,Fraud,Female,18-30,4491,205,4286,1250,3241
2002,Rural,Maharashtra,Crime Against Women,Dowry Deaths,Male,18-30,1110,956,154,972,138
2010,Urban,Madhya Pradesh,Crime Against Men,Robbery,Female,31-45,406,13,393,80,326
2009,Urban,West Bengal,Crime Against Children,Kidnapping,Female,60+,3655,1467,2188,2975,680
2006,Urban,Andhra Pradesh,Crime Against Women,Molestation,Female,18-30,3857,3236,621,3591,266
2003,Rural,Maharashtra,Other Crimes,Fraud,Male,46-60,5665,2829,2836,2962,2703
2005,Rural,Maharashtra,Other Crimes,Cyber Crime,Male,0-12,5871,3688,2183,4685,1186
2001,Rural,Rajasthan,Other Crimes,Fraud,Female,0-12,4105,2859,1246,4001,104
2001,Rural,Kerala,Crime Against Children,Kidnapping,Male,13-17,8135,511,7624,6973,1162
2004,Urban,Tamil Nadu,Other Crimes,Drug Offense,Male,13-17,8694,866,7828,2062,6632
2008,Rural,Nagaland,Crime Against Men,Robbery,Male,18-30,1488,37,1451,431,1057
2008,Rural,Himachal Pradesh,Crime Against Men,Extortion,Female,0-12,720,511,209,535,185
2004,Urban,Maharashtra,Crime Against Men,Murder,Female,13-17,9737,8366,1371,9378,359
2004,Rural,Maharashtra,Other Crimes,Fraud,Male,18-30,6069,3113,2956,3799,2270
2008,Urban,Punjab,Crime Against Children,Child Labor,Male,18-30,4826,2993,1833,4568,258
2002,Rural,West Bengal,Crime Against Men,Robbery,Male,0-12,3912,3567,345,3656,256
2007,Rural,Tamil Nadu,Crime Against Women,Dowry Deaths,Male,60+,9959,3200,6759,9957,2
2007,Rural,Nagaland,Other Crimes,Corruption,Female,31-45,6318,3046,3272,5089,1229
2010,Rural,Bihar,Property Crime,Vandalism,Female,31-45,2421,10,2411,1373,1048
2006,Rural,Punjab,Crime Against Women,Rape,Female,18-30,1114,35,1079,194,920
2007,Rural,Mizoram,Crime Against Children,Trafficking,Male,13-17,2779,1198,1581,2278,501
2009,Urban,West Bengal,Crime Against Children,Kidnapping,Male,46-60,9025,5629,3396,6527,2498
2003,Urban,Assam,Other Crimes,Drug Offense,Female,0-12,5678,3332,2346,4776,902
2006,Urban,Uttar Pradesh,Crime Against Women,Domestic Violence,Male,0-12,221,163,58,200,21
2001,Rural,Mizoram,Other Crimes,Drug Offense,Female,60+,6861,4878,1983,5894,967
2010,Rural,Himachal Pradesh,Crime Against Women,Domestic Violence,Female,18-30,9692,3616,6076,9189,503
2005,Rural,Arunachal Pradesh,Crime Against Men,Extortion,Female,18-30,6216,2303,3913,5504,712
2009,Rural,Himachal Pradesh,Property Crime,Vandalism,Male,46-60,5869,182,5687,1250,4619
2010,Urban,Assam,Property Crime,Arson,Male,46-60,7300,4890,2410,6309,991
2002,Rural,Assam,Property Crime,Vandalism,Female,13-17,6954,2609,4345,3149,3805
2007,Rural,Uttar Pradesh,Crime Against Women,Domestic Violence,Female,0-12,5394,136,5258,4347,1047
2007,Rural,Jharkhand,Crime Against Men,Robbery,Female,60+,9977,7717,2260,8390,1587
2002,Urban,Bihar,Property Crime,Arson,Female,0-12,6416,4879,1537,5434,982
2010,Urban,Chhattisgarh,Property Crime,Burglary,Female,46-60,2533,1507,1026,2363,170
2002,Rural,Arunachal Pradesh,Other Crimes,Fraud,Female,0-12,7268,3069,4199,3776,3492
2008,Urban,Bihar,Crime Against Children,Child Labor,Male,31-45,364,285,79,356,8
2005,Urban,Arunachal Pradesh,Crime Against Women,Dowry Deaths,Male,0-12,414,343,71,358,56
2002,Urban,Gujarat,Crime Against Women,Dowry Deaths,Female,46-60,9174,2154,7020,6157,3017
2007,Rural,Punjab,Crime Against Men,Assault,Male,31-45,8239,4574,3665,7323,916
2006,Rural,Assam,Crime Against Men,Extortion,Male,46-60,6532,252,6280,5771,761
2008,Urban,Delhi,Crime Against Women,Dowry Deaths,Male,31-45,3490,2214,1276,2474,1016
2008,Rural,Mizoram,Crime Against Women,Molestation,Female,0-12,4374,1796,2578,2182,2192
2003,Rural,Manipur,Crime Against Men,Murder,Male,31-45,9127,1411,7716,3126,6001
2002,Urban,Uttarakhand,Crime Against Children,Kidnapping,Female,0-12,801,189,612,509,292
2006,Urban,Uttarakhand,Crime Against Men,Assault,Male,18-30,110,76,34,105,5
2005,Urban,Punjab,Other Crimes,Corruption,Female,46-60,2967,2967,0,2967,0
2008,Urban,Telangana,Crime Against Women,Molestation,Male,18-30,268,78,190,112,156
2002,Urban,Haryana,Property Crime,Theft,Female,31-45,5981,5771,210,5967,14
2008,Urban,Himachal Pradesh,Crime Against Women,Molestation,Female,46-60,1032,706,326,979,53
2001,Rural,Jharkhand,Other Crimes,Fraud,Female,13-17,7338,231,7107,1978,5360
2010,Urban,Mizoram,Other Crimes,Corruption,Female,13-17,7013,6884,129,6988,25
2005,Rural,Tamil Nadu,Crime Against Children,Child Labor,Female,18-30,1747,95,1652,683,1064
2005,Rural,Delhi,Crime Against Children,Child Abuse,Male,46-60,8499,5279,3220,6902,1597
2007,Urban,Odisha,Other Crimes,Fraud,Male,31-45,4484,3518,966,4321,163
2003,Rural,Mizoram,Property Crime,Burglary,Female,13-17,8811,5047,3764,5828,2983
2003,Urban,Kerala,Crime Against Women,Domestic Violence,Male,0-12,7213,5236,1977,7070,143
2004,Rural,Manipur,Other Crimes,Corruption,Female,31-45,5080,3883,1197,4248,832
2007,Rural,Meghalaya,Other Crimes,Drug Offense,Male,60+,5691,2971,2720,3922,1769
2007,Rural,Uttarakhand,Crime Against Men,Extortion,Female,18-30,3903,679,3224,986,2917
2002,Rural,Himachal Pradesh,Other Crimes,Drug Offense,Female,46-60,3209,381,2828,1962,1247
2003,Urban,Uttarakhand,Crime Against Children,Child Labor,Female,60+,86,33,53,74,12
2009,Rural,West Bengal,Crime Against Women,Domestic Violence,Female,13-17,5832,1221,4611,3593,2239
2004,Rural,West Bengal,Property Crime,Theft,Female,46-60,956,239,717,659,297
2006,Urban,Uttar Pradesh,Crime Against Men,Assault,Male,46-60,7497,5113,2384,7399,98
2007,Rural,Manipur,Property Crime,Theft,Male,13-17,5673,4477,1196,4947,726
2002,Urban,Meghalaya,Crime Against Children,Trafficking,Female,31-45,8503,2398,6105,8130,373
2001,Urban,Assam,Other Crimes,Drug Offense,Male,18-30,971,410,561,643,328
2006,Urban,Chhattisgarh,Property Crime,Theft,Male,18-30,9830,5144,4686,7774,2056
2010,Urban,Gujarat,Crime Against Men,Robbery,Male,13-17,7269,3282,3987,4817,2452
2003,Urban,Odisha,Crime Against Children,Trafficking,Female,13-17,9222,4709,4513,6562,2660
2004,Urban,Mizoram,Crime Against Men,Assault,Female,46-60,8224,1914,6310,3373,4851
2002,Urban,Jammu & Kashmir,Crime Against Children,Trafficking,Female,60+,8953,2610,6343,2839,6114
2010,Rural,Tripura,Other Crimes,Corruption,Male,31-45,8832,6691,2141,8140,692
2009,Urban,Odisha,Crime Against Women,Rape,Female,60+,6671,5295,1376,6408,263
2010,Urban,Karnataka,Crime Against Men,Extortion,Female,60+,6929,4526,2403,5054,1875
2009,Rural,Tripura,Crime Against Men,Robbery,Male,0-12,1240,245,995,1177,63
2001,Rural,Chhattisgarh,Other Crimes,Drug Offense,Female,46-60,1738,282,1456,1540,198
2006,Urban,Odisha,Other Crimes,Drug Offense,Female,46-60,7353,1821,5532,6379,974
2006,Urban,Jharkhand,Crime Against Men,Extortion,Female,60+,1268,335,933,576,692
2002,Rural,Haryana,Property Crime,Vandalism,Female,13-17,8962,5507,3455,6547,2415
2006,Urban,Delhi,Crime Against Women,Molestation,Male,0-12,2305,897,1408,1217,1088
2008,Rural,Punjab,Crime Against Men,Robbery,Female,31-45,9098,8235,863,8263,835
2009,Rural,Manipur,Crime Against Men,Assault,Male,60+,1692,1299,393,1681,11
2007,Rural,Chhattisgarh,Crime Against Women,Dowry Deaths,Male,0-12,3495,3406,89,3425,70
2002,Rural,Uttarakhand,Crime Against Children,Child Labor,Male,46-60,6226,2294,3932,5536,690
2007,Urban,Sikkim,Other Crimes,Corruption,Male,31-45,3260,910,2350,940,2320
2003,Rural,Meghalaya,Crime Against Children,Trafficking,Male,31-45,5399,2271,3128,5291,108
2002,Urban,Jammu & Kashmir,Crime Against Children,Child Labor,Female,46-60,7327,2996,4331,6181,1146
2007,Rural,Madhya Pradesh,Other Crimes,Drug Offense,Male,31-45,123,74,49,123,0
2003,Urban,Madhya Pradesh,Crime Against Women,Domestic Violence,Female,0-12,4566,3976,590,4330,236
2007,Urban,West Bengal,Crime Against Women,Molestation,Female,31-45,6308,6296,12,6303,5
2003,Urban,Punjab,Other Crimes,Corruption,Female,13-17,1235,343,892,937,298
2005,Rural,Assam,Crime Against Women,Molestation,Male,46-60,4065,2664,1401,3249,816
2010,Urban,Assam,Other Crimes,Drug Offense,Female,46-60,7981,7825,156,7893,88
2010,Rural,Chhattisgarh,Crime Against Women,Domestic Violence,Male,46-60,9246,7533,1713,7818,1428
2010,Urban,Kerala,Crime Against Children,Kidnapping,Male,31-45,550,296,254,356,194
2004,Rural,Sikkim,Crime Against Women,Domestic Violence,Female,13-17,3524,3469,55,3498,26
2001,Rural,Telangana,Crime Against Men,Extortion,Female,0-12,7050,2950,4100,5954,1096
2009,Rural,Arunachal Pradesh,Crime Against Men,Robbery,Female,60+,6372,59,6313,1984,4388
2004,Urban,Karnataka,Crime Against Women,Molestation,Female,18-30,8354,4656,3698,5621,2733
2004,Rural,Gujarat,Crime Against Children,Child Labor,Female,13-17,676,659,17,669,7
2001,Rural,Jammu & Kashmir,Crime Against Children,Child Labor,Female,13-17,2796,390,2406,2139,657
2009,Urban,Jharkhand,Crime Against Women,Dowry Deaths,Female,0-12,1682,699,983,887,795
2004,Rural,Jammu & Kashmir,Other Crimes,Drug Offense,Male,18-30,7663,7660,3,7662,1
2004,Rural,Telangana,Crime Against Men,Robbery,Male,60+,1188,1050,138,1185,3
2007,Rural,Odisha,Crime Against Men,Extortion,Female,60+,4844,4368,476,4776,68
2005,Rural,Delhi,Crime Against Men,Murder,Male,0-12,192,19,173,114,78
2004,Urban,West Bengal,Crime Against Men,Robbery,Female,13-17,2487,1259,1228,2334,153
2001,Rural,Nagaland,Crime Against Children,Trafficking,Female,60+,7474,7002,472,7333,141
2002,Rural,Tamil Nadu,Property Crime,Theft,Female,46-60,6470,2388,4082,2615,3855
2008,Rural,Sikkim,Crime Against Men,Robbery,Male,46-60,3326,2768,558,2775,551
2006,Rural,Assam,Property Crime,Arson,Female,31-45,132,94,38,123,9
2009,Urban,Delhi,Crime Against Men,Assault,Male,18-30,1975,1174,801,1796,179
2001,Urban,Uttar Pradesh,Crime Against Children,Kidnapping,Female,46-60,9160,489,8671,1750,7410
2005,Urban,Maharashtra,Crime Against Men,Assault,Male,0-12,1185,278,907,472,713
2005,Rural,Gujarat,Crime Against Men,Extortion,Male,0-12,8474,4845,3629,5005,3469
2005,Urban,Jharkhand,Crime Against Men,Murder,Male,31-45,7058,4806,2252,5214,1844
2003,Urban,Uttarakhand,Crime Against Men,Assault,Female,18-30,794,216,578,260,534
2005,Rural,Mizoram,Crime Against Women,Dowry Deaths,Male,0-12,3630,2612,1018,3307,323
2003,Urban,Jharkhand,Crime Against Women,Molestation,Male,0-12,1439,639,800,1023,416
2006,Urban,Tripura,Other Crimes,Fraud,Male,46-60,2593,1466,1127,2051,542
2005,Urban,Sikkim,Crime Against Women,Domestic Violence,Male,0-12,5638,3495,2143,4166,1472
2010,Rural,Jharkhand,Crime Against Women,Dowry Deaths,Male,60+,1597,909,688,1231,366
2010,Urban,Mizoram,Crime Against Women,Dowry Deaths,Female,18-30,1766,1063,703,1388,378
2007,Rural,Goa,Crime Against Men,Extortion,Male,18-30,3795,2790,1005,3466,329
2007,Urban,Andhra Pradesh,Crime Against Men,Murder,Male,31-45,8740,4165,4575,4380,4360
2004,Urban,Gujarat,Crime Against Children,Kidnapping,Male,46-60,2795,1024,1771,2353,442
2007,Urban,Jammu & Kashmir,Crime Against Children,Trafficking,Female,60+,6973,5126,1847,6774,199
2004,Rural,Bihar,Other Crimes,Corruption,Female,60+,2783,1162,1621,1795,988
2008,Rural,Assam,Crime Against Women,Molestation,Male,31-45,416,396,20,404,12
2001,Urban,Tamil Nadu,Crime Against Men,Robbery,Female,31-45,4460,4308,152,4456,4
2006,Rural,Odisha,Crime Against Women,Molestation,Female,0-12,901,754,147,836,65
2006,Urban,West Bengal,Crime Against Women,Rape,Female,0-12,6861,4160,2701,6380,481
2007,Urban,Assam,Crime Against Women,Rape,Male,60+,4735,3020,1715,3534,1201
2008,Rural,Mizoram,Crime Against Children,Child Labor,Male,18-30,5021,622,4399,3523,1498
2010,Urban,Delhi,Crime Against Women,Molestation,Female,46-60,1366,1182,184,1364,2
2002,Rural,Delhi,Property Crime,Theft,Female,31-45,9516,2509,7007,4434,5082
2007,Rural,Goa,Property Crime,Burglary,Male,18-30,4087,2645,1442,3466,621
2009,Rural,Karnataka,Crime Against Children,Kidnapping,Male,31-45,1763,543,1220,723,1040
2001,Urban,Telangana,Crime Against Women,Rape,Female,46-60,1722,1492,230,1681,41
2005,Urban,Jammu & Kashmir,Property Crime,Vandalism,Male,18-30,842,379,463,652,190
2007,Urban,Maharashtra,Crime Against Women,Rape,Male,18-30,2223,1453,770,1663,560
2004,Urban,Sikkim,Property Crime,Theft,Male,0-12,4672,3224,1448,3477,1195
2008,Urban,Goa,Other Crimes,Drug Offense,Female,13-17,8198,2,8196,6912,1286
2010,Rural,Kerala,Property Crime,Burglary,Male,31-45,3478,279,3199,2857,621
2007,Rural,Telangana,Crime Against Men,Extortion,Male,31-45,9778,8889,889,9136,642
2001,Urban,Gujarat,Crime Against Women,Dowry Deaths,Male,60+,2889,2100,789,2585,304
2003,Rural,Andhra Pradesh,Crime Against Men,Robbery,Female,0-12,5657,5182,475,5386,271
2008,Urban,Tamil Nadu,Other Crimes,Cyber Crime,Female,13-17,8775,7054,1721,8398,377
2005,Rural,Uttar Pradesh,Other Crimes,Cyber Crime,Male,31-45,1503,98,1405,800,703
2010,Urban,Himachal Pradesh,Crime Against Men,Murder,Male,60+,4640,2208,2432,4289,351
2002,Urban,Sikkim,Crime Against Women,Molestation,Female,60+,3855,1929,1926,3415,440
2008,Urban,Uttarakhand,Crime Against Men,Murder,Male,18-30,3531,2872,659,3204,327
2006,Urban,Andhra Pradesh,Property Crime,Burglary,Female,46-60,2451,1367,1084,1529,922
2005,Urban,Tamil Nadu,Crime Against Children,Child Labor,Male,31-45,4879,266,4613,1708,3171
2001,Urban,Himachal Pradesh,Crime Against Women,Dowry Deaths,Male,13-17,4470,1306,3164,2257,2213
2006,Urban,Uttarakhand,Crime Against Men,Robbery,Male,46-60,840,164,676,552,288
2008,Rural,Gujarat,Crime Against Children,Child Abuse,Female,60+,4705,4423,282,4552,153
2008,Rural,Andhra Pradesh,Other Crimes,Drug Offense,Male,31-45,2417,307,2110,423,1994
2010,Urban,Arunachal Pradesh,Crime Against Men,Murder,Female,0-12,9108,5757,3351,7777,1331
2005,Urban,Mizoram,Crime Against Men,Extortion,Female,46-60,1973,1126,847,1873,100
2006,Urban,Odisha,Crime Against Men,Robbery,Male,60+,4364,1503,2861,3741,623
2004,Rural,Himachal Pradesh,Crime Against Women,Molestation,Female,0-12,7223,1521,5702,1694,5529
2004,Rural,Delhi,Crime Against Men,Assault,Male,31-45,8018,527,7491,2275,5743
2004,Rural,Himachal Pradesh,Crime Against Men,Assault,Female,0-12,1446,875,571,984,462
2008,Urban,Odisha,Property Crime,Theft,Male,60+,3786,2859,927,2939,847
2003,Urban,Maharashtra,Crime Against Women,Dowry Deaths,Male,60+,7459,4596,2863,6829,630
2001,Urban,Uttarakhand,Other Crimes,Drug Offense,Male,0-12,747,625,122,651,96
2010,Rural,Haryana,Crime Against Women,Molestation,Female,31-45,9764,1894,7870,5859,3905
2003,Rural,Madhya Pradesh,Property Crime,Theft,Female,31-45,7905,6248,1657,6511,1394
2007,Urban,Uttarakhand,Crime Against Children,Trafficking,Male,0-12,1552,1007,545,1112,440
2003,Urban,Jammu & Kashmir,Crime Against Men,Murder,Male,31-45,6556,142,6414,1504,5052
2004,Urban,Jharkhand,Other Crimes,Drug Offense,Male,46-60,1262,578,684,601,661
2007,Urban,Gujarat,Crime Against Men,Robbery,Female,13-17,9113,6140,2973,6619,2494
2009,Urban,Tripura,Property Crime,Arson,Male,0-12,2388,425,1963,537,1851
2010,Urban,Tamil Nadu,Crime Against Women,Rape,Male,13-17,179,44,135,94,85
2009,Urban,Kerala,Crime Against Men,Extortion,Male,13-17,5459,2286,3173,4573,886
2001,Rural,Arunachal Pradesh,Crime Against Women,Rape,Female,31-45,2359,685,1674,1310,1049
2009,Urban,Odisha,Property Crime,Arson,Female,13-17,5824,4097,1727,4466,1358
2010,Rural,Meghalaya,Other Crimes,Fraud,Female,31-45,1380,731,649,985,395
2001,Rural,Meghalaya,Property Crime,Vandalism,Male,31-45,6004,4155,1849,5945,59
2008,Urban,Tamil Nadu,Crime Against Men,Robbery,Female,18-30,5013,2912,2101,4475,538
2010,Rural,Sikkim,Crime Against Children,Kidnapping,Male,60+,4195,2534,1661,3634,561
2003,Rural,Jharkhand,Crime Against Men,Murder,Male,46-60,666,148,518,500,166
2007,Rural,Punjab,Crime Against Children,Kidnapping,Male,13-17,7989,4660,3329,7617,372
2003,Urban,Tripura,Property Crime,Theft,Female,13-17,3569,165,3404,522,3047
2003,Rural,Goa,Crime Against Men,Murder,Female,13-17,5501,1520,3981,4771,730
2003,Urban,Kerala,Property Crime,Burglary,Male,46-60,6144,2144,4000,4227,1917
2004,Urban,Goa,Property Crime,Vandalism,Female,31-45,4917,2030,2887,3465,1452
2003,Rural,Meghalaya,Other Crimes,Cyber Crime,Male,46-60,8883,3092,5791,4752,4131
2002,Urban,Chhattisgarh,Crime Against Men,Assault,Female,18-30,9014,2910,6104,6204,2810
2007,Rural,Odisha,Property Crime,Arson,Male,13-17,4913,921,3992,2075,2838
2001,Rural,Mizoram,Crime Against Women,Rape,Male,13-17,8539,8011,528,8507,32
2003,Rural,Chhattisgarh,Crime Against Men,Murder,Male,0-12,4542,958,3584,2953,1589
2005,Urban,Kerala,Property Crime,Arson,Male,46-60,4579,1239,3340,1674,2905
2006,Urban,West Bengal,Other Crimes,Corruption,Female,60+,936,697,239,873,63
2001,Urban,Goa,Crime Against Men,Robbery,Male,18-30,5227,2485,2742,4137,1090
2008,Rural,Odisha,Property Crime,Vandalism,Male,46-60,1907,952,955,1753,154
2006,Rural,Rajasthan,Property Crime,Burglary,Male,18-30,2966,935,2031,2374,592
2005,Rural,Haryana,Other Crimes,Drug Offense,Female,46-60,2350,1572,778,2254,96
2002,Rural,Tripura,Other Crimes,Cyber Crime,Female,31-45,6528,180,6348,5473,1055
2006,Urban,Andhra Pradesh,Other Crimes,Drug Offense,Male,46-60,6912,91,6821,3655,3257
2002,Rural,Nagaland,Crime Against Men,Assault,Male,18-30,7723,2637,5086,6438,1285
2010,Rural,Himachal Pradesh,Other Crimes,Corruption,Male,46-60,7658,2082,5576,2936,4722
2007,Urban,Sikkim,Crime Against Men,Robbery,Female,0-12,1524,1339,185,1401,123
2001,Urban,Uttar Pradesh,Property Crime,Theft,Female,46-60,822,317,505,741,81
2005,Rural,Delhi,Other Crimes,Fraud,Female,13-17,5783,3574,2209,5481,302
2001,Urban,Haryana,Crime Against Children,Trafficking,Female,0-12,7481,242,7239,5006,2475
2002,Rural,Himachal Pradesh,Other Crimes,Drug Offense,Female,18-30,2252,1458,794,1942,310
2005,Rural,Punjab,Crime Against Women,Dowry Deaths,Male,13-17,1534,235,1299,346,1188
2009,Rural,Tripura,Crime Against Women,Rape,Female,18-30,7221,6030,1191,6743,478
2005,Rural,Jharkhand,Crime Against Children,Child Labor,Female,18-30,8400,748,7652,5258,3142
2006,Rural,Kerala,Property Crime,Arson,Male,46-60,2125,528,1597,585,1540
2001,Urban,Jammu & Kashmir,Crime Against Women,Domestic Violence,Male,0-12,9838,1631,8207,8497,1341
2004,Urban,Bihar,Crime Against Children,Trafficking,Male,13-17,128,71,57,79,49
2004,Rural,Delhi,Crime Against Women,Dowry Deaths,Female,0-12,2534,1859,675,2340,194
2003,Rural,Telangana,Property Crime,Vandalism,Female,31-45,58,39,19,39,19
2008,Urban,Uttarakhand,Other Crimes,Drug Offense,Female,13-17,2307,1954,353,2158,149
2007,Rural,Punjab,Crime Against Men,Extortion,Male,0-12,6875,5199,1676,5589,1286
2003,Rural,Sikkim,Crime Against Children,Child Abuse,Male,13-17,9666,5731,3935,7719,1947
2005,Rural,Haryana,Property Crime,Theft,Female,13-17,2690,2010,680,2205,485
2002,Rural,Punjab,Property Crime,Burglary,Male,46-60,9609,239,9370,7790,1819
2010,Rural,Maharashtra,Other Crimes,Fraud,Female,0-12,901,31,870,275,626
2007,Urban,Madhya Pradesh,Crime Against Women,Domestic Violence,Female,60+,5692,4451,1241,4712,980
2007,Urban,Jammu & Kashmir,Other Crimes,Drug Offense,Male,13-17,6238,3692,2546,4174,2064
2002,Rural,Kerala,Crime Against Women,Rape,Female,0-12,5336,3425,1911,5212,124
2001,Urban,Jammu & Kashmir,Crime Against Children,Child Labor,Male,18-30,646,407,239,607,39
2008,Urban,Maharashtra,Crime Against Women,Rape,Male,13-17,3981,3588,393,3948,33
2005,Rural,West Bengal,Property Crime,Burglary,Male,0-12,7525,1499,6026,3188,4337
2006,Rural,Uttarakhand,Property Crime,Arson,Female,18-30,2650,1798,852,2169,481
2004,Urban,Manipur,Other Crimes,Corruption,Female,60+,3325,2900,425,2991,334
2007,Urban,Manipur,Crime Against Men,Robbery,Male,46-60,1970,281,1689,337,1633
2006,Rural,Bihar,Crime Against Women,Molestation,Female,46-60,2362,605,1757,1588,774
2005,Rural,West Bengal,Other Crimes,Drug Offense,Male,13-17,4322,3264,1058,3796,526
2003,Rural,Andhra Pradesh,Crime Against Men,Extortion,Male,31-45,7589,6749,840,7078,511
2003,Urban,Tamil Nadu,Property Crime,Vandalism,Female,0-12,975,216,759,639,336
2006,Urban,Tamil Nadu,Crime Against Children,Child Labor,Female,31-45,3277,1484,1793,1883,1394
2006,Urban,Maharashtra,Other Crimes,Cyber Crime,Male,13-17,4921,680,4241,1823,3098
2004,Urban,Jammu & Kashmir,Crime Against Children,Kidnapping,Male,0-12,2245,1533,712,1538,707
2003,Urban,Rajasthan,Crime Against Women,Molestation,Female,0-12,4853,583,4270,2809,2044
2003,Urban,Goa,Other Crimes,Fraud,Female,46-60,6633,3520,3113,3887,2746
2005,Urban,Andhra Pradesh,Crime Against Men,Robbery,Male,31-45,910,166,744,500,410
2004,Urban,Meghalaya,Other Crimes,Corruption,Male,13-17,5770,1006,4764,1385,4385
2009,Rural,Rajasthan,Property Crime,Theft,Male,60+,2983,2376,607,2718,265
2004,Rural,Uttar Pradesh,Crime Against Women,Dowry Deaths,Female,0-12,2394,1242,1152,2085,309
2002,Urban,Kerala,Property Crime,Theft,Male,46-60,1229,591,638,727,502
2004,Urban,Andhra Pradesh,Crime Against Men,Robbery,Female,46-60,6759,2416,4343,2898,3861
2002,Urban,Delhi,Crime Against Women,Domestic Violence,Female,31-45,5743,2922,2821,4222,1521
2006,Rural,Telangana,Crime Against Men,Murder,Male,60+,691,102,589,613,78
2010,Urban,Assam,Property Crime,Theft,Male,60+,9151,119,9032,1974,7177
2002,Urban,Tripura,Crime Against Men,Extortion,Female,18-30,7639,2896,4743,4425,3214
2001,Urban,Madhya Pradesh,Crime Against Men,Extortion,Male,0-12,2824,1520,1304,2388,436
2001,Urban,Madhya Pradesh,Other Crimes,Fraud,Female,60+,8053,5485,2568,6899,1154
2008,Urban,Uttarakhand,Crime Against Women,Molestation,Male,46-60,1627,390,1237,1299,328
2007,Rural,Himachal Pradesh,Property Crime,Vandalism,Female,13-17,1928,1840,88,1896,32
2002,Urban,Chhattisgarh,Crime Against Men,Extortion,Male,13-17,9137,7469,1668,8564,573
2008,Rural,Sikkim,Crime Against Men,Robbery,Male,13-17,3720,2840,880,3675,45
2010,Rural,Jammu & Kashmir,Crime Against Children,Trafficking,Female,31-45,9982,3141,6841,7731,2251
2008,Urban,Nagaland,Other Crimes,Cyber Crime,Male,31-45,8173,2786,5387,4582,3591
2006,Urban,Gujarat,Crime Against Women,Dowry Deaths,Female,18-30,6600,5605,995,6363,237
2005,Urban,Delhi,Other Crimes,Fraud,Female,13-17,878,826,52,830,48
2003,Urban,Andhra Pradesh,Property Crime,Arson,Male,13-17,318,111,207,293,25
2001,Urban,Nagaland,Property Crime,Arson,Male,0-12,5265,3895,1370,4580,685
2001,Urban,Uttarakhand,Crime Against Children,Kidnapping,Female,0-12,9730,4859,4871,6712,3018
2001,Rural,Nagaland,Crime Against Children,Child Abuse,Male,46-60,7365,3808,3557,4186,3179
2007,Rural,Madhya Pradesh,Crime Against Children,Trafficking,Female,0-12,1349,836,513,1057,292
2001,Rural,Arunachal Pradesh,Crime Against Children,Child Abuse,Female,60+,4877,345,4532,3629,1248
2004,Urban,Sikkim,Property Crime,Arson,Male,0-12,1811,714,1097,1668,143
2001,Urban,Odisha,Crime Against Children,Trafficking,Male,60+,2245,1970,275,2165,80
2001,Urban,Bihar,Other Crimes,Fraud,Male,0-12,7100,2344,4756,5669,1431
2003,Rural,Punjab,Crime Against Women,Rape,Female,18-30,8540,3771,4769,8222,318
2006,Rural,Andhra Pradesh,Property Crime,Theft,Female,18-30,7060,6818,242,6975,85
2009,Rural,Goa,Crime Against Children,Kidnapping,Female,60+,3732,1297,2435,3494,238
2009,Rural,Meghalaya,Other Crimes,Drug Offense,Female,60+,9349,5516,3833,7823,1526
2008,Urban,Himachal Pradesh,Property Crime,Theft,Female,31-45,4312,842,3470,1591,2721
2002,Urban,Madhya Pradesh,Property Crime,Theft,Male,60+,9442,8355,1087,8488,954
2003,Rural,Nagaland,Other Crimes,Cyber Crime,Male,0-12,8861,3205,5656,6815,2046
2004,Urban,Nagaland,Crime Against Women,Dowry Deaths,Male,46-60,9311,3489,5822,7303,2008
2005,Urban,Delhi,Property Crime,Theft,Male,18-30,3868,1531,2337,2940,928
2004,Rural,Uttarakhand,Crime Against Children,Kidnapping,Male,13-17,656,312,344,330,326
2004,Rural,Himachal Pradesh,Property Crime,Theft,Female,46-60,1661,1415,246,1454,207
2005,Urban,Kerala,Crime Against Men,Assault,Female,60+,4383,2515,1868,3124,1259
2003,Urban,Bihar,Other Crimes,Fraud,Male,0-12,9484,7140,2344,9293,191
2001,Urban,Rajasthan,Crime Against Children,Child Abuse,Female,46-60,3185,1408,1777,1476,1709
2001,Urban,Assam,Crime Against Men,Murder,Male,60+,6257,2203,4054,4405,1852
2008,Urban,Jharkhand,Property Crime,Vandalism,Male,46-60,5102,3139,1963,3499,1603
2003,Rural,Delhi,Property Crime,Vandalism,Male,13-17,1516,54,1462,449,1067
2003,Urban,Manipur,Crime Against Children,Kidnapping,Female,46-60,348,304,44,347,1
2002,Urban,Uttar Pradesh,Crime Against Children,Trafficking,Male,60+,6858,6550,308,6645,213
2003,Rural,Rajasthan,Crime Against Women,Molestation,Female,18-30,5143,1114,4029,3067,2076
2001,Urban,Sikkim,Other Crimes,Cyber Crime,Male,31-45,9346,4623,4723,7945,1401
2002,Urban,West Bengal,Crime Against Men,Robbery,Female,31-45,4669,1120,3549,3584,1085
2007,Rural,Arunachal Pradesh,Crime Against Women,Dowry Deaths,Female,18-30,2066,1814,252,1943,123
2002,Urban,Haryana,Crime Against Women,Domestic Violence,Female,13-17,7758,3237,4521,5592,2166
2005,Urban,Assam,Crime Against Women,Rape,Male,18-30,4648,1936,2712,4433,215
2006,Rural,Tamil Nadu,Crime Against Women,Rape,Female,60+,3400,1111,2289,1508,1892
2002,Urban,Bihar,Other Crimes,Corruption,Female,0-12,1828,136,1692,1432,396
2004,Urban,Andhra Pradesh,Crime Against Children,Child Abuse,Male,13-17,8794,8233,561,8240,554
2004,Urban,Uttar Pradesh,Property Crime,Theft,Male,46-60,71,49,22,65,6
2009,Rural,Madhya Pradesh,Property Crime,Burglary,Male,31-45,9319,8652,667,8831,488
2005,Urban,Tamil Nadu,Property Crime,Arson,Female,13-17,3526,3412,114,3457,69
2010,Urban,Andhra Pradesh,Other Crimes,Cyber Crime,Female,0-12,9812,9607,205,9689,123
2008,Urban,Meghalaya,Crime Against Men,Assault,Female,60+,3450,486,2964,3169,281
2004,Rural,Chhattisgarh,Crime Against Men,Robbery,Female,18-30,9480,8759,721,8818,662
2010,Rural,Uttarakhand,Crime Against Women,Rape,Male,18-30,6476,1318,5158,5952,524
2010,Urban,Tripura,Crime Against Men,Assault,Male,18-30,9852,9704,148,9780,72
2008,Urban,Odisha,Crime Against Women,Domestic Violence,Male,60+,5843,5249,594,5483,360
2008,Rural,Telangana,Crime Against Children,Kidnapping,Male,18-30,7218,6901,317,7188,30
2009,Rural,Meghalaya,Other Crimes,Fraud,Male,60+,5310,2575,2735,4796,514
2009,Rural,Sikkim,Crime Against Children,Kidnapping,Male,46-60,6636,6293,343,6531,105
2006,Rural,Mizoram,Crime Against Women,Domestic Violence,Male,0-12,2868,2106,762,2130,738
2002,Rural,Himachal Pradesh,Crime Against Women,Domestic Violence,Female,13-17,8137,2515,5622,5466,2671
2002,Rural,Himachal Pradesh,Crime Against Men,Robbery,Female,60+,1975,354,1621,830,1145
2010,Urban,Jammu & Kashmir,Property Crime,Theft,Female,0-12,6964,4698,2266,5164,1800
2006,Urban,Rajasthan,Other Crimes,Fraud,Male,46-60,2245,1657,588,1991,254
2010,Urban,Andhra Pradesh,Crime Against Children,Trafficking,Male,31-45,5331,1116,4215,3257,2074
2003,Rural,Chhattisgarh,Property Crime,Burglary,Female,13-17,6321,4430,1891,4511,1810
2001,Rural,Punjab,Crime Against Women,Domestic Violence,Male,60+,229,10,219,55,174
2002,Urban,Gujarat,Crime Against Women,Domestic Violence,Female,31-45,8175,7859,316,8144,31
2004,Urban,Andhra Pradesh,Crime Against Women,Molestation,Female,46-60,671,183,488,307,364
2005,Urban,Bihar,Property Crime,Arson,Female,13-17,7847,3838,4009,4139,3708
2003,Rural,Madhya Pradesh,Property Crime,Arson,Female,60+,5983,5245,738,5811,172
2003,Urban,Manipur,Crime Against Women,Dowry Deaths,Male,60+,8621,7444,1177,7731,890
2010,Rural,Meghalaya,Crime Against Women,Rape,Male,31-45,2016,1893,123,1915,101
2006,Rural,Tripura,Crime Against Children,Child Labor,Male,13-17,4816,430,4386,4766,50
2001,Urban,Himachal Pradesh,Other Crimes,Drug Offense,Male,46-60,5741,5033,708,5047,694
2008,Rural,Chhattisgarh,Crime Against Men,Assault,Male,0-12,1434,526,908,830,604
2008,Rural,Punjab,Crime Against Children,Child Labor,Female,60+,320,22,298,163,157
2008,Urban,Bihar,Crime Against Men,Robbery,Female,13-17,3906,2819,1087,3681,225
2007,Urban,Tamil Nadu,Crime Against Children,Trafficking,Female,13-17,1129,126,1003,1090,39
2007,Rural,Kerala,Crime Against Children,Child Abuse,Female,46-60,350,138,212,339,11
2010,Urban,West Bengal,Crime Against Men,Robbery,Female,46-60,5735,4542,1193,5424,311
2002,Urban,Kerala,Crime Against Women,Dowry Deaths,Male,0-12,1784,1536,248,1621,163
2006,Rural,Tripura,Property Crime,Arson,Female,60+,9238,3505,5733,8425,813
2005,Rural,Arunachal Pradesh,Other Crimes,Drug Offense,Male,46-60,2692,173,2519,433,2259
2002,Rural,Manipur,Other Crimes,Cyber Crime,Male,0-12,8131,3723,4408,6624,1507
2009,Rural,Telangana,Other Crimes,Drug Offense,Female,46-60,6374,3877,2497,5735,639
2007,Urban,Delhi,Crime Against Children,Trafficking,Female,13-17,658,469,189,514,144
2004,Rural,Maharashtra,Property Crime,Theft,Male,31-45,6935,2938,3997,2951,3984
2006,Urban,Madhya Pradesh,Other Crimes,Fraud,Female,31-45,2435,968,1467,2373,62
2006,Urban,Jammu & Kashmir,Crime Against Children,Child Labor,Female,0-12,792,544,248,747,45
2005,Urban,Meghalaya,Property Crime,Theft,Male,60+,8803,2283,6520,6844,1959
2009,Urban,Jharkhand,Property Crime,Vandalism,Female,31-45,6116,115,6001,3563,2553
2006,Rural,Punjab,Crime Against Children,Trafficking,Female,13-17,8809,4733,4076,5413,3396
2006,Rural,Andhra Pradesh,Crime Against Children,Kidnapping,Male,31-45,345,8,337,225,120
2001,Urban,West Bengal,Crime Against Women,Molestation,Female,31-45,8995,8816,179,8860,135
2005,Urban,Punjab,Other Crimes,Fraud,Male,13-17,241,0,241,57,184
2009,Rural,Madhya Pradesh,Crime Against Women,Rape,Female,60+,4394,1946,2448,2534,1860
2006,Urban,Uttar Pradesh,Other Crimes,Corruption,Male,46-60,9706,6713,2993,6779,2927
2001,Rural,Jammu & Kashmir,Crime Against Children,Child Abuse,Male,46-60,8633,770,7863,4221,4412
2010,Urban,Andhra Pradesh,Crime Against Children,Child Abuse,Female,13-17,7019,3903,3116,6604,415
2008,Rural,Tripura,Property Crime,Theft,Male,0-12,7674,1054,6620,2826,4848
2001,Rural,Arunachal Pradesh,Crime Against Children,Child Labor,Female,18-30,9248,6341,2907,7639,1609
2001,Urban,Chhattisgarh,Property Crime,Burglary,Male,31-45,6860,3510,3350,6724,136
2008,Urban,Nagaland,Crime Against Women,Dowry Deaths,Male,31-45,8589,3021,5568,7232,1357
2001,Urban,Andhra Pradesh,Other Crimes,Cyber Crime,Male,18-30,7143,4638,2505,7065,78
2006,Urban,Delhi,Property Crime,Burglary,Male,60+,4044,1750,2294,3703,341
2004,Rural,Madhya Pradesh,Crime Against Children,Child Abuse,Male,46-60,1337,131,1206,640,697
2001,Rural,Delhi,Crime Against Children,Trafficking,Male,31-45,6730,2960,3770,3502,3228
2002,Urban,Goa,Property Crime,Burglary,Female,46-60,1737,623,1114,1720,17
2009,Rural,Manipur,Other Crimes,Corruption,Male,46-60,542,252,290,493,49
2007,Urban,Chhattisgarh,Property Crime,Burglary,Male,18-30,2335,978,1357,2252,83
2010,Rural,Tripura,Crime Against Women,Rape,Female,0-12,5791,3514,2277,4195,1596
2009,Urban,Andhra Pradesh,Other Crimes,Fraud,Male,31-45,4012,106,3906,1887,2125
2005,Urban,Andhra Pradesh,Other Crimes,Drug Offense,Male,18-30,7482,3719,3763,5019,2463
2004,Rural,Rajasthan,Crime Against Children,Child Labor,Male,13-17,4421,24,4397,3314,1107
2006,Rural,Nagaland,Crime Against Women,Molestation,Male,46-60,3777,3651,126,3751,26
2009,Urban,Delhi,Crime Against Women,Dowry Deaths,Female,31-45,1183,762,421,1086,97
2008,Rural,Assam,Crime Against Children,Trafficking,Male,0-12,7773,177,7596,3519,4254
2010,Urban,Tripura,Crime Against Women,Molestation,Female,13-17,5234,5114,120,5217,17
2008,Rural,Haryana,Property Crime,Burglary,Male,13-17,4441,2017,2424,3653,788
2010,Urban,Maharashtra,Crime Against Men,Robbery,Male,31-45,4520,3829,691,3972,548
2002,Rural,Uttarakhand,Other Crimes,Corruption,Female,46-60,8472,3265,5207,3869,4603
2001,Rural,Telangana,Property Crime,Burglary,Male,60+,4852,2443,2409,2452,2400
2003,Rural,Nagaland,Crime Against Men,Assault,Male,31-45,5602,4750,852,5166,436
2007,Rural,Chhattisgarh,Crime Against Men,Robbery,Male,0-12,9195,3490,5705,8088,1107
2004,Rural,Mizoram,Property Crime,Burglary,Female,13-17,7326,5084,2242,6461,865
2001,Urban,Bihar,Crime Against Women,Domestic Violence,Male,46-60,6519,1634,4885,5368,1151
2009,Urban,Sikkim,Crime Against Men,Extortion,Female,60+,6083,521,5562,3381,2702
2009,Rural,Bihar,Property Crime,Vandalism,Male,31-45,629,540,89,595,34
2003,Rural,Goa,Property Crime,Vandalism,Male,46-60,1522,1072,450,1147,375
2001,Rural,Meghalaya,Property Crime,Theft,Female,31-45,8559,4896,3663,8244,315
2008,Rural,Telangana,Crime Against Children,Trafficking,Male,46-60,73,65,8,72,1
2007,Rural,Andhra Pradesh,Crime Against Children,Child Abuse,Male,13-17,8706,1807,6899,2190,6516
2008,Urban,Himachal Pradesh,Property Crime,Theft,Male,18-30,7402,2096,5306,5762,1640
2003,Rural,Punjab,Crime Against Women,Molestation,Female,0-12,2544,908,1636,2161,383
2001,Urban,Nagaland,Crime Against Women,Domestic Violence,Female,31-45,7255,3531,3724,6033,1222
2002,Urban,Punjab,Other Crimes,Drug Offense,Female,46-60,2602,2292,310,2553,49
2001,Rural,West Bengal,Crime Against Children,Trafficking,Female,46-60,8012,7459,553,7623,389
2004,Urban,Jammu & Kashmir,Property Crime,Burglary,Female,31-45,7812,2354,5458,4405,3407
2010,Urban,Rajasthan,Crime Against Children,Kidnapping,Female,18-30,5466,4642,824,5005,461
2008,Rural,Chhattisgarh,Other Crimes,Fraud,Male,60+,8054,5645,2409,6435,1619
2001,Rural,Jammu & Kashmir,Property Crime,Theft,Male,0-12,5421,4957,464,5397,24
2008,Urban,Karnataka,Crime Against Men,Murder,Female,13-17,6786,1849,4937,3244,3542
2003,Rural,Madhya Pradesh,Other Crimes,Drug Offense,Female,46-60,2117,1469,648,1471,646
2004,Rural,Tamil Nadu,Property Crime,Burglary,Male,46-60,1311,771,540,1040,271
2005,Rural,Arunachal Pradesh,Property Crime,Theft,Male,60+,2073,1412,661,1865,208
2006,Urban,Madhya Pradesh,Crime Against Children,Child Abuse,Male,46-60,4566,205,4361,944,3622
2006,Urban,Haryana,Other Crimes,Corruption,Male,31-45,7171,3590,3581,5596,1575
2003,Urban,Nagaland,Crime Against Men,Extortion,Female,46-60,2851,2810,41,2829,22
2008,Urban,Uttarakhand,Other Crimes,Fraud,Female,60+,363,194,169,331,32
2002,Rural,Nagaland,Crime Against Children,Child Labor,Female,0-12,8375,1739,6636,5406,2969
2007,Rural,Karnataka,Crime Against Men,Robbery,Female,46-60,311,73,238,283,28
2003,Urban,Meghalaya,Other Crimes,Drug Offense,Female,46-60,3585,2445,1140,3367,218
2004,Urban,Madhya Pradesh,Property Crime,Arson,Female,60+,9230,9147,83,9186,44
2010,Urban,Manipur,Crime Against Men,Murder,Female,0-12,9103,6961,2142,7395,1708
2004,Rural,Telangana,Crime Against Children,Trafficking,Male,60+,3993,3374,619,3860,133
2010,Urban,Jharkhand,Other Crimes,Cyber Crime,Female,31-45,425,219,206,276,149
2007,Rural,Jammu & Kashmir,Crime Against Men,Assault,Female,46-60,9565,7935,1630,8741,824
2005,Rural,Andhra Pradesh,Property Crime,Burglary,Male,0-12,6332,3046,3286,4240,2092
2003,Urban,Karnataka,Other Crimes,Corruption,Male,18-30,1315,503,812,898,417
2001,Urban,Punjab,Other Crimes,Cyber Crime,Female,18-30,5523,4545,978,5450,73
2007,Rural,Nagaland,Crime Against Women,Molestation,Male,46-60,6891,5809,1082,6561,330
2010,Urban,Assam,Crime Against Men,Assault,Female,18-30,7922,1578,6344,7693,229
2007,Rural,Telangana,Crime Against Women,Dowry Deaths,Female,0-12,4565,3476,1089,4381,184
2001,Rural,Nagaland,Crime Against Children,Kidnapping,Male,13-17,5998,1828,4170,4204,1794
2005,Urban,Odisha,Crime Against Children,Child Labor,Female,0-12,4661,2209,2452,3934,727
2006,Rural,Manipur,Crime Against Women,Domestic Violence,Female,60+,9673,9256,417,9471,202
2004,Rural,Tripura,Crime Against Children,Child Labor,Female,18-30,160,51,109,63,97
2006,Rural,West Bengal,Crime Against Children,Kidnapping,Male,18-30,261,129,132,153,108
2006,Rural,Assam,Crime Against Children,Child Abuse,Female,46-60,7663,6525,1138,7074,589
2006,Urban,Andhra Pradesh,Property Crime,Burglary,Female,31-45,5190,1751,3439,3520,1670
2004,Urban,Uttarakhand,Crime Against Children,Kidnapping,Male,0-12,7741,7550,191,7732,9
2009,Rural,Madhya Pradesh,Other Crimes,Fraud,Male,18-30,6312,4350,1962,4482,1830
2003,Urban,Odisha,Crime Against Children,Child Labor,Female,60+,3414,799,2615,1726,1688
2003,Rural,Jammu & Kashmir,Crime Against Men,Robbery,Male,31-45,3440,1000,2440,2794,646
2004,Rural,Nagaland,Property Crime,Theft,Male,18-30,7697,3199,4498,5280,2417
2003,Urban,Goa,Crime Against Women,Molestation,Female,18-30,530,482,48,484,46
2007,Rural,Mizoram,Crime Against Men,Murder,Female,46-60,8906,6269,2637,7915,991
2009,Rural,Assam,Crime Against Children,Child Abuse,Female,18-30,3931,1467,2464,2000,1931
2008,Rural,Uttarakhand,Crime Against Children,Child Abuse,Male,60+,4121,1956,2165,2502,1619
2004,Urban,Tripura,Other Crimes,Corruption,Female,31-45,2667,1290,1377,2361,306
2004,Urban,West Bengal,Crime Against Men,Robbery,Male,0-12,1498,1446,52,1486,12
2005,Rural,Meghalaya,Crime Against Children,Child Labor,Female,0-12,3560,667,2893,2413,1147
2008,Urban,Assam,Crime Against Men,Extortion,Female,31-45,9405,9154,251,9350,55
2002,Urban,Gujarat,Property Crime,Theft,Female,0-12,6452,5882,570,6195,257
2009,Rural,Nagaland,Crime Against Women,Domestic Violence,Male,18-30,836,254,582,321,515
2003,Rural,Manipur,Crime Against Men,Assault,Female,60+,6226,1157,5069,1708,4518
2006,Urban,Telangana,Crime Against Children,Child Labor,Female,18-30,2786,2010,776,2073,713
2002,Rural,Jharkhand,Crime Against Men,Murder,Male,31-45,2973,2541,432,2919,54
2001,Rural,Madhya Pradesh,Property Crime,Burglary,Male,18-30,2593,1,2592,1973,620
2009,Rural,Chhattisgarh,Crime Against Women,Rape,Male,46-60,3746,2081,1665,2586,1160
2004,Rural,Sikkim,Crime Against Men,Murder,Male,0-12,9638,9386,252,9587,51
2009,Rural,Bihar,Property Crime,Theft,Male,13-17,1159,870,289,928,231
2003,Urban,Mizoram,Crime Against Men,Murder,Male,46-60,7482,2248,5234,2827,4655
2008,Urban,Haryana,Other Crimes,Fraud,Male,46-60,2404,1904,500,2341,63
2009,Rural,Sikkim,Property Crime,Arson,Male,60+,7887,2000,5887,7674,213
2006,Urban,Himachal Pradesh,Crime Against Women,Dowry Deaths,Female,0-12,588,502,86,507,81
2005,Rural,Chhattisgarh,Crime Against Men,Extortion,Male,60+,6145,3193,2952,3684,2461
2006,Urban,Goa,Crime Against Children,Child Abuse,Male,60+,1299,329,970,888,411
2010,Rural,Uttarakhand,Crime Against Women,Dowry Deaths,Male,18-30,4540,1159,3381,1929,2611
2003,Urban,Uttar Pradesh,Crime Against Children,Kidnapping,Male,31-45,5375,862,4513,2380,2995
2009,Rural,Assam,Other Crimes,Corruption,Female,31-45,7322,130,7192,6973,349
2002,Rural,Andhra Pradesh,Crime Against Women,Molestation,Female,31-45,2650,730,1920,1969,681
2007,Urban,Maharashtra,Other Crimes,Drug Offense,Female,18-30,6930,4773,2157,5280,1650
2006,Urban,Uttar Pradesh,Crime Against Women,Rape,Female,46-60,6080,5865,215,5917,163
2010,Rural,Bihar,Other Crimes,Cyber Crime,Male,31-45,1621,417,1204,1040,581
2010,Rural,Himachal Pradesh,Crime Against Women,Domestic Violence,Male,18-30,4748,1755,2993,4238,510
2002,Urban,Nagaland,Property Crime,Arson,Male,0-12,5819,2966,2853,5345,474
2008,Rural,Punjab,Crime Against Men,Robbery,Male,13-17,7427,3739,3688,5410,2017
2006,Urban,Odisha,Crime Against Men,Extortion,Male,60+,8307,6147,2160,8045,262
2004,Rural,Meghalaya,Crime Against Children,Trafficking,Female,0-12,7965,574,7391,5055,2910
2006,Rural,Manipur,Property Crime,Theft,Male,13-17,4276,4227,49,4241,35
2004,Rural,Rajasthan,Property Crime,Arson,Male,46-60,135,2,133,66,69
2008,Rural,Himachal Pradesh,Property Crime,Burglary,Male,60+,5594,1022,4572,1176,4418
2001,Urban,Bihar,Crime Against Men,Robbery,Male,31-45,760,10,750,670,90
2009,Rural,Tamil Nadu,Crime Against Men,Extortion,Male,18-30,3581,465,3116,701,2880
2010,Rural,Arunachal Pradesh,Crime Against Children,Child Abuse,Male,0-12,8272,1605,6667,7107,1165
2008,Urban,Punjab,Crime Against Women,Dowry Deaths,Female,31-45,8449,3402,5047,6461,1988
2007,Urban,Kerala,Crime Against Men,Assault,Female,60+,2581,2408,173,2527,54
2006,Urban,Kerala,Crime Against Children,Trafficking,Male,31-45,9326,5284,4042,8440,886
2004,Rural,Himachal Pradesh,Other Crimes,Fraud,Female,46-60,6862,2888,3974,4041,2821
2005,Urban,Punjab,Crime Against Children,Kidnapping,Female,46-60,3992,1969,2023,2225,1767
2003,Rural,Nagaland,Crime Against Men,Assault,Female,60+,4945,751,4194,1492,3453
2005,Urban,Tamil Nadu,Other Crimes,Cyber Crime,Female,13-17,2520,1623,897,1642,878
2009,Rural,Jharkhand,Other Crimes,Drug Offense,Male,18-30,4415,3137,1278,3460,955
2009,Urban,Tripura,Crime Against Children,Child Abuse,Male,31-45,9474,7104,2370,8129,1345
2005,Rural,Sikkim,Crime Against Children,Trafficking,Female,46-60,8494,3131,5363,8274,220
2004,Urban,Odisha,Crime Against Women,Molestation,Male,13-17,4375,3621,754,3777,598
2003,Rural,Chhattisgarh,Crime Against Women,Rape,Female,46-60,5938,1338,4600,4065,1873
2010,Rural,Tripura,Other Crimes,Fraud,Female,13-17,8702,7798,904,7953,749
2007,Rural,Karnataka,Crime Against Women,Dowry Deaths,Female,13-17,8563,6669,1894,7899,664
2008,Urban,Odisha,Property Crime,Burglary,Female,0-12,700,177,523,473,227
2007,Rural,Telangana,Crime Against Children,Trafficking,Male,31-45,3408,2518,890,2552,856
2005,Urban,Mizoram,Crime Against Women,Molestation,Female,60+,8937,4527,4410,8135,802
2001,Rural,Delhi,Crime Against Men,Assault,Male,60+,7262,1291,5971,3340,3922
2008,Rural,Andhra Pradesh,Crime Against Women,Dowry Deaths,Female,60+,7384,1233,6151,5300,2084
2005,Urban,Mizoram,Crime Against Men,Extortion,Male,60+,4037,1244,2793,1836,2201
2009,Rural,Maharashtra,Property Crime,Theft,Female,0-12,3255,2189,1066,2459,796
2002,Rural,Assam,Property Crime,Theft,Female,18-30,9844,1427,8417,7626,2218
2004,Rural,Delhi,Crime Against Women,Domestic Violence,Male,46-60,2772,2046,726,2107,665
2007,Rural,Assam,Crime Against Children,Child Abuse,Female,46-60,907,151,756,276,631
2005,Urban,Tripura,Crime Against Women,Dowry Deaths,Male,46-60,729,721,8,728,1
2008,Rural,Delhi,Crime Against Children,Child Abuse,Male,60+,9251,6372,2879,7205,2046
2001,Rural,West Bengal,Crime Against Women,Molestation,Female,13-17,1821,1103,718,1809,12
2009,Rural,Uttarakhand,Crime Against Children,Child Abuse,Male,60+,7045,3708,3337,6074,971
2003,Urban,West Bengal,Crime Against Children,Kidnapping,Male,13-17,647,432,215,442,205
2001,Rural,Jammu & Kashmir,Other Crimes,Fraud,Male,31-45,9510,5447,4063,6280,3230
2003,Rural,Arunachal Pradesh,Crime Against Men,Robbery,Male,13-17,6132,2185,3947,5387,745
2007,Rural,Gujarat,Property Crime,Arson,Female,13-17,9508,2451,7057,2887,6621
2006,Urban,Gujarat,Crime Against Children,Child Labor,Female,31-45,1284,594,690,672,612
2003,Urban,Telangana,Crime Against Children,Kidnapping,Male,31-45,3113,2725,388,3035,78
2003,Rural,Andhra Pradesh,Property Crime,Arson,Female,60+,8929,435,8494,1436,7493
2004,Rural,Madhya Pradesh,Crime Against Women,Molestation,Male,13-17,6670,4118,2552,4923,1747
2004,Rural,Tripura,Crime Against Children,Trafficking,Male,18-30,8670,7633,1037,7805,865
2007,Rural,Tripura,Crime Against Children,Child Labor,Male,60+,7588,2353,5235,3139,4449
2007,Rural,Tamil Nadu,Crime Against Men,Assault,Male,13-17,7907,5468,2439,6452,1455
2004,Rural,Bihar,Property Crime,Vandalism,Male,18-30,8750,8665,85,8717,33
2007,Urban,Rajasthan,Crime Against Men,Assault,Male,13-17,7054,1837,5217,6866,188
2008,Rural,Karnataka,Property Crime,Burglary,Female,0-12,6387,3852,2535,5733,654
2008,Rural,Himachal Pradesh,Crime Against Children,Trafficking,Male,46-60,302,171,131,177,125
2004,Urban,Jharkhand,Crime Against Men,Murder,Male,13-17,4295,444,3851,4193,102
2009,Rural,Madhya Pradesh,Other Crimes,Drug Offense,Female,0-12,2001,1303,698,1485,516
2007,Urban,Tamil Nadu,Crime Against Women,Rape,Female,18-30,2380,1457,923,2267,113
2004,Urban,West Bengal,Crime Against Men,Murder,Male,31-45,8543,8302,241,8403,140
2004,Rural,Haryana,Crime Against Children,Child Abuse,Male,46-60,7732,5067,2665,6527,1205
2005,Urban,West Bengal,Other Crimes,Drug Offense,Male,13-17,6784,1744,5040,4450,2334
2003,Rural,Tripura,Crime Against Men,Assault,Female,31-45,5588,2865,2723,3970,1618
2006,Urban,Jharkhand,Crime Against Children,Child Abuse,Female,60+,6650,1425,5225,1552,5098
2003,Rural,Madhya Pradesh,Crime Against Women,Molestation,Female,13-17,6227,3491,2736,6203,24
2002,Rural,Andhra Pradesh,Property Crime,Vandalism,Male,18-30,3700,2648,1052,2979,721
2004,Rural,Rajasthan,Other Crimes,Cyber Crime,Male,46-60,5252,3712,1540,3984,1268
2006,Rural,Arunachal Pradesh,Other Crimes,Fraud,Male,60+,4715,3999,716,4120,595
2006,Urban,Arunachal Pradesh,Other Crimes,Drug Offense,Female,31-45,8810,8438,372,8797,13
2001,Rural,Himachal Pradesh,Property Crime,Theft,Male,13-17,8490,4442,4048,5582,2908
2002,Urban,Gujarat,Crime Against Men,Extortion,Male,46-60,3930,3033,897,3241,689
2001,Urban,Uttar Pradesh,Crime Against Children,Kidnapping,Female,18-30,9655,5111,4544,8732,923
2006,Rural,Assam,Property Crime,Arson,Female,46-60,8384,665,7719,6352,2032
2008,Urban,Punjab,Property Crime,Burglary,Male,31-45,8328,997,7331,6263,2065
2007,Urban,Andhra Pradesh,Other Crimes,Cyber Crime,Male,0-12,1682,1532,150,1539,143
2006,Urban,Nagaland,Property Crime,Theft,Female,60+,890,183,707,460,430
2003,Rural,Uttar Pradesh,Property Crime,Arson,Male,31-45,7261,6687,574,6773,488
2010,Urban,Delhi,Crime Against Women,Rape,Male,13-17,1863,1582,281,1779,84
2009,Rural,Jammu & Kashmir,Crime Against Children,Trafficking,Female,46-60,2268,1008,1260,1049,1219
2001,Rural,Haryana,Crime Against Men,Murder,Male,60+,4637,2151,2486,4125,512
2005,Urban,Haryana,Crime Against Children,Child Abuse,Female,60+,8395,7880,515,8039,356
2004,Urban,Goa,Other Crimes,Corruption,Male,0-12,4555,2939,1616,3534,1021
2008,Rural,Gujarat,Property Crime,Arson,Female,18-30,788,661,127,685,103
2009,Rural,Uttarakhand,Crime Against Children,Trafficking,Female,60+,5581,2678,2903,3375,2206
2007,Rural,Sikkim,Other Crimes,Fraud,Male,0-12,9994,7682,2312,9316,678
2007,Rural,Punjab,Crime Against Women,Molestation,Female,0-12,4173,1132,3041,3693,480
2010,Rural,Assam,Other Crimes,Corruption,Female,13-17,1813,715,1098,1494,319
2002,Urban,Bihar,Crime Against Men,Assault,Male,31-45,957,246,711,815,142
2003,Rural,Uttarakhand,Crime Against Men,Robbery,Male,46-60,741,172,569,577,164
2009,Urban,Jharkhand,Crime Against Women,Dowry Deaths,Male,0-12,2411,2019,392,2283,128
2004,Urban,Kerala,Crime Against Women,Molestation,Male,60+,8446,8188,258,8390,56
2005,Urban,West Bengal,Crime Against Men,Extortion,Female,46-60,4165,600,3565,1738,2427
2004,Rural,Bihar,Property Crime,Arson,Female,0-12,7626,6349,1277,6650,976
2004,Urban,Madhya Pradesh,Crime Against Children,Trafficking,Male,31-45,8300,4352,3948,7637,663
2001,Urban,Karnataka,Crime Against Women,Molestation,Female,18-30,2938,2765,173,2882,56
2005,Urban,Odisha,Other Crimes,Corruption,Male,31-45,6433,3334,3099,3428,3005
2010,Urban,Maharashtra,Other Crimes,Corruption,Female,46-60,8620,6678,1942,8337,283
2003,Rural,Maharashtra,Other Crimes,Corruption,Male,31-45,70,67,3,68,2
2002,Rural,Assam,Other Crimes,Cyber Crime,Female,46-60,8651,3896,4755,7137,1514
2008,Urban,Himachal Pradesh,Crime Against Women,Dowry Deaths,Female,60+,5031,4611,420,4785,246
2009,Rural,Andhra Pradesh,Crime Against Children,Child Abuse,Male,18-30,5730,1784,3946,2409,3321
2009,Urban,Meghalaya,Other Crimes,Cyber Crime,Male,13-17,7537,299,7238,1914,5623
2010,Rural,Odisha,Property Crime,Vandalism,Female,18-30,3682,1252,2430,2069,1613
2010,Rural,Goa,Crime Against Children,Child Abuse,Male,46-60,6626,986,5640,3839,2787
2010,Rural,Gujarat,Crime Against Men,Extortion,Male,18-30,4171,462,3709,2380,1791
2007,Rural,Mizoram,Crime Against Children,Child Labor,Male,13-17,4935,1373,3562,2517,2418
2008,Rural,Andhra Pradesh,Crime Against Men,Assault,Female,46-60,9466,686,8780,9424,42
2001,Urban,Himachal Pradesh,Crime Against Children,Kidnapping,Female,46-60,9128,4289,4839,5789,3339
2010,Rural,Sikkim,Crime Against Children,Trafficking,Female,18-30,6506,895,5611,3269,3237
2007,Rural,Mizoram,Other Crimes,Corruption,Female,46-60,2630,1312,1318,2005,625
2006,Rural,Telangana,Property Crime,Arson,Female,60+,3132,2507,625,2636,496
2010,Rural,Meghalaya,Crime Against Women,Rape,Female,13-17,7123,231,6892,1949,5174
2007,Rural,Punjab,Crime Against Men,Murder,Female,13-17,4204,3554,650,3856,348
2008,Rural,West Bengal,Crime Against Women,Rape,Female,46-60,6371,6223,148,6370,1
2007,Rural,Rajasthan,Crime Against Men,Assault,Female,0-12,1613,1413,200,1437,176
2003,Rural,Odisha,Crime Against Women,Dowry Deaths,Male,31-45,2120,1857,263,2078,42
2008,Urban,Rajasthan,Property Crime,Vandalism,Male,18-30,1547,1415,132,1436,111
2003,Urban,Odisha,Other Crimes,Fraud,Male,31-45,1848,1801,47,1834,14
2001,Rural,Gujarat,Crime Against Men,Extortion,Female,60+,7925,7220,705,7893,32
2004,Urban,Sikkim,Crime Against Men,Robbery,Male,46-60,3612,3001,611,3240,372
2009,Rural,Rajasthan,Crime Against Children,Trafficking,Male,60+,781,81,700,578,203
2005,Rural,Mizoram,Other Crimes,Drug Offense,Male,46-60,4334,3604,730,4195,139
2002,Rural,Tamil Nadu,Property Crime,Theft,Male,18-30,4294,1159,3135,2073,2221
2004,Urban,Punjab,Property Crime,Theft,Female,0-12,7745,5251,2494,7696,49
2007,Urban,Haryana,Crime Against Women,Molestation,Female,31-45,8457,2529,5928,4077,4380
2003,Rural,Bihar,Crime Against Women,Dowry Deaths,Female,0-12,8542,6674,1868,7187,1355
2002,Rural,Tamil Nadu,Other Crimes,Drug Offense,Male,13-17,4913,2538,2375,2585,2328
2003,Urban,West Bengal,Crime Against Women,Dowry Deaths,Female,46-60,215,188,27,200,15
2008,Rural,Gujarat,Other Crimes,Corruption,Male,60+,9833,7898,1935,8791,1042
2003,Rural,Himachal Pradesh,Crime Against Men,Murder,Female,18-30,1293,508,785,1289,4
2007,Urban,Himachal Pradesh,Property Crime,Arson,Male,0-12,3301,2373,928,2957,344
2003,Urban,Odisha,Crime Against Women,Domestic Violence,Female,46-60,8910,3522,5388,4388,4522
2002,Urban,Sikkim,Crime Against Children,Trafficking,Female,60+,1774,811,963,1304,470
2002,Urban,Meghalaya,Other Crimes,Corruption,Male,46-60,600,391,209,585,15
2009,Rural,Himachal Pradesh,Property Crime,Theft,Male,13-17,4231,2785,1446,3177,1054
2007,Urban,Uttar Pradesh,Crime Against Women,Rape,Female,0-12,7549,2717,4832,6060,1489
2001,Rural,Arunachal Pradesh,Crime Against Women,Domestic Violence,Male,18-30,5636,341,5295,528,5108
2001,Urban,Tamil Nadu,Crime Against Children,Kidnapping,Female,0-12,9385,1825,7560,9314,71
2010,Rural,Delhi,Crime Against Men,Assault,Male,18-30,4504,1535,2969,2928,1576
2008,Urban,Uttar Pradesh,Crime Against Children,Child Labor,Female,46-60,1625,546,1079,727,898
2006,Urban,Punjab,Other Crimes,Cyber Crime,Male,0-12,5659,2417,3242,5061,598
2009,Urban,Gujarat,Crime Against Children,Child Labor,Male,13-17,8044,5980,2064,7191,853
2007,Rural,Mizoram,Crime Against Men,Extortion,Female,0-12,2404,2192,212,2387,17
2007,Rural,Himachal Pradesh,Crime Against Women,Domestic Violence,Female,46-60,1261,942,319,1194,67
2002,Rural,Maharashtra,Property Crime,Theft,Female,13-17,3737,2077,1660,2376,1361
2009,Rural,Uttarakhand,Crime Against Women,Dowry Deaths,Male,18-30,461,240,221,289,172
2007,Urban,Meghalaya,Property Crime,Arson,Male,13-17,2347,635,1712,2027,320
2008,Urban,Assam,Crime Against Children,Child Abuse,Male,46-60,1812,368,1444,750,1062
2009,Urban,Mizoram,Crime Against Women,Molestation,Female,0-12,8914,1751,7163,1760,7154
2006,Urban,Goa,Crime Against Men,Robbery,Female,18-30,7776,2761,5015,6606,1170
2002,Rural,Punjab,Other Crimes,Cyber Crime,Female,18-30,7716,4925,2791,5004,2712
2006,Rural,Mizoram,Crime Against Women,Rape,Male,18-30,2023,1124,899,1545,478
2001,Rural,Odisha,Property Crime,Arson,Female,60+,784,575,209,735,49
2007,Urban,Maharashtra,Other Crimes,Corruption,Male,18-30,2470,1409,1061,2440,30
2010,Rural,Odisha,Crime Against Men,Extortion,Male,0-12,6050,66,5984,1515,4535
2009,Rural,Goa,Crime Against Women,Dowry Deaths,Female,0-12,8883,8879,4,8882,1
2004,Urban,West Bengal,Crime Against Men,Murder,Male,60+,1505,334,1171,696,809
2003,Rural,Odisha,Crime Against Children,Child Labor,Female,0-12,3412,1472,1940,1796,1616
2003,Rural,Uttar Pradesh,Crime Against Children,Child Abuse,Male,46-60,4027,1347,2680,1381,2646
2007,Rural,Karnataka,Crime Against Men,Extortion,Female,0-12,9750,3619,6131,6739,3011
2002,Urban,Assam,Crime Against Women,Dowry Deaths,Male,46-60,5534,3786,1748,4468,1066
2002,Rural,Haryana,Property Crime,Vandalism,Female,46-60,8809,3401,5408,5306,3503
2002,Urban,Himachal Pradesh,Other Crimes,Cyber Crime,Female,0-12,3190,1532,1658,2948,242
2002,Rural,Jharkhand,Other Crimes,Fraud,Male,60+,7318,2635,4683,3431,3887
2004,Urban,Jammu & Kashmir,Property Crime,Arson,Female,18-30,2186,399,1787,757,1429
2008,Urban,Delhi,Other Crimes,Fraud,Male,46-60,9672,7041,2631,8356,1316
2008,Rural,Rajasthan,Other Crimes,Corruption,Male,60+,8959,1605,7354,2837,6122
2005,Rural,Sikkim,Crime Against Women,Domestic Violence,Female,46-60,4239,1007,3232,2500,1739
2008,Rural,Goa,Crime Against Men,Assault,Female,46-60,541,491,50,520,21
2003,Urban,Jharkhand,Crime Against Men,Extortion,Male,46-60,503,155,348,358,145
2005,Urban,Odisha,Crime Against Children,Child Labor,Female,60+,8103,4878,3225,5992,2111
2005,Rural,Jharkhand,Property Crime,Theft,Male,18-30,7098,1712,5386,3664,3434
2001,Rural,West Bengal,Other Crimes,Drug Offense,Male,60+,6925,4979,1946,5136,1789
2006,Urban,West Bengal,Crime Against Women,Rape,Female,31-45,9022,5845,3177,7118,1904
2001,Urban,Mizoram,Crime Against Men,Extortion,Female,46-60,9605,6630,2975,8081,1524
2004,Urban,Tamil Nadu,Crime Against Men,Assault,Female,31-45,3634,145,3489,2014,1620
2006,Rural,Punjab,Other Crimes,Drug Offense,Male,0-12,6739,1044,5695,5104,1635
2005,Rural,Uttar Pradesh,Crime Against Men,Murder,Female,60+,3232,2009,1223,2791,441
2010,Rural,Assam,Crime Against Women,Dowry Deaths,Male,0-12,1332,1312,20,1325,7
2010,Urban,Jammu & Kashmir,Crime Against Women,Domestic Violence,Male,31-45,1214,82,1132,569,645
2004,Rural,Gujarat,Property Crime,Vandalism,Male,0-12,3444,9,3435,683,2761
2009,Urban,Tamil Nadu,Crime Against Children,Child Labor,Female,13-17,4027,483,3544,2941,1086
2009,Urban,Telangana,Crime Against Women,Domestic Violence,Male,60+,9333,5259,4074,5655,3678
2006,Urban,Chhattisgarh,Crime Against Children,Child Abuse,Male,0-12,7269,2258,5011,3146,4123
2001,Urban,Jammu & Kashmir,Crime Against Men,Robbery,Male,0-12,8751,4528,4223,8428,323
2009,Urban,Chhattisgarh,Crime Against Men,Assault,Male,31-45,6520,6201,319,6242,278
2002,Urban,Rajasthan,Property Crime,Vandalism,Female,31-45,7921,3583,4338,5113,2808
2010,Urban,Chhattisgarh,Other Crimes,Corruption,Female,31-45,5202,3359,1843,3879,1323
2003,Rural,Himachal Pradesh,Crime Against Children,Child Abuse,Female,18-30,4342,3926,416,4211,131
2001,Rural,Gujarat,Crime Against Children,Kidnapping,Male,60+,4596,4231,365,4417,179
2006,Urban,Rajasthan,Crime Against Women,Domestic Violence,Male,46-60,2609,762,1847,1313,1296
2002,Rural,Telangana,Crime Against Women,Dowry Deaths,Female,46-60,2382,103,2279,1869,513
2003,Rural,Gujarat,Property Crime,Burglary,Male,13-17,609,467,142,594,15
2007,Urban,Uttar Pradesh,Other Crimes,Fraud,Male,0-12,2910,1038,1872,1457,1453
2001,Urban,Sikkim,Crime Against Men,Robbery,Female,18-30,5352,2001,3351,3482,1870
2005,Rural,Chhattisgarh,Crime Against Women,Rape,Female,60+,1342,556,786,999,343
2001,Urban,Odisha,Crime Against Men,Assault,Female,31-45,106,13,93,96,10
2004,Rural,Kerala,Crime Against Men,Murder,Female,13-17,5544,1019,4525,2915,2629
2001,Rural,Punjab,Crime Against Children,Child Labor,Male,31-45,5136,3619,1517,4791,345
2009,Rural,West Bengal,Property Crime,Theft,Male,0-12,8396,6921,1475,8343,53
2007,Urban,Haryana,Crime Against Children,Child Labor,Female,13-17,8360,492,7868,4395,3965
2006,Rural,Delhi,Crime Against Children,Kidnapping,Female,31-45,7380,2658,4722,3200,4180
2006,Urban,Bihar,Other Crimes,Fraud,Female,18-30,1432,664,768,987,445
2010,Urban,Mizoram,Other Crimes,Corruption,Male,46-60,7905,7132,773,7528,377
2008,Rural,Himachal Pradesh,Other Crimes,Fraud,Male,0-12,3285,171,3114,3193,92
2010,Rural,Tripura,Crime Against Women,Domestic Violence,Male,13-17,6490,4442,2048,5166,1324
2006,Rural,Delhi,Property Crime,Theft,Female,18-30,4141,3361,780,4034,107
2005,Rural,Assam,Crime Against Men,Murder,Female,13-17,54,23,31,23,31
2006,Urban,Bihar,Crime Against Women,Domestic Violence,Male,46-60,7994,1074,6920,4366,3628
2010,Urban,Karnataka,Crime Against Men,Assault,Male,31-45,9027,3683,5344,6218,2809
2007,Urban,Odisha,Crime Against Children,Kidnapping,Female,18-30,351,213,138,310,41
2010,Urban,Tamil Nadu,Property Crime,Burglary,Male,13-17,6403,528,5875,5539,864
2001,Urban,Tamil Nadu,Crime Against Women,Rape,Male,60+,7604,4848,2756,6960,644
2003,Urban,Jammu & Kashmir,Crime Against Children,Trafficking,Male,0-12,6280,5456,824,6110,170
2003,Urban,Assam,Crime Against Children,Trafficking,Male,18-30,9996,3248,6748,7891,2105
2010,Urban,Madhya Pradesh,Other Crimes,Fraud,Female,0-12,3930,1419,2511,1678,2252
2001,Rural,Maharashtra,Other Crimes,Corruption,Male,13-17,211,51,160,120,91
2004,Rural,Jharkhand,Property Crime,Vandalism,Male,0-12,4927,794,4133,2588,2339
2010,Rural,Himachal Pradesh,Crime Against Children,Kidnapping,Male,0-12,3029,2696,333,2770,259
2010,Rural,Assam,Crime Against Men,Robbery,Female,31-45,3205,1802,1403,2497,708
2006,Urban,Gujarat,Crime Against Women,Molestation,Female,0-12,7705,912,6793,5268,2437
2006,Urban,Jammu & Kashmir,Crime Against Men,Robbery,Male,0-12,9930,479,9451,9804,126
2010,Rural,Rajasthan,Crime Against Children,Child Labor,Female,13-17,2948,180,2768,622,2326
2009,Urban,Madhya Pradesh,Crime Against Women,Rape,Female,0-12,2726,2349,377,2659,67
2005,Rural,Jammu & Kashmir,Other Crimes,Fraud,Female,13-17,7920,4811,3109,6739,1181
2004,Rural,Himachal Pradesh,Property Crime,Vandalism,Female,0-12,3226,1267,1959,2857,369
2001,Urban,Andhra Pradesh,Crime Against Men,Extortion,Male,46-60,3218,918,2300,2148,1070
2008,Urban,Uttar Pradesh,Property Crime,Vandalism,Male,13-17,9409,147,9262,1934,7475
2010,Urban,Jammu & Kashmir,Crime Against Men,Murder,Female,0-12,7628,1023,6605,6828,800
2007,Urban,Manipur,Other Crimes,Drug Offense,Female,0-12,3842,1187,2655,3228,614
2001,Urban,Maharashtra,Property Crime,Arson,Male,31-45,4418,1190,3228,2769,1649
2009,Urban,Tripura,Other Crimes,Drug Offense,Female,13-17,9354,7714,1640,7923,1431
2001,Urban,Tripura,Crime Against Men,Extortion,Female,46-60,5314,588,4726,2331,2983
2001,Rural,Chhattisgarh,Other Crimes,Fraud,Male,13-17,8720,418,8302,6715,2005
2003,Urban,Assam,Property Crime,Burglary,Male,60+,8030,332,7698,1245,6785
2009,Urban,Andhra Pradesh,Other Crimes,Cyber Crime,Male,0-12,3896,3820,76,3838,58
2006,Rural,Meghalaya,Crime Against Men,Assault,Male,0-12,4620,4166,454,4218,402
2001,Rural,Bihar,Crime Against Children,Child Labor,Male,18-30,5103,276,4827,2461,2642
2007,Urban,Chhattisgarh,Crime Against Women,Molestation,Male,31-45,717,248,469,283,434
2008,Urban,Nagaland,Crime Against Children,Trafficking,Male,18-30,6375,3115,3260,4082,2293
2003,Rural,Nagaland,Crime Against Men,Murder,Male,0-12,7262,6200,1062,6420,842
2010,Urban,Tamil Nadu,Crime Against Women,Rape,Female,46-60,6999,2617,4382,5750,1249
2007,Rural,Karnataka,Crime Against Men,Robbery,Male,13-17,8444,3895,4549,4528,3916
2007,Rural,Mizoram,Crime Against Children,Kidnapping,Male,13-17,531,434,97,443,88
2008,Rural,Bihar,Crime Against Women,Molestation,Male,46-60,3939,872,3067,1836,2103
2007,Urban,Karnataka,Crime Against Women,Rape,Male,46-60,723,492,231,573,150
2006,Rural,Uttarakhand,Other Crimes,Cyber Crime,Female,18-30,8459,8404,55,8410,49
2004,Urban,Nagaland,Crime Against Children,Trafficking,Male,0-12,3497,1794,1703,3280,217
2009,Rural,Nagaland,Property Crime,Burglary,Female,46-60,5641,5020,621,5567,74
2003,Rural,Uttarakhand,Property Crime,Arson,Male,13-17,1509,797,712,843,666
2003,Urban,Karnataka,Property Crime,Theft,Male,13-17,6094,3013,3081,5512,582
2003,Rural,Assam,Crime Against Women,Domestic Violence,Female,13-17,7734,483,7251,6571,1163
2004,Rural,Kerala,Crime Against Children,Child Labor,Male,0-12,4293,2886,1407,3566,727
2008,Rural,Jharkhand,Crime Against Women,Dowry Deaths,Male,0-12,757,51,706,720,37
2006,Urban,Nagaland,Other Crimes,Drug Offense,Male,18-30,7753,6691,1062,7002,751
2004,Urban,Jammu & Kashmir,Other Crimes,Cyber Crime,Female,13-17,582,152,430,407,175
2004,Rural,Gujarat,Other Crimes,Corruption,Female,18-30,1106,235,871,672,434
2010,Rural,West Bengal,Crime Against Women,Domestic Violence,Female,18-30,3523,1152,2371,2228,1295
2005,Urban,Andhra Pradesh,Crime Against Men,Assault,Female,60+,8889,2706,6183,8888,1
2010,Urban,Uttar Pradesh,Other Crimes,Cyber Crime,Male,60+,1529,1275,254,1426,103
2008,Urban,Rajasthan,Crime Against Men,Murder,Male,60+,6196,3171,3025,3481,2715
2008,Rural,Jammu & Kashmir,Crime Against Men,Robbery,Male,13-17,4364,2126,2238,2398,1966
2004,Urban,Punjab,Other Crimes,Drug Offense,Female,18-30,3561,2383,1178,2551,1010
2006,Urban,Rajasthan,Crime Against Women,Molestation,Female,46-60,8877,7726,1151,8783,94
2003,Urban,Bihar,Other Crimes,Corruption,Female,0-12,6408,4403,2005,5797,611
2002,Urban,Nagaland,Crime Against Women,Molestation,Male,31-45,5040,297,4743,4616,424
2004,Rural,Gujarat,Crime Against Women,Dowry Deaths,Male,60+,9622,5214,4408,8918,704
2010,Rural,Punjab,Property Crime,Arson,Female,60+,3590,3031,559,3151,439
2007,Urban,Jammu & Kashmir,Property Crime,Burglary,Male,60+,6424,336,6088,3584,2840
2010,Urban,Jammu & Kashmir,Crime Against Men,Extortion,Female,13-17,8703,6139,2564,6712,1991
2006,Rural,Odisha,Crime Against Children,Trafficking,Female,18-30,4603,729,3874,2963,1640
2006,Urban,Uttarakhand,Crime Against Children,Child Labor,Male,0-12,2547,1443,1104,1749,798
2007,Urban,Punjab,Property Crime,Theft,Male,60+,5491,2519,2972,3840,1651
2009,Urban,Gujarat,Property Crime,Theft,Female,13-17,7239,369,6870,3891,3348
2008,Rural,Himachal Pradesh,Crime Against Children,Child Labor,Male,13-17,8011,7740,271,7923,88
2002,Urban,Haryana,Property Crime,Theft,Female,18-30,7017,2300,4717,2702,4315
2010,Rural,Rajasthan,Other Crimes,Corruption,Male,60+,8935,3395,5540,5468,3467
2009,Rural,Kerala,Property Crime,Arson,Female,0-12,9256,141,9115,7799,1457
2003,Urban,Delhi,Crime Against Children,Child Abuse,Female,31-45,5224,1854,3370,4329,895
2009,Urban,Kerala,Crime Against Women,Dowry Deaths,Female,13-17,8437,7021,1416,7839,598
2002,Rural,Meghalaya,Other Crimes,Corruption,Male,60+,304,14,290,246,58
2003,Urban,Mizoram,Crime Against Children,Trafficking,Female,0-12,3666,846,2820,2467,1199
2005,Rural,Uttar Pradesh,Crime Against Men,Murder,Female,18-30,2089,1585,504,1766,323
2003,Rural,Gujarat,Crime Against Men,Murder,Male,18-30,7755,2733,5022,6139,1616
2006,Urban,Andhra Pradesh,Crime Against Children,Trafficking,Female,60+,5866,1473,4393,2915,2951
2002,Rural,Delhi,Crime Against Children,Child Abuse,Male,0-12,4358,990,3368,4140,218
2003,Urban,Karnataka,Crime Against Women,Molestation,Female,18-30,3045,1629,1416,2744,301
2002,Rural,Kerala,Crime Against Men,Murder,Male,60+,4299,1112,3187,1192,3107
2006,Urban,Uttar Pradesh,Crime Against Men,Robbery,Female,31-45,1425,1370,55,1396,29
2009,Urban,Madhya Pradesh,Property Crime,Vandalism,Female,0-12,1952,1165,787,1698,254
2008,Rural,Nagaland,Crime Against Men,Robbery,Male,0-12,7074,2126,4948,3336,3738
2002,Urban,Andhra Pradesh,Crime Against Women,Dowry Deaths,Female,31-45,3691,912,2779,2840,851
2002,Urban,Andhra Pradesh,Crime Against Women,Dowry Deaths,Male,60+,5784,1531,4253,3617,2167
2006,Urban,Chhattisgarh,Crime Against Men,Murder,Female,46-60,6053,606,5447,5123,930
2004,Urban,Delhi,Property Crime,Theft,Female,13-17,5182,2528,2654,4776,406
2002,Rural,Andhra Pradesh,Other Crimes,Drug Offense,Male,46-60,5584,1564,4020,5067,517
2001,Urban,Andhra Pradesh,Crime Against Children,Child Abuse,Female,31-45,6651,422,6229,3269,3382
2009,Urban,Chhattisgarh,Other Crimes,Corruption,Female,46-60,671,255,416,512,159
2002,Urban,Goa,Crime Against Women,Rape,Male,46-60,8915,3100,5815,4962,3953
2008,Rural,Jharkhand,Other Crimes,Drug Offense,Male,0-12,8092,3254,4838,4877,3215
2009,Urban,Madhya Pradesh,Crime Against Men,Extortion,Male,60+,4533,2258,2275,3488,1045
2009,Rural,Jharkhand,Crime Against Children,Child Abuse,Female,31-45,2999,1888,1111,2226,773
2001,Urban,Karnataka,Other Crimes,Corruption,Male,13-17,8562,7375,1187,7671,891
2009,Urban,Madhya Pradesh,Crime Against Women,Molestation,Female,31-45,9977,3228,6749,9258,719
2009,Urban,Punjab,Other Crimes,Corruption,Male,0-12,4501,795,3706,2411,2090
2009,Rural,Delhi,Other Crimes,Drug Offense,Female,18-30,3434,491,2943,2765,669
2007,Rural,Andhra Pradesh,Crime Against Men,Murder,Male,46-60,316,267,49,309,7
2010,Urban,Telangana,Other Crimes,Cyber Crime,Male,18-30,2524,1410,1114,2105,419
2002,Urban,Kerala,Crime Against Women,Domestic Violence,Female,13-17,3480,1626,1854,2364,1116
2002,Urban,Tamil Nadu,Property Crime,Vandalism,Male,0-12,7325,1436,5889,5228,2097
2001,Urban,Delhi,Crime Against Men,Robbery,Male,13-17,6687,5034,1653,5966,721
2005,Urban,Meghalaya,Crime Against Women,Rape,Female,13-17,8351,2109,6242,7246,1105
2003,Rural,Tripura,Property Crime,Theft,Female,60+,6258,3837,2421,6237,21
2005,Rural,Assam,Crime Against Men,Extortion,Female,18-30,4583,3075,1508,4189,394
2006,Urban,Chhattisgarh,Crime Against Women,Dowry Deaths,Female,0-12,6074,5838,236,5899,175
2006,Rural,Telangana,Crime Against Men,Murder,Male,0-12,7833,455,7378,740,7093
2007,Urban,Assam,Crime Against Children,Kidnapping,Male,31-45,211,162,49,181,30
2010,Rural,Nagaland,Crime Against Women,Dowry Deaths,Female,18-30,9628,7804,1824,8880,748
2006,Rural,Uttar Pradesh,Other Crimes,Corruption,Male,18-30,3615,1143,2472,1920,1695
2001,Rural,Tamil Nadu,Property Crime,Theft,Female,46-60,788,128,660,783,5
2007,Urban,Andhra Pradesh,Other Crimes,Drug Offense,Male,31-45,9457,5549,3908,6907,2550
2005,Rural,Himachal Pradesh,Other Crimes,Cyber Crime,Male,60+,5664,4841,823,5247,417
2007,Urban,Assam,Crime Against Men,Extortion,Male,13-17,1722,765,957,1006,716
2007,Rural,Kerala,Crime Against Women,Dowry Deaths,Female,0-12,5039,1914,3125,3833,1206
2003,Rural,Himachal Pradesh,Crime Against Women,Rape,Male,18-30,4372,3737,635,3815,557
2003,Rural,Delhi,Crime Against Men,Robbery,Male,13-17,8461,3842,4619,5019,3442
2001,Rural,Jharkhand,Other Crimes,Fraud,Male,13-17,9900,7386,2514,9521,379
2010,Rural,Maharashtra,Crime Against Women,Molestation,Male,0-12,4620,4408,212,4492,128
2007,Urban,Gujarat,Other Crimes,Corruption,Male,60+,4378,1511,2867,1580,2798
2002,Rural,Jammu & Kashmir,Crime Against Men,Assault,Female,13-17,5733,5619,114,5648,85
2009,Urban,Uttar Pradesh,Crime Against Men,Murder,Male,13-17,3299,997,2302,1570,1729
2003,Urban,Madhya Pradesh,Property Crime,Arson,Female,13-17,4051,3372,679,3564,487
2009,Urban,Jharkhand,Crime Against Children,Child Abuse,Male,31-45,9369,5544,3825,6407,2962
2006,Urban,Jharkhand,Other Crimes,Fraud,Female,18-30,6348,4747,1601,5295,1053
2007,Urban,Meghalaya,Other Crimes,Corruption,Male,13-17,7711,3754,3957,7680,31
2006,Rural,Manipur,Other Crimes,Drug Offense,Male,13-17,1003,175,828,630,373
2001,Rural,Maharashtra,Crime Against Children,Trafficking,Female,46-60,1971,173,1798,331,1640
2002,Rural,Chhattisgarh,Property Crime,Burglary,Female,46-60,7796,3559,4237,3962,3834
2003,Urban,Odisha,Crime Against Children,Child Abuse,Female,31-45,9300,2585,6715,6689,2611
2004,Rural,Haryana,Property Crime,Theft,Male,18-30,1692,93,1599,1018,674
2004,Rural,Punjab,Crime Against Men,Extortion,Female,46-60,324,107,217,161,163
2008,Urban,Delhi,Crime Against Men,Assault,Male,13-17,609,567,42,588,21
2009,Rural,Maharashtra,Property Crime,Burglary,Male,13-17,1649,269,1380,470,1179
2002,Urban,Tripura,Crime Against Men,Assault,Female,18-30,616,493,123,524,92
2002,Rural,Mizoram,Crime Against Children,Trafficking,Male,60+,8875,5929,2946,5984,2891
2009,Rural,Assam,Crime Against Men,Murder,Female,13-17,637,493,144,566,71
2007,Urban,Chhattisgarh,Crime Against Men,Robbery,Male,0-12,9297,7409,1888,8411,886
2006,Urban,Tamil Nadu,Other Crimes,Drug Offense,Female,46-60,9212,1175,8037,1537,7675
2003,Rural,Uttar Pradesh,Crime Against Women,Rape,Male,31-45,5402,3099,2303,5340,62
2009,Urban,Andhra Pradesh,Property Crime,Vandalism,Female,46-60,703,327,376,481,222
2002,Rural,Andhra Pradesh,Crime Against Women,Molestation,Female,18-30,263,55,208,156,107
2005,Urban,Haryana,Crime Against Children,Trafficking,Female,60+,5854,2634,3220,5016,838
2006,Urban,Telangana,Crime Against Men,Robbery,Female,46-60,9459,6364,3095,7304,2155
2004,Urban,Andhra Pradesh,Other Crimes,Cyber Crime,Female,0-12,912,891,21,898,14
2008,Urban,Rajasthan,Property Crime,Burglary,Male,0-12,2739,1016,1723,1365,1374
2002,Rural,Kerala,Crime Against Men,Extortion,Female,31-45,3115,981,2134,2451,664
2010,Urban,Sikkim,Crime Against Women,Molestation,Female,18-30,5025,179,4846,601,4424
2004,Rural,Tamil Nadu,Crime Against Men,Murder,Male,60+,4373,3109,1264,3273,1100
2004,Rural,Tamil Nadu,Crime Against Children,Child Abuse,Male,18-30,5584,249,5335,4715,869
2009,Rural,Rajasthan,Other Crimes,Fraud,Male,0-12,2349,1051,1298,2200,149
2001,Rural,Uttar Pradesh,Property Crime,Burglary,Female,13-17,2936,1529,1407,1811,1125
2001,Urban,Sikkim,Crime Against Children,Child Abuse,Female,0-12,6305,3180,3125,5470,835
2008,Rural,Bihar,Other Crimes,Drug Offense,Male,46-60,9932,1691,8241,1959,7973
2008,Urban,Uttar Pradesh,Crime Against Children,Child Labor,Male,13-17,3362,2478,884,2732,630
2007,Rural,Gujarat,Other Crimes,Corruption,Male,0-12,5543,4126,1417,4458,1085
2007,Urban,Arunachal Pradesh,Crime Against Children,Kidnapping,Male,60+,2040,1965,75,2005,35
2009,Urban,Tamil Nadu,Property Crime,Burglary,Female,0-12,5727,4468,1259,4902,825
2004,Rural,West Bengal,Property Crime,Arson,Female,18-30,1771,375,1396,1048,723
2009,Rural,Assam,Crime Against Children,Child Labor,Male,46-60,8083,2794,5289,4951,3132
2009,Rural,Karnataka,Other Crimes,Drug Offense,Male,18-30,1895,1112,783,1176,719
2001,Rural,Chhattisgarh,Crime Against Men,Assault,Male,13-17,4927,270,4657,2354,2573
2004,Rural,Delhi,Other Crimes,Fraud,Female,46-60,1073,602,471,843,230
2005,Urban,Rajasthan,Crime Against Men,Extortion,Male,31-45,5775,740,5035,1304,4471
2001,Rural,Bihar,Property Crime,Theft,Male,18-30,3197,582,2615,2337,860
2002,Rural,Himachal Pradesh,Crime Against Children,Kidnapping,Male,31-45,9937,4932,5005,8795,1142
2008,Urban,Tripura,Property Crime,Theft,Female,18-30,4513,3592,921,3733,780
2004,Urban,Assam,Property Crime,Burglary,Female,13-17,5582,1288,4294,2536,3046
2008,Urban,Bihar,Other Crimes,Corruption,Female,31-45,5894,4766,1128,5719,175
2007,Rural,Tamil Nadu,Crime Against Children,Child Labor,Female,60+,9041,3851,5190,6903,2138
2007,Rural,Tamil Nadu,Property Crime,Vandalism,Female,31-45,3224,939,2285,2495,729
2003,Rural,Assam,Crime Against Children,Child Labor,Female,13-17,8169,5640,2529,7555,614
2009,Rural,Jammu & Kashmir,Crime Against Men,Extortion,Female,18-30,7967,6352,1615,7349,618
2005,Urban,Assam,Crime Against Women,Domestic Violence,Female,31-45,1850,268,1582,684,1166
2004,Urban,Chhattisgarh,Crime Against Men,Extortion,Female,0-12,3481,943,2538,3401,80
2001,Rural,Assam,Crime Against Children,Trafficking,Male,31-45,5538,5434,104,5464,74
2009,Rural,Maharashtra,Crime Against Men,Murder,Male,46-60,6134,1274,4860,4691,1443
2007,Rural,Maharashtra,Crime Against Children,Child Abuse,Female,31-45,2697,747,1950,2348,349
2002,Urban,Chhattisgarh,Other Crimes,Corruption,Female,13-17,6266,3900,2366,6136,130
2005,Urban,Nagaland,Crime Against Women,Molestation,Female,60+,9886,744,9142,8838,1048
2009,Rural,Karnataka,Crime Against Men,Extortion,Male,13-17,7904,3725,4179,6823,1081
2005,Rural,Madhya Pradesh,Crime Against Women,Domestic Violence,Male,18-30,7164,1699,5465,2092,5072
2004,Urban,West Bengal,Crime Against Children,Child Labor,Female,18-30,7189,160,7029,329,6860
2007,Rural,Gujarat,Crime Against Women,Domestic Violence,Male,0-12,712,678,34,681,31
2001,Urban,Delhi,Property Crime,Theft,Male,31-45,1728,259,1469,1694,34
2009,Urban,Meghalaya,Crime Against Children,Child Labor,Female,0-12,8552,7105,1447,7403,1149
2010,Urban,Jharkhand,Crime Against Men,Extortion,Male,0-12,600,265,335,496,104
2004,Rural,Nagaland,Property Crime,Theft,Male,18-30,3769,774,2995,1166,2603
2010,Urban,Maharashtra,Crime Against Men,Murder,Male,46-60,6447,3134,3313,6263,184
2009,Urban,Assam,Crime Against Children,Child Abuse,Male,60+,9662,3312,6350,5397,4265
2010,Rural,Uttar Pradesh,Crime Against Men,Extortion,Female,31-45,2525,36,2489,839,1686
2002,Rural,Assam,Crime Against Children,Child Abuse,Male,13-17,9876,1898,7978,2066,7810
2001,Rural,Maharashtra,Crime Against Children,Child Abuse,Female,18-30,1805,171,1634,825,980
2003,Urban,Jharkhand,Crime Against Women,Dowry Deaths,Female,18-30,2939,272,2667,1414,1525
2005,Urban,Mizoram,Crime Against Children,Kidnapping,Female,46-60,8639,6515,2124,8067,572
2006,Rural,Punjab,Crime Against Women,Molestation,Female,13-17,8978,3055,5923,5103,3875
2005,Rural,Rajasthan,Crime Against Men,Extortion,Female,0-12,878,463,415,865,13
2001,Urban,Maharashtra,Property Crime,Arson,Male,31-45,8051,4765,3286,7746,305
2004,Rural,Rajasthan,Property Crime,Arson,Female,18-30,4002,3775,227,3792,210
2002,Urban,Andhra Pradesh,Crime Against Men,Extortion,Male,46-60,102,40,62,49,53
2003,Rural,Uttar Pradesh,Crime Against Women,Domestic Violence,Female,60+,4595,596,3999,3160,1435
2004,Rural,Arunachal Pradesh,Crime Against Children,Trafficking,Female,46-60,9957,3300,6657,8137,1820
2010,Rural,Punjab,Crime Against Women,Molestation,Female,13-17,8718,1656,7062,6969,1749
2001,Rural,Tripura,Crime Against Children,Child Labor,Female,60+,6053,5449,604,5625,428
2001,Urban,Kerala,Other Crimes,Corruption,Female,60+,9841,2155,7686,7975,1866
2004,Rural,Himachal Pradesh,Crime Against Women,Molestation,Male,13-17,3371,124,3247,1509,1862
2010,Rural,Punjab,Property Crime,Theft,Female,0-12,1326,333,993,404,922
2010,Rural,Maharashtra,Crime Against Children,Child Abuse,Male,31-45,1572,995,577,1034,538
2008,Rural,Rajasthan,Property Crime,Arson,Female,46-60,6707,2263,4444,3212,3495
2001,Rural,West Bengal,Crime Against Children,Child Labor,Male,0-12,5370,3209,2161,4331,1039
2010,Rural,Bihar,Other Crimes,Drug Offense,Female,18-30,1247,1156,91,1184,63
2002,Rural,Rajasthan,Crime Against Children,Trafficking,Female,0-12,9773,4372,5401,5483,4290
2004,Rural,Chhattisgarh,Crime Against Children,Trafficking,Female,18-30,458,7,451,84,374
2002,Rural,Uttarakhand,Crime Against Women,Molestation,Female,0-12,6168,5366,802,6005,163
2008,Urban,Tripura,Other Crimes,Cyber Crime,Female,31-45,4146,936,3210,1162,2984
2005,Urban,Tamil Nadu,Crime Against Women,Molestation,Female,60+,5058,1844,3214,2295,2763
2006,Rural,Uttar Pradesh,Crime Against Children,Trafficking,Female,0-12,760,391,369,439,321
2005,Urban,Odisha,Other Crimes,Cyber Crime,Male,31-45,7408,6088,1320,6662,746
2006,Urban,Tripura,Crime Against Men,Robbery,Male,18-30,2144,648,1496,1579,565
2009,Rural,Uttarakhand,Property Crime,Vandalism,Male,31-45,5192,1809,3383,3600,1592
2001,Urban,Meghalaya,Other Crimes,Fraud,Male,31-45,8940,192,8748,1383,7557
2004,Rural,Madhya Pradesh,Crime Against Women,Molestation,Male,18-30,7238,4979,2259,5838,1400
2006,Rural,Tripura,Other Crimes,Fraud,Female,0-12,7336,2529,4807,4334,3002
2008,Urban,Goa,Property Crime,Burglary,Male,0-12,873,683,190,818,55
2005,Rural,Tamil Nadu,Crime Against Men,Robbery,Male,18-30,3735,1839,1896,2883,852
2010,Rural,Manipur,Property Crime,Arson,Female,60+,6662,3346,3316,4462,2200
2004,Rural,West Bengal,Crime Against Women,Rape,Male,13-17,8561,105,8456,2549,6012
2005,Urban,Himachal Pradesh,Crime Against Children,Trafficking,Male,31-45,5716,3988,1728,4520,1196
2010,Rural,Bihar,Other Crimes,Fraud,Female,60+,3778,1947,1831,2872,906
2007,Rural,Chhattisgarh,Crime Against Men,Assault,Male,46-60,1556,866,690,1511,45
2009,Rural,Kerala,Other Crimes,Cyber Crime,Male,31-45,5535,2074,3461,3543,1992
2004,Rural,Haryana,Property Crime,Theft,Male,13-17,5436,4712,724,4872,564
2001,Rural,Goa,Other Crimes,Fraud,Male,18-30,7974,1213,6761,6965,1009
2003,Rural,Chhattisgarh,Crime Against Women,Rape,Male,13-17,7357,1668,5689,5489,1868
2002,Rural,Tripura,Other Crimes,Cyber Crime,Female,13-17,8591,7136,1455,8371,220
2009,Rural,Karnataka,Crime Against Women,Dowry Deaths,Female,18-30,8833,2957,5876,8250,583
2009,Urban,Madhya Pradesh,Crime Against Women,Dowry Deaths,Female,46-60,324,221,103,277,47
2008,Rural,Tripura,Crime Against Children,Child Labor,Male,18-30,365,32,333,154,211
2006,Rural,Delhi,Crime Against Children,Trafficking,Male,13-17,886,446,440,626,260
2008,Rural,Sikkim,Crime Against Women,Rape,Female,0-12,1862,495,1367,1398,464
2010,Urban,Gujarat,Crime Against Children,Trafficking,Female,0-12,2050,335,1715,783,1267
2001,Urban,Nagaland,Crime Against Women,Dowry Deaths,Male,46-60,5048,1802,3246,3238,1810
2002,Urban,West Bengal,Property Crime,Theft,Male,46-60,816,458,358,797,19
2003,Rural,Delhi,Property Crime,Arson,Male,46-60,7404,5715,1689,7260,144
2006,Urban,Jammu & Kashmir,Crime Against Women,Molestation,Male,31-45,2438,413,2025,2243,195
2002,Rural,Chhattisgarh,Other Crimes,Drug Offense,Male,60+,6981,797,6184,3257,3724
2004,Rural,Andhra Pradesh,Crime Against Men,Assault,Female,46-60,8648,3119,5529,7103,1545
2008,Rural,Assam,Other Crimes,Cyber Crime,Female,18-30,1363,581,782,688,675
2008,Rural,Uttarakhand,Crime Against Children,Kidnapping,Male,60+,6983,5676,1307,6592,391
2009,Rural,Telangana,Other Crimes,Cyber Crime,Female,13-17,9181,1710,7471,8886,295
2008,Urban,Odisha,Other Crimes,Corruption,Male,46-60,7610,3503,4107,7039,571
2003,Rural,Telangana,Other Crimes,Drug Offense,Female,18-30,2709,6,2703,1051,1658
2008,Urban,Delhi,Crime Against Women,Domestic Violence,Male,0-12,566,491,75,562,4
2002,Urban,Arunachal Pradesh,Crime Against Children,Child Abuse,Female,60+,4342,1836,2506,3911,431
2001,Urban,Uttarakhand,Crime Against Children,Trafficking,Male,13-17,5770,1469,4301,3547,2223
2005,Rural,Odisha,Other Crimes,Cyber Crime,Female,18-30,137,66,71,129,8
2010,Urban,Mizoram,Crime Against Women,Molestation,Male,46-60,4926,1173,3753,4076,850
2001,Rural,Odisha,Other Crimes,Drug Offense,Female,60+,6576,4376,2200,4930,1646
2001,Urban,Maharashtra,Crime Against Children,Kidnapping,Female,18-30,9401,3320,6081,7514,1887
2009,Rural,Assam,Crime Against Men,Extortion,Male,0-12,1511,970,541,1045,466
2008,Urban,Maharashtra,Other Crimes,Cyber Crime,Female,18-30,1718,352,1366,1542,176
2008,Rural,Rajasthan,Crime Against Children,Trafficking,Male,13-17,4097,1275,2822,1527,2570
2004,Rural,Jammu & Kashmir,Crime Against Men,Robbery,Male,46-60,8451,7749,702,7884,567
2008,Rural,Odisha,Crime Against Children,Kidnapping,Female,31-45,3412,666,2746,1553,1859
2002,Urban,Meghalaya,Crime Against Children,Child Labor,Female,46-60,8022,3328,4694,6740,1282
2004,Rural,Kerala,Property Crime,Arson,Male,46-60,4601,4482,119,4546,55
2008,Rural,Bihar,Crime Against Children,Child Abuse,Male,13-17,8693,5742,2951,7132,1561
2001,Rural,Assam,Other Crimes,Drug Offense,Male,46-60,7900,3372,4528,4176,3724
2005,Urban,Chhattisgarh,Property Crime,Vandalism,Female,46-60,7728,1421,6307,2880,4848
2008,Rural,Uttarakhand,Crime Against Women,Dowry Deaths,Male,18-30,4483,2273,2210,2496,1987
2008,Urban,Bihar,Crime Against Men,Robbery,Female,18-30,7338,7191,147,7297,41
2001,Urban,Uttar Pradesh,Other Crimes,Fraud,Female,13-17,799,716,83,746,53
2010,Rural,Odisha,Crime Against Men,Extortion,Male,18-30,3686,2423,1263,2644,1042
2010,Urban,Rajasthan,Crime Against Men,Robbery,Female,60+,4406,1975,2431,3572,834
2001,Urban,Meghalaya,Crime Against Women,Domestic Violence,Female,60+,464,319,145,414,50
2003,Urban,Tripura,Crime Against Children,Kidnapping,Female,46-60,739,664,75,739,0
2008,Rural,Odisha,Crime Against Women,Domestic Violence,Female,31-45,8231,767,7464,3586,4645
2002,Rural,Arunachal Pradesh,Property Crime,Vandalism,Female,60+,5675,5090,585,5440,235
2009,Rural,Himachal Pradesh,Crime Against Children,Child Labor,Female,0-12,7877,2834,5043,7396,481
2004,Urban,Meghalaya,Crime Against Women,Molestation,Male,13-17,2645,1580,1065,1892,753
2001,Urban,Arunachal Pradesh,Crime Against Children,Child Labor,Male,0-12,5862,2803,3059,4039,1823
2009,Urban,Madhya Pradesh,Crime Against Men,Robbery,Male,46-60,6004,4782,1222,5399,605
2003,Rural,Sikkim,Other Crimes,Cyber Crime,Female,13-17,6334,1175,5159,2467,3867
2003,Urban,Tripura,Other Crimes,Corruption,Male,46-60,4845,2919,1926,4035,810
2008,Urban,Madhya Pradesh,Crime Against Women,Domestic Violence,Female,0-12,9833,745,9088,6057,3776
2005,Urban,Himachal Pradesh,Property Crime,Vandalism,Male,60+,9104,4597,4507,5538,3566
2002,Urban,Madhya Pradesh,Crime Against Children,Kidnapping,Male,46-60,9526,7224,2302,8822,704
2008,Rural,Rajasthan,Other Crimes,Corruption,Male,18-30,6136,1773,4363,3172,2964
2005,Urban,Assam,Other Crimes,Fraud,Female,0-12,6679,2296,4383,5349,1330
2002,Urban,Odisha,Other Crimes,Cyber Crime,Male,13-17,1682,947,735,1649,33
2009,Urban,Rajasthan,Crime Against Women,Domestic Violence,Female,0-12,4169,1092,3077,2062,2107
2008,Rural,Uttar Pradesh,Crime Against Men,Extortion,Male,13-17,7279,3598,3681,4560,2719
2007,Rural,Karnataka,Property Crime,Arson,Male,18-30,8677,8480,197,8569,108
2008,Urban,Mizoram,Other Crimes,Cyber Crime,Female,18-30,8406,1782,6624,2491,5915
2009,Urban,Rajasthan,Crime Against Women,Domestic Violence,Female,31-45,6281,4326,1955,5679,602
2007,Rural,Bihar,Other Crimes,Cyber Crime,Female,13-17,5337,3216,2121,4481,856
2010,Rural,Nagaland,Crime Against Children,Trafficking,Male,18-30,669,117,552,649,20
2009,Urban,Nagaland,Crime Against Women,Rape,Male,13-17,7053,3410,3643,6403,650
2002,Rural,Tripura,Crime Against Women,Rape,Female,0-12,5537,1034,4503,1803,3734
2006,Urban,Gujarat,Crime Against Children,Child Labor,Female,60+,3834,2281,1553,2935,899
2007,Urban,West Bengal,Crime Against Children,Trafficking,Female,31-45,7930,1595,6335,7813,117
2003,Urban,Haryana,Crime Against Men,Murder,Male,0-12,2767,2000,767,2513,254
2007,Urban,Manipur,Property Crime,Burglary,Female,31-45,9238,7345,1893,7717,1521
2007,Urban,Madhya Pradesh,Crime Against Women,Rape,Male,60+,224,137,87,213,11
2004,Rural,Telangana,Other Crimes,Cyber Crime,Male,46-60,1135,806,329,919,216
2009,Rural,Manipur,Crime Against Women,Rape,Male,46-60,5746,444,5302,4689,1057
2001,Rural,Haryana,Crime Against Women,Dowry Deaths,Female,60+,9005,2462,6543,7802,1203
2004,Urban,Himachal Pradesh,Other Crimes,Corruption,Female,60+,2683,1025,1658,2312,371
2004,Urban,Andhra Pradesh,Crime Against Women,Domestic Violence,Male,18-30,1720,1655,65,1676,44
2003,Urban,Delhi,Crime Against Women,Domestic Violence,Female,31-45,6896,4339,2557,5979,917
2009,Urban,West Bengal,Property Crime,Arson,Male,18-30,7327,3947,3380,6261,1066
2003,Urban,Bihar,Property Crime,Vandalism,Male,13-17,3830,623,3207,2799,1031
2009,Urban,Jharkhand,Crime Against Women,Domestic Violence,Male,46-60,1740,1676,64,1726,14
2010,Rural,Odisha,Crime Against Men,Extortion,Male,18-30,156,114,42,156,0
2006,Rural,Kerala,Crime Against Women,Domestic Violence,Male,0-12,3768,2871,897,3264,504
2007,Rural,Tripura,Other Crimes,Corruption,Female,31-45,6488,567,5921,3106,3382
2010,Urban,Goa,Crime Against Children,Trafficking,Male,46-60,2939,1373,1566,2555,384
2002,Rural,Punjab,Crime Against Children,Child Abuse,Female,0-12,6956,3557,3399,4842,2114
2006,Rural,Assam,Other Crimes,Corruption,Female,18-30,9548,572,8976,3346,6202
2007,Rural,Punjab,Other Crimes,Drug Offense,Female,13-17,5204,1561,3643,3761,1443
2007,Urban,Jharkhand,Other Crimes,Drug Offense,Female,60+,9970,9812,158,9876,94
2010,Rural,Mizoram,Other Crimes,Fraud,Male,60+,538,278,260,344,194
2005,Urban,Sikkim,Property Crime,Arson,Female,60+,7184,5215,1969,5376,1808
2006,Urban,Tripura,Property Crime,Burglary,Male,13-17,5284,1614,3670,4609,675
2007,Rural,Mizoram,Crime Against Children,Child Abuse,Male,60+,9187,8874,313,9166,21
2010,Urban,Himachal Pradesh,Property Crime,Theft,Female,18-30,4234,2923,1311,3612,622
2010,Urban,Odisha,Crime Against Women,Domestic Violence,Female,60+,6097,4674,1423,5131,966
2005,Urban,Arunachal Pradesh,Crime Against Children,Kidnapping,Female,0-12,8171,7574,597,8019,152
2009,Urban,Assam,Crime Against Men,Murder,Male,0-12,7879,7567,312,7744,135
2005,Rural,Haryana,Crime Against Children,Child Abuse,Male,31-45,5013,2862,2151,3583,1430
2005,Rural,Delhi,Crime Against Women,Dowry Deaths,Female,31-45,6343,3480,2863,4627,1716
2006,Urban,Odisha,Crime Against Men,Robbery,Male,13-17,7560,844,6716,5248,2312
2005,Urban,Meghalaya,Crime Against Children,Child Abuse,Female,46-60,2056,1494,562,1997,59
2003,Rural,West Bengal,Other Crimes,Corruption,Male,13-17,2702,376,2326,840,1862
2005,Urban,Meghalaya,Crime Against Children,Kidnapping,Female,13-17,5993,1586,4407,2360,3633
2006,Rural,Nagaland,Property Crime,Vandalism,Female,13-17,5185,3244,1941,4581,604
2008,Rural,Andhra Pradesh,Property Crime,Burglary,Male,13-17,7063,780,6283,6954,109
2001,Rural,Kerala,Other Crimes,Fraud,Female,60+,2132,1679,453,1718,414
2002,Urban,Gujarat,Property Crime,Arson,Male,13-17,1098,540,558,978,120
2003,Urban,Maharashtra,Other Crimes,Corruption,Male,13-17,5678,3014,2664,3224,2454
2001,Rural,Andhra Pradesh,Property Crime,Vandalism,Male,13-17,3178,912,2266,1443,1735
2010,Urban,Tripura,Crime Against Children,Child Abuse,Male,13-17,3344,785,2559,1727,1617
2002,Rural,Jammu & Kashmir,Other Crimes,Fraud,Female,46-60,3800,3296,504,3623,177
2003,Urban,Sikkim,Crime Against Women,Molestation,Female,31-45,9958,3008,6950,5382,4576
2006,Urban,Odisha,Crime Against Men,Assault,Female,60+,6340,3150,3190,4510,1830
2008,Rural,Assam,Property Crime,Vandalism,Female,46-60,2124,647,1477,1906,218
2007,Urban,Uttarakhand,Other Crimes,Cyber Crime,Female,60+,3478,1953,1525,2760,718
2006,Rural,Mizoram,Other Crimes,Fraud,Male,31-45,911,539,372,840,71
2004,Rural,Rajasthan,Property Crime,Arson,Female,46-60,8707,7364,1343,7583,1124
2005,Rural,Chhattisgarh,Crime Against Women,Domestic Violence,Female,0-12,6926,1273,5653,6205,721
2005,Urban,Jharkhand,Crime Against Men,Murder,Male,18-30,8650,1422,7228,5387,3263
2002,Rural,Tripura,Crime Against Children,Child Abuse,Male,46-60,5332,3019,2313,3783,1549
2010,Urban,Telangana,Crime Against Women,Rape,Male,60+,8904,7510,1394,8392,512
2003,Rural,Arunachal Pradesh,Crime Against Children,Child Abuse,Female,13-17,886,784,102,804,82
2008,Urban,Andhra Pradesh,Crime Against Children,Trafficking,Male,18-30,4090,2678,1412,3163,927
2004,Urban,Mizoram,Crime Against Women,Molestation,Female,18-30,713,696,17,701,12
2003,Urban,Maharashtra,Property Crime,Burglary,Male,0-12,3709,729,2980,2594,1115
2003,Rural,Goa,Property Crime,Arson,Female,18-30,465,110,355,397,68
2005,Urban,Rajasthan,Other Crimes,Drug Offense,Male,0-12,133,111,22,114,19
2005,Rural,Bihar,Crime Against Children,Kidnapping,Male,18-30,2456,2451,5,2455,1
2008,Urban,Madhya Pradesh,Property Crime,Arson,Female,13-17,646,225,421,310,336
2010,Rural,Meghalaya,Crime Against Children,Child Abuse,Male,13-17,9346,5408,3938,8079,1267
2004,Urban,Manipur,Crime Against Women,Dowry Deaths,Male,0-12,3766,3384,382,3558,208
2001,Urban,Nagaland,Crime Against Children,Child Labor,Female,18-30,9883,9736,147,9834,49
2003,Urban,Punjab,Other Crimes,Drug Offense,Male,0-12,6307,5989,318,6219,88
2007,Urban,Punjab,Crime Against Women,Dowry Deaths,Male,13-17,7186,6591,595,7089,97
2007,Urban,Uttar Pradesh,Other Crimes,Cyber Crime,Male,31-45,3582,2626,956,3393,189
2007,Urban,West Bengal,Crime Against Children,Kidnapping,Male,18-30,9633,8795,838,9314,319
2010,Rural,Gujarat,Other Crimes,Drug Offense,Male,0-12,6292,582,5710,4548,1744
2004,Rural,Mizoram,Crime Against Men,Robbery,Female,0-12,8993,3556,5437,8432,561
2001,Rural,West Bengal,Other Crimes,Cyber Crime,Female,18-30,1966,676,1290,1159,807
2004,Rural,Tripura,Crime Against Children,Kidnapping,Female,18-30,5335,1877,3458,3818,1517
2003,Urban,Madhya Pradesh,Crime Against Children,Trafficking,Male,18-30,5870,950,4920,3877,1993
2010,Rural,Jammu & Kashmir,Crime Against Children,Kidnapping,Male,31-45,1324,192,1132,1016,308
2010,Rural,Meghalaya,Crime Against Children,Kidnapping,Male,31-45,7580,2620,4960,4941,2639
2004,Rural,Karnataka,Other Crimes,Drug Offense,Male,60+,3754,1300,2454,1492,2262
2010,Rural,Gujarat,Crime Against Children,Trafficking,Female,46-60,3088,2727,361,2728,360
2008,Rural,Delhi,Crime Against Children,Child Labor,Male,18-30,403,8,395,219,184
2009,Urban,Maharashtra,Crime Against Women,Molestation,Male,13-17,6301,3123,3178,4733,1568
2010,Urban,Meghalaya,Crime Against Children,Child Labor,Male,31-45,9010,5598,3412,8759,251
2003,Rural,Nagaland,Crime Against Children,Kidnapping,Female,31-45,4112,3821,291,3846,266
2004,Rural,Mizoram,Other Crimes,Cyber Crime,Female,46-60,4392,764,3628,3253,1139
2005,Rural,Uttar Pradesh,Property Crime,Theft,Male,60+,9183,8216,967,8693,490
2005,Urban,Arunachal Pradesh,Crime Against Men,Assault,Male,0-12,6139,1336,4803,4431,1708
2008,Urban,Punjab,Property Crime,Burglary,Female,60+,8709,5237,3472,7189,1520
2007,Rural,Andhra Pradesh,Crime Against Men,Murder,Male,13-17,3039,542,2497,1138,1901
2002,Rural,Assam,Crime Against Women,Dowry Deaths,Male,46-60,6257,3335,2922,3986,2271
2001,Rural,Himachal Pradesh,Other Crimes,Corruption,Female,60+,5746,791,4955,2063,3683
2002,Rural,Odisha,Property Crime,Theft,Female,31-45,9245,3859,5386,9003,242
2009,Rural,Tamil Nadu,Crime Against Women,Rape,Male,18-30,6471,4359,2112,4540,1931
2003,Urban,Haryana,Crime Against Children,Trafficking,Male,13-17,5481,2047,3434,2472,3009
2010,Urban,Jharkhand,Other Crimes,Corruption,Female,13-17,278,65,213,114,164
2008,Urban,Himachal Pradesh,Crime Against Women,Dowry Deaths,Male,60+,9682,176,9506,8385,1297
2006,Rural,Haryana,Other Crimes,Drug Offense,Female,18-30,1935,341,1594,705,1230
2001,Urban,Meghalaya,Crime Against Men,Murder,Female,46-60,4381,2292,2089,3220,1161
2004,Rural,Sikkim,Other Crimes,Corruption,Male,18-30,3625,785,2840,3473,152
2004,Rural,Nagaland,Other Crimes,Corruption,Male,46-60,6359,5321,1038,5581,778
2010,Urban,West Bengal,Property Crime,Arson,Male,0-12,7506,1605,5901,6113,1393
2005,Urban,Uttarakhand,Crime Against Women,Molestation,Male,18-30,4501,3238,1263,3447,1054
2006,Rural,Manipur,Crime Against Men,Extortion,Female,0-12,2074,1187,887,1387,687
2001,Urban,Bihar,Other Crimes,Corruption,Female,31-45,7734,3208,4526,4537,3197
2004,Urban,Maharashtra,Crime Against Women,Domestic Violence,Female,18-30,3188,1675,1513,1761,1427
2004,Rural,Manipur,Crime Against Women,Dowry Deaths,Male,13-17,3911,921,2990,1360,2551
2003,Rural,Mizoram,Crime Against Men,Murder,Male,0-12,297,213,84,284,13
2001,Rural,Goa,Crime Against Women,Dowry Deaths,Female,18-30,5439,148,5291,557,4882
2001,Urban,Odisha,Property Crime,Arson,Female,18-30,7632,5385,2247,7620,12
2002,Rural,Karnataka,Crime Against Children,Trafficking,Female,18-30,1313,450,863,1002,311
2010,Rural,Karnataka,Other Crimes,Drug Offense,Female,0-12,1782,326,1456,766,1016
2004,Rural,Tamil Nadu,Crime Against Men,Extortion,Female,13-17,4048,3530,518,3637,411
2008,Urban,Madhya Pradesh,Crime Against Men,Extortion,Female,0-12,8924,7852,1072,7859,1065
2008,Rural,Kerala,Other Crimes,Corruption,Male,0-12,4274,1718,2556,3578,696
2002,Rural,Gujarat,Crime Against Children,Child Abuse,Female,0-12,1237,864,373,997,240
2001,Urban,Bihar,Crime Against Children,Kidnapping,Female,31-45,6257,468,5789,3431,2826
2007,Urban,Manipur,Other Crimes,Cyber Crime,Female,60+,6840,2308,4532,5561,1279
2010,Urban,Odisha,Crime Against Children,Child Abuse,Female,0-12,4198,1718,2480,2164,2034
2009,Rural,Goa,Other Crimes,Cyber Crime,Male,13-17,5259,4875,384,5169,90
2008,Rural,Karnataka,Crime Against Men,Robbery,Female,18-30,6797,758,6039,4852,1945
2001,Urban,Odisha,Crime Against Women,Domestic Violence,Male,31-45,5955,2038,3917,5178,777
2001,Urban,Gujarat,Crime Against Men,Murder,Male,31-45,8515,1094,7421,4601,3914
2008,Rural,Kerala,Property Crime,Theft,Female,46-60,2332,392,1940,2189,143
2009,Urban,Delhi,Crime Against Men,Murder,Male,0-12,6628,1853,4775,2405,4223
2001,Rural,West Bengal,Crime Against Men,Robbery,Female,46-60,6017,5682,335,5704,313
2005,Urban,Uttar Pradesh,Crime Against Children,Child Labor,Female,18-30,9895,2268,7627,4585,5310
2002,Urban,Rajasthan,Crime Against Children,Trafficking,Male,0-12,652,334,318,438,214
2004,Urban,Madhya Pradesh,Crime Against Men,Robbery,Male,46-60,394,77,317,124,270
2010,Urban,Uttar Pradesh,Crime Against Women,Dowry Deaths,Male,13-17,4082,1857,2225,2162,1920
2002,Rural,Odisha,Crime Against Women,Domestic Violence,Male,0-12,1176,408,768,1055,121
2005,Urban,Tamil Nadu,Other Crimes,Drug Offense,Male,13-17,5761,714,5047,2954,2807
2008,Rural,Punjab,Crime Against Men,Assault,Male,18-30,6026,4218,1808,5449,577
2006,Rural,Arunachal Pradesh,Crime Against Men,Robbery,Female,31-45,4245,2635,1610,2762,1483
2005,Rural,Sikkim,Property Crime,Arson,Male,60+,9948,1988,7960,6151,3797
2002,Urban,Chhattisgarh,Crime Against Men,Extortion,Female,60+,1679,521,1158,915,764
2008,Urban,Uttar Pradesh,Property Crime,Theft,Female,46-60,2419,788,1631,1967,452
2007,Rural,Telangana,Property Crime,Theft,Female,0-12,251,116,135,246,5
2009,Rural,Kerala,Crime Against Men,Extortion,Male,31-45,4031,3358,673,3562,469
2003,Rural,Delhi,Crime Against Men,Murder,Female,13-17,7577,7231,346,7346,231
2010,Rural,Mizoram,Crime Against Women,Rape,Female,18-30,9795,8626,1169,8733,1062
2003,Urban,Telangana,Crime Against Women,Molestation,Female,46-60,1753,4,1749,1269,484
2009,Urban,Goa,Crime Against Men,Robbery,Female,46-60,3223,1596,1627,2482,741
2005,Rural,Andhra Pradesh,Property Crime,Theft,Female,31-45,1447,100,1347,729,718
2004,Urban,Andhra Pradesh,Property Crime,Arson,Male,46-60,8930,408,8522,1673,7257
2007,Urban,Karnataka,Other Crimes,Cyber Crime,Male,60+,6872,5763,1109,5918,954
2006,Urban,Chhattisgarh,Crime Against Women,Rape,Male,60+,4721,1765,2956,3862,859
2008,Rural,Andhra Pradesh,Crime Against Children,Kidnapping,Female,0-12,2814,1346,1468,1444,1370
2010,Rural,Gujarat,Crime Against Women,Domestic Violence,Female,0-12,2875,1984,891,2526,349
2006,Urban,Bihar,Crime Against Men,Extortion,Female,18-30,7239,3071,4168,6322,917
2008,Rural,Arunachal Pradesh,Property Crime,Arson,Female,0-12,7901,7489,412,7843,58
2004,Rural,Assam,Property Crime,Vandalism,Male,0-12,4482,2746,1736,3846,636
2007,Urban,Assam,Other Crimes,Cyber Crime,Male,18-30,7705,883,6822,1560,6145
2008,Urban,Maharashtra,Other Crimes,Drug Offense,Male,31-45,6184,5369,815,6031,153
2002,Urban,Rajasthan,Crime Against Men,Extortion,Male,46-60,5675,396,5279,2230,3445
2009,Urban,Chhattisgarh,Other Crimes,Drug Offense,Female,60+,4035,1841,2194,1976,2059
2001,Rural,Himachal Pradesh,Crime Against Women,Domestic Violence,Female,18-30,2448,2444,4,2448,0
2006,Rural,Uttar Pradesh,Crime Against Women,Molestation,Female,60+,4653,883,3770,1188,3465
2008,Rural,Odisha,Other Crimes,Fraud,Female,31-45,9923,7494,2429,8734,1189
2002,Urban,Kerala,Crime Against Children,Child Abuse,Male,60+,3532,2879,653,3063,469
2009,Urban,Tamil Nadu,Crime Against Men,Murder,Female,31-45,8342,5656,2686,7068,1274
2004,Rural,Punjab,Crime Against Children,Child Abuse,Male,0-12,9438,4773,4665,6373,3065
2001,Rural,Manipur,Crime Against Women,Molestation,Female,31-45,6159,794,5365,839,5320
2004,Urban,Rajasthan,Property Crime,Vandalism,Female,60+,9027,2960,6067,7788,1239
2007,Rural,Assam,Crime Against Children,Child Abuse,Male,13-17,3919,2459,1460,2685,1234
2009,Rural,Sikkim,Other Crimes,Fraud,Male,60+,4989,966,4023,1609,3380
2005,Urban,Meghalaya,Property Crime,Burglary,Female,18-30,3172,1783,1389,2036,1136
2001,Urban,Madhya Pradesh,Crime Against Children,Trafficking,Male,60+,2115,2010,105,2012,103
2003,Rural,Gujarat,Crime Against Children,Kidnapping,Male,60+,6761,6337,424,6341,420
2010,Urban,Meghalaya,Crime Against Children,Child Labor,Male,46-60,6137,1225,4912,4872,1265
2006,Rural,Karnataka,Crime Against Children,Child Abuse,Female,31-45,5298,1903,3395,2308,2990
2002,Rural,Madhya Pradesh,Crime Against Men,Robbery,Male,60+,9783,7833,1950,9548,235
2006,Rural,Himachal Pradesh,Crime Against Men,Robbery,Female,13-17,1310,608,702,1146,164
2006,Urban,Karnataka,Other Crimes,Drug Offense,Female,18-30,2681,1650,1031,2182,499
2005,Rural,Andhra Pradesh,Property Crime,Burglary,Male,13-17,6873,5638,1235,5869,1004
2004,Rural,Gujarat,Crime Against Men,Extortion,Male,18-30,855,524,331,631,224
2010,Urban,Uttarakhand,Crime Against Children,Child Abuse,Male,31-45,5888,1010,4878,4603,1285
2001,Urban,Kerala,Property Crime,Arson,Female,13-17,2908,1990,918,2857,51
2006,Urban,Karnataka,Crime Against Men,Extortion,Male,0-12,8070,3227,4843,6681,1389
2005,Rural,Jammu & Kashmir,Other Crimes,Cyber Crime,Female,13-17,9512,5116,4396,8374,1138
2002,Urban,Maharashtra,Crime Against Women,Molestation,Female,18-30,3575,994,2581,2229,1346
2001,Urban,Uttarakhand,Property Crime,Vandalism,Male,0-12,5861,1976,3885,2490,3371
2006,Rural,Kerala,Property Crime,Arson,Female,0-12,3900,2876,1024,3115,785
2009,Rural,Kerala,Crime Against Children,Child Abuse,Male,13-17,4022,2943,1079,3535,487
2002,Rural,Manipur,Crime Against Women,Rape,Female,31-45,1307,674,633,677,630
2008,Rural,Tamil Nadu,Crime Against Men,Extortion,Male,46-60,8517,2126,6391,6679,1838
2010,Urban,Chhattisgarh,Crime Against Children,Trafficking,Female,60+,7386,3666,3720,7234,152
2007,Urban,Chhattisgarh,Property Crime,Burglary,Female,18-30,3739,1482,2257,2399,1340
2005,Urban,Nagaland,Crime Against Women,Rape,Male,0-12,1302,836,466,852,450
2005,Rural,Manipur,Property Crime,Theft,Male,31-45,5026,621,4405,629,4397
2006,Rural,Goa,Other Crimes,Fraud,Female,60+,6359,3113,3246,4792,1567
2007,Urban,Nagaland,Crime Against Children,Child Abuse,Male,18-30,6225,435,5790,3536,2689
2008,Rural,Telangana,Crime Against Men,Murder,Male,13-17,4306,410,3896,2134,2172
2005,Rural,Goa,Crime Against Women,Dowry Deaths,Male,18-30,6264,1702,4562,4905,1359
2008,Urban,Himachal Pradesh,Crime Against Women,Molestation,Female,18-30,9004,8981,23,8996,8
2007,Rural,Haryana,Other Crimes,Drug Offense,Male,46-60,9066,8370,696,8811,255
2004,Rural,Maharashtra,Crime Against Women,Rape,Female,31-45,9788,2049,7739,6322,3466
2010,Rural,Telangana,Crime Against Children,Trafficking,Female,13-17,7024,4403,2621,4736,2288
2002,Urban,Meghalaya,Crime Against Men,Assault,Male,18-30,7711,2361,5350,3664,4047
2008,Rural,Jharkhand,Crime Against Women,Molestation,Male,31-45,2239,2060,179,2134,105
2010,Rural,Himachal Pradesh,Property Crime,Arson,Female,46-60,8179,1418,6761,1780,6399
2008,Urban,Manipur,Crime Against Women,Dowry Deaths,Female,18-30,4115,705,3410,2660,1455
2005,Rural,Telangana,Other Crimes,Fraud,Male,13-17,2259,563,1696,846,1413
2007,Urban,Nagaland,Crime Against Women,Domestic Violence,Female,60+,2173,1317,856,2024,149
2001,Rural,Tripura,Crime Against Children,Child Labor,Female,60+,2588,1894,694,2488,100
2009,Rural,Meghalaya,Crime Against Women,Domestic Violence,Female,60+,1680,918,762,1180,500
2003,Rural,Mizoram,Crime Against Women,Domestic Violence,Female,60+,3490,315,3175,357,3133
2007,Urban,Karnataka,Crime Against Children,Child Labor,Male,31-45,2996,2330,666,2372,624
2009,Rural,Delhi,Crime Against Women,Dowry Deaths,Female,31-45,4973,4216,757,4439,534
2006,Urban,Kerala,Crime Against Children,Child Labor,Male,46-60,6020,3137,2883,4960,1060
2002,Urban,Uttar Pradesh,Property Crime,Theft,Female,60+,5228,1030,4198,1425,3803
2007,Urban,Himachal Pradesh,Other Crimes,Drug Offense,Female,31-45,5581,4569,1012,5527,54
2006,Rural,Tamil Nadu,Other Crimes,Drug Offense,Female,46-60,8276,7420,856,7466,810
2003,Rural,Nagaland,Crime Against Children,Child Labor,Male,0-12,491,193,298,376,115
2006,Rural,Chhattisgarh,Crime Against Men,Robbery,Female,13-17,1758,1488,270,1631,127
2006,Rural,Mizoram,Crime Against Men,Extortion,Male,13-17,6417,512,5905,3199,3218
2009,Urban,Karnataka,Other Crimes,Cyber Crime,Female,31-45,666,561,105,625,41
2002,Urban,Haryana,Crime Against Men,Murder,Male,13-17,1289,611,678,696,593
2002,Rural,Meghalaya,Crime Against Men,Extortion,Female,46-60,1527,512,1015,1102,425
2006,Rural,Manipur,Property Crime,Arson,Female,60+,6233,3921,2312,5342,891
2006,Rural,Uttar Pradesh,Crime Against Men,Assault,Male,31-45,6765,5220,1545,6114,651
2010,Rural,Gujarat,Crime Against Women,Molestation,Male,46-60,5599,5144,455,5409,190
2005,Rural,Bihar,Crime Against Men,Extortion,Male,46-60,2171,1938,233,1960,211
2010,Rural,Uttar Pradesh,Property Crime,Theft,Female,13-17,7266,1465,5801,2020,5246
2004,Rural,Tamil Nadu,Property Crime,Arson,Female,46-60,2129,258,1871,383,1746
2008,Urban,Karnataka,Property Crime,Arson,Female,31-45,1008,428,580,921,87
2006,Rural,Delhi,Crime Against Women,Molestation,Female,13-17,7724,7104,620,7586,138
2003,Rural,Jharkhand,Crime Against Men,Robbery,Female,18-30,3771,72,3699,3116,655
2007,Rural,Haryana,Crime Against Men,Murder,Female,13-17,3321,1785,1536,2671,650
2007,Urban,Nagaland,Other Crimes,Corruption,Female,13-17,3583,2395,1188,3386,197
2010,Rural,Manipur,Crime Against Women,Domestic Violence,Female,46-60,2245,533,1712,1541,704
2002,Urban,Jammu & Kashmir,Property Crime,Burglary,Male,31-45,9889,8895,994,9146,743
2008,Urban,Rajasthan,Other Crimes,Fraud,Male,46-60,129,28,101,100,29
2009,Rural,Delhi,Crime Against Children,Kidnapping,Female,31-45,6752,1885,4867,4346,2406
2002,Urban,Assam,Crime Against Men,Murder,Male,0-12,6834,5620,1214,6035,799
2008,Urban,Punjab,Property Crime,Vandalism,Male,60+,3385,1435,1950,1576,1809
2006,Rural,Maharashtra,Crime Against Children,Trafficking,Male,60+,5185,3768,1417,5111,74
2008,Urban,Punjab,Property Crime,Vandalism,Male,13-17,5607,2246,3361,5564,43
2003,Urban,Uttarakhand,Crime Against Men,Robbery,Female,13-17,6661,4795,1866,6599,62
2002,Rural,Goa,Crime Against Men,Extortion,Female,46-60,5257,3100,2157,5211,46
2001,Rural,West Bengal,Other Crimes,Corruption,Female,31-45,8848,3995,4853,5252,3596
2001,Rural,Karnataka,Crime Against Children,Kidnapping,Male,31-45,9000,4941,4059,7120,1880
2010,Urban,Rajasthan,Crime Against Men,Extortion,Female,18-30,2431,1882,549,2126,305
2008,Rural,Sikkim,Crime Against Children,Trafficking,Male,18-30,1829,1536,293,1773,56
2004,Rural,Nagaland,Crime Against Children,Trafficking,Female,46-60,9969,478,9491,8666,1303
2009,Urban,Tamil Nadu,Other Crimes,Fraud,Female,0-12,1602,1225,377,1329,273
2010,Urban,Sikkim,Crime Against Children,Trafficking,Male,46-60,631,164,467,596,35
2007,Rural,Sikkim,Property Crime,Burglary,Female,0-12,7170,3798,3372,4901,2269
2004,Urban,Assam,Crime Against Men,Extortion,Male,46-60,2233,2020,213,2184,49
2002,Rural,Uttar Pradesh,Crime Against Men,Extortion,Male,46-60,1588,1330,258,1539,49
2006,Urban,Karnataka,Other Crimes,Fraud,Female,60+,3211,2765,446,2856,355
2009,Urban,Madhya Pradesh,Crime Against Men,Extortion,Female,60+,9081,3649,5432,4191,4890
2008,Urban,Himachal Pradesh,Property Crime,Vandalism,Female,60+,714,149,565,429,285
2005,Urban,Jammu & Kashmir,Other Crimes,Drug Offense,Female,46-60,7386,4784,2602,6139,1247
2005,Urban,West Bengal,Crime Against Children,Trafficking,Female,60+,8394,5800,2594,7838,556
2010,Rural,Uttarakhand,Crime Against Children,Child Abuse,Female,18-30,1190,902,288,1028,162
2006,Urban,Tamil Nadu,Other Crimes,Drug Offense,Female,60+,2432,1327,1105,1697,735
2001,Urban,Jammu & Kashmir,Crime Against Women,Rape,Male,60+,5788,5739,49,5773,15
2006,Rural,Kerala,Other Crimes,Cyber Crime,Male,46-60,9890,7663,2227,7746,2144
2009,Urban,Assam,Crime Against Women,Rape,Male,0-12,7107,621,6486,5969,1138
2005,Urban,Karnataka,Crime Against Men,Murder,Female,31-45,3774,2978,796,3458,316
2010,Rural,Karnataka,Other Crimes,Cyber Crime,Male,60+,1623,827,796,1337,286
2008,Rural,Punjab,Property Crime,Theft,Male,31-45,8858,6357,2501,8535,323
2007,Urban,Tripura,Crime Against Women,Domestic Violence,Female,60+,9796,886,8910,4092,5704
2005,Urban,Sikkim,Crime Against Women,Domestic Violence,Male,18-30,2691,1955,736,2083,608
2004,Urban,Rajasthan,Crime Against Women,Dowry Deaths,Male,0-12,8733,989,7744,8234,499
2002,Urban,Bihar,Crime Against Men,Extortion,Male,0-12,1690,1009,681,1546,144
2002,Rural,Delhi,Crime Against Men,Robbery,Male,13-17,7987,4753,3234,7816,171
2004,Urban,Arunachal Pradesh,Property Crime,Burglary,Female,46-60,7201,7010,191,7057,144
2008,Rural,Himachal Pradesh,Property Crime,Arson,Male,13-17,408,198,210,251,157
2010,Rural,Karnataka,Crime Against Children,Trafficking,Male,13-17,8514,4019,4495,5191,3323
2007,Rural,Tripura,Crime Against Men,Murder,Female,0-12,8538,5510,3028,7090,1448
2009,Urban,Gujarat,Crime Against Children,Kidnapping,Female,13-17,595,389,206,415,180
2001,Urban,Jammu & Kashmir,Crime Against Women,Molestation,Male,13-17,7103,3439,3664,6716,387
2007,Rural,Rajasthan,Property Crime,Theft,Female,60+,9476,9064,412,9097,379
2009,Rural,Jammu & Kashmir,Crime Against Children,Child Labor,Male,31-45,2407,1179,1228,2397,10
2004,Rural,Sikkim,Crime Against Children,Child Abuse,Male,13-17,8435,6188,2247,8373,62
2002,Rural,Telangana,Crime Against Men,Assault,Male,46-60,3774,3386,388,3724,50
2003,Urban,Assam,Crime Against Men,Extortion,Male,46-60,3960,2027,1933,3739,221
2009,Rural,Karnataka,Crime Against Children,Child Labor,Male,60+,5997,3138,2859,5789,208
2008,Urban,Chhattisgarh,Crime Against Men,Extortion,Male,0-12,8147,491,7656,5548,2599
2007,Rural,Assam,Property Crime,Arson,Male,13-17,6480,6035,445,6359,121
2003,Rural,Punjab,Crime Against Men,Robbery,Female,0-12,1648,387,1261,747,901
2009,Rural,Goa,Crime Against Children,Child Labor,Male,46-60,1950,501,1449,1528,422
2008,Urban,Meghalaya,Crime Against Women,Rape,Male,13-17,4376,896,3480,3967,409
2006,Urban,Chhattisgarh,Other Crimes,Corruption,Female,18-30,5521,1297,4224,2198,3323
2006,Rural,Tripura,Crime Against Women,Dowry Deaths,Female,13-17,5597,4327,1270,4780,817
2009,Urban,Jammu & Kashmir,Crime Against Men,Murder,Male,31-45,4640,3196,1444,3925,715
2002,Rural,Kerala,Property Crime,Vandalism,Female,0-12,8320,2831,5489,4235,4085
2008,Urban,Meghalaya,Crime Against Children,Trafficking,Female,46-60,940,638,302,907,33
2005,Rural,Goa,Crime Against Men,Assault,Male,0-12,3495,1722,1773,3140,355
2009,Urban,Kerala,Crime Against Women,Rape,Male,46-60,5824,4208,1616,4900,924
2006,Urban,Andhra Pradesh,Crime Against Women,Molestation,Male,18-30,6819,5105,1714,6048,771
2004,Rural,Maharashtra,Property Crime,Burglary,Male,0-12,8866,5803,3063,6673,2193
2007,Rural,Mizoram,Crime Against Children,Trafficking,Male,13-17,917,432,485,860,57
2002,Rural,Tamil Nadu,Crime Against Children,Trafficking,Female,60+,9649,5246,4403,6091,3558
2008,Rural,Tamil Nadu,Crime Against Children,Trafficking,Male,13-17,4543,360,4183,1253,3290
2007,Rural,Madhya Pradesh,Other Crimes,Fraud,Male,0-12,9120,5529,3591,6290,2830
2006,Urban,Goa,Crime Against Women,Domestic Violence,Male,46-60,6290,42,6248,3999,2291
2006,Rural,Andhra Pradesh,Crime Against Children,Child Labor,Male,18-30,1231,19,1212,173,1058
2010,Urban,Uttar Pradesh,Crime Against Children,Child Abuse,Female,13-17,591,522,69,545,46
2003,Rural,Odisha,Crime Against Children,Kidnapping,Female,60+,482,407,75,471,11
2009,Urban,Uttar Pradesh,Crime Against Women,Rape,Male,60+,7558,1639,5919,6109,1449
2007,Rural,Maharashtra,Other Crimes,Drug Offense,Male,60+,5176,1526,3650,3488,1688
2010,Urban,Meghalaya,Other Crimes,Drug Offense,Female,18-30,8077,1337,6740,4799,3278
2006,Urban,Telangana,Crime Against Men,Robbery,Female,0-12,7772,341,7431,787,6985
2009,Rural,Punjab,Property Crime,Arson,Female,0-12,5393,1551,3842,3764,1629
2002,Rural,Mizoram,Crime Against Children,Trafficking,Male,60+,6184,79,6105,5834,350
2009,Urban,Jharkhand,Crime Against Children,Trafficking,Male,31-45,2270,1930,340,2177,93
2008,Urban,Tamil Nadu,Property Crime,Theft,Female,13-17,5137,2436,2701,3184,1953
2003,Urban,Karnataka,Property Crime,Vandalism,Male,46-60,8538,4379,4159,8387,151
2010,Rural,Sikkim,Crime Against Women,Domestic Violence,Male,60+,5215,3677,1538,4760,455
2004,Rural,Uttar Pradesh,Crime Against Children,Child Labor,Female,13-17,9192,8154,1038,8223,969
2003,Rural,Assam,Property Crime,Vandalism,Male,18-30,1181,354,827,1171,10
2006,Rural,Sikkim,Crime Against Children,Child Labor,Male,31-45,258,166,92,174,84
2006,Urban,Sikkim,Other Crimes,Cyber Crime,Female,13-17,9227,2175,7052,4145,5082
2008,Urban,Telangana,Crime Against Women,Domestic Violence,Female,60+,7835,7490,345,7625,210
2004,Urban,Sikkim,Crime Against Children,Kidnapping,Female,60+,5537,3943,1594,4978,559
2002,Rural,Uttarakhand,Crime Against Men,Murder,Male,13-17,5960,1025,4935,1082,4878
2003,Urban,West Bengal,Crime Against Children,Child Labor,Male,18-30,8080,2652,5428,7611,469
2010,Rural,Madhya Pradesh,Other Crimes,Corruption,Female,13-17,7705,2775,4930,6370,1335
2005,Urban,Arunachal Pradesh,Other Crimes,Fraud,Female,46-60,3855,1356,2499,2241,1614
2006,Rural,Andhra Pradesh,Crime Against Women,Domestic Violence,Female,31-45,1350,1230,120,1238,112
2006,Rural,Manipur,Property Crime,Vandalism,Male,0-12,3717,273,3444,3697,20
2003,Urban,Mizoram,Crime Against Women,Domestic Violence,Female,46-60,8505,5555,2950,6316,2189
2003,Urban,Nagaland,Property Crime,Burglary,Female,0-12,2645,1310,1335,1709,936
2005,Urban,Himachal Pradesh,Property Crime,Burglary,Male,0-12,139,131,8,135,4
2004,Rural,Karnataka,Crime Against Men,Murder,Male,0-12,8077,1303,6774,8025,52
2009,Urban,Haryana,Crime Against Children,Child Labor,Male,13-17,8482,1065,7417,2624,5858
2004,Rural,Himachal Pradesh,Crime Against Women,Rape,Female,60+,6359,3807,2552,5827,532
2001,Urban,Arunachal Pradesh,Other Crimes,Drug Offense,Female,60+,4682,1787,2895,3094,1588
2009,Rural,Karnataka,Other Crimes,Drug Offense,Female,18-30,9985,5215,4770,6390,3595
2005,Rural,Jammu & Kashmir,Crime Against Men,Extortion,Male,46-60,6938,1356,5582,3804,3134
2007,Rural,Sikkim,Property Crime,Burglary,Male,60+,6201,5082,1119,5174,1027
2009,Rural,Punjab,Crime Against Women,Dowry Deaths,Male,18-30,2843,2254,589,2576,267
2002,Urban,Nagaland,Other Crimes,Corruption,Female,0-12,2994,1817,1177,2529,465
2007,Urban,Andhra Pradesh,Crime Against Men,Murder,Male,31-45,2823,184,2639,2254,569
2003,Rural,Andhra Pradesh,Crime Against Children,Kidnapping,Male,60+,1999,1770,229,1807,192
2001,Urban,West Bengal,Crime Against Men,Murder,Male,0-12,580,415,165,563,17
2010,Urban,Bihar,Crime Against Men,Assault,Male,60+,9761,4679,5082,5440,4321
2008,Rural,Telangana,Crime Against Men,Murder,Male,13-17,3402,62,3340,897,2505
2009,Urban,Gujarat,Crime Against Children,Trafficking,Female,31-45,4145,1392,2753,2830,1315
2002,Rural,Uttar Pradesh,Crime Against Children,Kidnapping,Male,31-45,4855,4109,746,4434,421
2010,Urban,Sikkim,Crime Against Women,Dowry Deaths,Male,31-45,3913,334,3579,901,3012
2002,Rural,Tripura,Crime Against Children,Kidnapping,Male,46-60,8512,2939,5573,6920,1592
2009,Urban,Tripura,Other Crimes,Corruption,Male,60+,6083,3179,2904,5404,679
2010,Rural,Uttarakhand,Crime Against Women,Domestic Violence,Female,46-60,9510,4762,4748,4812,4698
2003,Urban,Madhya Pradesh,Other Crimes,Corruption,Female,18-30,3934,913,3021,2367,1567
2003,Urban,Telangana,Property Crime,Vandalism,Male,31-45,4094,3232,862,3820,274
2001,Rural,Odisha,Property Crime,Arson,Female,31-45,4176,3577,599,4089,87
2009,Rural,Nagaland,Crime Against Men,Extortion,Female,18-30,8801,7500,1301,7909,892
2003,Rural,Uttar Pradesh,Crime Against Women,Rape,Female,0-12,9564,5335,4229,7325,2239
2009,Rural,Andhra Pradesh,Crime Against Women,Molestation,Male,31-45,9497,1663,7834,7006,2491
2007,Urban,Jharkhand,Crime Against Women,Dowry Deaths,Male,31-45,5608,3177,2431,4047,1561
2004,Urban,Mizoram,Property Crime,Burglary,Male,46-60,3337,477,2860,1332,2005
2009,Urban,Uttarakhand,Crime Against Children,Kidnapping,Male,13-17,7257,7039,218,7230,27
2004,Rural,Rajasthan,Property Crime,Burglary,Male,13-17,1511,515,996,548,963
2008,Rural,Uttarakhand,Crime Against Men,Murder,Male,60+,4564,2103,2461,4388,176
2006,Urban,Uttar Pradesh,Other Crimes,Cyber Crime,Female,13-17,3608,1716,1892,3392,216
2008,Urban,Odisha,Crime Against Men,Extortion,Female,60+,9625,1729,7896,8154,1471
2007,Urban,Himachal Pradesh,Crime Against Men,Robbery,Male,18-30,4851,267,4584,526,4325
2008,Rural,Punjab,Other Crimes,Corruption,Male,60+,7170,804,6366,5395,1775
2006,Rural,Tripura,Crime Against Children,Child Abuse,Male,0-12,2805,1047,1758,2355,450
2002,Rural,Bihar,Other Crimes,Drug Offense,Male,31-45,4168,1637,2531,3497,671
2007,Urban,Jharkhand,Crime Against Men,Assault,Female,46-60,3107,1420,1687,2209,898
2009,Urban,Kerala,Crime Against Children,Child Labor,Female,60+,6922,3308,3614,6315,607
2004,Urban,Haryana,Property Crime,Vandalism,Female,46-60,5637,2960,2677,4501,1136
2005,Urban,Manipur,Crime Against Children,Child Abuse,Female,60+,8674,505,8169,832,7842
2001,Urban,Jammu & Kashmir,Property Crime,Arson,Female,13-17,9619,6868,2751,8853,766
2009,Urban,Tripura,Crime Against Children,Child Labor,Male,31-45,7232,589,6643,4094,3138
2003,Rural,Uttar Pradesh,Other Crimes,Corruption,Female,18-30,8282,7676,606,7734,548
2006,Rural,Bihar,Property Crime,Vandalism,Female,60+,1076,760,316,1012,64
2001,Rural,Assam,Property Crime,Vandalism,Female,46-60,8436,3557,4879,8356,80
2008,Urban,Himachal Pradesh,Crime Against Children,Trafficking,Male,0-12,7756,7479,277,7479,277
2009,Rural,Jharkhand,Crime Against Children,Kidnapping,Female,46-60,6262,2701,3561,4448,1814
2007,Rural,Jharkhand,Crime Against Men,Murder,Male,60+,6617,531,6086,4128,2489
2008,Rural,Himachal Pradesh,Crime Against Women,Rape,Female,46-60,841,716,125,836,5
2009,Rural,Delhi,Other Crimes,Corruption,Female,31-45,7754,7020,734,7606,148
2005,Urban,Tripura,Crime Against Men,Robbery,Female,31-45,53,3,50,21,32
2010,Urban,Himachal Pradesh,Crime Against Men,Robbery,Female,31-45,2584,1342,1242,1890,694
2004,Urban,Nagaland,Property Crime,Theft,Female,13-17,8160,4816,3344,7422,738
2009,Rural,Jharkhand,Crime Against Women,Molestation,Female,60+,3127,2404,723,2664,463
2008,Rural,Punjab,Other Crimes,Drug Offense,Male,0-12,7041,1793,5248,4315,2726
2009,Rural,Tamil Nadu,Crime Against Women,Dowry Deaths,Female,60+,3595,788,2807,2756,839
2002,Urban,Odisha,Property Crime,Vandalism,Male,0-12,4412,3597,815,3614,798
2003,Rural,Telangana,Crime Against Women,Molestation,Female,31-45,8150,6095,2055,7856,294
2004,Rural,Manipur,Crime Against Men,Murder,Female,13-17,5872,3554,2318,5532,340
2010,Rural,Tripura,Other Crimes,Corruption,Female,60+,204,41,163,187,17
2007,Urban,Jharkhand,Crime Against Men,Robbery,Female,18-30,7662,3773,3889,5059,2603
2001,Rural,Uttarakhand,Crime Against Men,Robbery,Male,46-60,5142,4399,743,5104,38
2002,Urban,Tamil Nadu,Crime Against Children,Child Abuse,Male,46-60,6646,4253,2393,5306,1340
2008,Rural,Mizoram,Crime Against Women,Domestic Violence,Female,60+,1782,655,1127,1574,208
2007,Urban,Uttarakhand,Crime Against Men,Murder,Female,18-30,3153,2427,726,3124,29
2005,Urban,West Bengal,Crime Against Children,Trafficking,Female,46-60,390,20,370,387,3
2003,Urban,Nagaland,Crime Against Children,Kidnapping,Female,0-12,9886,2234,7652,5401,4485
2006,Rural,Delhi,Other Crimes,Cyber Crime,Female,18-30,3467,1962,1505,3225,242
2002,Urban,Nagaland,Crime Against Men,Assault,Male,18-30,3780,3656,124,3755,25
2005,Rural,Jammu & Kashmir,Other Crimes,Fraud,Female,46-60,7134,4149,2985,5860,1274
2007,Rural,Delhi,Crime Against Children,Trafficking,Female,13-17,2156,521,1635,671,1485
2004,Urban,Himachal Pradesh,Property Crime,Vandalism,Male,13-17,365,230,135,356,9
2010,Rural,Maharashtra,Crime Against Men,Assault,Male,46-60,9433,776,8657,6133,3300
2006,Rural,Arunachal Pradesh,Other Crimes,Corruption,Male,13-17,7376,259,7117,1179,6197
2003,Rural,Chhattisgarh,Crime Against Men,Robbery,Female,46-60,2083,793,1290,1444,639
2008,Rural,Jharkhand,Crime Against Women,Molestation,Male,13-17,8545,3784,4761,3915,4630
2005,Rural,Andhra Pradesh,Other Crimes,Fraud,Male,18-30,7430,4030,3400,5828,1602
2005,Urban,Assam,Crime Against Women,Rape,Male,18-30,3402,792,2610,981,2421
2004,Urban,Manipur,Other Crimes,Drug Offense,Male,13-17,6098,5415,683,6024,74
2003,Urban,Maharashtra,Crime Against Women,Rape,Male,13-17,8977,1796,7181,8891,86
2008,Urban,Assam,Property Crime,Arson,Female,0-12,6479,4025,2454,5129,1350
2008,Rural,West Bengal,Crime Against Women,Rape,Male,31-45,891,691,200,693,198
2009,Urban,Mizoram,Property Crime,Vandalism,Female,13-17,9486,4605,4881,7747,1739
2007,Urban,Mizoram,Property Crime,Arson,Male,18-30,2573,989,1584,1247,1326
2005,Rural,Chhattisgarh,Other Crimes,Corruption,Male,31-45,746,582,164,694,52
2002,Rural,Tamil Nadu,Crime Against Children,Kidnapping,Male,31-45,1041,1007,34,1038,3
2007,Urban,Nagaland,Property Crime,Burglary,Male,46-60,5530,1603,3927,3720,1810
2008,Rural,Tripura,Other Crimes,Drug Offense,Male,0-12,8436,4710,3726,7286,1150
2002,Urban,Meghalaya,Crime Against Men,Murder,Female,13-17,7651,250,7401,3156,4495
2005,Urban,Goa,Crime Against Children,Child Labor,Female,31-45,7837,2317,5520,4665,3172
2004,Rural,Nagaland,Property Crime,Burglary,Male,0-12,6970,2566,4404,3941,3029
2005,Rural,Maharashtra,Crime Against Men,Robbery,Female,13-17,9486,8815,671,8969,517
2003,Rural,Tripura,Crime Against Men,Robbery,Male,18-30,8537,1524,7013,4845,3692
2006,Rural,Bihar,Crime Against Children,Trafficking,Female,60+,3320,729,2591,1506,1814
2003,Urban,Manipur,Crime Against Women,Rape,Female,0-12,9304,1124,8180,6570,2734
2007,Urban,Manipur,Property Crime,Vandalism,Male,18-30,8868,6120,2748,6696,2172
2001,Urban,Uttarakhand,Crime Against Children,Trafficking,Female,31-45,9625,8674,951,9182,443
2002,Rural,Goa,Crime Against Men,Robbery,Male,31-45,2948,2075,873,2706,242
2003,Urban,Punjab,Crime Against Women,Molestation,Female,46-60,2161,1266,895,1664,497
2008,Urban,Gujarat,Other Crimes,Cyber Crime,Female,18-30,1346,120,1226,531,815
2004,Rural,Bihar,Property Crime,Burglary,Male,18-30,6237,887,5350,1525,4712
2007,Rural,Jammu & Kashmir,Crime Against Women,Domestic Violence,Male,0-12,3871,1177,2694,2631,1240
2009,Urban,Chhattisgarh,Other Crimes,Fraud,Female,31-45,6493,5512,981,6132,361
2009,Urban,Nagaland,Crime Against Children,Trafficking,Female,18-30,8009,5644,2365,6148,1861
2007,Rural,Sikkim,Property Crime,Burglary,Female,13-17,4353,3512,841,4045,308
2002,Rural,Punjab,Other Crimes,Corruption,Male,0-12,9741,838,8903,5226,4515
2001,Rural,Himachal Pradesh,Property Crime,Burglary,Male,13-17,1524,1053,471,1188,336
2003,Rural,Meghalaya,Crime Against Women,Molestation,Female,46-60,3637,1249,2388,1738,1899
2001,Rural,Meghalaya,Crime Against Women,Molestation,Male,31-45,8417,3365,5052,6170,2247
2007,Rural,Tamil Nadu,Crime Against Men,Robbery,Female,46-60,1512,866,646,1047,465
2008,Urban,Kerala,Property Crime,Theft,Male,31-45,8420,7108,1312,7985,435
2001,Urban,Arunachal Pradesh,Crime Against Women,Molestation,Male,0-12,9320,5214,4106,8738,582
2007,Rural,Gujarat,Crime Against Women,Rape,Male,0-12,6040,3124,2916,4598,1442
2010,Urban,Uttarakhand,Crime Against Children,Child Abuse,Female,31-45,4099,2827,1272,3985,114
2005,Rural,Gujarat,Crime Against Men,Extortion,Male,60+,3342,1794,1548,2764,578
2005,Rural,Telangana,Other Crimes,Drug Offense,Male,31-45,6201,3200,3001,5706,495
2004,Urban,Telangana,Other Crimes,Cyber Crime,Female,0-12,8433,5719,2714,7770,663
2003,Rural,Manipur,Other Crimes,Corruption,Male,46-60,5896,3716,2180,4409,1487
2001,Urban,Manipur,Crime Against Men,Extortion,Female,18-30,7723,2914,4809,5430,2293
2007,Urban,Kerala,Property Crime,Burglary,Female,18-30,1614,304,1310,1030,584
2003,Urban,Rajasthan,Other Crimes,Corruption,Female,18-30,5507,3258,2249,4683,824
2006,Urban,Punjab,Crime Against Men,Robbery,Male,31-45,4929,430,4499,2854,2075
2002,Rural,Mizoram,Crime Against Men,Robbery,Male,0-12,2237,2223,14,2231,6
2008,Urban,Haryana,Crime Against Men,Murder,Female,18-30,5168,4392,776,4781,387
2004,Rural,Jammu & Kashmir,Property Crime,Vandalism,Female,46-60,4742,319,4423,2052,2690
2009,Urban,Mizoram,Crime Against Men,Extortion,Male,0-12,5999,3434,2565,4668,1331
2001,Urban,Madhya Pradesh,Property Crime,Burglary,Female,18-30,4642,3487,1155,4239,403
2006,Rural,Kerala,Crime Against Women,Domestic Violence,Male,60+,516,156,360,308,208
2007,Urban,Nagaland,Other Crimes,Fraud,Male,31-45,1402,676,726,1156,246
2008,Urban,Jammu & Kashmir,Other Crimes,Corruption,Female,13-17,650,166,484,418,232
2008,Urban,Meghalaya,Property Crime,Burglary,Female,60+,6697,6329,368,6679,18
2008,Urban,Kerala,Crime Against Women,Dowry Deaths,Female,18-30,8942,123,8819,8915,27
2001,Urban,Arunachal Pradesh,Crime Against Men,Robbery,Female,60+,6011,2359,3652,2971,3040
2003,Rural,Telangana,Crime Against Men,Murder,Female,31-45,5857,4033,1824,4303,1554
2002,Urban,Assam,Crime Against Children,Trafficking,Male,18-30,9980,5985,3995,8001,1979
2009,Urban,Maharashtra,Property Crime,Burglary,Male,13-17,6194,1441,4753,5637,557
2009,Urban,Punjab,Crime Against Men,Assault,Female,0-12,6276,631,5645,2942,3334
2010,Urban,Rajasthan,Crime Against Women,Rape,Female,13-17,6244,5138,1106,5178,1066
2005,Urban,Jammu & Kashmir,Crime Against Women,Molestation,Male,0-12,1892,25,1867,910,982
2001,Urban,Manipur,Crime Against Men,Robbery,Male,31-45,6848,2197,4651,4170,2678
2009,Rural,Sikkim,Other Crimes,Drug Offense,Female,46-60,160,93,67,159,1
2001,Rural,Maharashtra,Crime Against Men,Extortion,Male,46-60,9655,1383,8272,4616,5039
2003,Urban,Uttar Pradesh,Crime Against Women,Domestic Violence,Female,31-45,8009,2111,5898,4048,3961
2003,Rural,Arunachal Pradesh,Crime Against Women,Rape,Male,0-12,9079,5908,3171,6316,2763
2004,Rural,Himachal Pradesh,Crime Against Women,Dowry Deaths,Female,0-12,3046,2981,65,3011,35
2002,Urban,Himachal Pradesh,Crime Against Men,Robbery,Female,31-45,7558,3701,3857,5657,1901
2010,Urban,Punjab,Crime Against Women,Molestation,Female,31-45,7177,1645,5532,5400,1777
2006,Rural,Kerala,Crime Against Women,Dowry Deaths,Male,0-12,1410,695,715,832,578
2010,Urban,Bihar,Property Crime,Theft,Female,18-30,7391,2265,5126,5661,1730
2006,Rural,Delhi,Property Crime,Arson,Male,60+,259,192,67,243,16
2007,Rural,Delhi,Other Crimes,Drug Offense,Male,31-45,9943,7922,2021,8996,947
2009,Urban,Jharkhand,Crime Against Men,Assault,Female,31-45,7863,3311,4552,5796,2067
2004,Urban,Delhi,Property Crime,Theft,Male,31-45,8814,7561,1253,8252,562
2010,Urban,Telangana,Other Crimes,Corruption,Female,0-12,985,808,177,848,137
2006,Rural,Tripura,Crime Against Men,Assault,Male,60+,773,451,322,723,50
2007,Rural,Assam,Property Crime,Burglary,Male,31-45,4404,4361,43,4361,43
2003,Rural,Uttarakhand,Other Crimes,Cyber Crime,Female,0-12,3344,2845,499,3300,44
2004,Urban,Maharashtra,Property Crime,Vandalism,Male,0-12,3039,2445,594,2634,405
2006,Urban,Tripura,Crime Against Children,Trafficking,Female,18-30,4367,238,4129,1949,2418
2001,Rural,Gujarat,Crime Against Children,Child Labor,Male,0-12,212,143,69,191,21
2001,Rural,Manipur,Property Crime,Vandalism,Female,13-17,6052,4384,1668,5636,416
2003,Urban,Uttar Pradesh,Crime Against Children,Child Abuse,Female,13-17,396,228,168,383,13
2010,Rural,Tamil Nadu,Property Crime,Theft,Male,46-60,1277,543,734,1081,196
2002,Rural,Punjab,Crime Against Women,Domestic Violence,Female,46-60,4819,3536,1283,4415,404
2001,Urban,Delhi,Crime Against Children,Trafficking,Male,31-45,2958,1192,1766,2490,468
2010,Urban,Telangana,Crime Against Women,Molestation,Female,0-12,5948,210,5738,479,5469
2004,Rural,Meghalaya,Crime Against Men,Extortion,Female,31-45,3439,217,3222,1864,1575
2006,Urban,Mizoram,Crime Against Women,Domestic Violence,Female,18-30,1934,864,1070,1445,489
2003,Rural,Arunachal Pradesh,Crime Against Women,Molestation,Male,31-45,4577,1866,2711,3712,865
2001,Rural,Haryana,Other Crimes,Drug Offense,Male,13-17,198,165,33,188,10
2008,Rural,Chhattisgarh,Crime Against Women,Domestic Violence,Male,18-30,6665,4035,2630,6561,104
2008,Urban,Bihar,Crime Against Women,Dowry Deaths,Male,31-45,4144,1052,3092,3488,656
2001,Rural,Punjab,Crime Against Women,Dowry Deaths,Female,46-60,1009,8,1001,304,705
2001,Rural,Kerala,Other Crimes,Cyber Crime,Male,46-60,2903,911,1992,2333,570
2002,Rural,West Bengal,Crime Against Men,Murder,Female,0-12,7452,461,6991,3427,4025
2008,Rural,Delhi,Crime Against Women,Domestic Violence,Female,46-60,2062,660,1402,1423,639
2003,Urban,Goa,Other Crimes,Cyber Crime,Female,13-17,2061,791,1270,1254,807
2009,Rural,Tripura,Property Crime,Vandalism,Female,0-12,5432,1375,4057,5060,372
2010,Rural,Uttarakhand,Property Crime,Theft,Female,0-12,2315,1580,735,1766,549
2006,Urban,Mizoram,Crime Against Children,Trafficking,Female,13-17,8942,1610,7332,2221,6721
2004,Rural,Delhi,Crime Against Women,Dowry Deaths,Male,0-12,288,164,124,212,76
2002,Rural,Assam,Crime Against Women,Dowry Deaths,Male,31-45,3208,1972,1236,2090,1118
2004,Rural,Tripura,Crime Against Women,Domestic Violence,Female,0-12,9000,2382,6618,5338,3662
2010,Urban,Telangana,Property Crime,Theft,Female,31-45,7350,860,6490,3404,3946
2008,Rural,Uttarakhand,Other Crimes,Corruption,Female,60+,7942,6032,1910,6328,1614
2001,Rural,Delhi,Crime Against Women,Rape,Female,13-17,1497,726,771,1105,392
2003,Rural,Odisha,Property Crime,Arson,Female,13-17,9629,8053,1576,9124,505
2006,Rural,West Bengal,Other Crimes,Fraud,Female,18-30,3987,3729,258,3828,159
2004,Urban,Karnataka,Other Crimes,Cyber Crime,Female,18-30,7529,7326,203,7413,116
2001,Rural,Jammu & Kashmir,Crime Against Children,Kidnapping,Male,18-30,3073,670,2403,1324,1749
2001,Rural,Nagaland,Crime Against Men,Robbery,Male,0-12,898,721,177,857,41
2008,Rural,Punjab,Crime Against Children,Trafficking,Male,46-60,3624,2260,1364,2768,856
2009,Rural,Tripura,Crime Against Men,Robbery,Male,46-60,8071,3027,5044,6568,1503
2005,Rural,Uttar Pradesh,Property Crime,Theft,Female,46-60,7376,1412,5964,5527,1849
2005,Urban,Kerala,Property Crime,Vandalism,Female,18-30,4061,34,4027,901,3160
2008,Urban,Delhi,Crime Against Men,Murder,Female,60+,9427,1970,7457,6967,2460
2010,Rural,Gujarat,Property Crime,Vandalism,Male,18-30,830,149,681,495,335
2005,Urban,Karnataka,Crime Against Men,Robbery,Male,46-60,8705,2040,6665,5852,2853
2003,Rural,Nagaland,Crime Against Men,Extortion,Female,60+,7045,5303,1742,5333,1712
2005,Urban,West Bengal,Other Crimes,Fraud,Male,13-17,433,426,7,427,6
2003,Rural,Sikkim,Property Crime,Theft,Male,31-45,3985,1670,2315,2879,1106
2001,Urban,Mizoram,Crime Against Men,Murder,Female,60+,1897,1439,458,1801,96
2007,Urban,Madhya Pradesh,Property Crime,Burglary,Female,13-17,2922,120,2802,2810,112
2010,Urban,West Bengal,Crime Against Men,Assault,Female,18-30,3866,2716,1150,2865,1001
2008,Urban,Jharkhand,Property Crime,Theft,Female,46-60,9320,6406,2914,7328,1992
2009,Rural,Delhi,Property Crime,Arson,Female,60+,172,46,126,164,8
2008,Rural,Mizoram,Crime Against Men,Murder,Male,13-17,8255,3999,4256,6270,1985
2003,Rural,Telangana,Crime Against Children,Child Abuse,Male,60+,4358,521,3837,2485,1873
2002,Rural,Manipur,Crime Against Children,Trafficking,Male,13-17,4904,3524,1380,4039,865
2008,Urban,Jharkhand,Crime Against Women,Molestation,Female,46-60,6096,1958,4138,4275,1821
2008,Urban,Karnataka,Other Crimes,Corruption,Female,46-60,7599,5275,2324,6816,783
2004,Urban,Manipur,Property Crime,Burglary,Male,0-12,1018,48,970,707,311
2001,Urban,Meghalaya,Crime Against Men,Robbery,Male,31-45,7069,3290,3779,3943,3126
2010,Urban,Odisha,Crime Against Women,Molestation,Male,13-17,55,24,31,30,25
2005,Rural,Karnataka,Crime Against Children,Child Labor,Male,13-17,487,414,73,461,26
2004,Urban,Bihar,Property Crime,Vandalism,Female,0-12,7567,5462,2105,6049,1518
2009,Rural,Gujarat,Other Crimes,Cyber Crime,Female,18-30,8911,3264,5647,4183,4728
2002,Rural,Meghalaya,Crime Against Children,Child Abuse,Female,46-60,1246,131,1115,404,842
2010,Rural,Chhattisgarh,Crime Against Women,Domestic Violence,Female,46-60,9176,3470,5706,6575,2601
2007,Urban,Karnataka,Crime Against Women,Dowry Deaths,Female,13-17,4056,1337,2719,1859,2197
2007,Urban,West Bengal,Other Crimes,Fraud,Male,60+,829,153,676,456,373
2001,Urban,Arunachal Pradesh,Other Crimes,Cyber Crime,Male,60+,8660,2190,6470,5131,3529
2004,Rural,Manipur,Crime Against Children,Child Abuse,Female,13-17,7464,414,7050,1156,6308
2003,Urban,Odisha,Other Crimes,Fraud,Male,46-60,6511,2044,4467,3891,2620
2010,Rural,Odisha,Other Crimes,Cyber Crime,Male,31-45,942,356,586,936,6
2006,Urban,Tamil Nadu,Other Crimes,Fraud,Female,31-45,1040,652,388,1005,35
2005,Rural,West Bengal,Crime Against Children,Child Abuse,Female,18-30,8916,3117,5799,4285,4631
2008,Urban,Karnataka,Crime Against Children,Child Abuse,Male,46-60,9055,5468,3587,8474,581
2007,Urban,Goa,Crime Against Women,Molestation,Male,31-45,6752,1736,5016,4589,2163
2005,Urban,West Bengal,Crime Against Women,Domestic Violence,Female,13-17,8084,2159,5925,5982,2102
2010,Rural,Delhi,Other Crimes,Corruption,Male,31-45,2560,2354,206,2551,9
2004,Rural,Tripura,Crime Against Children,Child Abuse,Male,60+,205,164,41,172,33
2003,Rural,Haryana,Property Crime,Arson,Male,31-45,4325,1820,2505,2654,1671
2006,Rural,Haryana,Other Crimes,Corruption,Male,13-17,1800,513,1287,1545,255
2005,Rural,Gujarat,Crime Against Men,Extortion,Male,31-45,3490,3391,99,3482,8
2005,Urban,Madhya Pradesh,Property Crime,Vandalism,Female,0-12,5185,3463,1722,3631,1554
2006,Urban,Delhi,Property Crime,Burglary,Male,0-12,2053,1260,793,1364,689
2007,Urban,Odisha,Crime Against Women,Dowry Deaths,Female,0-12,9274,66,9208,2845,6429
2005,Urban,Jharkhand,Crime Against Men,Assault,Male,13-17,3915,2851,1064,3432,483
2010,Rural,Chhattisgarh,Crime Against Children,Child Labor,Male,18-30,6058,2230,3828,3731,2327
2001,Urban,Telangana,Crime Against Children,Kidnapping,Female,0-12,7087,4995,2092,6938,149
2007,Rural,Nagaland,Crime Against Men,Robbery,Female,31-45,9262,1220,8042,4586,4676
2006,Urban,Gujarat,Other Crimes,Fraud,Male,60+,8764,6419,2345,8194,570
2002,Urban,Arunachal Pradesh,Other Crimes,Cyber Crime,Female,13-17,3460,175,3285,1842,1618
2005,Rural,Goa,Other Crimes,Corruption,Female,60+,1005,991,14,992,13
2009,Urban,Manipur,Other Crimes,Cyber Crime,Male,0-12,672,465,207,634,38
2003,Rural,Karnataka,Crime Against Women,Dowry Deaths,Female,18-30,3531,1577,1954,2937,594
2006,Rural,Assam,Other Crimes,Fraud,Male,18-30,5047,307,4740,1126,3921
2009,Urban,West Bengal,Other Crimes,Cyber Crime,Male,13-17,5076,4828,248,5066,10
2001,Urban,Himachal Pradesh,Other Crimes,Drug Offense,Male,60+,3104,8,3096,314,2790
2005,Rural,Meghalaya,Other Crimes,Fraud,Male,0-12,7620,5416,2204,6649,971
2010,Urban,Odisha,Crime Against Children,Trafficking,Male,46-60,9768,4475,5293,5439,4329
2001,Rural,Madhya Pradesh,Crime Against Men,Assault,Female,13-17,2685,914,1771,1208,1477
2008,Rural,Assam,Crime Against Men,Murder,Female,18-30,770,408,362,603,167
2009,Urban,Meghalaya,Crime Against Women,Dowry Deaths,Male,0-12,9306,5848,3458,6988,2318
2007,Rural,Andhra Pradesh,Crime Against Women,Dowry Deaths,Male,18-30,9402,9102,300,9167,235
2008,Rural,Rajasthan,Crime Against Children,Child Abuse,Male,18-30,8791,1695,7096,7764,1027
2003,Urban,Meghalaya,Crime Against Women,Molestation,Male,18-30,5701,136,5565,5497,204
2004,Rural,Gujarat,Property Crime,Vandalism,Female,60+,6176,1059,5117,4578,1598
2001,Urban,Jharkhand,Crime Against Children,Child Labor,Male,31-45,2080,1873,207,1888,192
2005,Rural,Madhya Pradesh,Property Crime,Arson,Female,13-17,3512,2444,1068,3028,484
2008,Rural,Odisha,Crime Against Women,Dowry Deaths,Female,31-45,7596,3719,3877,4186,3410
2004,Rural,Jharkhand,Property Crime,Arson,Female,18-30,6283,2673,3610,5911,372
2001,Urban,Mizoram,Crime Against Children,Trafficking,Male,46-60,4457,1436,3021,3495,962
2007,Urban,Assam,Crime Against Women,Dowry Deaths,Male,18-30,7568,3200,4368,6352,1216
2010,Rural,Jharkhand,Other Crimes,Corruption,Male,60+,3431,2485,946,3166,265
2008,Rural,Manipur,Crime Against Women,Rape,Male,46-60,2027,931,1096,1330,697
2009,Urban,Himachal Pradesh,Other Crimes,Drug Offense,Male,31-45,9045,8135,910,8607,438
2002,Rural,Kerala,Crime Against Children,Trafficking,Male,0-12,8306,1376,6930,6955,1351
2004,Rural,Karnataka,Crime Against Children,Child Labor,Male,18-30,6858,6429,429,6480,378
2005,Rural,Rajasthan,Property Crime,Burglary,Female,18-30,9971,4102,5869,6112,3859
2009,Urban,Uttarakhand,Crime Against Children,Child Abuse,Female,46-60,2182,1101,1081,1582,600
2004,Urban,Tripura,Property Crime,Burglary,Male,18-30,7096,2134,4962,6581,515
2005,Urban,Maharashtra,Crime Against Men,Murder,Female,46-60,429,429,0,429,0
2007,Rural,Arunachal Pradesh,Other Crimes,Drug Offense,Female,60+,441,420,21,431,10
2003,Urban,Sikkim,Crime Against Children,Child Abuse,Male,13-17,7021,3235,3786,4522,2499
2008,Rural,Haryana,Other Crimes,Cyber Crime,Female,18-30,4129,1599,2530,3321,808
2003,Urban,Odisha,Crime Against Children,Child Abuse,Male,31-45,5321,1825,3496,4027,1294
2001,Rural,Uttar Pradesh,Other Crimes,Fraud,Male,46-60,7250,6989,261,7035,215
2006,Rural,Telangana,Crime Against Children,Child Abuse,Female,31-45,1449,1260,189,1426,23
2009,Rural,Andhra Pradesh,Property Crime,Arson,Male,0-12,9819,3936,5883,6067,3752
2008,Urban,Goa,Crime Against Children,Kidnapping,Male,13-17,1308,118,1190,284,1024
2010,Rural,Punjab,Property Crime,Theft,Female,18-30,815,605,210,780,35
2006,Rural,Arunachal Pradesh,Other Crimes,Corruption,Female,46-60,2401,1577,824,1885,516
2001,Rural,Haryana,Crime Against Women,Dowry Deaths,Female,46-60,3345,2047,1298,3156,189
2005,Urban,Andhra Pradesh,Crime Against Men,Extortion,Male,60+,3927,940,2987,3513,414
2009,Urban,Kerala,Crime Against Women,Molestation,Female,60+,9600,2896,6704,3997,5603
2002,Urban,Madhya Pradesh,Crime Against Men,Murder,Male,60+,5345,1527,3818,1542,3803
2010,Urban,Karnataka,Crime Against Men,Assault,Female,0-12,2952,1097,1855,2826,126
2008,Rural,Uttarakhand,Crime Against Children,Child Labor,Male,18-30,2643,2410,233,2418,225
2003,Rural,Jammu & Kashmir,Crime Against Children,Child Abuse,Female,18-30,3600,660,2940,711,2889
2006,Urban,Uttar Pradesh,Crime Against Women,Domestic Violence,Male,13-17,6344,3787,2557,4847,1497
2001,Urban,Uttarakhand,Crime Against Children,Child Labor,Male,13-17,6330,2906,3424,4713,1617
2003,Rural,Assam,Crime Against Men,Murder,Female,0-12,3614,456,3158,477,3137
2007,Urban,Tamil Nadu,Property Crime,Vandalism,Female,18-30,7296,5191,2105,6247,1049
2006,Urban,Tripura,Crime Against Women,Rape,Female,46-60,5324,4888,436,5179,145
2006,Urban,Meghalaya,Property Crime,Burglary,Female,13-17,3653,1249,2404,1511,2142
2003,Rural,Telangana,Property Crime,Arson,Female,60+,1028,345,683,577,451
2008,Urban,Bihar,Other Crimes,Cyber Crime,Female,46-60,1500,504,996,1264,236
2006,Rural,Haryana,Property Crime,Arson,Female,60+,5815,3349,2466,4591,1224
2008,Rural,Andhra Pradesh,Crime Against Women,Rape,Male,60+,7924,955,6969,7255,669
2010,Rural,Himachal Pradesh,Crime Against Women,Domestic Violence,Female,13-17,6236,1995,4241,5321,915
2004,Urban,Jammu & Kashmir,Crime Against Men,Robbery,Male,18-30,5874,88,5786,116,5758
2003,Rural,Telangana,Property Crime,Burglary,Male,0-12,1295,1110,185,1278,17
2010,Urban,Delhi,Crime Against Men,Robbery,Male,0-12,4674,1584,3090,4012,662
2003,Urban,Rajasthan,Crime Against Women,Dowry Deaths,Male,13-17,2176,1754,422,2078,98
2004,Urban,Meghalaya,Property Crime,Theft,Male,18-30,7828,1651,6177,4372,3456
2003,Rural,Rajasthan,Crime Against Women,Rape,Female,18-30,1474,1454,20,1465,9
2006,Urban,Andhra Pradesh,Crime Against Women,Domestic Violence,Female,60+,4615,4469,146,4483,132
2005,Urban,Karnataka,Other Crimes,Fraud,Male,18-30,2856,443,2413,1485,1371
2007,Rural,Rajasthan,Crime Against Men,Murder,Male,46-60,4358,217,4141,2005,2353
2006,Urban,Rajasthan,Other Crimes,Cyber Crime,Female,31-45,4166,3989,177,4139,27
2004,Rural,Karnataka,Other Crimes,Fraud,Female,31-45,6464,5836,628,6065,399
2003,Urban,West Bengal,Crime Against Men,Robbery,Male,31-45,5855,4068,1787,4913,942
2003,Rural,Kerala,Crime Against Children,Trafficking,Female,0-12,3047,976,2071,1645,1402
2006,Rural,Tamil Nadu,Crime Against Women,Rape,Male,46-60,1346,234,1112,452,894
2008,Rural,West Bengal,Property Crime,Vandalism,Male,13-17,602,373,229,399,203
2010,Urban,Manipur,Crime Against Children,Child Abuse,Male,60+,5523,5377,146,5391,132
2005,Urban,Andhra Pradesh,Crime Against Men,Assault,Male,46-60,9149,4396,4753,8809,340
2007,Urban,Jammu & Kashmir,Crime Against Children,Kidnapping,Female,13-17,5979,296,5683,4390,1589
2007,Urban,Maharashtra,Crime Against Women,Molestation,Male,18-30,1553,79,1474,608,945
2001,Urban,Manipur,Crime Against Children,Child Labor,Female,0-12,8103,2072,6031,6400,1703
2001,Rural,Tripura,Property Crime,Burglary,Male,18-30,1487,236,1251,884,603
2002,Rural,Karnataka,Crime Against Women,Domestic Violence,Male,18-30,3588,1377,2211,1937,1651
2010,Urban,Tamil Nadu,Property Crime,Vandalism,Female,31-45,5400,934,4466,2749,2651
2003,Rural,Kerala,Crime Against Men,Robbery,Male,13-17,7286,5800,1486,6441,845
2008,Rural,Nagaland,Property Crime,Theft,Male,0-12,7088,4416,2672,5794,1294
2005,Urban,Punjab,Property Crime,Vandalism,Male,31-45,4746,4583,163,4590,156
2003,Urban,Kerala,Other Crimes,Fraud,Female,18-30,8247,4079,4168,7496,751
2004,Urban,Himachal Pradesh,Crime Against Children,Trafficking,Female,60+,6073,3827,2246,4618,1455
2005,Urban,Arunachal Pradesh,Crime Against Men,Assault,Male,31-45,3690,3017,673,3124,566
2008,Rural,Punjab,Crime Against Women,Rape,Male,0-12,4722,861,3861,2686,2036
2010,Rural,Madhya Pradesh,Other Crimes,Fraud,Female,60+,8532,545,7987,4355,4177
2006,Urban,Sikkim,Crime Against Children,Child Abuse,Male,46-60,2927,1691,1236,1980,947
2002,Rural,Haryana,Other Crimes,Corruption,Male,0-12,9626,2446,7180,5522,4104
2010,Rural,Goa,Other Crimes,Corruption,Male,31-45,5031,4982,49,5029,2
2006,Rural,Jammu & Kashmir,Crime Against Women,Rape,Male,60+,165,157,8,165,0
2007,Rural,Uttar Pradesh,Other Crimes,Drug Offense,Female,46-60,5674,3995,1679,4971,703
2002,Urban,Karnataka,Crime Against Women,Rape,Male,0-12,4781,4349,432,4697,84
2001,Urban,Assam,Crime Against Women,Rape,Female,31-45,500,6,494,394,106
2007,Urban,Arunachal Pradesh,Other Crimes,Fraud,Female,31-45,3120,1727,1393,2987,133
2010,Urban,Nagaland,Property Crime,Burglary,Male,18-30,8267,3853,4414,5101,3166
2007,Rural,Nagaland,Property Crime,Theft,Male,13-17,3139,1844,1295,2008,1131
2008,Urban,Punjab,Property Crime,Vandalism,Female,46-60,4248,2043,2205,2529,1719
2006,Urban,Kerala,Crime Against Women,Dowry Deaths,Male,0-12,1512,1355,157,1391,121
2002,Rural,Assam,Crime Against Women,Dowry Deaths,Female,18-30,2196,863,1333,1440,756
2003,Rural,Madhya Pradesh,Crime Against Women,Dowry Deaths,Male,0-12,5331,434,4897,1181,4150
2006,Rural,Assam,Crime Against Children,Kidnapping,Male,46-60,2440,236,2204,427,2013
2003,Urban,Tripura,Crime Against Children,Child Abuse,Male,18-30,7290,1326,5964,2560,4730
2006,Urban,Gujarat,Property Crime,Vandalism,Male,18-30,7364,4360,3004,4622,2742
2004,Rural,Kerala,Crime Against Children,Child Labor,Male,60+,3019,1666,1353,2279,740
2008,Urban,West Bengal,Other Crimes,Drug Offense,Female,13-17,8870,4757,4113,5815,3055
2008,Rural,Jharkhand,Property Crime,Burglary,Female,46-60,2212,1158,1054,1977,235
2004,Rural,Kerala,Crime Against Children,Kidnapping,Male,0-12,9698,8373,1325,9050,648
2001,Urban,Andhra Pradesh,Other Crimes,Corruption,Female,46-60,9829,1554,8275,8758,1071
2010,Rural,Haryana,Other Crimes,Fraud,Male,18-30,2392,1143,1249,1597,795
2008,Urban,Manipur,Other Crimes,Drug Offense,Female,13-17,4332,3402,930,4092,240
2007,Rural,Madhya Pradesh,Crime Against Men,Extortion,Female,31-45,3184,604,2580,1372,1812
2009,Rural,Karnataka,Crime Against Children,Trafficking,Male,60+,3283,2853,430,3202,81
2002,Rural,Jammu & Kashmir,Crime Against Women,Rape,Female,46-60,8737,6580,2157,7736,1001
2010,Rural,Rajasthan,Crime Against Children,Child Labor,Male,46-60,6061,5511,550,5814,247
2010,Rural,Tripura,Other Crimes,Fraud,Female,18-30,3727,665,3062,3185,542
2005,Urban,Maharashtra,Other Crimes,Fraud,Female,13-17,7238,6214,1024,6788,450
2003,Rural,Tamil Nadu,Crime Against Men,Extortion,Female,60+,6570,2208,4362,2832,3738
2003,Rural,Tripura,Crime Against Children,Kidnapping,Female,18-30,3952,486,3466,951,3001
2008,Urban,Kerala,Crime Against Men,Assault,Female,13-17,4679,1659,3020,3687,992
2002,Urban,Nagaland,Other Crimes,Fraud,Male,0-12,5647,3749,1898,4782,865
2009,Urban,Manipur,Crime Against Children,Kidnapping,Male,46-60,5358,2220,3138,4611,747
2005,Rural,Karnataka,Other Crimes,Corruption,Male,13-17,4755,1340,3415,2310,2445
2004,Urban,Nagaland,Crime Against Children,Child Labor,Female,60+,9018,704,8314,6958,2060
2009,Urban,Odisha,Property Crime,Burglary,Female,46-60,1182,955,227,1086,96
2009,Urban,Mizoram,Property Crime,Vandalism,Female,13-17,4913,3912,1001,4048,865
2008,Urban,Bihar,Crime Against Women,Molestation,Female,31-45,4572,3947,625,4089,483
2009,Urban,Odisha,Other Crimes,Cyber Crime,Male,31-45,3025,1279,1746,2129,896
2008,Urban,Delhi,Crime Against Women,Domestic Violence,Female,0-12,4135,822,3313,3009,1126
2010,Rural,Goa,Crime Against Children,Kidnapping,Female,13-17,9719,5306,4413,8005,1714
2001,Urban,Gujarat,Other Crimes,Corruption,Female,31-45,8283,2967,5316,3033,5250
2002,Urban,Gujarat,Other Crimes,Corruption,Male,13-17,1970,121,1849,428,1542
2003,Urban,Bihar,Crime Against Women,Dowry Deaths,Female,60+,4985,2335,2650,4160,825
2003,Urban,Gujarat,Property Crime,Burglary,Male,13-17,9670,6482,3188,7791,1879
2002,Rural,Madhya Pradesh,Crime Against Men,Murder,Male,60+,8995,758,8237,7632,1363
2004,Urban,Andhra Pradesh,Property Crime,Burglary,Female,13-17,295,173,122,263,32
2006,Rural,Maharashtra,Property Crime,Arson,Male,0-12,924,25,899,567,357
2008,Urban,Madhya Pradesh,Crime Against Children,Kidnapping,Female,13-17,9211,6182,3029,8114,1097
2009,Rural,Andhra Pradesh,Crime Against Women,Rape,Male,0-12,102,1,101,59,43
2005,Urban,Kerala,Other Crimes,Fraud,Male,13-17,764,687,77,724,40
2001,Rural,Arunachal Pradesh,Crime Against Men,Robbery,Male,31-45,8201,6713,1488,6724,1477
2002,Rural,Haryana,Property Crime,Burglary,Male,31-45,881,144,737,480,401
2005,Rural,Bihar,Property Crime,Arson,Male,18-30,105,50,55,79,26
2010,Rural,Bihar,Crime Against Men,Extortion,Female,60+,4622,952,3670,2089,2533
2010,Rural,Madhya Pradesh,Crime Against Men,Robbery,Male,31-45,8113,359,7754,3427,4686
2007,Rural,Assam,Property Crime,Arson,Female,31-45,3374,2486,888,2679,695
2002,Urban,Uttarakhand,Property Crime,Theft,Female,31-45,8687,2911,5776,8240,447
2004,Urban,Andhra Pradesh,Property Crime,Arson,Female,46-60,2639,2071,568,2413,226
2008,Urban,Kerala,Crime Against Men,Robbery,Female,46-60,1623,1520,103,1524,99
2003,Rural,Uttarakhand,Crime Against Women,Dowry Deaths,Female,0-12,9405,7685,1720,8639,766
2004,Urban,Maharashtra,Crime Against Children,Child Abuse,Male,46-60,4857,2021,2836,2322,2535
2008,Rural,Tamil Nadu,Crime Against Children,Trafficking,Male,13-17,6710,4508,2202,5291,1419
2009,Urban,Haryana,Property Crime,Arson,Female,46-60,7099,33,7066,6590,509
2008,Rural,Mizoram,Crime Against Children,Child Labor,Male,13-17,9971,3364,6607,8769,1202
2002,Rural,Uttarakhand,Property Crime,Theft,Male,46-60,5047,2909,2138,3466,1581
2004,Urban,Himachal Pradesh,Property Crime,Burglary,Female,18-30,759,63,696,269,490
2007,Rural,Himachal Pradesh,Crime Against Men,Assault,Male,0-12,6538,3764,2774,3906,2632
2001,Urban,Goa,Crime Against Children,Child Abuse,Female,31-45,9757,8835,922,9131,626
2001,Rural,West Bengal,Property Crime,Arson,Female,18-30,225,4,221,73,152
2007,Urban,Jharkhand,Other Crimes,Drug Offense,Male,31-45,552,512,40,528,24
2004,Urban,Mizoram,Crime Against Men,Assault,Female,13-17,8034,7588,446,7813,221
2003,Rural,Assam,Property Crime,Arson,Male,0-12,5387,3020,2367,3253,2134
2009,Urban,Punjab,Crime Against Children,Child Labor,Male,0-12,8027,2855,5172,6311,1716
2003,Urban,Telangana,Property Crime,Burglary,Female,46-60,8310,4111,4199,6902,1408
2006,Rural,Tamil Nadu,Crime Against Men,Extortion,Male,0-12,8615,5721,2894,5913,2702
2007,Rural,Tamil Nadu,Crime Against Children,Child Abuse,Male,18-30,380,166,214,265,115
2003,Rural,Manipur,Crime Against Women,Dowry Deaths,Male,46-60,8137,1086,7051,2246,5891
2007,Rural,Tamil Nadu,Other Crimes,Cyber Crime,Female,60+,5393,3055,2338,5149,244
2009,Urban,Manipur,Crime Against Children,Child Labor,Female,13-17,6939,716,6223,4195,2744
2008,Urban,Bihar,Property Crime,Theft,Female,60+,1932,1103,829,1753,179
2001,Urban,Maharashtra,Crime Against Women,Rape,Male,13-17,4158,686,3472,806,3352
2005,Rural,Bihar,Other Crimes,Drug Offense,Male,13-17,252,89,163,156,96
2004,Urban,Rajasthan,Crime Against Women,Rape,Male,13-17,7559,6330,1229,6385,1174
2009,Rural,Tamil Nadu,Crime Against Children,Child Labor,Male,0-12,1570,1537,33,1551,19
2008,Urban,Telangana,Property Crime,Arson,Female,18-30,9375,7272,2103,8432,943
2006,Urban,Himachal Pradesh,Crime Against Men,Extortion,Male,31-45,1107,351,756,1039,68
2003,Rural,Maharashtra,Crime Against Women,Dowry Deaths,Female,18-30,6857,3021,3836,4979,1878
2007,Rural,Arunachal Pradesh,Property Crime,Burglary,Female,60+,8408,6807,1601,7551,857
2004,Urban,Tamil Nadu,Crime Against Children,Child Abuse,Female,13-17,7139,3316,3823,3340,3799
2006,Rural,Delhi,Other Crimes,Corruption,Male,31-45,8957,5398,3559,6172,2785
2005,Rural,Uttarakhand,Crime Against Men,Robbery,Female,13-17,6717,4992,1725,6113,604
2008,Rural,Kerala,Crime Against Men,Extortion,Female,0-12,1494,786,708,794,700
2003,Urban,Delhi,Other Crimes,Corruption,Male,60+,2395,576,1819,1098,1297
2005,Urban,Haryana,Other Crimes,Cyber Crime,Male,31-45,5455,1422,4033,4961,494
2010,Rural,Jammu & Kashmir,Crime Against Women,Domestic Violence,Female,31-45,738,531,207,718,20
2003,Rural,Karnataka,Crime Against Children,Trafficking,Female,0-12,1666,1418,248,1575,91
2007,Rural,Maharashtra,Crime Against Women,Rape,Female,31-45,6089,3369,2720,5168,921
2009,Rural,Tripura,Other Crimes,Corruption,Male,46-60,4084,1598,2486,3268,816
2002,Urban,Nagaland,Crime Against Women,Rape,Male,46-60,431,336,95,382,49
2009,Rural,Himachal Pradesh,Property Crime,Theft,Male,31-45,4248,1354,2894,3106,1142
2010,Urban,Andhra Pradesh,Crime Against Children,Kidnapping,Female,13-17,9563,3330,6233,7955,1608
2009,Rural,Odisha,Other Crimes,Drug Offense,Female,60+,5674,5462,212,5571,103
2004,Urban,Manipur,Other Crimes,Drug Offense,Male,18-30,7541,771,6770,4704,2837
2005,Urban,Jharkhand,Crime Against Women,Dowry Deaths,Male,31-45,3685,3117,568,3210,475
2010,Urban,Telangana,Other Crimes,Drug Offense,Female,60+,250,8,242,81,169
2007,Rural,Manipur,Property Crime,Theft,Female,46-60,3960,3387,573,3608,352
2001,Rural,Tamil Nadu,Crime Against Men,Robbery,Female,31-45,3242,2119,1123,3220,22
2006,Urban,Kerala,Property Crime,Arson,Male,0-12,6622,5525,1097,5945,677
2002,Rural,Andhra Pradesh,Crime Against Children,Trafficking,Female,18-30,592,13,579,317,275
2007,Rural,Odisha,Crime Against Women,Molestation,Female,13-17,1111,1067,44,1103,8
2007,Rural,Chhattisgarh,Crime Against Men,Extortion,Female,18-30,7126,6731,395,6868,258
2003,Rural,Mizoram,Crime Against Women,Dowry Deaths,Female,31-45,9106,8238,868,8489,617
2010,Urban,Andhra Pradesh,Property Crime,Burglary,Female,13-17,1676,118,1558,1080,596
2005,Rural,Kerala,Property Crime,Burglary,Male,60+,9774,5113,4661,5192,4582
2007,Rural,Uttarakhand,Property Crime,Theft,Male,60+,575,210,365,390,185
2007,Rural,Chhattisgarh,Crime Against Children,Kidnapping,Female,13-17,6993,5345,1648,6956,37
2010,Urban,Tripura,Crime Against Women,Domestic Violence,Female,31-45,1160,851,309,873,287
2001,Rural,Tamil Nadu,Other Crimes,Fraud,Male,18-30,52,49,3,49,3
2005,Rural,Kerala,Crime Against Men,Murder,Male,31-45,7683,6957,726,7501,182
2004,Urban,Andhra Pradesh,Crime Against Children,Kidnapping,Male,0-12,9329,4675,4654,8294,1035
2001,Rural,Tripura,Crime Against Children,Child Labor,Female,31-45,3994,2115,1879,3547,447
2001,Rural,Odisha,Crime Against Children,Trafficking,Female,13-17,9105,1295,7810,2926,6179
2001,Rural,Karnataka,Crime Against Men,Extortion,Male,18-30,8047,5884,2163,6844,1203
2006,Urban,Meghalaya,Property Crime,Burglary,Male,31-45,6502,5771,731,6218,284
2005,Urban,Goa,Crime Against Men,Assault,Male,0-12,7873,2545,5328,6323,1550
2005,Rural,Karnataka,Crime Against Women,Dowry Deaths,Male,60+,1938,162,1776,1909,29
2007,Rural,Assam,Crime Against Men,Assault,Male,46-60,3800,2493,1307,2593,1207
2009,Rural,Chhattisgarh,Crime Against Women,Rape,Female,60+,4197,3370,827,3502,695
2007,Urban,Meghalaya,Crime Against Women,Rape,Female,13-17,5949,5796,153,5836,113
2009,Urban,Uttarakhand,Crime Against Children,Trafficking,Female,60+,7941,3361,4580,6535,1406
2009,Urban,Jammu & Kashmir,Crime Against Men,Assault,Female,46-60,4549,1197,3352,1680,2869
2003,Urban,West Bengal,Property Crime,Vandalism,Male,0-12,359,339,20,342,17
2002,Rural,Uttar Pradesh,Crime Against Children,Child Labor,Female,60+,8172,1415,6757,7209,963
2008,Urban,Himachal Pradesh,Crime Against Women,Dowry Deaths,Male,60+,358,163,195,266,92
2006,Rural,Haryana,Other Crimes,Drug Offense,Female,31-45,7108,5869,1239,6353,755
2005,Urban,Uttar Pradesh,Property Crime,Burglary,Male,13-17,4093,931,3162,1205,2888
2009,Rural,Arunachal Pradesh,Property Crime,Arson,Male,13-17,6272,5638,634,6207,65
2006,Urban,West Bengal,Other Crimes,Fraud,Male,18-30,6921,2131,4790,2539,4382
2009,Urban,Mizoram,Crime Against Women,Molestation,Male,31-45,9581,622,8959,793,8788
2009,Rural,Punjab,Property Crime,Theft,Male,18-30,8951,2707,6244,6264,2687
2005,Urban,Mizoram,Other Crimes,Cyber Crime,Male,31-45,449,369,80,394,55
2005,Urban,Meghalaya,Crime Against Children,Trafficking,Female,46-60,9849,2712,7137,8220,1629
2009,Rural,Delhi,Crime Against Women,Dowry Deaths,Male,31-45,7655,3672,3983,4647,3008
2003,Rural,Chhattisgarh,Crime Against Men,Assault,Female,18-30,4456,963,3493,3556,900
2002,Urban,Odisha,Other Crimes,Drug Offense,Female,0-12,7011,4940,2071,6342,669
2010,Urban,Goa,Property Crime,Theft,Female,0-12,5478,2534,2944,5476,2
2001,Urban,Arunachal Pradesh,Other Crimes,Drug Offense,Male,46-60,6055,405,5650,2816,3239
2002,Rural,Bihar,Crime Against Men,Extortion,Female,13-17,1600,161,1439,1049,551
2004,Rural,Himachal Pradesh,Crime Against Children,Child Labor,Female,0-12,7680,4957,2723,6247,1433
2009,Rural,Assam,Property Crime,Arson,Female,31-45,1113,218,895,245,868
2001,Rural,Rajasthan,Other Crimes,Drug Offense,Male,31-45,6792,4388,2404,6494,298
2009,Rural,Himachal Pradesh,Crime Against Men,Robbery,Female,60+,1414,1254,160,1347,67
2002,Urban,Tripura,Crime Against Children,Trafficking,Male,60+,5846,4244,1602,4473,1373
2005,Rural,Assam,Crime Against Men,Extortion,Female,13-17,4758,3199,1559,4113,645
2007,Rural,Jharkhand,Crime Against Children,Trafficking,Female,46-60,1896,1391,505,1706,190
2006,Urban,Uttar Pradesh,Crime Against Women,Dowry Deaths,Female,46-60,3571,3309,262,3479,92
2007,Urban,Arunachal Pradesh,Crime Against Children,Child Abuse,Male,18-30,6198,1574,4624,4574,1624
2001,Rural,Rajasthan,Crime Against Men,Robbery,Male,60+,6868,5105,1763,6631,237
2008,Urban,Mizoram,Crime Against Children,Trafficking,Male,60+,2319,1998,321,2187,132
2005,Urban,Chhattisgarh,Other Crimes,Fraud,Female,13-17,9097,2766,6331,7945,1152
2004,Rural,Rajasthan,Crime Against Women,Molestation,Male,18-30,8907,8624,283,8773,134
2005,Rural,Bihar,Crime Against Women,Molestation,Female,46-60,4830,469,4361,4067,763
2006,Urban,Tamil Nadu,Crime Against Women,Rape,Male,0-12,7684,7403,281,7655,29
2008,Urban,Mizoram,Crime Against Men,Murder,Male,0-12,3238,1301,1937,3015,223
2002,Urban,Rajasthan,Crime Against Children,Child Labor,Male,60+,8215,4204,4011,5860,2355
2007,Urban,Odisha,Property Crime,Vandalism,Male,18-30,1289,245,1044,787,502
2002,Urban,Uttar Pradesh,Other Crimes,Fraud,Male,18-30,5051,2882,2169,3435,1616
2005,Rural,Uttarakhand,Property Crime,Arson,Female,18-30,8688,1086,7602,1107,7581
2009,Urban,Andhra Pradesh,Crime Against Women,Dowry Deaths,Female,46-60,3304,3192,112,3274,30
2009,Rural,Karnataka,Crime Against Women,Rape,Male,31-45,8581,2012,6569,3444,5137
2008,Rural,Jharkhand,Crime Against Women,Molestation,Male,46-60,8152,2521,5631,7471,681
2004,Rural,Manipur,Crime Against Children,Child Abuse,Male,13-17,9891,1510,8381,5612,4279
2007,Urban,Haryana,Crime Against Women,Rape,Female,46-60,720,580,140,716,4
2009,Rural,Jammu & Kashmir,Crime Against Women,Dowry Deaths,Male,60+,6768,3286,3482,5305,1463
2009,Urban,Chhattisgarh,Property Crime,Theft,Female,31-45,9935,154,9781,4907,5028
2003,Urban,Bihar,Other Crimes,Drug Offense,Male,13-17,2504,1041,1463,2033,471
2008,Rural,Tamil Nadu,Other Crimes,Fraud,Male,18-30,3457,3332,125,3340,117
2009,Urban,Tripura,Property Crime,Burglary,Male,60+,667,158,509,597,70
2004,Rural,Goa,Crime Against Women,Rape,Female,46-60,7327,24,7303,4587,2740
2003,Rural,Uttarakhand,Other Crimes,Corruption,Male,18-30,2846,1397,1449,2041,805
2004,Urban,Himachal Pradesh,Other Crimes,Cyber Crime,Female,13-17,8948,6402,2546,7359,1589
2008,Rural,Goa,Crime Against Children,Kidnapping,Male,31-45,3994,1171,2823,1324,2670
2003,Urban,Haryana,Crime Against Men,Robbery,Female,13-17,7099,20,7079,3828,3271
2003,Urban,Arunachal Pradesh,Other Crimes,Drug Offense,Male,31-45,6990,6221,769,6269,721
2007,Rural,Mizoram,Property Crime,Burglary,Female,31-45,4328,620,3708,3171,1157
2003,Rural,Arunachal Pradesh,Crime Against Children,Trafficking,Male,0-12,6389,4532,1857,5466,923
2006,Urban,Manipur,Crime Against Men,Extortion,Male,31-45,2077,1789,288,1917,160
2001,Urban,Bihar,Crime Against Women,Rape,Female,60+,5554,1203,4351,3316,2238
2007,Rural,Gujarat,Crime Against Children,Kidnapping,Female,18-30,63,36,27,45,18
2009,Urban,Himachal Pradesh,Crime Against Women,Dowry Deaths,Male,60+,1503,1133,370,1485,18
2005,Urban,Arunachal Pradesh,Crime Against Women,Molestation,Female,18-30,5204,3048,2156,3051,2153
2002,Urban,Maharashtra,Crime Against Children,Child Abuse,Male,60+,8236,1071,7165,3039,5197
2007,Urban,Haryana,Other Crimes,Fraud,Male,46-60,2462,1732,730,1936,526
2004,Urban,Uttarakhand,Crime Against Men,Assault,Female,13-17,2555,102,2453,152,2403
2008,Urban,Rajasthan,Crime Against Men,Extortion,Female,0-12,9118,7869,1249,8841,277
2010,Rural,Manipur,Crime Against Men,Assault,Female,31-45,9954,2507,7447,3073,6881
2006,Urban,Uttar Pradesh,Property Crime,Vandalism,Female,13-17,2691,2197,494,2357,334
2003,Rural,Bihar,Crime Against Men,Murder,Male,46-60,4235,3200,1035,3353,882
2001,Rural,Jharkhand,Crime Against Men,Robbery,Female,60+,319,176,143,287,32
2001,Rural,Manipur,Other Crimes,Drug Offense,Female,60+,4706,1081,3625,1400,3306
2005,Urban,Jammu & Kashmir,Crime Against Women,Molestation,Female,0-12,9308,1121,8187,4703,4605
2001,Rural,Tripura,Crime Against Men,Murder,Female,46-60,2048,984,1064,1075,973
2008,Urban,Bihar,Crime Against Children,Child Abuse,Female,13-17,4691,3908,783,4252,439
2007,Rural,West Bengal,Other Crimes,Corruption,Female,13-17,4916,2456,2460,3235,1681
2004,Rural,Punjab,Crime Against Children,Child Labor,Male,0-12,9414,4739,4675,8832,582
2002,Rural,Sikkim,Crime Against Men,Assault,Female,46-60,3173,2726,447,2747,426
2010,Urban,Bihar,Crime Against Women,Domestic Violence,Male,0-12,8556,7327,1229,7922,634
2006,Urban,Rajasthan,Crime Against Children,Child Abuse,Male,46-60,9477,1954,7523,4169,5308
2007,Rural,Odisha,Crime Against Men,Murder,Female,13-17,7307,5099,2208,5878,1429
2007,Rural,Assam,Crime Against Men,Extortion,Male,31-45,1399,729,670,1338,61
2004,Rural,Gujarat,Crime Against Men,Murder,Female,31-45,2500,1052,1448,1348,1152
2009,Rural,Tamil Nadu,Crime Against Women,Rape,Male,60+,2406,422,1984,1098,1308
2007,Urban,Sikkim,Crime Against Children,Kidnapping,Female,13-17,4600,4596,4,4598,2
2003,Urban,Sikkim,Crime Against Men,Assault,Female,31-45,6162,1718,4444,2504,3658
2004,Urban,Delhi,Crime Against Children,Child Abuse,Male,0-12,4160,1232,2928,3462,698
2010,Rural,Mizoram,Property Crime,Vandalism,Female,13-17,2385,2295,90,2328,57
2008,Rural,Tripura,Other Crimes,Fraud,Female,13-17,1745,795,950,1313,432
2008,Rural,Odisha,Other Crimes,Drug Offense,Female,13-17,6757,387,6370,839,5918
2007,Urban,Kerala,Crime Against Women,Rape,Female,46-60,6475,108,6367,1072,5403
2008,Urban,Karnataka,Crime Against Children,Trafficking,Male,18-30,410,232,178,378,32
2010,Rural,Meghalaya,Crime Against Men,Assault,Female,0-12,1804,1753,51,1754,50
2003,Urban,Uttarakhand,Property Crime,Vandalism,Male,13-17,6669,4377,2292,5352,1317
2004,Urban,Tripura,Property Crime,Theft,Male,60+,6754,4824,1930,5159,1595
2010,Rural,Punjab,Property Crime,Vandalism,Female,46-60,4959,71,4888,1588,3371
2006,Rural,Bihar,Other Crimes,Fraud,Female,0-12,5562,415,5147,4326,1236
2001,Urban,Himachal Pradesh,Crime Against Women,Molestation,Male,60+,6801,568,6233,2935,3866
2009,Rural,Haryana,Crime Against Children,Child Abuse,Female,60+,7320,5292,2028,6063,1257
2003,Urban,Uttar Pradesh,Crime Against Men,Murder,Female,13-17,9707,3578,6129,9504,203
2006,Rural,West Bengal,Crime Against Women,Molestation,Female,46-60,791,307,484,425,366
2001,Urban,Delhi,Crime Against Men,Assault,Female,31-45,8484,7144,1340,7548,936
2008,Urban,Assam,Other Crimes,Fraud,Female,0-12,7552,1422,6130,5441,2111
2006,Rural,Chhattisgarh,Property Crime,Theft,Female,13-17,6366,2396,3970,4350,2016
2001,Urban,Telangana,Crime Against Women,Dowry Deaths,Female,0-12,8251,7654,597,7903,348
2007,Urban,Meghalaya,Crime Against Women,Rape,Male,46-60,1851,978,873,1590,261
2009,Rural,Rajasthan,Crime Against Women,Domestic Violence,Female,13-17,5522,2871,2651,3387,2135
2002,Urban,Punjab,Property Crime,Arson,Female,0-12,5822,1319,4503,5513,309
2010,Urban,Kerala,Crime Against Children,Child Labor,Male,46-60,417,233,184,372,45
2005,Urban,Uttar Pradesh,Other Crimes,Fraud,Male,46-60,6232,6120,112,6127,105
2005,Urban,Assam,Crime Against Women,Rape,Male,18-30,3261,2391,870,3038,223
2007,Urban,Mizoram,Property Crime,Vandalism,Female,0-12,9006,1943,7063,6326,2680
2003,Rural,Kerala,Property Crime,Vandalism,Male,46-60,4451,3686,765,3794,657
2009,Urban,Andhra Pradesh,Crime Against Men,Murder,Male,31-45,9292,4840,4452,5792,3500
2005,Urban,Kerala,Crime Against Men,Robbery,Male,18-30,3734,1522,2212,3035,699
2007,Rural,Madhya Pradesh,Crime Against Women,Molestation,Male,46-60,2673,2036,637,2245,428
2003,Urban,Bihar,Crime Against Women,Rape,Female,13-17,2560,1468,1092,1783,777
2010,Urban,Rajasthan,Crime Against Men,Extortion,Female,46-60,644,434,210,531,113
2003,Urban,Himachal Pradesh,Crime Against Children,Trafficking,Female,60+,164,106,58,116,48
2002,Rural,Madhya Pradesh,Crime Against Children,Trafficking,Female,46-60,6220,5633,587,6139,81
2002,Rural,Delhi,Crime Against Children,Kidnapping,Female,18-30,4388,1018,3370,3771,617
2009,Urban,Kerala,Property Crime,Theft,Female,46-60,1033,930,103,962,71
2010,Urban,Punjab,Crime Against Men,Robbery,Male,60+,3457,28,3429,2624,833
2001,Urban,Odisha,Crime Against Children,Child Labor,Male,18-30,7328,5044,2284,5953,1375
2007,Rural,Arunachal Pradesh,Property Crime,Vandalism,Male,60+,3204,2932,272,3040,164
2004,Urban,Karnataka,Property Crime,Vandalism,Male,46-60,3592,2857,735,3279,313
2006,Urban,Rajasthan,Crime Against Women,Domestic Violence,Female,13-17,8433,7078,1355,7445,988
2009,Rural,Himachal Pradesh,Other Crimes,Fraud,Female,60+,2032,1966,66,2002,30
2002,Rural,Goa,Crime Against Men,Extortion,Female,0-12,5361,4955,406,5059,302
2004,Urban,Jammu & Kashmir,Other Crimes,Cyber Crime,Male,60+,4078,37,4041,641,3437
2007,Urban,Assam,Crime Against Children,Kidnapping,Female,0-12,7606,6001,1605,7080,526
2010,Rural,Gujarat,Crime Against Women,Domestic Violence,Female,18-30,7187,4822,2365,6326,861
2003,Urban,Himachal Pradesh,Other Crimes,Corruption,Male,13-17,7070,4305,2765,6757,313
2002,Rural,Manipur,Property Crime,Burglary,Female,18-30,2486,2180,306,2308,178
2006,Rural,Sikkim,Crime Against Children,Child Labor,Male,13-17,2480,2016,464,2471,9
2002,Rural,Punjab,Property Crime,Vandalism,Male,46-60,3900,888,3012,2757,1143
2010,Urban,Tripura,Property Crime,Theft,Female,13-17,6136,2463,3673,2730,3406
2007,Urban,Karnataka,Crime Against Women,Dowry Deaths,Female,46-60,8906,6747,2159,6774,2132
2004,Urban,Goa,Crime Against Men,Extortion,Female,31-45,6376,2625,3751,5917,459
2006,Urban,Karnataka,Other Crimes,Cyber Crime,Female,31-45,7802,2703,5099,4320,3482
2003,Rural,Sikkim,Other Crimes,Cyber Crime,Male,18-30,1827,1073,754,1489,338
2006,Urban,Sikkim,Crime Against Children,Child Labor,Female,60+,9682,7850,1832,8039,1643
2004,Rural,Arunachal Pradesh,Property Crime,Theft,Male,18-30,7653,6055,1598,7617,36
2003,Rural,Maharashtra,Crime Against Women,Rape,Female,31-45,1276,228,1048,342,934
2006,Urban,Himachal Pradesh,Other Crimes,Corruption,Male,60+,3956,3239,717,3730,226
2007,Rural,Gujarat,Other Crimes,Corruption,Male,46-60,7702,2226,5476,6702,1000
2007,Rural,Uttar Pradesh,Crime Against Men,Extortion,Female,46-60,9051,6115,2936,7074,1977
2001,Rural,Assam,Crime Against Men,Assault,Male,0-12,2519,2462,57,2517,2
2003,Urban,Delhi,Crime Against Men,Assault,Male,31-45,7318,338,6980,4393,2925
2010,Urban,Rajasthan,Property Crime,Theft,Male,18-30,4920,2091,2829,3708,1212
2005,Urban,Jharkhand,Crime Against Women,Rape,Female,46-60,773,55,718,497,276
2006,Rural,Meghalaya,Other Crimes,Cyber Crime,Male,31-45,8501,385,8116,5233,3268
2005,Urban,Jharkhand,Other Crimes,Corruption,Male,18-30,744,278,466,712,32
2009,Urban,Madhya Pradesh,Crime Against Men,Assault,Female,60+,2495,1396,1099,2199,296
2006,Urban,Arunachal Pradesh,Property Crime,Burglary,Male,46-60,7696,6715,981,7488,208
2004,Urban,Chhattisgarh,Other Crimes,Drug Offense,Male,13-17,6020,1857,4163,4351,1669
2010,Rural,Andhra Pradesh,Property Crime,Burglary,Female,60+,9966,76,9890,9508,458
2002,Rural,Punjab,Crime Against Children,Kidnapping,Male,60+,9289,3845,5444,6411,2878
2007,Rural,Arunachal Pradesh,Crime Against Men,Extortion,Female,31-45,6440,6102,338,6151,289
2007,Rural,West Bengal,Crime Against Women,Dowry Deaths,Female,31-45,62,53,9,56,6
2005,Rural,Jammu & Kashmir,Crime Against Men,Extortion,Male,60+,8964,3492,5472,7192,1772
2009,Urban,Haryana,Property Crime,Burglary,Female,31-45,6627,5185,1442,6243,384
2003,Rural,Haryana,Property Crime,Arson,Female,0-12,2322,800,1522,2057,265
2007,Rural,Punjab,Crime Against Men,Extortion,Female,18-30,5243,724,4519,1906,3337
2003,Urban,Uttar Pradesh,Crime Against Children,Child Labor,Male,13-17,8769,287,8482,8146,623
2006,Urban,Gujarat,Crime Against Women,Molestation,Female,13-17,8458,4716,3742,6476,1982
2008,Rural,Kerala,Other Crimes,Fraud,Male,13-17,7609,4674,2935,6819,790
2007,Urban,Kerala,Crime Against Children,Child Abuse,Male,60+,7896,80,7816,267,7629
2010,Urban,Sikkim,Other Crimes,Fraud,Female,13-17,7652,1312,6340,2106,5546
2004,Rural,Assam,Crime Against Men,Robbery,Female,60+,5011,4809,202,4960,51
2006,Urban,Odisha,Property Crime,Theft,Female,46-60,6954,5523,1431,6454,500
2008,Rural,Jharkhand,Crime Against Women,Domestic Violence,Male,46-60,3742,1677,2065,2201,1541
2010,Urban,Odisha,Crime Against Women,Domestic Violence,Male,13-17,9563,6912,2651,8044,1519
2009,Urban,Goa,Other Crimes,Fraud,Female,18-30,1131,940,191,1113,18
2006,Rural,Haryana,Crime Against Children,Child Abuse,Female,60+,1466,714,752,853,613
2009,Rural,Rajasthan,Property Crime,Vandalism,Male,31-45,7607,4483,3124,5522,2085
2006,Urban,Maharashtra,Crime Against Children,Kidnapping,Male,60+,1615,1008,607,1404,211
2003,Rural,Himachal Pradesh,Crime Against Men,Extortion,Male,46-60,1379,178,1201,1278,101
2005,Urban,Sikkim,Crime Against Children,Trafficking,Female,0-12,8364,5893,2471,6333,2031
2009,Rural,Karnataka,Crime Against Men,Murder,Male,0-12,6593,5810,783,5953,640
2010,Urban,Gujarat,Crime Against Children,Kidnapping,Male,18-30,3653,400,3253,1960,1693
2002,Rural,Kerala,Other Crimes,Drug Offense,Male,60+,6114,305,5809,2629,3485
2001,Urban,West Bengal,Property Crime,Vandalism,Female,46-60,7647,2969,4678,6538,1109
2005,Rural,Manipur,Crime Against Children,Kidnapping,Female,46-60,9325,8837,488,9014,311
2007,Rural,Andhra Pradesh,Crime Against Men,Murder,Female,31-45,7188,5375,1813,6177,1011
2002,Rural,Bihar,Other Crimes,Drug Offense,Male,60+,5526,5003,523,5515,11
2005,Urban,Jharkhand,Other Crimes,Fraud,Female,18-30,2220,648,1572,1372,848
2008,Rural,Andhra Pradesh,Crime Against Men,Robbery,Female,60+,304,153,151,212,92
2008,Urban,Delhi,Crime Against Men,Extortion,Female,18-30,6790,268,6522,6127,663
2010,Urban,Karnataka,Crime Against Women,Domestic Violence,Male,0-12,709,80,629,202,507
2001,Urban,Arunachal Pradesh,Crime Against Men,Murder,Male,31-45,4957,2508,2449,4479,478
2004,Urban,Manipur,Property Crime,Theft,Female,0-12,6478,489,5989,5462,1016
2003,Urban,West Bengal,Crime Against Children,Trafficking,Female,0-12,5019,3666,1353,4429,590
2009,Rural,Delhi,Property Crime,Theft,Male,18-30,1123,839,284,964,159
2001,Rural,Tripura,Crime Against Women,Dowry Deaths,Female,31-45,5324,2707,2617,4752,572
2007,Urban,Arunachal Pradesh,Crime Against Children,Child Abuse,Male,31-45,7701,2876,4825,4405,3296
2009,Rural,Sikkim,Property Crime,Theft,Female,13-17,4289,1156,3133,1680,2609
2002,Rural,Telangana,Crime Against Children,Child Abuse,Male,31-45,1076,325,751,399,677
2006,Rural,Arunachal Pradesh,Crime Against Men,Assault,Female,0-12,537,93,444,273,264
2007,Urban,Meghalaya,Crime Against Women,Dowry Deaths,Male,18-30,6374,3411,2963,5528,846
2001,Urban,Maharashtra,Crime Against Women,Rape,Male,46-60,8366,3601,4765,7453,913
2010,Rural,Kerala,Crime Against Women,Domestic Violence,Female,0-12,5256,1162,4094,2392,2864
2010,Urban,Jammu & Kashmir,Crime Against Men,Murder,Female,13-17,5123,518,4605,1761,3362
2001,Urban,Odisha,Property Crime,Theft,Male,46-60,9984,6996,2988,7236,2748
2006,Rural,Bihar,Other Crimes,Fraud,Female,46-60,9981,7744,2237,8416,1565
2010,Urban,Andhra Pradesh,Crime Against Men,Robbery,Female,18-30,3632,2860,772,3163,469
2007,Urban,Jammu & Kashmir,Crime Against Women,Rape,Male,0-12,1761,620,1141,1238,523
2010,Urban,Haryana,Crime Against Children,Trafficking,Female,0-12,3724,509,3215,3416,308
2002,Urban,Himachal Pradesh,Crime Against Children,Child Abuse,Female,60+,5351,4714,637,4780,571
2008,Rural,Arunachal Pradesh,Crime Against Women,Dowry Deaths,Male,60+,2584,855,1729,1439,1145
2009,Urban,Odisha,Crime Against Women,Domestic Violence,Male,46-60,6543,1928,4615,5285,1258
2008,Rural,Manipur,Crime Against Men,Murder,Male,0-12,5016,214,4802,1052,3964
2002,Urban,Andhra Pradesh,Property Crime,Arson,Female,46-60,1496,1163,333,1334,162
2002,Urban,Andhra Pradesh,Crime Against Women,Dowry Deaths,Female,13-17,3779,2130,1649,2604,1175
2005,Rural,Punjab,Other Crimes,Cyber Crime,Male,60+,6450,453,5997,2972,3478
2004,Rural,Mizoram,Other Crimes,Cyber Crime,Male,46-60,8563,629,7934,8498,65
2008,Urban,Madhya Pradesh,Crime Against Children,Trafficking,Female,0-12,4496,3046,1450,4450,46
2006,Urban,Manipur,Other Crimes,Drug Offense,Female,18-30,7700,5872,1828,6158,1542
2010,Urban,Tripura,Other Crimes,Corruption,Female,31-45,4626,2384,2242,4028,598
2006,Urban,Uttar Pradesh,Crime Against Women,Dowry Deaths,Female,0-12,6639,1996,4643,3416,3223
2003,Rural,Arunachal Pradesh,Crime Against Children,Kidnapping,Female,0-12,8799,282,8517,8378,421
2007,Rural,Jharkhand,Other Crimes,Cyber Crime,Female,0-12,2378,1882,496,1929,449
2009,Urban,Mizoram,Crime Against Women,Rape,Female,13-17,7186,4078,3108,6570,616
2010,Urban,Andhra Pradesh,Other Crimes,Cyber Crime,Female,60+,2384,2273,111,2314,70
2003,Urban,Madhya Pradesh,Crime Against Children,Child Abuse,Male,60+,381,56,325,299,82
2010,Rural,Haryana,Crime Against Women,Dowry Deaths,Male,60+,5016,1211,3805,2103,2913
2007,Rural,Uttarakhand,Other Crimes,Drug Offense,Female,60+,6642,786,5856,2149,4493
2005,Urban,Rajasthan,Property Crime,Burglary,Female,46-60,4352,3736,616,4098,254
2006,Urban,Haryana,Crime Against Men,Robbery,Male,13-17,5893,4526,1367,4622,1271
2003,Rural,Telangana,Crime Against Women,Domestic Violence,Female,0-12,7752,2651,5101,4215,3537
2004,Urban,Tamil Nadu,Property Crime,Theft,Female,13-17,8881,8169,712,8860,21
2009,Urban,Jharkhand,Other Crimes,Corruption,Male,46-60,2735,1268,1467,2317,418
2006,Urban,Jharkhand,Property Crime,Arson,Male,13-17,3269,1233,2036,2998,271
2010,Urban,Tripura,Crime Against Children,Kidnapping,Male,31-45,5080,1902,3178,2938,2142
2004,Urban,Tamil Nadu,Crime Against Men,Murder,Female,18-30,5825,3973,1852,5031,794
2005,Rural,Jammu & Kashmir,Property Crime,Arson,Female,0-12,7873,4205,3668,5396,2477
2008,Rural,Assam,Crime Against Children,Child Abuse,Male,60+,7420,3452,3968,3828,3592
2001,Urban,Telangana,Property Crime,Arson,Male,31-45,5438,1625,3813,5212,226
2003,Rural,Delhi,Property Crime,Theft,Female,46-60,9399,5256,4143,6183,3216
2004,Rural,Bihar,Property Crime,Arson,Female,0-12,6038,4771,1267,4990,1048
2001,Rural,Andhra Pradesh,Other Crimes,Corruption,Female,31-45,1181,890,291,1070,111
2009,Rural,Delhi,Crime Against Children,Child Labor,Female,13-17,4263,299,3964,2241,2022
2001,Urban,Himachal Pradesh,Crime Against Men,Extortion,Male,46-60,6414,2116,4298,4745,1669
2001,Rural,Tamil Nadu,Crime Against Women,Molestation,Female,0-12,1128,720,408,964,164
2008,Urban,Manipur,Crime Against Children,Child Abuse,Male,31-45,1006,902,104,988,18
2009,Urban,Haryana,Crime Against Women,Rape,Female,31-45,8866,3541,5325,7123,1743
2006,Rural,Chhattisgarh,Crime Against Children,Kidnapping,Male,46-60,3173,2141,1032,2323,850
2002,Rural,Delhi,Crime Against Children,Child Labor,Female,46-60,9027,8373,654,8711,316
2002,Urban,West Bengal,Property Crime,Burglary,Male,60+,6953,5070,1883,6263,690
2007,Urban,Rajasthan,Property Crime,Arson,Female,13-17,2414,1654,760,2236,178
2005,Rural,Punjab,Crime Against Children,Child Labor,Male,60+,1588,1469,119,1485,103
2004,Urban,Maharashtra,Crime Against Children,Child Labor,Male,18-30,9663,2650,7013,4619,5044
2006,Rural,Andhra Pradesh,Property Crime,Vandalism,Female,31-45,6198,5511,687,5826,372
2007,Rural,Nagaland,Crime Against Women,Molestation,Female,60+,5254,2168,3086,2541,2713
2001,Urban,Chhattisgarh,Crime Against Men,Robbery,Male,0-12,1967,969,998,1670,297
2002,Rural,Mizoram,Other Crimes,Fraud,Male,13-17,898,216,682,668,230
2004,Rural,Andhra Pradesh,Property Crime,Theft,Male,18-30,5217,1226,3991,3072,2145
2003,Rural,Tripura,Property Crime,Theft,Male,46-60,2093,1367,726,1726,367
2008,Urban,Chhattisgarh,Crime Against Men,Assault,Female,60+,4943,2861,2082,4874,69
2010,Urban,Mizoram,Crime Against Children,Child Abuse,Female,18-30,885,841,44,841,44
2002,Rural,Chhattisgarh,Crime Against Children,Trafficking,Male,0-12,9273,6910,2363,7075,2198
2002,Urban,Mizoram,Crime Against Children,Child Labor,Female,18-30,5908,3226,2682,3349,2559
2001,Urban,Tamil Nadu,Crime Against Men,Robbery,Female,13-17,6266,3513,2753,5411,855
2007,Urban,Arunachal Pradesh,Crime Against Children,Child Abuse,Female,31-45,5012,3293,1719,4990,22
2004,Rural,Rajasthan,Other Crimes,Cyber Crime,Female,31-45,858,283,575,804,54
2002,Rural,Uttarakhand,Property Crime,Burglary,Male,31-45,832,442,390,585,247
2004,Urban,Assam,Other Crimes,Drug Offense,Male,13-17,8756,4626,4130,8325,431
2006,Urban,Maharashtra,Crime Against Women,Dowry Deaths,Male,46-60,4460,4284,176,4304,156
2009,Rural,Jammu & Kashmir,Property Crime,Arson,Male,18-30,8277,2353,5924,5688,2589
2010,Urban,Himachal Pradesh,Property Crime,Burglary,Female,31-45,662,543,119,592,70
2007,Urban,Delhi,Other Crimes,Corruption,Female,0-12,9636,6085,3551,8876,760
2005,Urban,Odisha,Crime Against Children,Trafficking,Female,0-12,4883,456,4427,3279,1604
2002,Rural,Odisha,Crime Against Children,Kidnapping,Female,0-12,6910,5929,981,6139,771
2009,Urban,Madhya Pradesh,Property Crime,Vandalism,Female,0-12,6704,2298,4406,5925,779
2005,Urban,Meghalaya,Crime Against Children,Trafficking,Male,18-30,4200,1396,2804,2729,1471
2006,Urban,Assam,Property Crime,Burglary,Female,60+,3195,2018,1177,2778,417
2010,Urban,Rajasthan,Crime Against Women,Dowry Deaths,Female,18-30,9732,1087,8645,3583,6149
2006,Rural,Tripura,Crime Against Women,Rape,Male,13-17,9102,1508,7594,4040,5062
2003,Urban,Tamil Nadu,Other Crimes,Drug Offense,Male,13-17,4809,2978,1831,4593,216
2008,Urban,Karnataka,Other Crimes,Drug Offense,Female,31-45,3618,1814,1804,3482,136
2007,Rural,Uttarakhand,Crime Against Children,Child Labor,Female,60+,6364,670,5694,4247,2117
2003,Rural,Kerala,Crime Against Children,Child Abuse,Male,60+,7533,2244,5289,3796,3737
2002,Rural,Kerala,Crime Against Children,Child Labor,Female,18-30,2289,908,1381,1680,609
2002,Urban,Himachal Pradesh,Crime Against Men,Murder,Female,60+,1399,1236,163,1368,31
2004,Urban,Andhra Pradesh,Crime Against Women,Dowry Deaths,Male,46-60,9559,2596,6963,9330,229
2007,Urban,Bihar,Other Crimes,Fraud,Female,31-45,8573,2134,6439,5708,2865
2002,Urban,Andhra Pradesh,Property Crime,Burglary,Male,60+,3928,3094,834,3672,256
2003,Rural,Meghalaya,Crime Against Women,Rape,Male,46-60,1806,830,976,1223,583
2005,Rural,Gujarat,Crime Against Women,Rape,Female,31-45,2703,1298,1405,2017,686
2009,Rural,Uttar Pradesh,Crime Against Children,Trafficking,Male,18-30,4683,3530,1153,3623,1060
2001,Rural,Meghalaya,Crime Against Women,Rape,Female,46-60,2444,651,1793,1846,598
2009,Urban,Bihar,Property Crime,Burglary,Female,31-45,1879,889,990,1861,18
2003,Urban,Andhra Pradesh,Crime Against Men,Robbery,Female,60+,7596,3529,4067,7139,457
2004,Urban,Gujarat,Property Crime,Arson,Male,46-60,7126,990,6136,4309,2817
2002,Rural,Haryana,Crime Against Children,Child Abuse,Female,0-12,6237,4497,1740,5357,880
2009,Rural,Bihar,Crime Against Children,Child Labor,Male,46-60,9799,4163,5636,9465,334
2001,Rural,Nagaland,Crime Against Men,Extortion,Female,0-12,6674,600,6074,5209,1465
2006,Rural,Madhya Pradesh,Property Crime,Arson,Female,13-17,464,416,48,436,28
2010,Rural,Assam,Property Crime,Arson,Female,13-17,6059,2828,3231,4220,1839
2008,Urban,Himachal Pradesh,Property Crime,Burglary,Male,13-17,3298,2802,496,2986,312
2009,Rural,Delhi,Crime Against Children,Child Abuse,Female,0-12,3805,19,3786,1722,2083
2008,Urban,Himachal Pradesh,Property Crime,Vandalism,Female,13-17,3694,1291,2403,1510,2184
2001,Rural,Haryana,Property Crime,Vandalism,Male,13-17,1612,1050,562,1324,288
2004,Urban,Uttar Pradesh,Crime Against Men,Assault,Female,0-12,7977,324,7653,450,7527
2007,Urban,Uttarakhand,Property Crime,Arson,Female,0-12,5880,5763,117,5820,60
2010,Rural,West Bengal,Other Crimes,Cyber Crime,Female,31-45,4952,800,4152,4240,712
2001,Urban,Goa,Crime Against Men,Assault,Male,46-60,5984,2451,3533,4613,1371
2002,Rural,Goa,Crime Against Children,Trafficking,Male,60+,57,11,46,12,45
2007,Urban,Mizoram,Property Crime,Vandalism,Female,60+,9028,5642,3386,7869,1159
2002,Urban,Odisha,Crime Against Men,Assault,Male,31-45,5493,4067,1426,4726,767
2003,Rural,Rajasthan,Crime Against Women,Rape,Male,0-12,4553,438,4115,1795,2758
2010,Urban,Mizoram,Crime Against Men,Extortion,Female,60+,7641,134,7507,7190,451
2008,Urban,Uttarakhand,Property Crime,Burglary,Female,31-45,9198,8080,1118,8517,681
2003,Urban,Kerala,Crime Against Children,Child Abuse,Male,18-30,7296,4559,2737,5065,2231
2004,Rural,Telangana,Crime Against Women,Molestation,Female,31-45,9592,3971,5621,6699,2893
2005,Rural,Tripura,Crime Against Children,Child Labor,Male,0-12,5673,3350,2323,4450,1223
2010,Rural,Manipur,Crime Against Children,Kidnapping,Male,46-60,6716,4857,1859,6427,289
2002,Rural,Bihar,Crime Against Men,Extortion,Female,60+,3781,48,3733,3033,748
2005,Rural,Gujarat,Crime Against Children,Child Abuse,Female,46-60,7012,4394,2618,5406,1606
2004,Rural,Odisha,Property Crime,Arson,Female,60+,1126,526,600,711,415
2004,Urban,Uttarakhand,Crime Against Men,Assault,Male,0-12,5162,753,4409,3417,1745
2005,Urban,Chhattisgarh,Property Crime,Burglary,Female,46-60,7454,1217,6237,3492,3962
2002,Rural,Punjab,Crime Against Children,Kidnapping,Female,46-60,9509,6920,2589,7860,1649
2003,Urban,West Bengal,Crime Against Men,Extortion,Female,18-30,115,97,18,102,13
2005,Urban,Maharashtra,Other Crimes,Cyber Crime,Male,0-12,7443,4406,3037,4964,2479
2010,Rural,Jharkhand,Crime Against Men,Extortion,Male,0-12,1957,255,1702,753,1204
2001,Rural,Meghalaya,Other Crimes,Fraud,Female,60+,980,170,810,537,443
2007,Rural,Assam,Property Crime,Arson,Male,13-17,3386,3380,6,3382,4
2006,Urban,Manipur,Other Crimes,Fraud,Female,0-12,6535,2641,3894,2736,3799
2003,Urban,Uttarakhand,Other Crimes,Corruption,Male,46-60,3500,1094,2406,1752,1748
2002,Rural,Sikkim,Crime Against Men,Assault,Male,13-17,4332,1477,2855,3099,1233
2003,Rural,Jharkhand,Crime Against Men,Assault,Male,13-17,8270,5670,2600,6697,1573
2010,Urban,Sikkim,Other Crimes,Cyber Crime,Male,13-17,9721,6616,3105,7722,1999
2006,Urban,Tamil Nadu,Crime Against Women,Dowry Deaths,Female,60+,788,490,298,780,8
2005,Rural,Andhra Pradesh,Property Crime,Vandalism,Female,31-45,308,184,124,247,61
2010,Rural,Jammu & Kashmir,Crime Against Children,Child Labor,Male,18-30,6817,2504,4313,6112,705
2008,Rural,Delhi,Crime Against Children,Child Labor,Female,18-30,5070,2505,2565,3097,1973
2006,Urban,Tripura,Crime Against Men,Assault,Male,0-12,8197,8193,4,8194,3
2004,Urban,Uttar Pradesh,Property Crime,Theft,Male,18-30,8916,6780,2136,8181,735
2003,Rural,Bihar,Property Crime,Burglary,Female,31-45,7240,488,6752,4944,2296
2004,Urban,Chhattisgarh,Property Crime,Theft,Female,46-60,6576,2513,4063,6015,561
2002,Rural,Odisha,Crime Against Men,Assault,Male,46-60,4073,3621,452,3963,110
2005,Rural,Nagaland,Crime Against Children,Child Labor,Male,31-45,6952,115,6837,3907,3045
2003,Rural,Tripura,Crime Against Children,Child Abuse,Female,18-30,5280,1601,3679,1961,3319
2006,Urban,Goa,Property Crime,Theft,Female,46-60,4442,23,4419,678,3764
2001,Urban,West Bengal,Property Crime,Theft,Male,13-17,7937,3047,4890,7594,343
2008,Urban,Karnataka,Other Crimes,Cyber Crime,Female,13-17,1767,206,1561,450,1317
2003,Rural,Punjab,Property Crime,Theft,Male,18-30,9382,1457,7925,6301,3081
2006,Urban,Manipur,Crime Against Women,Rape,Male,18-30,9948,4192,5756,4691,5257
2009,Urban,Uttar Pradesh,Crime Against Women,Dowry Deaths,Male,46-60,2396,1333,1063,2274,122
2006,Urban,Sikkim,Crime Against Men,Robbery,Male,0-12,2800,656,2144,2327,473
2002,Urban,Tripura,Property Crime,Burglary,Female,31-45,1929,447,1482,1435,494
2001,Urban,Jammu & Kashmir,Crime Against Men,Extortion,Female,18-30,7598,6402,1196,6651,947
2002,Rural,Maharashtra,Other Crimes,Drug Offense,Female,60+,2592,401,2191,2002,590
2006,Rural,Gujarat,Other Crimes,Fraud,Male,60+,561,554,7,555,6
2010,Urban,Uttarakhand,Crime Against Women,Dowry Deaths,Male,13-17,2045,1097,948,1934,111
2001,Urban,Karnataka,Property Crime,Theft,Female,18-30,5886,3366,2520,4598,1288
2007,Rural,Maharashtra,Crime Against Men,Murder,Female,18-30,737,442,295,679,58
2001,Urban,Sikkim,Crime Against Women,Domestic Violence,Male,13-17,3879,1043,2836,1930,1949
2002,Rural,Andhra Pradesh,Other Crimes,Fraud,Female,46-60,1544,751,793,1401,143
2010,Urban,Arunachal Pradesh,Property Crime,Theft,Female,31-45,1469,661,808,933,536
2010,Rural,Sikkim,Property Crime,Vandalism,Male,13-17,6779,4818,1961,6605,174
2001,Rural,Manipur,Other Crimes,Cyber Crime,Female,60+,6417,4416,2001,5873,544
2006,Rural,Rajasthan,Property Crime,Vandalism,Female,0-12,1413,57,1356,322,1091
2001,Rural,Goa,Crime Against Children,Kidnapping,Female,46-60,9303,5041,4262,5306,3997
2009,Rural,West Bengal,Property Crime,Vandalism,Male,31-45,6566,4476,2090,6420,146
2001,Urban,Telangana,Other Crimes,Drug Offense,Female,13-17,5509,2155,3354,5414,95
2006,Rural,Bihar,Property Crime,Arson,Female,18-30,3163,1130,2033,2699,464
2008,Rural,Sikkim,Crime Against Women,Domestic Violence,Female,0-12,1738,935,803,1445,293
2002,Rural,Odisha,Other Crimes,Drug Offense,Female,60+,949,422,527,498,451
2002,Urban,Madhya Pradesh,Other Crimes,Corruption,Female,18-30,696,500,196,544,152
2007,Urban,Manipur,Crime Against Women,Domestic Violence,Male,0-12,9798,2208,7590,4947,4851
2010,Rural,Tamil Nadu,Crime Against Men,Murder,Male,31-45,9879,1086,8793,2483,7396
2005,Rural,Nagaland,Crime Against Children,Child Abuse,Male,31-45,5793,5326,467,5452,341
2003,Urban,Uttar Pradesh,Crime Against Children,Kidnapping,Male,46-60,7882,969,6913,7853,29
2010,Urban,Jammu & Kashmir,Crime Against Children,Kidnapping,Female,31-45,4280,3403,877,3714,566
2001,Rural,Andhra Pradesh,Other Crimes,Corruption,Female,46-60,9273,7597,1676,7759,1514
2008,Rural,Madhya Pradesh,Property Crime,Arson,Male,13-17,2426,1668,758,2285,141
2007,Rural,Maharashtra,Crime Against Children,Trafficking,Female,60+,3178,176,3002,2480,698
2004,Urban,Madhya Pradesh,Crime Against Women,Rape,Female,46-60,7239,6040,1199,6624,615
2004,Rural,Bihar,Other Crimes,Drug Offense,Male,46-60,1687,456,1231,1223,464
2009,Rural,Uttar Pradesh,Crime Against Women,Domestic Violence,Male,18-30,9194,1629,7565,2752,6442
2003,Urban,Telangana,Crime Against Children,Kidnapping,Male,46-60,5088,4478,610,4972,116
2006,Urban,Meghalaya,Crime Against Children,Trafficking,Female,46-60,4894,4653,241,4851,43
2009,Urban,Tamil Nadu,Crime Against Men,Extortion,Male,31-45,3160,1573,1587,1839,1321
2007,Urban,Uttarakhand,Crime Against Children,Child Labor,Male,60+,2395,2260,135,2274,121
2004,Urban,Manipur,Crime Against Women,Dowry Deaths,Female,0-12,8526,1161,7365,3869,4657
2006,Urban,Gujarat,Property Crime,Theft,Female,18-30,6420,1492,4928,3544,2876
2004,Rural,Delhi,Other Crimes,Drug Offense,Female,31-45,6588,6159,429,6472,116
2004,Urban,Bihar,Other Crimes,Corruption,Female,60+,9041,6350,2691,8499,542
2006,Urban,Manipur,Other Crimes,Corruption,Female,60+,2798,2773,25,2786,12
2007,Rural,Telangana,Crime Against Men,Assault,Female,31-45,4885,2191,2694,3793,1092
2003,Rural,Andhra Pradesh,Crime Against Men,Extortion,Female,13-17,3619,5,3614,1932,1687
2006,Rural,Uttarakhand,Other Crimes,Cyber Crime,Male,46-60,8601,4715,3886,5210,3391
2005,Urban,Sikkim,Crime Against Women,Domestic Violence,Male,13-17,3845,1293,2552,2659,1186
2009,Rural,Punjab,Other Crimes,Fraud,Female,31-45,1798,77,1721,666,1132
2007,Urban,Karnataka,Crime Against Women,Domestic Violence,Female,46-60,3077,831,2246,2705,372
2005,Rural,Andhra Pradesh,Crime Against Men,Robbery,Female,18-30,9856,803,9053,5261,4595
2009,Rural,Jammu & Kashmir,Other Crimes,Corruption,Male,0-12,227,76,151,126,101
2001,Rural,Delhi,Other Crimes,Corruption,Female,31-45,5875,4578,1297,4655,1220
2003,Rural,Assam,Crime Against Children,Trafficking,Female,18-30,6812,5974,838,6569,243
2002,Urban,Nagaland,Crime Against Men,Murder,Female,18-30,467,310,157,390,77
2004,Urban,Rajasthan,Crime Against Men,Assault,Male,60+,7872,783,7089,7843,29
2004,Urban,Arunachal Pradesh,Other Crimes,Cyber Crime,Female,60+,5911,5862,49,5897,14
2005,Rural,Karnataka,Crime Against Women,Rape,Male,46-60,5027,3191,1836,3892,1135
2001,Urban,Rajasthan,Crime Against Men,Murder,Male,13-17,4702,1343,3359,3377,1325
2009,Urban,West Bengal,Crime Against Children,Child Abuse,Male,0-12,4438,1494,2944,1961,2477
2008,Rural,Delhi,Property Crime,Vandalism,Male,31-45,2980,2916,64,2967,13
2002,Rural,Jharkhand,Other Crimes,Drug Offense,Male,13-17,89,73,16,76,13
2007,Urban,Sikkim,Crime Against Women,Molestation,Female,31-45,4916,1337,3579,3001,1915
2002,Rural,Chhattisgarh,Property Crime,Burglary,Male,0-12,6811,4095,2716,6680,131
2008,Rural,Uttarakhand,Crime Against Children,Trafficking,Male,0-12,958,708,250,826,132
2008,Rural,Madhya Pradesh,Crime Against Men,Murder,Female,18-30,7398,1424,5974,5169,2229
2007,Rural,Kerala,Crime Against Children,Trafficking,Female,13-17,4276,2607,1669,4137,139
2008,Rural,Telangana,Property Crime,Arson,Male,0-12,6891,4217,2674,4421,2470
2005,Rural,Punjab,Crime Against Women,Domestic Violence,Female,31-45,7103,5757,1346,6450,653
2008,Urban,Tripura,Crime Against Men,Assault,Male,18-30,5727,3955,1772,4064,1663
2003,Urban,Manipur,Crime Against Men,Extortion,Female,60+,2993,1821,1172,1957,1036
2001,Urban,Manipur,Crime Against Men,Extortion,Female,60+,4361,3472,889,3856,505
2009,Rural,Haryana,Crime Against Women,Domestic Violence,Female,0-12,715,12,703,446,269
2007,Rural,Andhra Pradesh,Other Crimes,Drug Offense,Male,0-12,533,363,170,527,6
2010,Urban,Sikkim,Crime Against Women,Dowry Deaths,Female,13-17,3476,878,2598,2754,722
2009,Urban,Delhi,Other Crimes,Cyber Crime,Female,60+,6518,1287,5231,6076,442
2006,Urban,Jharkhand,Property Crime,Arson,Female,31-45,2559,1188,1371,1665,894
2002,Rural,Arunachal Pradesh,Crime Against Women,Rape,Female,13-17,1640,306,1334,518,1122
2002,Urban,Assam,Crime Against Women,Molestation,Male,31-45,3798,703,3095,3122,676
2002,Urban,Bihar,Property Crime,Burglary,Female,60+,7166,1002,6164,3485,3681
2010,Urban,Meghalaya,Crime Against Children,Trafficking,Male,0-12,7908,7624,284,7790,118
2003,Urban,Uttarakhand,Crime Against Women,Molestation,Male,0-12,5292,1111,4181,2277,3015
2002,Rural,Sikkim,Property Crime,Arson,Female,0-12,9115,6509,2606,7733,1382
2004,Rural,Arunachal Pradesh,Property Crime,Arson,Male,13-17,9601,6892,2709,8331,1270
2002,Rural,Assam,Crime Against Men,Murder,Male,18-30,7917,2516,5401,5286,2631
2010,Rural,Gujarat,Property Crime,Arson,Male,18-30,221,129,92,172,49
2003,Rural,Haryana,Crime Against Men,Murder,Male,0-12,9555,2650,6905,7717,1838
2002,Rural,Gujarat,Property Crime,Burglary,Female,46-60,6758,1471,5287,2441,4317
2004,Rural,Andhra Pradesh,Property Crime,Theft,Female,18-30,2521,834,1687,1662,859
2009,Urban,West Bengal,Crime Against Children,Child Labor,Female,60+,5567,4121,1446,5470,97
2004,Rural,Maharashtra,Crime Against Women,Dowry Deaths,Male,13-17,8570,8306,264,8358,212
2002,Rural,Assam,Crime Against Men,Murder,Female,60+,1897,405,1492,970,927
2010,Urban,Odisha,Other Crimes,Corruption,Male,0-12,3801,2425,1376,3706,95
2007,Rural,Bihar,Property Crime,Vandalism,Male,18-30,9539,9416,123,9501,38
2001,Rural,Meghalaya,Crime Against Men,Murder,Male,60+,5504,4159,1345,4798,706
2001,Rural,Andhra Pradesh,Property Crime,Theft,Female,13-17,1614,1247,367,1405,209
2010,Rural,West Bengal,Crime Against Women,Molestation,Female,60+,277,218,59,243,34
2001,Rural,Tripura,Crime Against Children,Trafficking,Female,18-30,2345,878,1467,1447,898
2010,Urban,Mizoram,Crime Against Women,Domestic Violence,Female,60+,5262,2200,3062,4389,873
2008,Rural,Kerala,Other Crimes,Cyber Crime,Female,60+,7258,5896,1362,6348,910
2009,Rural,Nagaland,Crime Against Women,Domestic Violence,Female,0-12,3316,2505,811,2899,417
2010,Rural,Madhya Pradesh,Other Crimes,Corruption,Male,0-12,9567,3000,6567,8237,1330
2009,Rural,Odisha,Crime Against Children,Child Abuse,Male,13-17,2593,399,2194,1616,977
2007,Rural,Sikkim,Other Crimes,Corruption,Female,18-30,8397,6236,2161,8350,47
2007,Urban,Madhya Pradesh,Crime Against Men,Robbery,Female,31-45,3704,3201,503,3227,477
2007,Rural,Himachal Pradesh,Crime Against Children,Child Abuse,Female,0-12,4144,1341,2803,1784,2360
2005,Rural,Nagaland,Crime Against Children,Trafficking,Female,31-45,6190,800,5390,976,5214
2004,Urban,Telangana,Crime Against Children,Child Abuse,Female,0-12,3107,175,2932,1036,2071
2004,Urban,Chhattisgarh,Other Crimes,Corruption,Female,13-17,8294,227,8067,2395,5899
2006,Rural,Karnataka,Property Crime,Burglary,Female,18-30,5901,5501,400,5857,44
2001,Urban,Odisha,Property Crime,Burglary,Male,31-45,5994,1968,4026,4826,1168
2009,Rural,Bihar,Property Crime,Burglary,Female,60+,2815,1518,1297,2081,734
2009,Rural,Odisha,Other Crimes,Fraud,Male,60+,4381,2104,2277,3221,1160
2003,Urban,Jharkhand,Crime Against Children,Child Labor,Female,0-12,4957,4822,135,4862,95
2008,Urban,Chhattisgarh,Crime Against Children,Child Labor,Male,0-12,176,165,11,175,1
2010,Rural,Maharashtra,Crime Against Women,Domestic Violence,Female,31-45,9426,1912,7514,6377,3049
2006,Rural,Gujarat,Property Crime,Burglary,Female,46-60,2961,1544,1417,1695,1266
2002,Urban,Arunachal Pradesh,Crime Against Men,Murder,Female,13-17,2859,891,1968,1592,1267
2006,Urban,Kerala,Crime Against Men,Assault,Male,31-45,5221,1287,3934,4542,679
2004,Rural,Punjab,Other Crimes,Corruption,Male,31-45,1676,116,1560,472,1204
2009,Urban,Assam,Other Crimes,Fraud,Female,18-30,3093,1311,1782,3049,44
2004,Urban,Arunachal Pradesh,Crime Against Men,Robbery,Female,13-17,3599,2683,916,3495,104
2005,Rural,Tripura,Crime Against Women,Molestation,Male,13-17,1162,718,444,867,295
2002,Rural,Karnataka,Other Crimes,Fraud,Male,31-45,1964,417,1547,435,1529
2004,Urban,Himachal Pradesh,Crime Against Men,Extortion,Female,18-30,615,336,279,373,242
2002,Urban,Punjab,Crime Against Women,Dowry Deaths,Female,18-30,2372,773,1599,2168,204
2007,Urban,Delhi,Crime Against Children,Kidnapping,Male,31-45,6962,1266,5696,6710,252
2006,Urban,Jharkhand,Crime Against Women,Dowry Deaths,Female,31-45,3328,2865,463,3246,82
2010,Rural,Goa,Other Crimes,Fraud,Male,18-30,776,639,137,661,115
2005,Urban,Odisha,Other Crimes,Corruption,Female,46-60,6953,4344,2609,5269,1684
2008,Rural,Mizoram,Property Crime,Vandalism,Female,13-17,8683,2363,6320,4249,4434
2007,Urban,Tamil Nadu,Crime Against Men,Murder,Female,18-30,8111,504,7607,3999,4112
2002,Urban,Mizoram,Crime Against Children,Kidnapping,Male,13-17,5350,5173,177,5243,107
2007,Rural,Goa,Crime Against Children,Child Abuse,Female,60+,3194,1157,2037,2257,937
2003,Rural,Jammu & Kashmir,Crime Against Women,Dowry Deaths,Female,31-45,2373,942,1431,2224,149
2001,Rural,Delhi,Property Crime,Vandalism,Female,13-17,8696,704,7992,1372,7324
2006,Rural,Jharkhand,Other Crimes,Corruption,Male,60+,6602,6467,135,6515,87
2002,Urban,Manipur,Crime Against Men,Murder,Female,31-45,586,461,125,521,65
2010,Urban,Manipur,Crime Against Men,Murder,Female,46-60,798,91,707,740,58
2010,Rural,Jammu & Kashmir,Other Crimes,Cyber Crime,Male,18-30,979,821,158,848,131
2004,Urban,Rajasthan,Crime Against Men,Murder,Female,60+,8923,2828,6095,6931,1992
2007,Urban,Andhra Pradesh,Property Crime,Arson,Male,31-45,9641,6495,3146,8802,839
2001,Rural,Manipur,Crime Against Women,Molestation,Male,13-17,5716,1520,4196,2984,2732
2006,Urban,Haryana,Crime Against Men,Murder,Female,60+,122,92,30,96,26
2002,Rural,Gujarat,Other Crimes,Cyber Crime,Male,0-12,1019,122,897,983,36
2005,Urban,Arunachal Pradesh,Crime Against Children,Child Labor,Male,46-60,5894,4736,1158,5294,600
2010,Urban,Tamil Nadu,Crime Against Women,Rape,Female,31-45,2387,2071,316,2208,179
2001,Rural,Gujarat,Property Crime,Vandalism,Male,31-45,2897,2479,418,2534,363
2009,Urban,West Bengal,Property Crime,Vandalism,Male,0-12,5003,1279,3724,3188,1815
2010,Rural,Arunachal Pradesh,Crime Against Children,Child Abuse,Male,13-17,597,90,507,388,209
2008,Urban,Assam,Other Crimes,Cyber Crime,Male,18-30,859,470,389,482,377
2003,Urban,Jharkhand,Crime Against Women,Dowry Deaths,Female,60+,7628,2500,5128,4264,3364
2007,Urban,Goa,Crime Against Women,Dowry Deaths,Male,0-12,670,313,357,472,198
2005,Urban,Assam,Crime Against Men,Robbery,Female,0-12,9480,6593,2887,7975,1505
2005,Rural,Odisha,Property Crime,Arson,Male,31-45,4838,3648,1190,4036,802
2010,Rural,Kerala,Crime Against Men,Murder,Female,31-45,5574,3996,1578,4149,1425
2003,Rural,Punjab,Other Crimes,Cyber Crime,Female,13-17,8008,7701,307,7748,260
2009,Rural,Delhi,Other Crimes,Cyber Crime,Female,0-12,408,336,72,368,40
2008,Urban,Maharashtra,Property Crime,Theft,Female,31-45,3994,1588,2406,3404,590
2004,Rural,Punjab,Crime Against Men,Assault,Male,46-60,2875,2202,673,2799,76
2002,Rural,Goa,Crime Against Men,Robbery,Female,31-45,3169,949,2220,2267,902
2006,Urban,Bihar,Crime Against Children,Child Abuse,Female,0-12,4569,3186,1383,3672,897
2001,Rural,Nagaland,Crime Against Men,Assault,Female,0-12,386,311,75,383,3
2003,Urban,Telangana,Crime Against Children,Trafficking,Male,13-17,8236,2875,5361,6267,1969
2009,Rural,Karnataka,Crime Against Men,Extortion,Female,46-60,9440,6413,3027,6706,2734
2006,Rural,Rajasthan,Crime Against Women,Rape,Female,31-45,8676,2329,6347,3951,4725
2002,Urban,Madhya Pradesh,Property Crime,Arson,Male,0-12,7664,160,7504,4897,2767
2002,Urban,Maharashtra,Property Crime,Arson,Male,0-12,5173,4886,287,4931,242
2008,Urban,Sikkim,Other Crimes,Cyber Crime,Male,46-60,7118,1365,5753,5755,1363
2002,Urban,Bihar,Crime Against Children,Child Abuse,Female,18-30,4065,2194,1871,3488,577
2009,Rural,Odisha,Crime Against Children,Trafficking,Female,31-45,1411,998,413,1185,226
2010,Rural,Arunachal Pradesh,Crime Against Children,Trafficking,Female,31-45,7479,3894,3585,7270,209
2005,Rural,Jammu & Kashmir,Crime Against Children,Trafficking,Male,46-60,7335,793,6542,2129,5206
2005,Urban,Uttar Pradesh,Other Crimes,Drug Offense,Female,18-30,6788,5836,952,6464,324
2007,Urban,Uttar Pradesh,Crime Against Women,Molestation,Female,46-60,7414,6443,971,7058,356
2007,Rural,Uttarakhand,Crime Against Men,Extortion,Female,60+,5794,929,4865,2167,3627
2002,Urban,Karnataka,Crime Against Women,Rape,Male,31-45,7179,4562,2617,5068,2111
2001,Urban,Delhi,Crime Against Children,Child Labor,Male,18-30,8609,393,8216,4731,3878
2003,Rural,Jharkhand,Crime Against Women,Domestic Violence,Male,18-30,4593,4057,536,4362,231
2007,Urban,Jharkhand,Other Crimes,Cyber Crime,Female,31-45,7766,5937,1829,6752,1014
2001,Rural,Goa,Property Crime,Burglary,Female,46-60,2277,356,1921,395,1882
2009,Urban,Uttarakhand,Crime Against Children,Child Labor,Female,13-17,2658,472,2186,839,1819
2003,Urban,Bihar,Property Crime,Vandalism,Female,13-17,4483,4448,35,4449,34
2004,Rural,Uttar Pradesh,Crime Against Women,Rape,Male,18-30,3809,796,3013,976,2833
2009,Urban,Karnataka,Crime Against Women,Rape,Male,60+,7454,2669,4785,4875,2579
2002,Urban,Telangana,Crime Against Children,Child Abuse,Female,31-45,4219,950,3269,3298,921
2002,Urban,Odisha,Crime Against Women,Rape,Female,0-12,1981,282,1699,1508,473
2008,Urban,Tripura,Crime Against Women,Rape,Female,31-45,6374,5049,1325,6296,78
2006,Rural,Delhi,Property Crime,Vandalism,Female,46-60,9866,5405,4461,7403,2463
2001,Urban,Bihar,Crime Against Men,Extortion,Male,60+,5291,959,4332,5094,197
2004,Urban,Kerala,Crime Against Children,Kidnapping,Female,13-17,9351,6903,2448,8567,784
2010,Rural,Tripura,Crime Against Children,Child Abuse,Male,31-45,7963,7222,741,7270,693
2003,Rural,Telangana,Property Crime,Burglary,Male,0-12,1331,847,484,924,407
2006,Rural,Assam,Crime Against Children,Trafficking,Male,0-12,4006,3375,631,3799,207
2002,Urban,Tamil Nadu,Crime Against Children,Kidnapping,Female,0-12,1848,156,1692,244,1604
2007,Rural,Uttarakhand,Property Crime,Burglary,Female,0-12,4859,318,4541,878,3981
2003,Rural,Mizoram,Crime Against Women,Domestic Violence,Female,18-30,1877,690,1187,1851,26
2009,Urban,Gujarat,Other Crimes,Fraud,Female,31-45,4715,3753,962,3996,719
2009,Rural,Manipur,Property Crime,Arson,Male,13-17,9437,8562,875,9063,374
2007,Urban,Bihar,Crime Against Men,Robbery,Male,13-17,5890,1810,4080,2907,2983
2002,Urban,Kerala,Crime Against Men,Robbery,Male,18-30,278,75,203,95,183
2009,Rural,Arunachal Pradesh,Other Crimes,Cyber Crime,Female,60+,7430,361,7069,2889,4541
2002,Urban,Delhi,Crime Against Men,Extortion,Male,13-17,7901,6340,1561,6988,913
2008,Rural,Punjab,Crime Against Men,Murder,Male,13-17,2923,1307,1616,1641,1282
2003,Rural,Nagaland,Crime Against Children,Child Abuse,Female,0-12,2989,584,2405,796,2193
2003,Urban,Kerala,Crime Against Men,Extortion,Male,46-60,2696,2481,215,2651,45
2005,Urban,Odisha,Crime Against Men,Assault,Female,31-45,3710,2508,1202,2662,1048
2008,Urban,Jharkhand,Crime Against Women,Molestation,Female,13-17,7067,7017,50,7026,41
2010,Rural,Gujarat,Crime Against Children,Child Labor,Male,31-45,2951,1343,1608,2450,501
2008,Rural,West Bengal,Property Crime,Theft,Male,31-45,3865,2685,1180,3766,99
2003,Rural,Jammu & Kashmir,Other Crimes,Fraud,Male,0-12,1391,269,1122,1029,362
2005,Urban,Mizoram,Other Crimes,Drug Offense,Male,18-30,1807,1092,715,1478,329
2002,Urban,Uttarakhand,Other Crimes,Drug Offense,Female,46-60,4657,1641,3016,3412,1245
2002,Rural,West Bengal,Crime Against Men,Murder,Female,31-45,4800,1483,3317,4025,775
2006,Rural,Uttarakhand,Crime Against Women,Rape,Female,0-12,5991,3942,2049,4788,1203
2006,Urban,Karnataka,Crime Against Children,Child Labor,Female,60+,5936,568,5368,4792,1144
2009,Urban,Gujarat,Crime Against Men,Robbery,Male,18-30,9919,7895,2024,9433,486
2009,Rural,Tamil Nadu,Crime Against Children,Kidnapping,Female,31-45,5146,2786,2360,4428,718
2009,Urban,Maharashtra,Crime Against Men,Assault,Female,18-30,232,153,79,166,66
2009,Rural,Madhya Pradesh,Crime Against Children,Child Labor,Male,46-60,2758,1227,1531,2210,548
2003,Urban,Arunachal Pradesh,Property Crime,Theft,Female,18-30,1613,1196,417,1265,348
2004,Urban,Jammu & Kashmir,Other Crimes,Fraud,Male,13-17,3017,1082,1935,2884,133
2002,Urban,Madhya Pradesh,Crime Against Men,Assault,Male,0-12,1355,627,728,1317,38
2003,Urban,Telangana,Property Crime,Arson,Male,0-12,3852,2443,1409,3720,132
2005,Rural,Arunachal Pradesh,Property Crime,Arson,Female,0-12,2228,348,1880,1384,844
2007,Rural,Himachal Pradesh,Property Crime,Theft,Female,18-30,4346,3519,827,4254,92
2006,Rural,Andhra Pradesh,Crime Against Children,Trafficking,Male,18-30,9804,1571,8233,3208,6596
2005,Urban,Madhya Pradesh,Crime Against Children,Child Abuse,Male,46-60,1688,55,1633,304,1384
2009,Rural,Uttar Pradesh,Crime Against Children,Kidnapping,Female,0-12,8602,7567,1035,7923,679
2002,Urban,Karnataka,Crime Against Men,Murder,Female,13-17,9389,7820,1569,8429,960
2010,Rural,Mizoram,Property Crime,Arson,Female,46-60,2214,963,1251,1164,1050
2001,Urban,Andhra Pradesh,Crime Against Men,Murder,Male,31-45,8481,7977,504,8008,473
2004,Urban,Jammu & Kashmir,Other Crimes,Cyber Crime,Female,18-30,5854,3487,2367,5580,274
2007,Urban,Chhattisgarh,Other Crimes,Fraud,Male,13-17,2693,1416,1277,2014,679
2004,Urban,Chhattisgarh,Property Crime,Burglary,Male,31-45,3211,2145,1066,2158,1053
2010,Rural,Punjab,Crime Against Women,Domestic Violence,Male,18-30,2059,2038,21,2038,21
2003,Urban,Haryana,Property Crime,Arson,Female,0-12,7914,4272,3642,4451,3463
2006,Urban,Assam,Property Crime,Arson,Female,18-30,1045,1011,34,1012,33
2008,Rural,Nagaland,Crime Against Men,Extortion,Male,31-45,6134,3081,3053,5257,877
2003,Urban,West Bengal,Crime Against Children,Trafficking,Female,46-60,9990,8489,1501,9120,870
2003,Urban,Manipur,Other Crimes,Drug Offense,Male,31-45,7872,3904,3968,7198,674
2010,Urban,Odisha,Property Crime,Theft,Female,13-17,5004,20,4984,4685,319
2008,Rural,Bihar,Crime Against Children,Child Labor,Female,13-17,196,75,121,184,12
2009,Rural,Assam,Crime Against Children,Kidnapping,Male,0-12,1245,1227,18,1233,12
2006,Rural,Chhattisgarh,Crime Against Women,Rape,Male,31-45,367,25,342,42,325
2007,Urban,Goa,Property Crime,Arson,Male,60+,6816,6030,786,6389,427
2005,Urban,West Bengal,Crime Against Women,Dowry Deaths,Male,46-60,5359,4588,771,4817,542
2004,Rural,Madhya Pradesh,Property Crime,Arson,Male,18-30,6447,2664,3783,5060,1387
2001,Rural,Karnataka,Other Crimes,Drug Offense,Female,0-12,506,103,403,478,28
2002,Urban,Goa,Crime Against Children,Child Labor,Female,0-12,9023,8581,442,8936,87
2001,Urban,West Bengal,Property Crime,Vandalism,Female,13-17,6613,2069,4544,3616,2997
2008,Rural,Manipur,Property Crime,Burglary,Female,13-17,7592,6373,1219,6488,1104
2001,Rural,Andhra Pradesh,Other Crimes,Fraud,Female,31-45,3428,655,2773,1913,1515
2006,Urban,Meghalaya,Crime Against Women,Molestation,Female,60+,9815,2383,7432,7286,2529
2005,Urban,Karnataka,Other Crimes,Corruption,Male,0-12,8766,1885,6881,5931,2835
2009,Urban,Andhra Pradesh,Crime Against Men,Assault,Male,13-17,7059,3841,3218,4262,2797
2007,Urban,Telangana,Crime Against Children,Trafficking,Male,31-45,6578,4983,1595,5990,588
2008,Rural,Meghalaya,Crime Against Children,Kidnapping,Male,46-60,3956,3176,780,3348,608
2001,Urban,Punjab,Crime Against Men,Murder,Male,0-12,4434,2993,1441,3198,1236
2001,Urban,Tamil Nadu,Crime Against Men,Assault,Female,46-60,6308,293,6015,2233,4075
2005,Urban,Odisha,Crime Against Children,Trafficking,Male,31-45,7030,5076,1954,5725,1305
2007,Urban,Mizoram,Crime Against Men,Assault,Female,0-12,2946,135,2811,546,2400
2008,Urban,Jharkhand,Property Crime,Arson,Male,0-12,7044,4712,2332,6338,706
2001,Rural,Madhya Pradesh,Crime Against Women,Molestation,Male,60+,6472,2521,3951,2965,3507
2002,Rural,Gujarat,Crime Against Men,Assault,Male,13-17,201,120,81,121,80
2001,Rural,Sikkim,Property Crime,Vandalism,Male,60+,6140,4640,1500,5830,310
2001,Rural,Uttar Pradesh,Other Crimes,Fraud,Male,60+,8790,6474,2316,7416,1374
2008,Rural,Karnataka,Crime Against Children,Trafficking,Female,0-12,4679,3346,1333,3347,1332
2006,Rural,Madhya Pradesh,Crime Against Children,Trafficking,Male,60+,7343,3457,3886,5989,1354
2005,Rural,Maharashtra,Property Crime,Arson,Male,13-17,7524,6953,571,7475,49
2009,Urban,Manipur,Other Crimes,Corruption,Male,60+,5214,3322,1892,3920,1294
2001,Rural,Tripura,Other Crimes,Corruption,Male,13-17,5839,4675,1164,5197,642
2002,Urban,Odisha,Crime Against Children,Child Labor,Male,18-30,2485,925,1560,991,1494
2001,Rural,Odisha,Crime Against Children,Child Labor,Female,31-45,7577,1109,6468,5823,1754
2006,Rural,Madhya Pradesh,Crime Against Women,Molestation,Male,0-12,9841,3616,6225,4312,5529
2007,Urban,Uttar Pradesh,Crime Against Children,Trafficking,Male,13-17,538,474,64,520,18
2004,Rural,Haryana,Other Crimes,Corruption,Male,0-12,2091,995,1096,1598,493
2005,Rural,Sikkim,Crime Against Women,Dowry Deaths,Female,18-30,3432,1341,2091,1611,1821
2004,Rural,Jammu & Kashmir,Property Crime,Theft,Male,60+,4119,3331,788,3557,562
2009,Urban,Andhra Pradesh,Crime Against Children,Trafficking,Male,18-30,9327,4944,4383,5658,3669
2006,Rural,Madhya Pradesh,Crime Against Women,Molestation,Male,60+,9009,328,8681,1002,8007
2004,Urban,Jharkhand,Property Crime,Vandalism,Male,0-12,8950,3041,5909,8744,206
2008,Rural,Madhya Pradesh,Crime Against Men,Extortion,Female,31-45,5344,2633,2711,3263,2081
2002,Rural,Tripura,Crime Against Children,Kidnapping,Male,0-12,6148,2097,4051,5494,654
2005,Rural,Bihar,Crime Against Children,Child Abuse,Male,31-45,9342,8720,622,8744,598
2009,Urban,Jammu & Kashmir,Crime Against Women,Molestation,Female,46-60,8819,4134,4685,4951,3868
2002,Urban,Delhi,Crime Against Men,Extortion,Female,0-12,3230,2211,1019,3195,35
2008,Urban,Odisha,Crime Against Men,Extortion,Female,60+,9698,5246,4452,5353,4345
2010,Urban,Rajasthan,Crime Against Women,Domestic Violence,Female,13-17,1699,747,952,1548,151
2009,Urban,Tamil Nadu,Other Crimes,Corruption,Male,0-12,5349,1091,4258,2911,2438
2006,Urban,Assam,Other Crimes,Fraud,Male,0-12,9091,7385,1706,8674,417
2004,Urban,Karnataka,Property Crime,Theft,Female,60+,4383,1094,3289,3035,1348
2006,Rural,Tamil Nadu,Crime Against Men,Murder,Male,60+,4288,1627,2661,3906,382
2005,Rural,Arunachal Pradesh,Other Crimes,Cyber Crime,Female,13-17,3416,2158,1258,2958,458
2002,Rural,Odisha,Crime Against Children,Child Labor,Male,31-45,8933,1191,7742,4901,4032
2003,Rural,Maharashtra,Crime Against Children,Trafficking,Male,31-45,9228,6680,2548,7551,1677
2004,Rural,Chhattisgarh,Other Crimes,Fraud,Male,0-12,5595,2002,3593,3364,2231
2002,Rural,Gujarat,Crime Against Men,Extortion,Female,31-45,1974,235,1739,1386,588
2006,Urban,Goa,Crime Against Children,Kidnapping,Female,31-45,4540,1694,2846,4264,276
2005,Urban,Rajasthan,Crime Against Children,Child Abuse,Male,31-45,7602,43,7559,2499,5103
2007,Rural,Punjab,Crime Against Children,Child Labor,Male,60+,1902,1868,34,1878,24
2004,Urban,Tamil Nadu,Other Crimes,Corruption,Female,18-30,5033,3262,1771,4557,476
2008,Rural,Odisha,Crime Against Women,Molestation,Male,46-60,1713,1241,472,1430,283
2003,Urban,Jharkhand,Crime Against Men,Murder,Female,60+,5514,4124,1390,4608,906
2001,Urban,Assam,Crime Against Children,Child Abuse,Male,18-30,9899,5015,4884,9785,114
2009,Urban,Punjab,Other Crimes,Corruption,Female,18-30,1236,420,816,943,293
2008,Rural,Delhi,Property Crime,Burglary,Female,0-12,9717,8003,1714,8277,1440
2003,Urban,Meghalaya,Property Crime,Burglary,Female,13-17,3476,961,2515,2463,1013
2003,Rural,Rajasthan,Crime Against Women,Domestic Violence,Male,0-12,3896,764,3132,2056,1840
2005,Urban,Jammu & Kashmir,Other Crimes,Corruption,Male,60+,4572,2754,1818,4296,276
2001,Urban,Goa,Crime Against Men,Murder,Male,46-60,1142,333,809,392,750
2008,Rural,Kerala,Crime Against Children,Kidnapping,Female,13-17,1745,1416,329,1462,283
2006,Rural,Odisha,Crime Against Men,Extortion,Female,31-45,3307,622,2685,3206,101
2006,Urban,Haryana,Crime Against Men,Murder,Male,31-45,1675,510,1165,852,823
2007,Rural,Goa,Crime Against Children,Kidnapping,Female,0-12,4234,1008,3226,2990,1244
2005,Urban,Punjab,Crime Against Women,Domestic Violence,Male,18-30,3294,1505,1789,2160,1134
2003,Urban,Kerala,Crime Against Children,Kidnapping,Male,13-17,1646,973,673,1576,70
2008,Urban,Odisha,Other Crimes,Fraud,Male,31-45,6796,5673,1123,6485,311
2010,Rural,Kerala,Crime Against Women,Dowry Deaths,Male,46-60,637,366,271,493,144
2009,Rural,Telangana,Property Crime,Burglary,Female,13-17,9211,8986,225,9096,115
2002,Urban,Haryana,Crime Against Children,Child Labor,Male,13-17,9240,840,8400,2392,6848
2003,Rural,Uttar Pradesh,Property Crime,Theft,Female,46-60,7655,1200,6455,6358,1297
2003,Rural,Arunachal Pradesh,Property Crime,Burglary,Male,46-60,9015,6476,2539,7372,1643
2008,Urban,Meghalaya,Property Crime,Burglary,Female,0-12,6082,167,5915,4288,1794
2003,Rural,Arunachal Pradesh,Crime Against Women,Domestic Violence,Male,18-30,8764,1827,6937,4622,4142
2001,Urban,Sikkim,Crime Against Men,Extortion,Male,0-12,4473,3295,1178,3352,1121
2009,Urban,Sikkim,Crime Against Children,Child Labor,Male,0-12,8628,7319,1309,7608,1020
2006,Rural,Maharashtra,Crime Against Women,Molestation,Male,46-60,6537,179,6358,2402,4135
2005,Urban,Maharashtra,Crime Against Children,Trafficking,Male,60+,3551,2343,1208,3426,125
2009,Rural,Rajasthan,Crime Against Children,Trafficking,Male,60+,2902,29,2873,1399,1503
2009,Rural,Assam,Crime Against Men,Robbery,Female,0-12,9037,5771,3266,7144,1893
2006,Rural,Punjab,Property Crime,Arson,Female,31-45,6511,4536,1975,4589,1922
2008,Rural,Madhya Pradesh,Crime Against Children,Child Abuse,Female,31-45,4633,3325,1308,4083,550
2006,Urban,Odisha,Property Crime,Burglary,Female,60+,7533,5107,2426,5593,1940
2003,Urban,Bihar,Crime Against Children,Child Labor,Female,31-45,9914,645,9269,5803,4111
2003,Rural,Delhi,Property Crime,Theft,Female,31-45,3781,273,3508,2777,1004
2006,Urban,Telangana,Crime Against Men,Robbery,Male,0-12,4440,2253,2187,3029,1411
2010,Urban,Manipur,Other Crimes,Fraud,Male,18-30,3771,2748,1023,3028,743
2010,Urban,Meghalaya,Property Crime,Burglary,Male,18-30,167,162,5,162,5
2003,Rural,Sikkim,Crime Against Children,Child Abuse,Female,0-12,3012,1820,1192,1935,1077
2010,Urban,Mizoram,Other Crimes,Cyber Crime,Male,18-30,3851,3422,429,3604,247
2007,Rural,Jharkhand,Crime Against Women,Rape,Male,60+,8842,2989,5853,7386,1456
2002,Urban,Kerala,Crime Against Women,Molestation,Male,13-17,9310,2065,7245,2428,6882
2006,Rural,Bihar,Crime Against Men,Extortion,Male,46-60,8098,6208,1890,7709,389
2003,Urban,Haryana,Property Crime,Vandalism,Female,46-60,5507,2525,2982,4875,632
2006,Urban,Arunachal Pradesh,Crime Against Children,Child Abuse,Male,46-60,6028,3872,2156,5170,858
2009,Urban,Goa,Crime Against Children,Child Abuse,Male,60+,3549,1978,1571,2529,1020
2008,Urban,Gujarat,Property Crime,Theft,Female,13-17,9964,8863,1101,9262,702
2001,Urban,Chhattisgarh,Crime Against Men,Murder,Female,46-60,2828,2033,795,2106,722
2005,Urban,Uttar Pradesh,Crime Against Children,Child Labor,Male,60+,5936,1075,4861,2604,3332
2006,Urban,Assam,Crime Against Men,Murder,Male,0-12,3877,1300,2577,2784,1093
2006,Urban,Gujarat,Property Crime,Burglary,Female,46-60,7793,2024,5769,5590,2203
2002,Rural,West Bengal,Other Crimes,Fraud,Female,31-45,3629,1274,2355,2564,1065
2010,Rural,Bihar,Other Crimes,Corruption,Male,18-30,4958,4217,741,4560,398
2001,Rural,Andhra Pradesh,Crime Against Men,Extortion,Female,31-45,463,74,389,208,255
2003,Urban,Odisha,Other Crimes,Cyber Crime,Male,18-30,4100,3459,641,3623,477
2004,Rural,Arunachal Pradesh,Crime Against Women,Domestic Violence,Female,18-30,4654,4322,332,4647,7
2005,Rural,Meghalaya,Crime Against Women,Domestic Violence,Male,31-45,3955,226,3729,1718,2237
2007,Rural,Jammu & Kashmir,Crime Against Children,Kidnapping,Male,46-60,7571,3657,3914,7331,240
2003,Urban,Nagaland,Crime Against Women,Molestation,Male,31-45,2404,2223,181,2371,33
2007,Rural,Gujarat,Crime Against Men,Murder,Male,18-30,8402,4982,3420,6534,1868
2002,Urban,Manipur,Crime Against Women,Dowry Deaths,Male,13-17,2104,211,1893,2033,71
2002,Rural,Jammu & Kashmir,Crime Against Women,Domestic Violence,Female,31-45,4393,2613,1780,3115,1278
2008,Urban,Punjab,Crime Against Men,Robbery,Male,31-45,992,763,229,823,169
2004,Rural,Chhattisgarh,Crime Against Women,Molestation,Male,0-12,4890,4408,482,4494,396
2001,Urban,Meghalaya,Other Crimes,Corruption,Female,60+,1250,464,786,1249,1
2003,Rural,Haryana,Property Crime,Theft,Male,31-45,7546,6126,1420,6365,1181
2002,Rural,Tripura,Crime Against Men,Murder,Female,13-17,5876,3690,2186,5166,710
2007,Rural,Kerala,Crime Against Women,Rape,Male,13-17,4557,393,4164,2766,1791
2010,Rural,Tripura,Other Crimes,Corruption,Female,46-60,7967,249,7718,1208,6759
2007,Rural,Karnataka,Crime Against Men,Murder,Female,0-12,736,563,173,623,113
2003,Urban,Telangana,Crime Against Men,Assault,Male,60+,9727,7813,1914,7970,1757
2006,Urban,Kerala,Crime Against Men,Extortion,Male,13-17,6944,6258,686,6460,484
2002,Rural,Gujarat,Crime Against Children,Child Labor,Male,46-60,7421,2376,5045,2382,5039
2006,Urban,Uttarakhand,Property Crime,Burglary,Female,13-17,1415,1057,358,1060,355
2002,Rural,Punjab,Crime Against Men,Robbery,Female,31-45,978,948,30,959,19
2008,Urban,Karnataka,Crime Against Men,Murder,Female,31-45,4944,4616,328,4930,14
2001,Urban,Andhra Pradesh,Crime Against Children,Child Labor,Female,0-12,8504,2553,5951,6990,1514
2003,Rural,Uttarakhand,Crime Against Women,Domestic Violence,Male,46-60,6559,5929,630,6080,479
2008,Urban,Karnataka,Property Crime,Arson,Female,0-12,5079,1028,4051,2151,2928
2010,Urban,Jharkhand,Property Crime,Arson,Female,60+,3412,2023,1389,2419,993
2005,Rural,Uttar Pradesh,Crime Against Children,Child Labor,Female,60+,7064,89,6975,3437,3627
2002,Rural,Sikkim,Other Crimes,Corruption,Male,18-30,2417,9,2408,1505,912
2005,Urban,Gujarat,Crime Against Children,Kidnapping,Male,46-60,2324,513,1811,690,1634
2005,Rural,Assam,Property Crime,Vandalism,Male,31-45,5708,4470,1238,5005,703
2008,Urban,Kerala,Crime Against Children,Child Abuse,Male,0-12,7507,2814,4693,7157,350
2005,Rural,West Bengal,Crime Against Women,Dowry Deaths,Female,46-60,7418,5835,1583,6611,807
2001,Rural,Tamil Nadu,Other Crimes,Cyber Crime,Female,31-45,6781,4679,2102,6365,416
2009,Rural,Himachal Pradesh,Crime Against Children,Kidnapping,Male,46-60,4166,2984,1182,4145,21
2004,Urban,Odisha,Other Crimes,Corruption,Female,60+,3453,3251,202,3310,143
2006,Urban,Maharashtra,Crime Against Children,Child Abuse,Male,13-17,2374,1015,1359,2230,144
2008,Rural,Uttarakhand,Other Crimes,Drug Offense,Female,60+,3590,1425,2165,3166,424
2002,Urban,Uttar Pradesh,Property Crime,Arson,Male,31-45,2427,1906,521,2188,239
2008,Rural,Chhattisgarh,Crime Against Men,Robbery,Male,46-60,311,307,4,309,2
2009,Urban,Meghalaya,Crime Against Women,Dowry Deaths,Male,46-60,552,540,12,552,0
2009,Rural,Mizoram,Crime Against Women,Dowry Deaths,Male,31-45,8179,5048,3131,6351,1828
2003,Urban,Punjab,Other Crimes,Drug Offense,Male,13-17,1184,333,851,684,500
2005,Urban,Andhra Pradesh,Crime Against Women,Rape,Male,31-45,8897,5931,2966,8426,471
2002,Urban,Bihar,Crime Against Men,Murder,Female,60+,2886,1260,1626,2540,346
2007,Urban,Himachal Pradesh,Crime Against Children,Child Abuse,Female,60+,3081,2405,676,2963,118
2005,Rural,Andhra Pradesh,Crime Against Children,Trafficking,Female,60+,9797,1143,8654,9745,52
2003,Rural,Andhra Pradesh,Crime Against Women,Rape,Female,0-12,4440,2566,1874,2893,1547
2007,Urban,Odisha,Property Crime,Vandalism,Male,0-12,7306,1888,5418,6917,389
2008,Urban,Punjab,Property Crime,Theft,Female,31-45,8631,364,8267,2911,5720
2005,Urban,Delhi,Crime Against Men,Robbery,Male,13-17,1469,1062,407,1337,132
2007,Urban,Meghalaya,Other Crimes,Drug Offense,Female,60+,5555,33,5522,2076,3479
2007,Urban,Manipur,Property Crime,Burglary,Male,46-60,5751,224,5527,4338,1413
2005,Urban,Jammu & Kashmir,Property Crime,Burglary,Male,46-60,729,158,571,611,118
2003,Rural,Odisha,Crime Against Men,Robbery,Male,60+,1175,60,1115,414,761
2003,Urban,Haryana,Crime Against Children,Kidnapping,Male,18-30,1728,497,1231,1689,39
2005,Urban,Tamil Nadu,Property Crime,Burglary,Male,0-12,4161,3029,1132,3787,374
2005,Rural,Karnataka,Property Crime,Arson,Female,18-30,6888,3823,3065,5024,1864
2004,Urban,Uttarakhand,Crime Against Children,Child Abuse,Female,46-60,8698,6008,2690,7436,1262
2001,Urban,Assam,Crime Against Men,Extortion,Female,46-60,9698,1638,8060,7327,2371
2002,Rural,Odisha,Property Crime,Vandalism,Male,60+,3289,297,2992,3147,142
2006,Urban,Maharashtra,Crime Against Men,Extortion,Female,0-12,2884,1709,1175,2792,92
2002,Rural,Sikkim,Crime Against Men,Murder,Male,60+,7765,4162,3603,6122,1643
2002,Rural,Tamil Nadu,Crime Against Children,Child Abuse,Male,0-12,9379,506,8873,5335,4044
2007,Rural,Chhattisgarh,Crime Against Children,Child Abuse,Male,13-17,6648,2593,4055,4686,1962
2010,Urban,Manipur,Property Crime,Burglary,Female,60+,2842,173,2669,1130,1712
2007,Urban,Uttarakhand,Other Crimes,Drug Offense,Male,0-12,3642,3305,337,3594,48
2005,Urban,Goa,Other Crimes,Drug Offense,Male,13-17,2786,1313,1473,2342,444
2002,Urban,Uttarakhand,Property Crime,Vandalism,Male,13-17,2579,1675,904,2056,523
2009,Urban,Gujarat,Other Crimes,Corruption,Female,13-17,8616,5238,3378,6263,2353
2008,Rural,Jammu & Kashmir,Crime Against Children,Trafficking,Female,18-30,1678,177,1501,1305,373
2010,Rural,Telangana,Crime Against Children,Child Abuse,Male,0-12,3769,3752,17,3764,5
2005,Rural,Haryana,Crime Against Children,Trafficking,Male,0-12,2577,379,2198,551,2026
2006,Rural,Karnataka,Property Crime,Vandalism,Female,60+,3656,355,3301,1390,2266
2004,Urban,Uttarakhand,Other Crimes,Corruption,Male,0-12,7536,6904,632,7281,255
2002,Rural,Nagaland,Crime Against Children,Kidnapping,Male,46-60,8842,1214,7628,3529,5313
2002,Rural,Tripura,Crime Against Women,Rape,Female,13-17,9230,50,9180,3128,6102
2005,Urban,Sikkim,Crime Against Men,Assault,Male,31-45,5850,3827,2023,5784,66
2008,Rural,Haryana,Other Crimes,Corruption,Female,31-45,7987,2957,5030,4784,3203
2009,Urban,Jharkhand,Crime Against Women,Rape,Male,31-45,4264,3818,446,4201,63
2004,Urban,Rajasthan,Crime Against Children,Trafficking,Male,13-17,9197,3745,5452,6386,2811
2009,Urban,Nagaland,Crime Against Men,Robbery,Male,46-60,2742,2475,267,2512,230
2003,Rural,Madhya Pradesh,Other Crimes,Drug Offense,Female,31-45,8471,1096,7375,4158,4313
2010,Urban,Arunachal Pradesh,Crime Against Men,Murder,Male,31-45,7961,5728,2233,6397,1564
2008,Rural,Assam,Other Crimes,Cyber Crime,Female,0-12,6427,2401,4026,3589,2838
2001,Urban,Nagaland,Crime Against Women,Rape,Male,60+,3987,3031,956,3532,455
2002,Urban,Manipur,Crime Against Men,Robbery,Female,31-45,8773,6692,2081,8378,395
2005,Urban,Tamil Nadu,Crime Against Men,Robbery,Male,46-60,4499,159,4340,1024,3475
2003,Rural,Uttar Pradesh,Crime Against Children,Child Abuse,Female,18-30,3655,2052,1603,2796,859
2003,Rural,Mizoram,Other Crimes,Corruption,Male,31-45,1730,835,895,1225,505
2006,Rural,Delhi,Crime Against Women,Molestation,Male,46-60,4013,1842,2171,3525,488
2005,Rural,Arunachal Pradesh,Crime Against Children,Kidnapping,Male,18-30,4709,3234,1475,4634,75
2003,Rural,Jharkhand,Other Crimes,Fraud,Female,0-12,1926,1060,866,1658,268
2010,Urban,Andhra Pradesh,Property Crime,Vandalism,Female,60+,822,646,176,700,122
2004,Urban,Delhi,Crime Against Women,Domestic Violence,Male,31-45,7557,199,7358,7449,108
2001,Urban,Uttarakhand,Other Crimes,Corruption,Female,0-12,4439,3078,1361,3298,1141
2010,Urban,Nagaland,Crime Against Children,Child Abuse,Male,31-45,7372,4934,2438,6461,911
2007,Urban,Haryana,Crime Against Women,Molestation,Female,0-12,6308,1455,4853,2427,3881
2004,Rural,Mizoram,Crime Against Men,Murder,Male,13-17,9766,2513,7253,8693,1073
2003,Rural,Jammu & Kashmir,Crime Against Women,Rape,Male,60+,2804,1547,1257,2793,11
2010,Rural,Tripura,Crime Against Children,Child Labor,Female,31-45,8371,1087,7284,3216,5155
2001,Urban,Bihar,Other Crimes,Corruption,Female,18-30,2712,2631,81,2658,54
2004,Rural,Manipur,Property Crime,Vandalism,Female,18-30,2961,20,2941,2356,605
2005,Urban,Rajasthan,Other Crimes,Drug Offense,Male,46-60,9560,7171,2389,9119,441
2008,Rural,Telangana,Crime Against Men,Extortion,Female,60+,9374,7,9367,3130,6244
2001,Rural,Tamil Nadu,Other Crimes,Cyber Crime,Female,31-45,2772,2734,38,2753,19
2001,Rural,Chhattisgarh,Crime Against Men,Robbery,Male,46-60,9152,3416,5736,5211,3941
2010,Rural,Himachal Pradesh,Other Crimes,Corruption,Female,13-17,8388,7115,1273,7939,449
2003,Urban,Assam,Other Crimes,Fraud,Female,31-45,6960,181,6779,3506,3454
2009,Rural,Haryana,Crime Against Children,Child Labor,Female,31-45,3353,3325,28,3333,20
2002,Urban,Assam,Property Crime,Burglary,Female,31-45,6799,5533,1266,6594,205
2001,Rural,Tripura,Crime Against Women,Rape,Female,13-17,1870,782,1088,1309,561
2007,Urban,West Bengal,Crime Against Men,Extortion,Female,60+,8593,5606,2987,6809,1784
2005,Urban,Telangana,Crime Against Men,Robbery,Male,31-45,8049,5122,2927,7269,780
2009,Rural,Sikkim,Other Crimes,Drug Offense,Male,46-60,5075,3047,2028,4336,739
2001,Urban,Tamil Nadu,Crime Against Children,Kidnapping,Male,60+,8931,2956,5975,4419,4512
2008,Rural,Uttarakhand,Crime Against Men,Assault,Female,31-45,7959,4263,3696,4896,3063
2009,Urban,Telangana,Crime Against Women,Domestic Violence,Female,31-45,6205,1642,4563,3668,2537
2004,Rural,Uttar Pradesh,Crime Against Women,Dowry Deaths,Female,18-30,8050,4961,3089,6405,1645
2004,Rural,Andhra Pradesh,Property Crime,Theft,Male,31-45,9347,900,8447,8804,543
2006,Rural,West Bengal,Crime Against Men,Extortion,Female,31-45,2517,306,2211,2064,453
2008,Urban,Manipur,Property Crime,Burglary,Male,31-45,1912,1176,736,1904,8
2003,Rural,Tamil Nadu,Crime Against Children,Kidnapping,Male,0-12,9381,9362,19,9366,15
2010,Urban,Mizoram,Crime Against Children,Child Labor,Male,31-45,5185,4563,622,4784,401
2010,Rural,Tamil Nadu,Crime Against Men,Robbery,Female,0-12,2075,670,1405,1709,366
2002,Rural,Kerala,Crime Against Men,Assault,Female,46-60,6044,651,5393,2728,3316
2008,Rural,Arunachal Pradesh,Crime Against Men,Extortion,Male,13-17,9005,3514,5491,5998,3007
2008,Urban,Mizoram,Crime Against Women,Rape,Male,60+,3517,1624,1893,2665,852
2003,Urban,Gujarat,Property Crime,Vandalism,Male,60+,3621,1213,2408,2300,1321
2008,Rural,Madhya Pradesh,Crime Against Children,Trafficking,Male,0-12,2269,970,1299,1059,1210
2003,Urban,Haryana,Crime Against Children,Child Labor,Female,13-17,8376,485,7891,2274,6102
2004,Urban,Goa,Other Crimes,Drug Offense,Male,46-60,926,712,214,901,25
2003,Urban,West Bengal,Crime Against Men,Assault,Female,0-12,1587,946,641,1029,558
2007,Urban,Nagaland,Other Crimes,Fraud,Male,31-45,1327,762,565,1165,162
2003,Urban,Chhattisgarh,Property Crime,Burglary,Male,31-45,3957,959,2998,1213,2744
2003,Rural,Odisha,Property Crime,Burglary,Female,18-30,8035,1292,6743,4955,3080
2001,Urban,West Bengal,Property Crime,Burglary,Male,18-30,223,144,79,196,27
2006,Urban,Delhi,Crime Against Men,Assault,Male,46-60,9631,4307,5324,5251,4380
2004,Rural,Jharkhand,Crime Against Children,Child Labor,Female,13-17,1833,1331,502,1336,497
2004,Rural,Nagaland,Crime Against Women,Rape,Female,31-45,6615,1801,4814,6474,141
2007,Urban,Andhra Pradesh,Crime Against Children,Trafficking,Male,46-60,5534,2811,2723,5339,195
2007,Urban,Tripura,Other Crimes,Cyber Crime,Male,60+,957,489,468,671,286
2010,Urban,Tamil Nadu,Property Crime,Vandalism,Male,46-60,361,357,4,360,1
2010,Rural,Andhra Pradesh,Crime Against Women,Molestation,Male,60+,2337,1166,1171,1373,964
2005,Urban,Haryana,Crime Against Women,Molestation,Female,13-17,4610,1163,3447,2612,1998
2009,Rural,Jharkhand,Crime Against Women,Molestation,Male,31-45,7384,3162,4222,6422,962
2009,Urban,Assam,Crime Against Men,Robbery,Male,60+,5188,4185,1003,4755,433
2009,Rural,Arunachal Pradesh,Property Crime,Arson,Female,31-45,2030,1564,466,1996,34
2005,Urban,Sikkim,Crime Against Men,Robbery,Female,0-12,842,515,327,749,93
2001,Rural,Chhattisgarh,Crime Against Women,Domestic Violence,Female,18-30,8319,1532,6787,2384,5935
2006,Urban,Goa,Crime Against Children,Child Abuse,Male,60+,6546,5837,709,6098,448
2009,Rural,Uttar Pradesh,Crime Against Women,Molestation,Female,13-17,6001,1042,4959,1900,4101
2002,Rural,Sikkim,Crime Against Men,Murder,Male,18-30,7755,402,7353,2745,5010
2007,Urban,Nagaland,Property Crime,Vandalism,Female,31-45,3098,3073,25,3073,25
2001,Urban,Meghalaya,Crime Against Children,Kidnapping,Female,13-17,9863,9408,455,9599,264
2007,Rural,Rajasthan,Crime Against Children,Trafficking,Male,60+,6282,2889,3393,5933,349
2003,Urban,Madhya Pradesh,Crime Against Children,Child Labor,Female,60+,7269,194,7075,6141,1128
2009,Rural,Maharashtra,Crime Against Women,Rape,Female,60+,2475,1005,1470,2468,7
2005,Urban,Meghalaya,Crime Against Children,Kidnapping,Female,31-45,927,111,816,330,597
2010,Rural,Kerala,Property Crime,Vandalism,Female,13-17,6105,4554,1551,4946,1159
2008,Rural,Rajasthan,Property Crime,Vandalism,Female,31-45,8661,6319,2342,8131,530
2008,Rural,Goa,Crime Against Women,Domestic Violence,Female,31-45,2022,622,1400,762,1260
2008,Urban,Haryana,Crime Against Women,Rape,Female,60+,2796,2566,230,2654,142
2003,Urban,Jammu & Kashmir,Crime Against Children,Trafficking,Male,31-45,594,387,207,456,138
2010,Rural,Mizoram,Other Crimes,Cyber Crime,Male,31-45,3146,840,2306,2118,1028
2007,Rural,Gujarat,Crime Against Women,Dowry Deaths,Female,46-60,2530,1114,1416,2397,133
2006,Urban,Meghalaya,Crime Against Women,Rape,Male,13-17,244,94,150,215,29
2007,Rural,Meghalaya,Crime Against Men,Murder,Male,18-30,4069,1531,2538,1548,2521
2009,Urban,West Bengal,Crime Against Women,Molestation,Male,31-45,5958,3211,2747,5018,940
2008,Urban,Kerala,Property Crime,Burglary,Male,46-60,9074,1435,7639,4560,4514
2004,Rural,Bihar,Crime Against Women,Dowry Deaths,Female,46-60,5151,4831,320,4845,306
2003,Rural,Punjab,Crime Against Children,Child Abuse,Female,46-60,4202,296,3906,3512,690
2004,Rural,Chhattisgarh,Crime Against Men,Extortion,Male,60+,9853,9499,354,9730,123
2008,Rural,Manipur,Property Crime,Vandalism,Female,13-17,3167,147,3020,1926,1241
2008,Rural,Maharashtra,Other Crimes,Corruption,Male,46-60,8769,2966,5803,6940,1829
2007,Rural,Odisha,Crime Against Children,Child Labor,Male,60+,5262,3576,1686,4328,934
2002,Rural,Meghalaya,Crime Against Men,Murder,Female,46-60,5825,2782,3043,3133,2692
2003,Rural,Chhattisgarh,Crime Against Children,Child Abuse,Female,13-17,9807,6122,3685,6363,3444
2005,Rural,Uttar Pradesh,Crime Against Children,Trafficking,Female,60+,3568,1071,2497,3304,264
2004,Rural,Chhattisgarh,Crime Against Men,Murder,Male,31-45,366,11,355,317,49
2002,Urban,Chhattisgarh,Other Crimes,Cyber Crime,Female,60+,5678,5452,226,5517,161
2005,Rural,Arunachal Pradesh,Other Crimes,Cyber Crime,Female,13-17,4580,1497,3083,1968,2612
2003,Urban,Gujarat,Crime Against Women,Rape,Male,0-12,5839,3161,2678,4979,860
2004,Rural,Manipur,Property Crime,Vandalism,Female,0-12,791,193,598,206,585
2009,Rural,Manipur,Crime Against Children,Kidnapping,Male,0-12,6768,4533,2235,6330,438
2001,Rural,Karnataka,Crime Against Women,Domestic Violence,Male,46-60,8191,3355,4836,7971,220
2001,Rural,Bihar,Crime Against Men,Assault,Female,18-30,5348,3909,1439,5292,56
2006,Urban,Telangana,Property Crime,Vandalism,Female,46-60,9563,8390,1173,9502,61
2006,Urban,Maharashtra,Crime Against Men,Assault,Male,60+,1675,365,1310,440,1235
2010,Rural,Uttar Pradesh,Crime Against Men,Extortion,Female,13-17,1959,83,1876,1388,571
2008,Urban,Nagaland,Crime Against Men,Murder,Male,46-60,3832,284,3548,3442,390
2003,Urban,Tripura,Property Crime,Burglary,Female,13-17,2503,2443,60,2503,0
2010,Urban,Kerala,Crime Against Men,Murder,Female,60+,4316,3955,361,4275,41
2002,Rural,Madhya Pradesh,Crime Against Men,Robbery,Male,18-30,2424,1050,1374,1181,1243
2005,Rural,Odisha,Other Crimes,Cyber Crime,Female,46-60,6386,1830,4556,3576,2810
2010,Urban,Goa,Crime Against Men,Murder,Male,60+,2808,634,2174,1940,868
2008,Urban,Uttarakhand,Crime Against Children,Kidnapping,Female,31-45,9302,9135,167,9146,156
2008,Rural,Goa,Crime Against Men,Extortion,Male,0-12,8822,8378,444,8574,248
2006,Urban,Bihar,Property Crime,Theft,Male,31-45,922,749,173,774,148
2006,Urban,Chhattisgarh,Property Crime,Burglary,Male,13-17,3196,1012,2184,1545,1651
2009,Urban,Haryana,Crime Against Children,Kidnapping,Female,13-17,9715,6132,3583,9595,120
2001,Urban,Gujarat,Property Crime,Burglary,Female,60+,89,47,42,71,18
2008,Urban,Assam,Crime Against Children,Trafficking,Female,0-12,2085,1678,407,2084,1
2001,Rural,Andhra Pradesh,Crime Against Women,Dowry Deaths,Female,13-17,7601,5491,2110,5912,1689
2003,Urban,Andhra Pradesh,Crime Against Men,Robbery,Female,13-17,1874,793,1081,1770,104
2002,Urban,Karnataka,Crime Against Women,Domestic Violence,Male,60+,9298,5084,4214,7265,2033
2001,Urban,Bihar,Crime Against Women,Domestic Violence,Male,13-17,3939,185,3754,363,3576
2002,Rural,Meghalaya,Property Crime,Theft,Male,60+,9894,6550,3344,7535,2359
2003,Rural,Gujarat,Property Crime,Theft,Female,13-17,8107,6093,2014,6411,1696
2007,Rural,Uttar Pradesh,Crime Against Women,Molestation,Male,60+,1656,687,969,727,929
2008,Urban,Karnataka,Crime Against Children,Trafficking,Female,46-60,4479,3419,1060,4437,42
2003,Urban,Uttar Pradesh,Other Crimes,Corruption,Female,13-17,7547,1867,5680,2703,4844
2006,Rural,West Bengal,Crime Against Children,Child Abuse,Female,31-45,7040,4207,2833,6784,256
2010,Urban,Andhra Pradesh,Crime Against Men,Robbery,Female,0-12,3661,3273,388,3546,115
2009,Urban,Sikkim,Crime Against Women,Rape,Female,18-30,2601,2331,270,2492,109
2003,Rural,Jammu & Kashmir,Other Crimes,Fraud,Female,13-17,8926,3982,4944,8702,224
2007,Urban,Sikkim,Other Crimes,Cyber Crime,Male,46-60,5863,5730,133,5798,65
2006,Urban,Meghalaya,Property Crime,Burglary,Female,46-60,7770,7121,649,7734,36
2010,Urban,Chhattisgarh,Crime Against Women,Dowry Deaths,Male,60+,924,192,732,679,245
2002,Rural,Uttarakhand,Crime Against Women,Dowry Deaths,Male,13-17,3195,930,2265,2020,1175
2003,Urban,Rajasthan,Crime Against Women,Dowry Deaths,Male,31-45,9350,7564,1786,8166,1184
2001,Urban,Goa,Property Crime,Arson,Male,60+,7734,304,7430,691,7043
2001,Rural,Goa,Crime Against Women,Molestation,Female,60+,6969,5134,1835,5522,1447
2010,Urban,Assam,Crime Against Men,Extortion,Male,60+,7475,935,6540,4511,2964
2006,Urban,Karnataka,Property Crime,Arson,Female,31-45,9320,1129,8191,5477,3843
2004,Urban,Meghalaya,Crime Against Women,Domestic Violence,Male,13-17,7016,631,6385,3739,3277
2006,Rural,Sikkim,Other Crimes,Drug Offense,Female,0-12,6610,4962,1648,6438,172
2002,Urban,Mizoram,Crime Against Men,Robbery,Male,31-45,8215,5560,2655,6914,1301
2004,Urban,Haryana,Property Crime,Burglary,Male,13-17,1093,828,265,880,213
2003,Urban,Telangana,Property Crime,Vandalism,Female,13-17,1779,394,1385,767,1012
2009,Urban,Goa,Property Crime,Arson,Female,18-30,3750,3353,397,3461,289
2008,Rural,Kerala,Crime Against Women,Domestic Violence,Female,13-17,549,41,508,261,288
2006,Urban,Maharashtra,Crime Against Men,Robbery,Female,31-45,8681,5232,3449,5686,2995
2003,Urban,Haryana,Other Crimes,Drug Offense,Female,60+,1249,1124,125,1165,84
2009,Rural,Telangana,Other Crimes,Drug Offense,Male,46-60,8296,1151,7145,3078,5218
2009,Urban,Meghalaya,Property Crime,Burglary,Female,31-45,6856,4896,1960,6135,721
2001,Rural,Tamil Nadu,Crime Against Men,Assault,Male,60+,2245,630,1615,2154,91
2010,Urban,Jammu & Kashmir,Crime Against Men,Murder,Female,13-17,4284,148,4136,1461,2823
2003,Urban,Uttar Pradesh,Crime Against Children,Child Abuse,Male,46-60,3478,656,2822,802,2676
2010,Urban,Madhya Pradesh,Other Crimes,Fraud,Female,13-17,6922,10,6912,208,6714
2003,Urban,Tripura,Crime Against Women,Domestic Violence,Male,18-30,7307,1146,6161,3657,3650
2001,Rural,Odisha,Crime Against Children,Trafficking,Female,31-45,9161,2522,6639,5773,3388
2010,Rural,Mizoram,Property Crime,Arson,Female,0-12,3870,662,3208,2366,1504
2009,Urban,Maharashtra,Crime Against Children,Kidnapping,Male,31-45,5616,3644,1972,4320,1296
2001,Urban,Andhra Pradesh,Crime Against Children,Trafficking,Female,31-45,8300,4722,3578,7305,995
2004,Urban,West Bengal,Crime Against Children,Trafficking,Female,31-45,3753,1696,2057,2501,1252
2004,Urban,Karnataka,Crime Against Women,Rape,Male,46-60,5371,5179,192,5226,145
2009,Rural,Uttarakhand,Crime Against Women,Domestic Violence,Male,13-17,4103,1704,2399,2883,1220
2008,Rural,Sikkim,Crime Against Men,Extortion,Female,13-17,6281,5143,1138,5422,859
2001,Urban,Sikkim,Crime Against Children,Child Labor,Male,0-12,8117,471,7646,5843,2274
2008,Rural,Delhi,Property Crime,Burglary,Male,13-17,5182,4566,616,4686,496
2010,Urban,Delhi,Crime Against Women,Rape,Female,18-30,7992,1464,6528,3873,4119
2009,Rural,Punjab,Crime Against Men,Robbery,Female,31-45,2456,1160,1296,2120,336
2004,Rural,Himachal Pradesh,Other Crimes,Cyber Crime,Female,60+,6036,3572,2464,5738,298
2008,Urban,Rajasthan,Property Crime,Burglary,Male,13-17,2897,473,2424,1583,1314
2007,Urban,Goa,Crime Against Men,Extortion,Male,46-60,5009,2846,2163,4398,611
2002,Urban,Tripura,Crime Against Men,Assault,Female,46-60,7745,4081,3664,7090,655
2005,Rural,Maharashtra,Crime Against Children,Child Labor,Female,46-60,5489,2276,3213,4641,848
2010,Rural,Jharkhand,Other Crimes,Corruption,Female,31-45,6415,4667,1748,5656,759
2003,Rural,Haryana,Property Crime,Burglary,Female,13-17,7991,6588,1403,7631,360
2001,Urban,Tamil Nadu,Crime Against Children,Trafficking,Male,0-12,8304,6516,1788,6589,1715
2005,Rural,Madhya Pradesh,Crime Against Children,Child Abuse,Female,0-12,7761,6200,1561,6945,816
2008,Urban,Chhattisgarh,Other Crimes,Fraud,Female,31-45,481,236,245,295,186
2002,Urban,Manipur,Property Crime,Arson,Female,18-30,2627,263,2364,2251,376
2004,Rural,Telangana,Crime Against Children,Child Labor,Female,13-17,3807,1093,2714,3587,220
2008,Urban,Uttar Pradesh,Crime Against Men,Assault,Male,0-12,1263,1248,15,1252,11
2009,Rural,Telangana,Crime Against Men,Murder,Male,13-17,2966,446,2520,2375,591
2001,Rural,Chhattisgarh,Crime Against Men,Robbery,Male,60+,1942,1462,480,1881,61
2003,Rural,Delhi,Other Crimes,Drug Offense,Female,60+,7170,5545,1625,5615,1555
2006,Urban,Kerala,Crime Against Women,Dowry Deaths,Male,0-12,6558,1004,5554,2914,3644
2007,Rural,Jammu & Kashmir,Crime Against Women,Domestic Violence,Female,18-30,9990,7572,2418,7865,2125
2008,Rural,Meghalaya,Property Crime,Theft,Male,31-45,5472,4039,1433,4335,1137
2005,Rural,Himachal Pradesh,Crime Against Children,Kidnapping,Male,13-17,3095,1035,2060,1041,2054
2008,Urban,Himachal Pradesh,Crime Against Children,Kidnapping,Female,13-17,1801,1739,62,1783,18
2009,Rural,Chhattisgarh,Other Crimes,Drug Offense,Male,13-17,741,132,609,309,432
2002,Urban,Uttarakhand,Crime Against Children,Trafficking,Female,46-60,8813,2810,6003,3506,5307
2004,Rural,Manipur,Property Crime,Arson,Male,18-30,9059,1765,7294,8729,330
2008,Urban,Tamil Nadu,Property Crime,Burglary,Male,60+,9093,4363,4730,7575,1518
2006,Rural,Manipur,Crime Against Women,Rape,Female,18-30,2269,1892,377,1897,372
2001,Rural,Telangana,Crime Against Men,Assault,Female,0-12,4965,3281,1684,4277,688
2008,Rural,Telangana,Crime Against Children,Child Abuse,Male,0-12,6571,1270,5301,4810,1761
2007,Urban,Rajasthan,Other Crimes,Fraud,Female,60+,6200,6119,81,6200,0
2008,Rural,Punjab,Crime Against Women,Molestation,Female,60+,2656,155,2501,2441,215
2007,Urban,Madhya Pradesh,Crime Against Women,Dowry Deaths,Male,60+,6050,1965,4085,2911,3139
2008,Urban,Tripura,Property Crime,Arson,Male,60+,4618,781,3837,1361,3257
2009,Urban,Assam,Crime Against Children,Child Labor,Female,60+,3315,1008,2307,3174,141
2010,Rural,West Bengal,Property Crime,Theft,Female,31-45,1856,1129,727,1186,670
2009,Rural,Andhra Pradesh,Crime Against Children,Kidnapping,Female,60+,532,356,176,430,102
2007,Urban,Gujarat,Property Crime,Theft,Male,18-30,8644,7955,689,8478,166
2009,Rural,Assam,Property Crime,Arson,Male,46-60,9720,4362,5358,4920,4800
2006,Urban,Punjab,Property Crime,Arson,Male,60+,3989,2039,1950,3673,316
2001,Rural,Gujarat,Other Crimes,Corruption,Female,46-60,7081,4446,2635,6485,596
2005,Urban,Assam,Other Crimes,Fraud,Male,18-30,3655,861,2794,2214,1441
2010,Rural,Jharkhand,Property Crime,Arson,Female,60+,4846,33,4813,811,4035
2003,Urban,Goa,Other Crimes,Cyber Crime,Female,0-12,868,568,300,867,1
2004,Urban,Gujarat,Crime Against Women,Dowry Deaths,Female,13-17,121,70,51,78,43
2009,Urban,Odisha,Crime Against Women,Molestation,Female,18-30,3027,1045,1982,1806,1221
2002,Urban,Goa,Property Crime,Arson,Female,18-30,6646,6203,443,6544,102
2008,Rural,Telangana,Crime Against Men,Murder,Male,18-30,6074,2829,3245,4728,1346
2003,Rural,Assam,Crime Against Men,Murder,Male,13-17,1548,1442,106,1478,70
2002,Rural,Telangana,Other Crimes,Drug Offense,Male,13-17,6056,756,5300,3808,2248
2010,Urban,Uttar Pradesh,Crime Against Children,Trafficking,Female,46-60,8754,2091,6663,2462,6292
2009,Urban,West Bengal,Other Crimes,Cyber Crime,Male,46-60,3032,2455,577,2570,462
2009,Urban,Maharashtra,Property Crime,Arson,Female,13-17,4123,507,3616,2297,1826
2009,Rural,Meghalaya,Property Crime,Arson,Female,31-45,540,54,486,213,327
2010,Rural,Karnataka,Crime Against Women,Domestic Violence,Male,60+,9874,3078,6796,6499,3375
2007,Urban,Sikkim,Property Crime,Theft,Male,0-12,1943,1672,271,1803,140
2008,Urban,Mizoram,Property Crime,Burglary,Female,18-30,7231,1743,5488,3792,3439
2007,Rural,Tripura,Crime Against Children,Child Labor,Male,31-45,6002,4285,1717,4487,1515
2002,Urban,Arunachal Pradesh,Crime Against Children,Child Abuse,Female,46-60,5932,2859,3073,3888,2044
2006,Urban,Arunachal Pradesh,Property Crime,Burglary,Female,31-45,8026,1555,6471,4063,3963
2007,Urban,Meghalaya,Crime Against Men,Robbery,Male,46-60,8945,5332,3613,6442,2503
2002,Rural,Jharkhand,Other Crimes,Cyber Crime,Female,13-17,7461,7069,392,7093,368
2010,Urban,Gujarat,Other Crimes,Corruption,Male,46-60,2050,1279,771,1937,113
2008,Urban,Uttarakhand,Other Crimes,Fraud,Male,31-45,6221,850,5371,2646,3575
2006,Rural,Bihar,Crime Against Women,Rape,Male,13-17,8435,6489,1946,6605,1830
2006,Rural,Andhra Pradesh,Crime Against Children,Child Labor,Male,46-60,5439,1503,3936,4365,1074
2003,Urban,Jammu & Kashmir,Crime Against Men,Extortion,Male,31-45,415,15,400,248,167
2001,Urban,Madhya Pradesh,Crime Against Women,Molestation,Female,18-30,1441,1377,64,1392,49
2010,Rural,Rajasthan,Crime Against Children,Kidnapping,Male,13-17,5152,2850,2302,3018,2134
2003,Urban,Karnataka,Property Crime,Theft,Male,31-45,3161,1339,1822,1683,1478
2009,Rural,Rajasthan,Crime Against Children,Trafficking,Male,0-12,1589,1145,444,1459,130
2010,Rural,Goa,Crime Against Children,Kidnapping,Male,46-60,5751,599,5152,5487,264
2002,Rural,Haryana,Crime Against Children,Child Labor,Male,60+,296,167,129,173,123
2008,Urban,Tamil Nadu,Crime Against Men,Assault,Female,0-12,6670,6153,517,6338,332
2009,Rural,Arunachal Pradesh,Crime Against Children,Trafficking,Male,13-17,5906,3496,2410,4977,929
2004,Rural,Arunachal Pradesh,Other Crimes,Fraud,Female,46-60,1021,199,822,393,628
2009,Rural,Meghalaya,Other Crimes,Fraud,Female,18-30,4099,2034,2065,2746,1353
2003,Rural,Himachal Pradesh,Crime Against Men,Murder,Female,46-60,3549,327,3222,512,3037
2007,Rural,Haryana,Crime Against Children,Trafficking,Male,60+,369,140,229,315,54
2003,Urban,Jharkhand,Crime Against Women,Molestation,Male,0-12,9661,1352,8309,7232,2429
2010,Rural,Bihar,Crime Against Children,Child Labor,Male,13-17,7825,3411,4414,4733,3092
2006,Urban,Tamil Nadu,Other Crimes,Cyber Crime,Male,18-30,677,225,452,266,411
2010,Rural,Assam,Crime Against Children,Kidnapping,Female,31-45,3664,2958,706,3324,340
2010,Rural,Madhya Pradesh,Crime Against Children,Child Abuse,Male,31-45,7969,6931,1038,7381,588
2005,Rural,Telangana,Crime Against Children,Child Labor,Female,46-60,1350,1125,225,1266,84
2010,Rural,Maharashtra,Crime Against Children,Trafficking,Male,0-12,999,846,153,860,139
2006,Rural,Nagaland,Crime Against Children,Child Abuse,Female,31-45,6494,2314,4180,3769,2725
2006,Urban,Mizoram,Crime Against Children,Trafficking,Male,46-60,1730,1285,445,1667,63
2001,Rural,Himachal Pradesh,Crime Against Men,Assault,Male,18-30,7444,5947,1497,6555,889
2001,Urban,Chhattisgarh,Crime Against Men,Assault,Male,13-17,4424,4220,204,4251,173
2008,Urban,Uttarakhand,Crime Against Children,Child Abuse,Male,18-30,8103,4183,3920,4630,3473
2008,Rural,Chhattisgarh,Crime Against Men,Robbery,Female,31-45,4575,160,4415,3634,941
2001,Urban,Maharashtra,Property Crime,Vandalism,Male,46-60,3573,337,3236,3140,433
2010,Rural,Uttarakhand,Crime Against Women,Domestic Violence,Female,46-60,5097,4632,465,4681,416
2004,Rural,Karnataka,Other Crimes,Drug Offense,Female,13-17,9881,3441,6440,8570,1311
2001,Urban,Nagaland,Crime Against Men,Assault,Male,46-60,6621,28,6593,5363,1258
2004,Rural,Madhya Pradesh,Other Crimes,Cyber Crime,Male,0-12,9175,3858,5317,8067,1108
2010,Urban,Karnataka,Crime Against Men,Murder,Male,31-45,4496,4260,236,4373,123
2002,Urban,Mizoram,Other Crimes,Cyber Crime,Male,13-17,9176,3153,6023,5522,3654
2001,Rural,Chhattisgarh,Crime Against Men,Murder,Male,60+,5008,914,4094,1388,3620
2003,Urban,Telangana,Crime Against Children,Kidnapping,Male,31-45,2538,1900,638,2461,77
2004,Urban,Andhra Pradesh,Crime Against Women,Rape,Female,60+,470,279,191,281,189
2006,Rural,Jharkhand,Property Crime,Theft,Female,46-60,1145,456,689,796,349
2010,Rural,Kerala,Crime Against Women,Dowry Deaths,Female,0-12,9177,8640,537,8644,533
2006,Urban,Rajasthan,Property Crime,Theft,Female,13-17,3963,1275,2688,2126,1837
2006,Rural,Tripura,Property Crime,Arson,Male,46-60,5677,3017,2660,3994,1683
2009,Urban,Kerala,Other Crimes,Corruption,Female,13-17,4104,2741,1363,3487,617
2003,Urban,Arunachal Pradesh,Other Crimes,Drug Offense,Male,0-12,3994,3511,483,3525,469
2002,Rural,Karnataka,Crime Against Children,Child Abuse,Female,18-30,9849,8643,1206,9147,702
2009,Rural,Andhra Pradesh,Crime Against Children,Child Abuse,Male,18-30,5983,4181,1802,4421,1562
2004,Urban,Sikkim,Crime Against Children,Child Abuse,Female,46-60,8769,5795,2974,7600,1169
2007,Rural,Jharkhand,Crime Against Men,Assault,Male,18-30,870,749,121,860,10
2006,Rural,Haryana,Crime Against Men,Assault,Female,13-17,9433,3693,5740,5099,4334
2004,Urban,Bihar,Crime Against Women,Molestation,Male,31-45,2399,1321,1078,1979,420
2010,Rural,Tripura,Property Crime,Arson,Female,60+,6686,4525,2161,5083,1603
2009,Rural,Assam,Other Crimes,Drug Offense,Male,13-17,8346,3837,4509,4657,3689
2005,Urban,Gujarat,Crime Against Men,Robbery,Male,18-30,5629,4966,663,5218,411
2001,Rural,Rajasthan,Crime Against Men,Extortion,Male,46-60,4832,1861,2971,2100,2732
2006,Urban,Jammu & Kashmir,Crime Against Children,Trafficking,Male,18-30,3455,800,2655,996,2459
2009,Rural,Nagaland,Crime Against Men,Robbery,Female,13-17,7676,6125,1551,6555,1121
2007,Rural,Telangana,Other Crimes,Drug Offense,Male,31-45,3434,535,2899,2819,615
2001,Urban,Arunachal Pradesh,Other Crimes,Drug Offense,Female,13-17,7172,3015,4157,6621,551
2010,Rural,Telangana,Crime Against Children,Child Abuse,Female,18-30,2815,2466,349,2593,222
2009,Rural,Andhra Pradesh,Other Crimes,Fraud,Male,46-60,1995,1775,220,1873,122
2003,Urban,Tamil Nadu,Crime Against Men,Extortion,Male,0-12,9163,492,8671,7274,1889
2010,Urban,Karnataka,Crime Against Women,Molestation,Female,18-30,2689,2545,144,2587,102
2001,Rural,Haryana,Property Crime,Theft,Female,46-60,4665,1721,2944,3528,1137
2002,Urban,Chhattisgarh,Crime Against Children,Kidnapping,Female,18-30,4180,2393,1787,3748,432
2004,Rural,Kerala,Crime Against Women,Dowry Deaths,Female,46-60,8001,3682,4319,3695,4306
2009,Rural,Goa,Other Crimes,Drug Offense,Female,0-12,427,84,343,219,208
2005,Urban,Maharashtra,Property Crime,Arson,Male,18-30,6783,3167,3616,5718,1065
2009,Rural,Assam,Crime Against Women,Molestation,Female,18-30,548,263,285,356,192
2006,Rural,Rajasthan,Crime Against Men,Robbery,Male,31-45,6653,407,6246,2915,3738
2003,Rural,Delhi,Crime Against Children,Child Labor,Female,46-60,9195,3002,6193,3651,5544
2004,Urban,Uttarakhand,Crime Against Children,Kidnapping,Female,0-12,481,277,204,455,26
2007,Rural,Uttarakhand,Other Crimes,Corruption,Male,31-45,3134,2221,913,2568,566
2003,Rural,Sikkim,Property Crime,Arson,Female,31-45,843,68,775,481,362
2006,Urban,Haryana,Crime Against Children,Trafficking,Male,31-45,5978,349,5629,3546,2432
2010,Urban,Punjab,Crime Against Women,Domestic Violence,Female,13-17,9347,1344,8003,2282,7065
2010,Urban,Telangana,Other Crimes,Corruption,Male,13-17,3610,2963,647,3417,193
2002,Urban,Mizoram,Crime Against Women,Domestic Violence,Male,13-17,6854,5551,1303,6430,424
2006,Urban,Mizoram,Other Crimes,Fraud,Female,13-17,2366,1146,1220,1415,951
2006,Urban,Arunachal Pradesh,Property Crime,Vandalism,Male,31-45,122,97,25,101,21
2010,Urban,Tamil Nadu,Other Crimes,Fraud,Female,46-60,5457,323,5134,4069,1388
2006,Rural,Bihar,Crime Against Women,Domestic Violence,Female,60+,8730,7293,1437,7890,840
2002,Urban,Assam,Crime Against Children,Trafficking,Female,46-60,1133,124,1009,989,144
2004,Urban,Gujarat,Property Crime,Arson,Female,60+,7138,5273,1865,6168,970
2008,Rural,Andhra Pradesh,Other Crimes,Corruption,Female,13-17,239,23,216,113,126
2003,Rural,Maharashtra,Other Crimes,Corruption,Female,18-30,9904,1277,8627,4802,5102
2005,Rural,Tripura,Crime Against Women,Rape,Male,31-45,338,202,136,330,8
2004,Urban,Punjab,Crime Against Children,Child Abuse,Female,60+,7162,1349,5813,7015,147
2008,Rural,West Bengal,Property Crime,Vandalism,Female,31-45,9367,3361,6006,3492,5875
2006,Urban,Mizoram,Other Crimes,Fraud,Male,0-12,8795,1876,6919,8023,772
2002,Rural,Uttarakhand,Crime Against Women,Dowry Deaths,Female,13-17,6210,5286,924,5694,516
2002,Rural,Rajasthan,Crime Against Men,Murder,Female,18-30,9781,9139,642,9740,41
2004,Rural,Jharkhand,Crime Against Women,Domestic Violence,Male,60+,9719,2166,7553,4803,4916
2006,Rural,Himachal Pradesh,Crime Against Women,Rape,Female,46-60,7625,929,6696,3502,4123
2007,Rural,Punjab,Crime Against Children,Trafficking,Female,18-30,9767,5653,4114,6037,3730
2001,Rural,Chhattisgarh,Crime Against Women,Domestic Violence,Male,60+,9247,1626,7621,9058,189
2005,Urban,Himachal Pradesh,Crime Against Children,Child Labor,Female,0-12,7739,3369,4370,6973,766
2005,Urban,Odisha,Property Crime,Vandalism,Male,13-17,2018,1702,316,1877,141
2008,Urban,Meghalaya,Crime Against Women,Molestation,Female,31-45,2778,127,2651,970,1808
2002,Rural,Jharkhand,Property Crime,Theft,Female,13-17,8679,6034,2645,8588,91
2008,Rural,Uttarakhand,Crime Against Women,Domestic Violence,Male,13-17,7308,4845,2463,6784,524
2007,Rural,Telangana,Other Crimes,Fraud,Female,0-12,7723,7305,418,7546,177
2007,Urban,Maharashtra,Crime Against Children,Kidnapping,Female,18-30,1835,472,1363,690,1145
2008,Rural,Odisha,Property Crime,Burglary,Male,31-45,9721,6158,3563,7377,2344
2002,Urban,Karnataka,Property Crime,Burglary,Female,0-12,8409,7053,1356,7723,686
2006,Urban,Tripura,Other Crimes,Cyber Crime,Female,60+,1787,1579,208,1611,176
2008,Rural,Uttarakhand,Other Crimes,Cyber Crime,Female,46-60,5947,2705,3242,3197,2750
2002,Urban,Uttarakhand,Other Crimes,Fraud,Male,18-30,3697,1155,2542,1586,2111
2002,Rural,Tripura,Crime Against Men,Murder,Male,46-60,9760,954,8806,5785,3975
2004,Urban,Gujarat,Crime Against Children,Child Abuse,Female,31-45,2909,2524,385,2773,136
2007,Rural,Madhya Pradesh,Other Crimes,Corruption,Female,46-60,2462,1284,1178,1939,523
2008,Urban,Delhi,Property Crime,Burglary,Male,18-30,7131,3575,3556,6774,357
2001,Rural,Mizoram,Crime Against Children,Trafficking,Male,18-30,664,249,415,594,70
2001,Rural,Manipur,Other Crimes,Corruption,Male,0-12,9964,4167,5797,8916,1048
2005,Urban,Mizoram,Crime Against Children,Child Labor,Male,60+,4935,3263,1672,4396,539
2010,Urban,Rajasthan,Property Crime,Vandalism,Male,46-60,9214,2384,6830,8238,976
2001,Rural,West Bengal,Other Crimes,Cyber Crime,Male,18-30,183,109,74,132,51
2005,Urban,Telangana,Crime Against Children,Trafficking,Female,18-30,9460,8729,731,9442,18
2009,Rural,Karnataka,Crime Against Men,Extortion,Male,60+,2242,2137,105,2201,41
2009,Rural,Uttarakhand,Property Crime,Arson,Female,0-12,6229,4235,1994,5793,436
2005,Urban,Rajasthan,Crime Against Men,Extortion,Female,0-12,3888,1155,2733,1317,2571
2005,Urban,Arunachal Pradesh,Other Crimes,Drug Offense,Male,31-45,5186,2860,2326,2905,2281
2005,Rural,Tripura,Crime Against Children,Kidnapping,Female,60+,9322,7520,1802,8883,439
2001,Urban,Gujarat,Property Crime,Burglary,Female,0-12,4143,4070,73,4077,66
2005,Rural,Manipur,Crime Against Men,Murder,Male,0-12,4493,2468,2025,4088,405
2008,Rural,Delhi,Property Crime,Arson,Male,13-17,7416,370,7046,6347,1069
2010,Rural,Nagaland,Property Crime,Burglary,Male,18-30,8345,3725,4620,5212,3133
2004,Urban,Mizoram,Crime Against Children,Trafficking,Female,60+,5562,3657,1905,4015,1547
2003,Rural,Andhra Pradesh,Crime Against Children,Kidnapping,Male,13-17,2939,2335,604,2824,115
2003,Rural,Himachal Pradesh,Crime Against Women,Rape,Male,60+,6349,4552,1797,5300,1049
2007,Rural,Arunachal Pradesh,Crime Against Women,Domestic Violence,Male,60+,9258,2102,7156,7259,1999
2004,Rural,Bihar,Crime Against Women,Molestation,Female,60+,2769,1073,1696,1697,1072
2003,Urban,Uttar Pradesh,Crime Against Women,Molestation,Male,60+,4086,2484,1602,3841,245
2005,Urban,Mizoram,Property Crime,Vandalism,Male,0-12,6571,81,6490,2231,4340
2003,Rural,Nagaland,Crime Against Men,Extortion,Female,31-45,4835,3653,1182,4633,202
2004,Urban,Gujarat,Crime Against Women,Dowry Deaths,Female,18-30,5418,1116,4302,4040,1378
2001,Rural,Telangana,Crime Against Men,Murder,Female,46-60,2886,1738,1148,2727,159
2002,Rural,Tripura,Property Crime,Burglary,Female,18-30,2045,1987,58,2008,37
2006,Urban,Jharkhand,Property Crime,Theft,Male,46-60,5744,2652,3092,3723,2021
2003,Urban,Tripura,Crime Against Children,Child Labor,Male,0-12,6076,5714,362,5787,289
2001,Urban,West Bengal,Crime Against Children,Child Abuse,Male,31-45,3074,2402,672,2449,625
2010,Rural,West Bengal,Crime Against Women,Domestic Violence,Female,0-12,3451,1455,1996,1657,1794
2006,Rural,Tripura,Crime Against Women,Rape,Female,18-30,2469,2448,21,2460,9
2005,Rural,Uttar Pradesh,Crime Against Women,Dowry Deaths,Female,18-30,3804,3255,549,3320,484
2001,Urban,Telangana,Property Crime,Vandalism,Female,60+,4477,2211,2266,2215,2262
2009,Urban,Rajasthan,Crime Against Men,Murder,Male,60+,3233,3026,207,3030,203
2003,Rural,Maharashtra,Crime Against Women,Molestation,Female,60+,3503,786,2717,2453,1050
2004,Urban,Assam,Crime Against Women,Rape,Female,18-30,4454,822,3632,1730,2724
2009,Urban,Gujarat,Crime Against Men,Extortion,Female,18-30,7679,504,7175,6308,1371
2009,Rural,Karnataka,Crime Against Men,Assault,Male,46-60,6324,5706,618,6172,152
2007,Rural,Sikkim,Property Crime,Arson,Male,0-12,7261,1994,5267,4726,2535
2003,Urban,Odisha,Crime Against Men,Robbery,Female,31-45,6592,1475,5117,4651,1941
2003,Rural,Nagaland,Property Crime,Burglary,Male,46-60,4730,1989,2741,4721,9
2002,Urban,Jharkhand,Other Crimes,Cyber Crime,Female,0-12,2886,1246,1640,2565,321
2009,Rural,Himachal Pradesh,Other Crimes,Fraud,Female,18-30,7482,3312,4170,4885,2597
2009,Rural,West Bengal,Property Crime,Vandalism,Female,18-30,5232,3641,1591,3817,1415
2007,Urban,Tripura,Crime Against Children,Child Labor,Male,60+,2531,1721,810,2085,446
2003,Rural,Rajasthan,Property Crime,Burglary,Female,46-60,6362,5204,1158,5792,570
2004,Urban,Meghalaya,Crime Against Men,Robbery,Male,46-60,4191,3809,382,4091,100
2008,Urban,Sikkim,Crime Against Children,Trafficking,Male,0-12,4745,4125,620,4571,174
2005,Urban,West Bengal,Crime Against Men,Robbery,Female,18-30,6682,6105,577,6428,254
2008,Rural,Kerala,Other Crimes,Corruption,Male,18-30,6839,5819,1020,5884,955
2006,Rural,Tamil Nadu,Crime Against Women,Domestic Violence,Female,31-45,3217,960,2257,963,2254
2003,Urban,Odisha,Crime Against Women,Rape,Female,13-17,7724,4700,3024,6066,1658
2004,Urban,Meghalaya,Crime Against Children,Child Abuse,Female,0-12,1643,1079,564,1505,138
2003,Rural,Odisha,Crime Against Children,Trafficking,Male,18-30,7258,1676,5582,5451,1807
2006,Urban,Kerala,Other Crimes,Drug Offense,Male,0-12,8023,6040,1983,7289,734
2004,Rural,Himachal Pradesh,Property Crime,Theft,Female,46-60,9826,3183,6643,4694,5132
2008,Urban,Telangana,Crime Against Men,Robbery,Female,0-12,6399,521,5878,3706,2693
2001,Rural,Madhya Pradesh,Property Crime,Arson,Female,60+,7735,6121,1614,6822,913
2004,Urban,Jharkhand,Property Crime,Vandalism,Female,0-12,8587,5893,2694,6388,2199
2008,Urban,Jharkhand,Crime Against Men,Robbery,Male,31-45,3107,121,2986,667,2440
2005,Urban,Rajasthan,Crime Against Women,Molestation,Female,0-12,8878,3248,5630,6019,2859
2007,Urban,Uttar Pradesh,Crime Against Men,Assault,Male,0-12,328,129,199,242,86
2006,Urban,Andhra Pradesh,Crime Against Men,Extortion,Female,31-45,9828,6053,3775,7640,2188
2001,Rural,Chhattisgarh,Crime Against Children,Trafficking,Female,46-60,4107,1629,2478,3311,796
2005,Rural,Arunachal Pradesh,Crime Against Children,Child Abuse,Male,0-12,2010,614,1396,656,1354
2001,Urban,Tamil Nadu,Property Crime,Theft,Female,46-60,2520,506,2014,2278,242
2004,Urban,Mizoram,Crime Against Children,Kidnapping,Male,0-12,3513,2215,1298,2897,616
2004,Rural,Arunachal Pradesh,Other Crimes,Cyber Crime,Male,0-12,3740,3568,172,3687,53
2007,Rural,Nagaland,Other Crimes,Cyber Crime,Male,18-30,6747,6143,604,6418,329
2010,Rural,Mizoram,Other Crimes,Drug Offense,Female,46-60,3678,1674,2004,2877,801
2002,Urban,Gujarat,Crime Against Women,Domestic Violence,Female,13-17,7656,557,7099,2435,5221
2010,Rural,Haryana,Property Crime,Vandalism,Male,60+,9018,6291,2727,8157,861
2009,Rural,Manipur,Property Crime,Arson,Male,18-30,1668,1172,496,1366,302
2004,Urban,Arunachal Pradesh,Crime Against Men,Murder,Female,60+,6017,2260,3757,2943,3074
2002,Rural,Himachal Pradesh,Crime Against Men,Murder,Male,18-30,5089,3842,1247,4251,838
2003,Urban,Chhattisgarh,Other Crimes,Corruption,Male,18-30,6659,2173,4486,6326,333
2002,Rural,Telangana,Crime Against Children,Child Labor,Female,60+,155,107,48,139,16
2002,Urban,Himachal Pradesh,Crime Against Children,Kidnapping,Male,31-45,8056,5541,2515,7931,125
2007,Rural,Meghalaya,Crime Against Men,Extortion,Female,18-30,3627,3208,419,3537,90
2003,Rural,Tamil Nadu,Other Crimes,Cyber Crime,Male,18-30,914,209,705,435,479
2009,Urban,Jammu & Kashmir,Crime Against Women,Domestic Violence,Male,0-12,4826,491,4335,3709,1117
2007,Rural,Uttar Pradesh,Crime Against Men,Murder,Female,46-60,8711,5491,3220,8118,593
2004,Rural,Assam,Crime Against Children,Kidnapping,Female,18-30,8175,3992,4183,5529,2646
2005,Urban,Assam,Crime Against Men,Assault,Female,46-60,7901,1835,6066,6035,1866
2009,Rural,Meghalaya,Property Crime,Theft,Male,46-60,2507,1946,561,2193,314
2004,Rural,Nagaland,Crime Against Women,Dowry Deaths,Female,60+,3061,233,2828,378,2683
2003,Urban,Punjab,Crime Against Women,Dowry Deaths,Male,46-60,7320,2419,4901,4736,2584
2005,Rural,Manipur,Property Crime,Burglary,Female,31-45,9553,2269,7284,8322,1231
2007,Rural,Chhattisgarh,Crime Against Men,Murder,Male,0-12,5476,4170,1306,4940,536
2003,Urban,Nagaland,Property Crime,Vandalism,Female,0-12,1067,466,601,763,304
2007,Urban,Tamil Nadu,Crime Against Women,Dowry Deaths,Male,13-17,7172,387,6785,2035,5137
2006,Urban,Madhya Pradesh,Crime Against Women,Dowry Deaths,Male,0-12,3928,3069,859,3173,755
2001,Rural,Madhya Pradesh,Property Crime,Theft,Male,31-45,6734,2054,4680,2529,4205
2005,Rural,Maharashtra,Other Crimes,Drug Offense,Female,13-17,3100,238,2862,2617,483
2010,Rural,Haryana,Property Crime,Burglary,Male,31-45,755,740,15,750,5
2002,Rural,West Bengal,Crime Against Children,Child Labor,Male,0-12,1862,1720,142,1787,75
2005,Rural,Assam,Other Crimes,Corruption,Female,60+,1247,684,563,1149,98
2006,Urban,Tamil Nadu,Property Crime,Theft,Male,31-45,4756,2942,1814,3878,878
2005,Urban,Maharashtra,Crime Against Men,Extortion,Male,18-30,6624,1602,5022,1831,4793
2007,Rural,Madhya Pradesh,Property Crime,Vandalism,Male,60+,5339,1921,3418,3078,2261
2006,Urban,Goa,Crime Against Children,Child Abuse,Male,31-45,9980,1909,8071,3121,6859
2005,Rural,Nagaland,Property Crime,Burglary,Female,31-45,5889,4980,909,5726,163
2009,Rural,Odisha,Crime Against Men,Robbery,Female,18-30,9922,5124,4798,6351,3571
2007,Rural,Nagaland,Crime Against Children,Child Abuse,Female,46-60,6842,5794,1048,6021,821
2005,Rural,Rajasthan,Crime Against Women,Rape,Male,13-17,3367,2039,1328,3002,365
2003,Urban,Jammu & Kashmir,Property Crime,Theft,Female,46-60,7894,1213,6681,2094,5800
2008,Rural,Manipur,Other Crimes,Cyber Crime,Female,60+,8997,6754,2243,8862,135
2003,Rural,Kerala,Crime Against Women,Domestic Violence,Female,18-30,4212,1115,3097,2797,1415
2008,Urban,Madhya Pradesh,Crime Against Men,Assault,Male,0-12,639,392,247,444,195
2008,Rural,Meghalaya,Crime Against Women,Dowry Deaths,Female,60+,1209,485,724,882,327
2003,Urban,Nagaland,Crime Against Women,Domestic Violence,Female,31-45,3018,914,2104,2715,303
2002,Rural,Meghalaya,Crime Against Children,Trafficking,Male,18-30,5610,2091,3519,2456,3154
2006,Urban,Maharashtra,Property Crime,Vandalism,Male,18-30,2013,837,1176,1681,332
2002,Urban,Goa,Property Crime,Arson,Female,18-30,2567,1255,1312,1636,931
2008,Urban,Madhya Pradesh,Crime Against Children,Child Abuse,Male,18-30,2292,2188,104,2269,23
2009,Rural,Mizoram,Crime Against Children,Trafficking,Male,18-30,3944,2202,1742,3285,659
2008,Urban,Mizoram,Crime Against Children,Kidnapping,Male,31-45,3371,1247,2124,1453,1918
2008,Rural,Tripura,Crime Against Men,Murder,Male,60+,8746,1126,7620,7423,1323
2001,Rural,Delhi,Crime Against Children,Trafficking,Male,31-45,1653,732,921,982,671
2006,Urban,Haryana,Property Crime,Arson,Female,60+,6098,5462,636,6060,38
2008,Rural,Uttarakhand,Other Crimes,Drug Offense,Male,31-45,8110,4535,3575,4835,3275
2009,Rural,Uttar Pradesh,Crime Against Children,Child Labor,Male,31-45,4244,4239,5,4241,3
2005,Rural,Sikkim,Crime Against Children,Child Labor,Male,0-12,4058,172,3886,4052,6
2007,Rural,Himachal Pradesh,Crime Against Women,Rape,Female,46-60,2870,2047,823,2330,540
2005,Urban,Mizoram,Other Crimes,Fraud,Female,31-45,3656,2474,1182,3400,256
2010,Urban,Tripura,Crime Against Children,Child Labor,Male,46-60,2573,320,2253,1116,1457
2002,Urban,West Bengal,Crime Against Men,Assault,Male,31-45,5292,4508,784,5051,241
2008,Urban,Telangana,Crime Against Children,Child Abuse,Male,18-30,150,36,114,128,22
2002,Rural,Assam,Other Crimes,Fraud,Female,18-30,2292,2279,13,2288,4
2009,Urban,Haryana,Property Crime,Theft,Male,31-45,371,340,31,348,23
2006,Urban,Haryana,Other Crimes,Drug Offense,Male,13-17,1966,498,1468,600,1366
2002,Urban,Rajasthan,Property Crime,Vandalism,Male,60+,5877,5839,38,5869,8
2007,Rural,Jammu & Kashmir,Crime Against Children,Child Abuse,Female,18-30,4885,132,4753,1646,3239
2003,Rural,Mizoram,Crime Against Women,Molestation,Male,18-30,6694,1996,4698,3676,3018
2004,Urban,Tamil Nadu,Crime Against Women,Dowry Deaths,Female,46-60,5674,5435,239,5491,183
2009,Rural,Tripura,Other Crimes,Drug Offense,Female,60+,2682,956,1726,2634,48
2009,Urban,Chhattisgarh,Crime Against Men,Murder,Female,60+,575,269,306,531,44
2001,Urban,Punjab,Other Crimes,Drug Offense,Male,31-45,2028,1308,720,1546,482
2005,Rural,Karnataka,Crime Against Women,Domestic Violence,Female,18-30,2442,751,1691,1473,969
2005,Rural,Haryana,Crime Against Women,Molestation,Female,46-60,9301,3535,5766,4283,5018
2007,Urban,Delhi,Crime Against Children,Child Abuse,Male,31-45,2757,780,1977,1578,1179
2007,Urban,Maharashtra,Crime Against Men,Assault,Female,13-17,7351,7068,283,7098,253
2010,Rural,Jharkhand,Crime Against Children,Child Abuse,Female,46-60,2351,1895,456,2227,124
2002,Rural,Bihar,Property Crime,Burglary,Female,60+,8636,3140,5496,4385,4251
2007,Urban,Uttarakhand,Crime Against Men,Extortion,Male,31-45,1353,348,1005,1111,242
2009,Rural,West Bengal,Other Crimes,Fraud,Male,0-12,2273,0,2273,1346,927
2005,Rural,Jharkhand,Other Crimes,Corruption,Female,60+,8912,6647,2265,8829,83
2007,Rural,Bihar,Crime Against Children,Trafficking,Female,46-60,5032,997,4035,4307,725
2009,Urban,Andhra Pradesh,Crime Against Men,Assault,Male,13-17,1460,940,520,1066,394
2007,Rural,Manipur,Crime Against Women,Rape,Female,13-17,7532,4855,2677,6293,1239
2010,Urban,Delhi,Crime Against Men,Assault,Male,46-60,8532,5977,2555,6085,2447
2005,Urban,Madhya Pradesh,Crime Against Women,Domestic Violence,Female,13-17,6388,890,5498,3612,2776
2010,Rural,Andhra Pradesh,Property Crime,Arson,Male,13-17,6900,3670,3230,3823,3077
2001,Urban,Arunachal Pradesh,Property Crime,Vandalism,Male,13-17,9526,6494,3032,8843,683
2002,Rural,Tamil Nadu,Crime Against Children,Kidnapping,Female,46-60,5042,266,4776,432,4610
2007,Urban,Gujarat,Other Crimes,Corruption,Male,60+,3409,3357,52,3399,10
2008,Urban,Tripura,Crime Against Children,Child Labor,Female,31-45,1874,1212,662,1254,620
2010,Rural,Himachal Pradesh,Crime Against Men,Assault,Male,13-17,4480,3531,949,4345,135
2003,Urban,Nagaland,Other Crimes,Fraud,Male,0-12,800,563,237,742,58
2002,Rural,Sikkim,Crime Against Women,Dowry Deaths,Male,13-17,4130,4061,69,4116,14
2009,Urban,Punjab,Crime Against Children,Trafficking,Female,13-17,8821,636,8185,879,7942
2006,Urban,Madhya Pradesh,Other Crimes,Drug Offense,Male,0-12,2017,1050,967,1327,690
2001,Urban,Himachal Pradesh,Other Crimes,Drug Offense,Female,31-45,7933,1782,6151,5235,2698
2006,Urban,Haryana,Crime Against Women,Rape,Female,31-45,8643,2442,6201,6606,2037
2005,Urban,Meghalaya,Crime Against Men,Murder,Female,0-12,7904,7853,51,7874,30
2008,Rural,Odisha,Crime Against Men,Robbery,Female,18-30,900,287,613,524,376
2005,Rural,Madhya Pradesh,Crime Against Men,Assault,Female,18-30,9073,8758,315,8934,139
2005,Urban,Andhra Pradesh,Crime Against Children,Kidnapping,Male,46-60,6303,55,6248,2071,4232
2001,Urban,Telangana,Property Crime,Arson,Female,13-17,6797,2107,4690,5640,1157
2005,Rural,Mizoram,Other Crimes,Fraud,Female,13-17,5116,3252,1864,4580,536
2001,Rural,Jharkhand,Crime Against Women,Rape,Male,18-30,2121,908,1213,1828,293
2004,Rural,Jharkhand,Crime Against Children,Child Labor,Male,13-17,5891,46,5845,4096,1795
2001,Urban,Kerala,Crime Against Men,Assault,Female,46-60,3982,3077,905,3136,846
2008,Urban,Manipur,Crime Against Children,Child Abuse,Male,18-30,4058,3072,986,3744,314
2001,Rural,Punjab,Property Crime,Arson,Female,31-45,5537,3454,2083,5206,331
2006,Urban,Goa,Crime Against Women,Rape,Male,60+,9306,8703,603,8798,508
2006,Urban,Delhi,Crime Against Men,Extortion,Female,18-30,2884,1895,989,1960,924
2001,Urban,Karnataka,Property Crime,Burglary,Female,46-60,6691,2912,3779,4655,2036
2004,Urban,Meghalaya,Crime Against Children,Kidnapping,Male,13-17,7310,3665,3645,6435,875
2009,Rural,Jharkhand,Crime Against Children,Kidnapping,Female,13-17,3432,814,2618,1963,1469
2005,Rural,West Bengal,Crime Against Women,Molestation,Female,18-30,2993,2140,853,2835,158
2002,Rural,Jharkhand,Crime Against Women,Domestic Violence,Male,60+,6661,2886,3775,6177,484
2001,Rural,Maharashtra,Property Crime,Arson,Female,18-30,2082,904,1178,1012,1070
2007,Urban,Arunachal Pradesh,Crime Against Children,Kidnapping,Female,46-60,4769,2680,2089,2996,1773
2008,Rural,Assam,Other Crimes,Fraud,Male,60+,3079,247,2832,1215,1864
2009,Urban,Chhattisgarh,Other Crimes,Cyber Crime,Female,0-12,9771,4064,5707,5226,4545
2009,Rural,Delhi,Property Crime,Vandalism,Male,0-12,8373,5456,2917,5955,2418
2004,Rural,Jharkhand,Crime Against Men,Robbery,Female,0-12,788,769,19,781,7
2002,Urban,Goa,Crime Against Women,Dowry Deaths,Female,13-17,8941,5389,3552,6461,2480
2007,Urban,Himachal Pradesh,Crime Against Children,Trafficking,Female,18-30,3037,1837,1200,2264,773
2007,Rural,Karnataka,Crime Against Children,Child Abuse,Male,60+,8288,6525,1763,7080,1208
2005,Rural,Bihar,Crime Against Children,Trafficking,Female,0-12,5503,3719,1784,4627,876
2002,Rural,Mizoram,Property Crime,Arson,Male,46-60,5993,4516,1477,5432,561
2009,Urban,Gujarat,Crime Against Children,Kidnapping,Male,13-17,7394,5648,1746,6752,642
2005,Rural,Assam,Crime Against Women,Molestation,Female,46-60,1715,128,1587,756,959
2010,Rural,Rajasthan,Crime Against Men,Extortion,Female,60+,9640,8110,1530,9004,636
2005,Rural,West Bengal,Crime Against Women,Domestic Violence,Female,0-12,3359,2852,507,3093,266
2005,Rural,Kerala,Property Crime,Theft,Male,60+,882,304,578,836,46
2003,Urban,Odisha,Crime Against Women,Rape,Female,46-60,8278,7744,534,8181,97
2008,Rural,Assam,Property Crime,Burglary,Female,31-45,1065,300,765,420,645
2010,Urban,Goa,Crime Against Women,Molestation,Female,18-30,4451,270,4181,3959,492
2010,Rural,Goa,Property Crime,Burglary,Female,60+,3646,885,2761,1253,2393
2010,Urban,Tripura,Property Crime,Theft,Female,18-30,6914,1104,5810,3620,3294
2010,Urban,Andhra Pradesh,Crime Against Men,Murder,Male,13-17,5501,3462,2039,3580,1921
2009,Rural,Uttarakhand,Crime Against Men,Extortion,Male,13-17,7100,297,6803,6442,658
2003,Rural,Arunachal Pradesh,Property Crime,Theft,Male,13-17,7995,6446,1549,7441,554
2007,Urban,Andhra Pradesh,Crime Against Men,Extortion,Female,18-30,3298,90,3208,827,2471
2005,Rural,Gujarat,Crime Against Women,Domestic Violence,Male,0-12,7087,6023,1064,6337,750
2008,Urban,Goa,Crime Against Children,Trafficking,Male,0-12,7641,2160,5481,4333,3308
2004,Rural,Uttar Pradesh,Crime Against Men,Assault,Male,0-12,377,347,30,349,28
2007,Rural,Uttar Pradesh,Property Crime,Burglary,Male,13-17,9912,4223,5689,6904,3008
2008,Urban,Uttarakhand,Other Crimes,Fraud,Female,31-45,6644,5889,755,6382,262
2006,Urban,Uttarakhand,Crime Against Men,Robbery,Female,13-17,3816,1350,2466,3519,297
2008,Urban,Sikkim,Other Crimes,Fraud,Female,60+,3768,2742,1026,2958,810
2004,Rural,Andhra Pradesh,Crime Against Women,Domestic Violence,Male,60+,9711,5065,4646,6107,3604
2002,Urban,Haryana,Crime Against Children,Child Labor,Male,0-12,4886,1238,3648,3027,1859
2002,Rural,Meghalaya,Crime Against Children,Child Labor,Female,31-45,7859,2080,5779,2544,5315
2002,Rural,Kerala,Crime Against Women,Molestation,Female,0-12,9353,8005,1348,8181,1172
2006,Urban,Tamil Nadu,Property Crime,Burglary,Female,46-60,6972,87,6885,1440,5532
2002,Rural,Andhra Pradesh,Crime Against Men,Extortion,Male,13-17,1845,255,1590,1599,246
2005,Rural,Tamil Nadu,Crime Against Children,Child Abuse,Male,46-60,1199,678,521,921,278
2002,Urban,Tamil Nadu,Other Crimes,Cyber Crime,Male,31-45,7798,5117,2681,7217,581
2003,Urban,Maharashtra,Property Crime,Vandalism,Female,46-60,8988,7361,1627,7739,1249
2008,Urban,Chhattisgarh,Other Crimes,Corruption,Male,18-30,3298,404,2894,2246,1052
2001,Urban,Punjab,Crime Against Men,Murder,Male,18-30,4623,892,3731,3259,1364
2009,Rural,Karnataka,Crime Against Women,Rape,Male,60+,2818,970,1848,1952,866
2002,Rural,Manipur,Property Crime,Arson,Male,0-12,6172,525,5647,2264,3908
2009,Urban,Andhra Pradesh,Property Crime,Theft,Male,31-45,2608,1611,997,1952,656
2007,Rural,Goa,Property Crime,Theft,Male,31-45,3132,2868,264,2891,241
2005,Rural,West Bengal,Crime Against Men,Robbery,Male,18-30,5631,2545,3086,5226,405
2002,Urban,Bihar,Crime Against Children,Child Labor,Male,0-12,9028,5131,3897,6232,2796
2002,Rural,Uttar Pradesh,Property Crime,Theft,Male,13-17,416,185,231,285,131
2009,Urban,Uttar Pradesh,Crime Against Men,Assault,Male,0-12,805,292,513,414,391
2009,Rural,Telangana,Property Crime,Burglary,Female,13-17,2630,2156,474,2166,464
2003,Urban,Jammu & Kashmir,Other Crimes,Fraud,Female,31-45,2208,2086,122,2110,98
2002,Rural,Jammu & Kashmir,Crime Against Children,Kidnapping,Female,46-60,424,38,386,296,128
2004,Rural,Uttar Pradesh,Other Crimes,Cyber Crime,Male,60+,3118,683,2435,2874,244
2004,Rural,Uttarakhand,Crime Against Men,Murder,Female,46-60,8542,1582,6960,6867,1675
2009,Rural,Odisha,Crime Against Children,Child Abuse,Female,31-45,9891,5832,4059,7460,2431
2005,Rural,Odisha,Other Crimes,Fraud,Female,18-30,7585,6992,593,7131,454
2010,Urban,Jharkhand,Other Crimes,Cyber Crime,Male,60+,3706,2801,905,3056,650
2009,Rural,Punjab,Other Crimes,Corruption,Male,46-60,8931,8282,649,8779,152
2003,Urban,Assam,Crime Against Men,Murder,Female,60+,3426,3177,249,3361,65
2003,Rural,Sikkim,Crime Against Women,Molestation,Male,18-30,1003,825,178,893,110
2007,Rural,Madhya Pradesh,Crime Against Men,Murder,Female,0-12,3143,2529,614,2681,462
2010,Urban,Manipur,Other Crimes,Drug Offense,Male,31-45,6259,4962,1297,5418,841
2008,Rural,Rajasthan,Property Crime,Vandalism,Female,31-45,6720,103,6617,5768,952
2007,Urban,Goa,Other Crimes,Corruption,Female,13-17,4209,2601,1608,2986,1223
2010,Urban,West Bengal,Other Crimes,Fraud,Male,18-30,8723,3204,5519,4025,4698
2005,Urban,Odisha,Property Crime,Theft,Male,46-60,4624,1707,2917,2561,2063
2010,Rural,Nagaland,Crime Against Men,Murder,Male,0-12,7082,984,6098,6403,679
2001,Urban,Bihar,Property Crime,Vandalism,Male,46-60,9065,2310,6755,6364,2701
2006,Urban,Himachal Pradesh,Crime Against Men,Extortion,Male,31-45,4517,862,3655,2424,2093
2005,Rural,Uttarakhand,Crime Against Children,Child Labor,Male,46-60,8544,5269,3275,6532,2012
2003,Urban,Sikkim,Property Crime,Arson,Female,0-12,5904,1271,4633,5761,143
2002,Rural,Uttar Pradesh,Crime Against Children,Child Abuse,Male,0-12,6196,1264,4932,1323,4873
2003,Rural,Nagaland,Crime Against Children,Child Labor,Female,13-17,8951,2485,6466,3575,5376
2005,Rural,Uttar Pradesh,Crime Against Men,Assault,Female,60+,9051,6187,2864,6483,2568
2005,Rural,Maharashtra,Crime Against Men,Murder,Male,0-12,1213,473,740,737,476
2009,Rural,Andhra Pradesh,Crime Against Men,Assault,Male,46-60,953,152,801,240,713
2008,Rural,Arunachal Pradesh,Crime Against Women,Molestation,Male,0-12,3940,2247,1693,3557,383
2004,Rural,Nagaland,Crime Against Women,Molestation,Male,31-45,9935,9661,274,9814,121
2008,Urban,Assam,Other Crimes,Drug Offense,Female,60+,7410,1911,5499,3027,4383
2005,Urban,Gujarat,Other Crimes,Drug Offense,Female,13-17,1321,1303,18,1321,0
2002,Rural,Bihar,Crime Against Children,Child Abuse,Female,0-12,8993,5142,3851,8670,323
2008,Urban,Gujarat,Crime Against Women,Domestic Violence,Female,31-45,4295,2058,2237,2784,1511
2005,Rural,Tamil Nadu,Property Crime,Arson,Male,60+,8621,5676,2945,6482,2139
2002,Urban,Manipur,Other Crimes,Fraud,Female,60+,3783,2954,829,3542,241
2005,Urban,Uttar Pradesh,Crime Against Children,Child Abuse,Male,18-30,3041,310,2731,522,2519
2008,Rural,Gujarat,Crime Against Children,Child Abuse,Female,13-17,2481,1305,1176,2078,403
2008,Rural,Assam,Crime Against Men,Murder,Male,18-30,3606,2839,767,3408,198
2007,Urban,Sikkim,Other Crimes,Drug Offense,Male,0-12,6197,4952,1245,6079,118
2007,Urban,West Bengal,Crime Against Children,Kidnapping,Female,46-60,5997,2653,3344,5555,442
2007,Urban,Uttarakhand,Crime Against Children,Child Abuse,Female,18-30,5280,2661,2619,2729,2551
2001,Urban,Rajasthan,Crime Against Women,Molestation,Female,13-17,8775,8130,645,8242,533
2004,Rural,Odisha,Crime Against Children,Child Labor,Male,13-17,5006,1542,3464,1566,3440
2004,Urban,Punjab,Property Crime,Burglary,Male,46-60,3743,3408,335,3729,14
2009,Urban,Maharashtra,Crime Against Women,Molestation,Female,13-17,9008,1045,7963,3034,5974
2002,Rural,Jharkhand,Crime Against Women,Rape,Female,60+,6636,5500,1136,5728,908
2007,Urban,Odisha,Crime Against Children,Child Labor,Female,60+,3448,3398,50,3441,7
2010,Rural,Haryana,Other Crimes,Cyber Crime,Female,0-12,8955,302,8653,4364,4591
2002,Rural,Bihar,Crime Against Children,Kidnapping,Male,46-60,4107,1984,2123,3948,159
2004,Rural,Arunachal Pradesh,Crime Against Men,Extortion,Female,13-17,5986,4113,1873,5683,303
2010,Urban,West Bengal,Property Crime,Theft,Female,0-12,9875,5212,4663,6496,3379
2003,Rural,Andhra Pradesh,Crime Against Men,Extortion,Female,31-45,2046,159,1887,2031,15
2009,Rural,Tripura,Crime Against Children,Child Abuse,Female,13-17,980,60,920,565,415
2008,Urban,Odisha,Crime Against Women,Dowry Deaths,Female,31-45,5831,790,5041,4974,857
2002,Rural,Goa,Other Crimes,Drug Offense,Female,60+,6311,3608,2703,5417,894
2009,Rural,Tamil Nadu,Crime Against Women,Molestation,Male,60+,2295,331,1964,976,1319
2004,Urban,Telangana,Crime Against Women,Molestation,Female,13-17,3343,2742,601,3172,171
2003,Urban,Uttar Pradesh,Crime Against Women,Domestic Violence,Male,60+,8993,2794,6199,3478,5515
2006,Urban,Rajasthan,Other Crimes,Cyber Crime,Female,13-17,3518,534,2984,2525,993
2002,Urban,Odisha,Crime Against Children,Child Labor,Male,46-60,493,439,54,493,0
2003,Urban,Manipur,Crime Against Children,Kidnapping,Female,46-60,9394,5328,4066,7549,1845
2006,Rural,West Bengal,Crime Against Children,Child Labor,Female,60+,1011,983,28,1005,6
2006,Urban,Karnataka,Crime Against Women,Rape,Female,60+,1428,278,1150,923,505
2006,Urban,Gujarat,Crime Against Women,Molestation,Female,0-12,559,287,272,493,66
2001,Rural,Delhi,Crime Against Children,Child Labor,Female,46-60,1560,468,1092,683,877
2003,Urban,Tripura,Property Crime,Vandalism,Female,46-60,8016,4794,3222,5601,2415
2001,Urban,Odisha,Crime Against Women,Domestic Violence,Female,46-60,3650,2494,1156,3541,109
2010,Urban,Tripura,Property Crime,Arson,Male,0-12,7909,2729,5180,6754,1155
2006,Rural,Odisha,Other Crimes,Cyber Crime,Male,46-60,6664,3274,3390,6599,65
2009,Urban,Uttarakhand,Property Crime,Theft,Male,18-30,8053,1053,7000,3478,4575
2009,Rural,Nagaland,Crime Against Women,Rape,Male,31-45,8037,6384,1653,8033,4
2010,Rural,Nagaland,Crime Against Children,Trafficking,Male,60+,7171,6923,248,7009,162
2007,Urban,Gujarat,Crime Against Men,Extortion,Male,31-45,1764,1024,740,1155,609
2003,Urban,Telangana,Other Crimes,Drug Offense,Male,31-45,4238,3161,1077,3541,697
2006,Rural,Sikkim,Crime Against Men,Extortion,Male,60+,3949,987,2962,2553,1396
2001,Urban,Sikkim,Crime Against Women,Rape,Male,46-60,1276,236,1040,1113,163
2003,Rural,Bihar,Crime Against Children,Kidnapping,Male,18-30,2131,1702,429,2103,28
2008,Rural,Bihar,Crime Against Children,Child Labor,Male,60+,9873,4537,5336,5669,4204
2004,Urban,West Bengal,Property Crime,Arson,Female,31-45,8655,6143,2512,8287,368
2009,Rural,Punjab,Crime Against Women,Molestation,Female,31-45,2131,174,1957,1052,1079
2005,Urban,Uttar Pradesh,Property Crime,Theft,Male,0-12,9991,9677,314,9720,271
2001,Urban,Punjab,Property Crime,Theft,Male,13-17,3815,3559,256,3572,243
2007,Rural,Goa,Crime Against Children,Trafficking,Female,0-12,9491,6286,3205,8026,1465
2001,Rural,Jammu & Kashmir,Crime Against Children,Kidnapping,Male,13-17,3171,537,2634,886,2285
2003,Rural,Mizoram,Crime Against Men,Extortion,Male,18-30,1184,176,1008,628,556
2002,Urban,Kerala,Crime Against Women,Molestation,Female,13-17,4358,1590,2768,2598,1760
2008,Urban,Meghalaya,Other Crimes,Corruption,Female,13-17,3270,1927,1343,3232,38
2004,Urban,Telangana,Other Crimes,Fraud,Male,0-12,4101,2242,1859,2420,1681
2004,Urban,Uttar Pradesh,Other Crimes,Fraud,Male,31-45,3797,1892,1905,2883,914
2002,Rural,Gujarat,Crime Against Women,Molestation,Male,18-30,2681,2053,628,2562,119
2009,Urban,Nagaland,Crime Against Children,Child Abuse,Female,31-45,7709,6228,1481,6362,1347
2007,Rural,Gujarat,Property Crime,Burglary,Female,46-60,8960,2379,6581,6324,2636
2003,Rural,Haryana,Other Crimes,Drug Offense,Male,31-45,8630,6954,1676,7862,768
2004,Urban,Sikkim,Property Crime,Arson,Female,13-17,839,679,160,812,27
2003,Urban,West Bengal,Crime Against Men,Assault,Female,13-17,5793,1789,4004,1846,3947
2006,Rural,Assam,Property Crime,Vandalism,Male,31-45,729,322,407,331,398
2001,Urban,Goa,Other Crimes,Drug Offense,Male,13-17,5639,3084,2555,4511,1128
2006,Urban,Tripura,Other Crimes,Cyber Crime,Male,18-30,7598,5386,2212,7473,125
2008,Rural,Maharashtra,Crime Against Women,Molestation,Female,60+,9472,7154,2318,8002,1470
2003,Urban,Delhi,Crime Against Women,Dowry Deaths,Male,60+,4030,2172,1858,2706,1324
2003,Rural,Andhra Pradesh,Crime Against Women,Domestic Violence,Female,46-60,2521,416,2105,667,1854
2004,Rural,Assam,Property Crime,Theft,Male,31-45,5147,3203,1944,3913,1234
2003,Urban,Haryana,Crime Against Children,Trafficking,Male,31-45,7257,6973,284,7191,66
2009,Urban,Jammu & Kashmir,Crime Against Children,Child Labor,Male,60+,8829,6510,2319,7590,1239
2003,Rural,West Bengal,Property Crime,Theft,Female,18-30,2394,800,1594,948,1446
2009,Urban,Bihar,Crime Against Children,Child Abuse,Female,0-12,4902,4544,358,4707,195
2004,Urban,Tripura,Crime Against Children,Trafficking,Male,13-17,7665,5041,2624,6942,723
2004,Rural,Assam,Crime Against Men,Robbery,Male,46-60,4641,4420,221,4477,164
2002,Rural,Jharkhand,Property Crime,Burglary,Female,18-30,7125,4772,2353,5796,1329
2005,Urban,Kerala,Other Crimes,Corruption,Female,18-30,8414,494,7920,5599,2815
2005,Rural,Bihar,Crime Against Children,Kidnapping,Female,46-60,3835,3829,6,3835,0
2002,Rural,Jammu & Kashmir,Other Crimes,Drug Offense,Male,18-30,6296,2890,3406,3164,3132
2006,Rural,Meghalaya,Crime Against Men,Murder,Female,60+,493,97,396,277,216
2010,Urban,Assam,Property Crime,Vandalism,Male,0-12,4131,126,4005,2775,1356
2002,Rural,Himachal Pradesh,Crime Against Children,Trafficking,Male,18-30,9654,8564,1090,8794,860
2002,Urban,Karnataka,Crime Against Children,Kidnapping,Female,31-45,9154,2757,6397,7062,2092
2002,Rural,Uttarakhand,Other Crimes,Cyber Crime,Male,0-12,1356,795,561,886,470
2010,Rural,Punjab,Other Crimes,Drug Offense,Female,46-60,7561,4597,2964,7117,444
2003,Urban,Goa,Property Crime,Arson,Female,13-17,1397,739,658,1353,44
2003,Rural,West Bengal,Other Crimes,Drug Offense,Female,46-60,5156,1309,3847,2363,2793
2008,Urban,Maharashtra,Crime Against Women,Dowry Deaths,Male,13-17,2610,2063,547,2498,112
2007,Urban,Rajasthan,Other Crimes,Drug Offense,Female,18-30,5201,3045,2156,3690,1511
2008,Urban,Jharkhand,Property Crime,Arson,Female,13-17,3362,873,2489,3352,10
2005,Rural,Chhattisgarh,Crime Against Children,Child Labor,Male,60+,8044,5262,2782,5759,2285
2001,Urban,Assam,Crime Against Children,Kidnapping,Male,60+,9585,4090,5495,7605,1980
2003,Urban,Jammu & Kashmir,Crime Against Women,Dowry Deaths,Female,0-12,6639,3073,3566,5673,966
2005,Rural,Bihar,Other Crimes,Corruption,Male,31-45,7433,5655,1778,7147,286
2004,Rural,Haryana,Crime Against Women,Molestation,Male,31-45,8578,6079,2499,7024,1554
2007,Rural,Madhya Pradesh,Crime Against Women,Domestic Violence,Male,0-12,2943,569,2374,1011,1932
2008,Rural,Gujarat,Crime Against Women,Dowry Deaths,Male,18-30,4067,563,3504,1958,2109
2004,Rural,Odisha,Crime Against Men,Robbery,Male,46-60,8960,6146,2814,7760,1200
2007,Urban,Uttarakhand,Crime Against Women,Molestation,Male,0-12,2085,1992,93,2072,13
2007,Rural,Bihar,Crime Against Children,Child Labor,Female,31-45,6353,6291,62,6312,41
2005,Rural,Chhattisgarh,Property Crime,Arson,Male,31-45,7103,1744,5359,6861,242
2005,Urban,Kerala,Other Crimes,Corruption,Female,0-12,5575,546,5029,2177,3398
2001,Rural,Uttar Pradesh,Crime Against Children,Kidnapping,Male,60+,8417,1741,6676,3942,4475
2009,Rural,Assam,Crime Against Men,Assault,Female,18-30,250,35,215,179,71
2003,Rural,Meghalaya,Crime Against Women,Dowry Deaths,Female,13-17,4238,2402,1836,3222,1016
2008,Urban,Kerala,Crime Against Men,Extortion,Male,31-45,9151,330,8821,7579,1572
2010,Rural,Manipur,Property Crime,Arson,Female,31-45,1210,101,1109,702,508
2010,Urban,Arunachal Pradesh,Crime Against Children,Kidnapping,Male,0-12,892,381,511,845,47
2007,Urban,Himachal Pradesh,Crime Against Women,Dowry Deaths,Male,0-12,431,89,342,280,151
2006,Rural,Mizoram,Crime Against Men,Robbery,Female,13-17,1645,1628,17,1633,12
2001,Urban,Jammu & Kashmir,Crime Against Children,Child Labor,Male,13-17,552,12,540,272,280
2010,Urban,Punjab,Other Crimes,Fraud,Male,60+,832,216,616,440,392
2007,Rural,Gujarat,Property Crime,Vandalism,Female,60+,4357,1412,2945,1693,2664
2003,Rural,Gujarat,Other Crimes,Corruption,Male,0-12,9243,8593,650,9181,62
2003,Rural,Odisha,Crime Against Men,Extortion,Female,13-17,5416,1482,3934,4222,1194
2005,Urban,Assam,Crime Against Women,Domestic Violence,Male,0-12,4228,2946,1282,3663,565
2010,Rural,West Bengal,Property Crime,Vandalism,Female,46-60,8335,6619,1716,8306,29
2009,Urban,Gujarat,Crime Against Women,Rape,Female,60+,4682,1295,3387,4425,257
2007,Rural,Himachal Pradesh,Crime Against Women,Rape,Male,46-60,6861,6229,632,6391,470
2005,Rural,Telangana,Crime Against Children,Child Abuse,Male,31-45,8922,6724,2198,7550,1372
2008,Urban,Gujarat,Crime Against Children,Trafficking,Male,18-30,6436,1281,5155,3528,2908
2005,Urban,Tripura,Crime Against Men,Extortion,Female,0-12,5518,2123,3395,2572,2946
2005,Urban,Punjab,Crime Against Men,Extortion,Male,60+,9277,7980,1297,8871,406
2009,Rural,Maharashtra,Crime Against Men,Murder,Male,46-60,4186,2658,1528,3867,319
2009,Urban,Chhattisgarh,Property Crime,Arson,Male,60+,778,393,385,691,87
2002,Rural,Kerala,Property Crime,Theft,Male,60+,4591,3265,1326,3269,1322
2009,Rural,Chhattisgarh,Crime Against Men,Murder,Male,13-17,9976,8642,1334,8708,1268
2010,Rural,Jammu & Kashmir,Other Crimes,Fraud,Female,13-17,1458,580,878,833,625
2001,Rural,Tripura,Other Crimes,Corruption,Male,18-30,5859,814,5045,2790,3069
2007,Rural,Uttar Pradesh,Crime Against Children,Child Abuse,Male,60+,3769,2447,1322,3130,639
2008,Urban,Meghalaya,Other Crimes,Cyber Crime,Female,0-12,5922,2986,2936,4894,1028
2009,Rural,Telangana,Crime Against Men,Extortion,Male,0-12,9110,4923,4187,6049,3061
2010,Rural,Nagaland,Crime Against Children,Child Abuse,Male,60+,3757,1129,2628,2345,1412
2007,Rural,Andhra Pradesh,Property Crime,Burglary,Female,0-12,4807,974,3833,4417,390
2003,Urban,Mizoram,Crime Against Women,Molestation,Male,46-60,2465,1827,638,2206,259
2004,Urban,Nagaland,Crime Against Women,Dowry Deaths,Male,18-30,3337,1195,2142,2056,1281
2002,Urban,Assam,Property Crime,Burglary,Female,13-17,3640,1898,1742,2704,936
2002,Rural,Himachal Pradesh,Other Crimes,Corruption,Male,31-45,9278,4577,4701,6502,2776
2007,Urban,Maharashtra,Crime Against Men,Murder,Male,0-12,104,7,97,94,10
2001,Urban,Odisha,Crime Against Women,Domestic Violence,Male,31-45,1683,1229,454,1520,163
2003,Urban,Goa,Other Crimes,Drug Offense,Female,0-12,9088,8989,99,9010,78
2002,Rural,Madhya Pradesh,Crime Against Men,Murder,Male,31-45,9036,1605,7431,6119,2917
2001,Urban,Chhattisgarh,Property Crime,Burglary,Male,60+,2632,726,1906,1047,1585
2005,Urban,Madhya Pradesh,Other Crimes,Corruption,Female,18-30,1697,451,1246,854,843
2001,Rural,Haryana,Crime Against Children,Child Labor,Female,0-12,3097,296,2801,1958,1139
2007,Rural,Andhra Pradesh,Crime Against Children,Kidnapping,Male,46-60,9228,4762,4466,6370,2858
2003,Rural,Bihar,Other Crimes,Cyber Crime,Female,18-30,6951,4819,2132,5012,1939
2010,Rural,Himachal Pradesh,Property Crime,Burglary,Female,60+,7563,1877,5686,2140,5423
2002,Urban,Uttar Pradesh,Crime Against Women,Domestic Violence,Male,0-12,4446,1395,3051,2143,2303
2006,Urban,Maharashtra,Crime Against Men,Murder,Male,18-30,858,788,70,799,59
2006,Rural,Tripura,Crime Against Women,Molestation,Male,18-30,6267,5075,1192,5311,956
2010,Urban,Gujarat,Crime Against Children,Kidnapping,Female,46-60,1234,360,874,440,794
2009,Urban,Karnataka,Property Crime,Vandalism,Female,46-60,5533,4810,723,4836,697
2001,Rural,Andhra Pradesh,Crime Against Children,Child Labor,Female,46-60,4040,1784,2256,2517,1523
2008,Urban,Maharashtra,Other Crimes,Drug Offense,Female,31-45,2357,1379,978,1704,653
2004,Rural,Chhattisgarh,Crime Against Women,Rape,Male,13-17,9357,4603,4754,4694,4663
2001,Urban,Punjab,Property Crime,Burglary,Female,18-30,2403,1575,828,1948,455
2006,Rural,Himachal Pradesh,Property Crime,Arson,Male,18-30,4375,408,3967,3532,843
2009,Urban,Assam,Crime Against Children,Trafficking,Female,18-30,4780,1142,3638,3868,912
2001,Urban,Kerala,Crime Against Children,Child Abuse,Female,31-45,5325,1389,3936,5068,257
2009,Rural,Uttarakhand,Crime Against Women,Molestation,Female,0-12,6916,5657,1259,6788,128
2004,Urban,Jharkhand,Other Crimes,Fraud,Male,31-45,5094,412,4682,1652,3442
2005,Urban,Goa,Crime Against Men,Murder,Male,31-45,4549,2477,2072,4103,446
2004,Rural,Sikkim,Crime Against Children,Trafficking,Male,18-30,2946,1208,1738,1845,1101
2005,Urban,Madhya Pradesh,Property Crime,Theft,Male,13-17,1993,493,1500,1260,733
2004,Urban,Jammu & Kashmir,Crime Against Women,Molestation,Female,13-17,8140,7133,1007,7600,540
2003,Urban,Sikkim,Crime Against Women,Dowry Deaths,Male,18-30,2700,2289,411,2542,158
2003,Urban,Kerala,Crime Against Men,Robbery,Male,0-12,8261,6259,2002,6316,1945
2007,Urban,Maharashtra,Crime Against Women,Domestic Violence,Male,18-30,5046,4837,209,5009,37
2002,Urban,Assam,Crime Against Children,Trafficking,Male,0-12,4296,2030,2266,3945,351
2009,Urban,Delhi,Other Crimes,Fraud,Male,13-17,3438,2614,824,3306,132
2002,Rural,Mizoram,Crime Against Children,Child Labor,Male,18-30,8533,1609,6924,5344,3189
2010,Rural,Odisha,Crime Against Men,Extortion,Male,46-60,1818,9,1809,111,1707
2005,Rural,Maharashtra,Crime Against Children,Child Abuse,Male,18-30,7725,1182,6543,2264,5461
2009,Urban,Chhattisgarh,Crime Against Women,Dowry Deaths,Female,31-45,4409,3607,802,3784,625
2004,Urban,Assam,Property Crime,Burglary,Female,60+,7727,1084,6643,5193,2534
2003,Urban,Maharashtra,Crime Against Men,Murder,Female,13-17,4432,1576,2856,2078,2354
2005,Urban,Uttar Pradesh,Crime Against Women,Domestic Violence,Male,60+,6894,6112,782,6190,704
2008,Urban,Tripura,Crime Against Men,Murder,Male,18-30,6345,2995,3350,4714,1631
2005,Urban,Nagaland,Other Crimes,Corruption,Female,60+,8975,8746,229,8790,185
2004,Urban,Jharkhand,Crime Against Men,Assault,Female,60+,6359,5473,886,5474,885
2002,Rural,Madhya Pradesh,Other Crimes,Drug Offense,Male,31-45,2751,1294,1457,1438,1313
2002,Urban,Kerala,Property Crime,Arson,Female,18-30,6047,4791,1256,5135,912
2001,Rural,Jammu & Kashmir,Other Crimes,Cyber Crime,Male,18-30,7963,2689,5274,7879,84
2003,Rural,Madhya Pradesh,Crime Against Men,Extortion,Female,13-17,4648,2508,2140,2758,1890
2010,Rural,Tripura,Crime Against Children,Trafficking,Male,31-45,3926,1256,2670,2684,1242
2002,Urban,Punjab,Crime Against Children,Kidnapping,Female,31-45,705,180,525,674,31
2010,Rural,Delhi,Crime Against Women,Domestic Violence,Female,13-17,8177,7018,1159,7915,262
2006,Urban,Tamil Nadu,Crime Against Men,Murder,Female,31-45,2137,564,1573,1037,1100
2003,Urban,Jharkhand,Crime Against Children,Trafficking,Male,31-45,2655,234,2421,1229,1426
2001,Urban,Chhattisgarh,Property Crime,Theft,Male,60+,3826,1477,2349,2785,1041
2006,Urban,Tamil Nadu,Property Crime,Theft,Female,60+,3973,1891,2082,3971,2
2002,Rural,Madhya Pradesh,Crime Against Children,Kidnapping,Male,0-12,3594,590,3004,2188,1406
2004,Urban,Nagaland,Crime Against Men,Robbery,Female,0-12,5425,3742,1683,5181,244
2005,Urban,Gujarat,Crime Against Women,Dowry Deaths,Male,60+,7190,1566,5624,2613,4577
2002,Urban,Jammu & Kashmir,Crime Against Women,Domestic Violence,Female,13-17,6649,1457,5192,6063,586
2006,Urban,Jharkhand,Other Crimes,Drug Offense,Male,0-12,1648,136,1512,162,1486
2003,Urban,Sikkim,Other Crimes,Corruption,Male,46-60,9575,9556,19,9568,7
2004,Urban,Jharkhand,Crime Against Children,Child Abuse,Female,31-45,3045,1159,1886,1252,1793
2007,Urban,Odisha,Crime Against Women,Dowry Deaths,Female,13-17,3105,300,2805,1965,1140
2004,Rural,Chhattisgarh,Other Crimes,Cyber Crime,Female,18-30,5345,502,4843,4229,1116
2004,Urban,Uttar Pradesh,Crime Against Men,Murder,Female,60+,2711,2424,287,2446,265
2003,Urban,Meghalaya,Crime Against Women,Molestation,Male,0-12,9446,7009,2437,9035,411
2001,Rural,Andhra Pradesh,Crime Against Women,Molestation,Female,31-45,1551,1151,400,1208,343
2004,Rural,Chhattisgarh,Property Crime,Theft,Male,31-45,5408,3867,1541,4000,1408
2002,Urban,Rajasthan,Property Crime,Arson,Female,18-30,1034,256,778,938,96
2002,Urban,Punjab,Crime Against Men,Assault,Female,60+,805,102,703,607,198
2005,Rural,Chhattisgarh,Other Crimes,Fraud,Female,18-30,2368,1832,536,1882,486
2009,Urban,Rajasthan,Other Crimes,Corruption,Female,31-45,7954,6447,1507,6919,1035
2006,Rural,Uttarakhand,Other Crimes,Drug Offense,Male,31-45,8729,4701,4028,6760,1969
2001,Rural,Tripura,Crime Against Men,Robbery,Male,0-12,6104,2838,3266,5711,393
2004,Rural,Goa,Property Crime,Arson,Female,60+,4605,2184,2421,3288,1317
2004,Rural,Tripura,Crime Against Children,Trafficking,Male,31-45,985,465,520,520,465
2008,Urban,Assam,Crime Against Children,Kidnapping,Male,13-17,6353,4741,1612,5185,1168
2006,Urban,Telangana,Property Crime,Vandalism,Female,31-45,8786,1024,7762,5585,3201
2005,Urban,Sikkim,Crime Against Women,Rape,Male,13-17,1949,985,964,1161,788
2007,Rural,Maharashtra,Property Crime,Theft,Male,60+,9375,3840,5535,7090,2285
2001,Rural,Rajasthan,Crime Against Men,Robbery,Male,60+,6543,3954,2589,4894,1649
2003,Urban,Jammu & Kashmir,Crime Against Men,Robbery,Female,18-30,2908,1953,955,2401,507
2007,Rural,Goa,Crime Against Women,Dowry Deaths,Male,18-30,3025,234,2791,1041,1984
2004,Rural,Uttar Pradesh,Property Crime,Burglary,Female,0-12,1963,419,1544,457,1506
2005,Rural,Manipur,Property Crime,Burglary,Male,0-12,1512,1255,257,1273,239
2005,Urban,Tamil Nadu,Other Crimes,Drug Offense,Female,60+,9232,1141,8091,6781,2451
2003,Rural,Tripura,Crime Against Women,Domestic Violence,Male,60+,2369,2259,110,2276,93
2007,Urban,Gujarat,Crime Against Women,Molestation,Male,60+,7908,7073,835,7356,552
2007,Rural,Andhra Pradesh,Other Crimes,Corruption,Male,13-17,4829,1070,3759,4178,651
2002,Urban,Madhya Pradesh,Crime Against Men,Extortion,Female,60+,7083,1298,5785,3192,3891
2001,Urban,Rajasthan,Crime Against Children,Kidnapping,Female,0-12,3401,1258,2143,2756,645
2001,Rural,Odisha,Crime Against Children,Kidnapping,Male,13-17,6160,2291,3869,2691,3469
2009,Urban,Haryana,Property Crime,Theft,Male,18-30,8254,7647,607,7694,560
2003,Rural,Telangana,Crime Against Children,Kidnapping,Female,60+,8165,2026,6139,4206,3959
2005,Urban,Jammu & Kashmir,Property Crime,Vandalism,Male,18-30,7140,4644,2496,6643,497
2002,Rural,Meghalaya,Other Crimes,Cyber Crime,Female,18-30,7163,5685,1478,6573,590
2003,Urban,Nagaland,Property Crime,Arson,Female,13-17,8329,6315,2014,7364,965
2010,Rural,Assam,Crime Against Children,Trafficking,Male,18-30,151,54,97,120,31
2006,Rural,Nagaland,Crime Against Men,Extortion,Female,60+,6231,2798,3433,4831,1400
2009,Urban,Odisha,Crime Against Men,Extortion,Female,46-60,3232,911,2321,2477,755
2001,Urban,Mizoram,Other Crimes,Drug Offense,Female,31-45,1481,746,735,971,510
2009,Urban,Madhya Pradesh,Other Crimes,Cyber Crime,Female,60+,5137,1715,3422,4486,651
2009,Urban,Odisha,Crime Against Children,Trafficking,Male,60+,8103,6018,2085,7182,921
2009,Urban,Uttarakhand,Other Crimes,Drug Offense,Female,18-30,8814,3804,5010,4100,4714
2002,Rural,Karnataka,Other Crimes,Cyber Crime,Female,18-30,1167,614,553,888,279
2002,Rural,Bihar,Property Crime,Vandalism,Male,18-30,5840,1169,4671,4332,1508
2003,Urban,Sikkim,Crime Against Women,Dowry Deaths,Male,46-60,5591,3074,2517,4986,605
2002,Urban,Arunachal Pradesh,Crime Against Children,Kidnapping,Male,13-17,5197,2493,2704,4577,620
2007,Urban,Bihar,Crime Against Men,Assault,Male,46-60,1964,379,1585,713,1251
2007,Urban,Delhi,Crime Against Children,Trafficking,Male,46-60,3942,2476,1466,2740,1202
2003,Rural,Uttar Pradesh,Crime Against Women,Molestation,Female,46-60,8912,5701,3211,7057,1855
2005,Urban,Bihar,Property Crime,Burglary,Female,18-30,4526,3485,1041,3640,886
2010,Rural,Meghalaya,Property Crime,Vandalism,Male,60+,5707,2807,2900,4100,1607
2005,Urban,Maharashtra,Crime Against Women,Domestic Violence,Female,31-45,3158,1488,1670,1994,1164
2006,Rural,Meghalaya,Crime Against Men,Extortion,Male,18-30,2065,1740,325,1939,126
2003,Rural,Telangana,Crime Against Women,Domestic Violence,Male,60+,4209,2779,1430,3508,701
2001,Rural,Himachal Pradesh,Crime Against Children,Child Labor,Female,60+,1754,1372,382,1407,347
2002,Urban,Uttar Pradesh,Other Crimes,Drug Offense,Male,46-60,3358,2180,1178,2867,491
2008,Urban,Uttarakhand,Property Crime,Vandalism,Female,31-45,9361,8039,1322,8483,878
2008,Urban,Karnataka,Crime Against Women,Dowry Deaths,Female,13-17,4343,969,3374,2506,1837
2010,Rural,Andhra Pradesh,Crime Against Men,Assault,Male,18-30,8528,5573,2955,5728,2800
2009,Rural,Uttar Pradesh,Property Crime,Burglary,Male,0-12,8865,4931,3934,7635,1230
2006,Rural,Manipur,Other Crimes,Cyber Crime,Female,31-45,7135,530,6605,6571,564
2008,Rural,Tamil Nadu,Property Crime,Theft,Male,0-12,2848,2010,838,2671,177
2003,Urban,Tripura,Crime Against Women,Domestic Violence,Male,18-30,2439,717,1722,1005,1434
2009,Urban,Chhattisgarh,Crime Against Women,Domestic Violence,Female,60+,3989,1755,2234,2627,1362
2008,Urban,Goa,Other Crimes,Corruption,Female,0-12,4872,4025,847,4387,485
2006,Urban,Haryana,Crime Against Men,Extortion,Female,46-60,3402,1963,1439,2989,413
2003,Urban,Uttar Pradesh,Property Crime,Vandalism,Female,60+,9591,6845,2746,7160,2431
2002,Urban,Nagaland,Crime Against Women,Dowry Deaths,Female,60+,9112,1981,7131,8206,906
2003,Rural,Uttar Pradesh,Other Crimes,Corruption,Female,60+,8264,4379,3885,6904,1360
2003,Rural,Kerala,Crime Against Women,Molestation,Male,0-12,6552,2899,3653,4930,1622
2002,Urban,Delhi,Property Crime,Arson,Male,60+,453,227,226,375,78
2003,Urban,Punjab,Property Crime,Vandalism,Female,18-30,3292,1633,1659,3050,242
2004,Rural,Sikkim,Crime Against Women,Domestic Violence,Female,60+,9451,4074,5377,8773,678
2008,Rural,Assam,Crime Against Children,Child Abuse,Female,13-17,7063,6481,582,6680,383
2010,Urban,Gujarat,Crime Against Children,Child Abuse,Female,46-60,1418,153,1265,495,923
2006,Urban,Tripura,Crime Against Children,Child Labor,Male,46-60,6714,133,6581,3140,3574
2007,Rural,Haryana,Crime Against Children,Kidnapping,Female,31-45,6749,6720,29,6728,21
2001,Rural,Telangana,Crime Against Women,Rape,Male,31-45,9560,8848,712,9084,476
2003,Rural,Meghalaya,Crime Against Men,Extortion,Female,0-12,5178,4240,938,4839,339
2007,Urban,Jharkhand,Crime Against Men,Robbery,Male,60+,8266,2468,5798,7621,645
2007,Urban,Chhattisgarh,Other Crimes,Corruption,Male,0-12,8703,430,8273,1167,7536
2007,Rural,Tripura,Crime Against Women,Domestic Violence,Male,0-12,2229,1893,336,1965,264
2001,Rural,Odisha,Property Crime,Arson,Male,46-60,2301,291,2010,633,1668
2003,Rural,Maharashtra,Crime Against Children,Child Labor,Female,18-30,9071,7071,2000,8623,448
2004,Urban,Delhi,Property Crime,Vandalism,Male,46-60,1675,359,1316,379,1296
2010,Rural,Karnataka,Crime Against Women,Rape,Female,46-60,3775,1893,1882,2550,1225
2008,Rural,Madhya Pradesh,Crime Against Men,Assault,Male,13-17,8168,2276,5892,6624,1544
2001,Rural,Kerala,Property Crime,Vandalism,Female,18-30,5291,5226,65,5262,29
2009,Rural,Arunachal Pradesh,Crime Against Women,Rape,Female,13-17,2733,771,1962,1708,1025
2002,Urban,Sikkim,Crime Against Children,Child Labor,Male,31-45,6266,2413,3853,4659,1607
2008,Urban,Madhya Pradesh,Crime Against Women,Domestic Violence,Male,60+,1069,504,565,509,560
2010,Rural,Chhattisgarh,Crime Against Women,Molestation,Female,13-17,2211,1775,436,1947,264
2007,Urban,Bihar,Property Crime,Vandalism,Male,0-12,4213,1627,2586,1874,2339
2004,Urban,Uttar Pradesh,Crime Against Men,Murder,Female,13-17,7244,1384,5860,5566,1678
2009,Rural,Kerala,Other Crimes,Fraud,Female,46-60,3218,1595,1623,2521,697
2007,Rural,Chhattisgarh,Crime Against Women,Rape,Female,18-30,1389,175,1214,257,1132
2007,Urban,Telangana,Property Crime,Vandalism,Male,13-17,2274,1974,300,2155,119
2009,Rural,Jharkhand,Property Crime,Burglary,Female,60+,8692,4940,3752,5852,2840
2002,Rural,Odisha,Crime Against Women,Dowry Deaths,Male,0-12,6924,874,6050,5193,1731
2002,Rural,Bihar,Crime Against Men,Extortion,Female,0-12,3110,2001,1109,2829,281
2005,Urban,Punjab,Crime Against Men,Extortion,Male,18-30,8917,1176,7741,7870,1047
2006,Rural,Sikkim,Crime Against Men,Murder,Male,60+,8887,5293,3594,7294,1593
2002,Urban,Nagaland,Property Crime,Burglary,Male,31-45,9368,2620,6748,6275,3093
2008,Urban,Kerala,Crime Against Women,Molestation,Male,31-45,4286,1797,2489,3736,550
2008,Urban,Tamil Nadu,Crime Against Children,Child Abuse,Female,60+,4492,3121,1371,4262,230
2005,Urban,Jammu & Kashmir,Crime Against Women,Rape,Male,46-60,2831,774,2057,1163,1668
2003,Rural,Tripura,Property Crime,Burglary,Female,31-45,6747,5789,958,6170,577
2004,Urban,Jammu & Kashmir,Crime Against Women,Molestation,Female,13-17,281,58,223,99,182
2008,Rural,Nagaland,Property Crime,Theft,Male,0-12,9270,8147,1123,9256,14
2001,Urban,Chhattisgarh,Property Crime,Arson,Male,0-12,7174,1419,5755,4312,2862
2003,Urban,Nagaland,Property Crime,Theft,Male,46-60,2077,1106,971,1292,785
2010,Rural,Chhattisgarh,Crime Against Women,Dowry Deaths,Female,0-12,7569,3726,3843,4916,2653
2009,Rural,Rajasthan,Property Crime,Burglary,Male,18-30,9436,6201,3235,7942,1494
2003,Rural,Maharashtra,Crime Against Children,Child Labor,Female,13-17,882,805,77,805,77
2005,Urban,Punjab,Crime Against Children,Trafficking,Female,13-17,9228,3927,5301,8947,281
2010,Rural,Delhi,Other Crimes,Fraud,Male,46-60,778,776,2,778,0
2010,Urban,Goa,Crime Against Women,Rape,Male,60+,3633,1817,1816,1897,1736
2002,Urban,Karnataka,Other Crimes,Corruption,Male,46-60,6600,5263,1337,6238,362
2009,Rural,Goa,Crime Against Children,Trafficking,Female,0-12,4965,1817,3148,3668,1297
2002,Urban,Nagaland,Other Crimes,Corruption,Male,13-17,7175,2981,4194,4911,2264
2001,Urban,Delhi,Crime Against Men,Extortion,Female,46-60,7359,5767,1592,6195,1164
2002,Urban,Tamil Nadu,Crime Against Men,Murder,Female,18-30,8298,631,7667,1570,6728
2010,Rural,Telangana,Crime Against Women,Domestic Violence,Male,0-12,9114,3659,5455,7654,1460
2004,Rural,Tripura,Crime Against Children,Child Labor,Male,18-30,6400,570,5830,4716,1684
2010,Rural,Arunachal Pradesh,Crime Against Men,Robbery,Male,60+,4520,3409,1111,4463,57
2008,Urban,Madhya Pradesh,Crime Against Women,Domestic Violence,Female,13-17,4021,2625,1396,3992,29
2002,Rural,Mizoram,Crime Against Men,Robbery,Female,13-17,9371,4331,5040,6732,2639
2001,Rural,Andhra Pradesh,Crime Against Children,Trafficking,Male,31-45,6549,894,5655,6213,336
2003,Rural,Uttar Pradesh,Crime Against Men,Robbery,Male,18-30,1513,224,1289,613,900
2009,Urban,Tamil Nadu,Crime Against Men,Robbery,Female,13-17,4278,1012,3266,3989,289
2001,Rural,Tamil Nadu,Crime Against Children,Trafficking,Male,31-45,6578,3180,3398,6552,26
2006,Rural,Uttar Pradesh,Crime Against Men,Murder,Male,60+,3991,265,3726,3536,455
2005,Rural,Assam,Crime Against Men,Extortion,Female,60+,5127,2520,2607,3717,1410
2009,Urban,Maharashtra,Property Crime,Burglary,Male,60+,4069,2722,1347,3689,380
2004,Rural,Assam,Crime Against Children,Child Abuse,Female,18-30,7371,5952,1419,6288,1083
2002,Urban,Nagaland,Other Crimes,Corruption,Male,13-17,8297,3212,5085,3805,4492
2006,Rural,Uttar Pradesh,Crime Against Women,Rape,Male,31-45,2868,953,1915,1521,1347
2004,Rural,Tripura,Other Crimes,Fraud,Female,0-12,6032,5401,631,5425,607
2004,Rural,Kerala,Crime Against Men,Robbery,Male,46-60,4301,4090,211,4124,177
2002,Urban,Arunachal Pradesh,Crime Against Women,Domestic Violence,Female,46-60,7562,7041,521,7453,109
2001,Urban,Haryana,Crime Against Men,Assault,Male,0-12,5342,2563,2779,5291,51
2010,Urban,Jammu & Kashmir,Crime Against Women,Molestation,Male,60+,6738,6183,555,6686,52
2003,Rural,Madhya Pradesh,Crime Against Men,Murder,Female,18-30,6620,4375,2245,5780,840
2007,Urban,Rajasthan,Property Crime,Vandalism,Female,31-45,1067,173,894,966,101
2009,Rural,Tamil Nadu,Crime Against Men,Murder,Male,18-30,4305,2274,2031,3294,1011
2008,Urban,Meghalaya,Crime Against Women,Rape,Male,18-30,7485,1533,5952,5974,1511
2010,Urban,Gujarat,Crime Against Children,Child Labor,Male,46-60,5122,898,4224,3685,1437
2005,Urban,Karnataka,Crime Against Men,Assault,Male,46-60,6158,5671,487,5732,426
2002,Rural,Chhattisgarh,Crime Against Children,Trafficking,Male,60+,4158,3906,252,4098,60
2003,Rural,Punjab,Other Crimes,Drug Offense,Female,0-12,4500,120,4380,3477,1023
2001,Urban,Manipur,Crime Against Women,Rape,Male,13-17,3929,2558,1371,2728,1201
2002,Rural,Meghalaya,Crime Against Men,Robbery,Male,31-45,5748,665,5083,5077,671
2003,Rural,Andhra Pradesh,Property Crime,Vandalism,Male,18-30,3405,147,3258,1899,1506
2001,Rural,Uttarakhand,Crime Against Children,Trafficking,Female,60+,9779,732,9047,877,8902
2004,Rural,Goa,Crime Against Men,Extortion,Female,18-30,2225,102,2123,1963,262
2007,Rural,Sikkim,Crime Against Men,Murder,Female,60+,55,24,31,33,22
2003,Urban,Sikkim,Property Crime,Burglary,Male,31-45,8949,5258,3691,7296,1653
2001,Urban,Sikkim,Crime Against Men,Robbery,Female,31-45,922,748,174,824,98
2001,Rural,Telangana,Crime Against Men,Murder,Female,46-60,3582,1266,2316,2071,1511
2009,Rural,Karnataka,Crime Against Children,Trafficking,Male,60+,8374,5419,2955,6765,1609
2001,Rural,Jammu & Kashmir,Other Crimes,Fraud,Male,18-30,387,72,315,327,60
2003,Urban,Tripura,Other Crimes,Corruption,Male,13-17,2171,836,1335,2052,119
2008,Rural,Jammu & Kashmir,Crime Against Men,Assault,Male,0-12,7929,1123,6806,3099,4830
2007,Rural,Uttarakhand,Other Crimes,Cyber Crime,Female,31-45,7427,5052,2375,5879,1548
2002,Rural,Karnataka,Crime Against Women,Molestation,Female,46-60,7534,1788,5746,1934,5600
2004,Rural,Punjab,Crime Against Children,Child Abuse,Male,31-45,4651,3652,999,4103,548
2004,Rural,Madhya Pradesh,Crime Against Men,Robbery,Male,60+,4367,9,4358,1004,3363
2006,Urban,Rajasthan,Property Crime,Vandalism,Female,13-17,1482,643,839,835,647
2003,Rural,Telangana,Other Crimes,Corruption,Female,18-30,2732,1290,1442,1748,984
2001,Urban,Manipur,Crime Against Men,Murder,Female,46-60,2053,1505,548,1845,208
2005,Urban,Gujarat,Property Crime,Vandalism,Male,46-60,301,237,64,258,43
2001,Urban,Uttar Pradesh,Other Crimes,Drug Offense,Male,46-60,2303,875,1428,1178,1125
2001,Rural,Telangana,Other Crimes,Corruption,Female,46-60,9026,35,8991,7415,1611
2002,Rural,Haryana,Property Crime,Vandalism,Male,0-12,7646,1968,5678,5290,2356
2007,Urban,Bihar,Crime Against Men,Robbery,Male,46-60,534,373,161,381,153
2010,Rural,Gujarat,Crime Against Women,Molestation,Female,31-45,7031,911,6120,1813,5218
2006,Urban,Madhya Pradesh,Crime Against Men,Murder,Female,0-12,7540,2781,4759,7174,366
2002,Urban,Sikkim,Property Crime,Theft,Female,46-60,3711,2877,834,3218,493
2001,Urban,Uttarakhand,Crime Against Men,Assault,Male,13-17,4461,3586,875,4374,87
2002,Rural,Haryana,Other Crimes,Cyber Crime,Female,13-17,332,279,53,281,51
2007,Urban,Nagaland,Crime Against Women,Dowry Deaths,Female,31-45,9730,8044,1686,9714,16
2005,Urban,Maharashtra,Crime Against Women,Dowry Deaths,Female,18-30,8422,1881,6541,4533,3889
2003,Urban,Maharashtra,Crime Against Men,Murder,Male,13-17,7883,7068,815,7606,277
2010,Rural,West Bengal,Other Crimes,Drug Offense,Female,0-12,4299,1427,2872,2003,2296
2002,Urban,Uttar Pradesh,Crime Against Men,Robbery,Male,60+,1984,1695,289,1890,94
2006,Urban,Chhattisgarh,Crime Against Women,Domestic Violence,Male,60+,840,458,382,482,358
2001,Urban,Haryana,Property Crime,Arson,Male,60+,1554,1523,31,1546,8
2007,Rural,Nagaland,Crime Against Men,Robbery,Female,46-60,5540,2425,3115,3288,2252
2008,Rural,Karnataka,Other Crimes,Drug Offense,Male,18-30,5123,2092,3031,3863,1260
2007,Rural,Odisha,Other Crimes,Fraud,Male,46-60,304,105,199,189,115
2009,Rural,Kerala,Crime Against Women,Molestation,Male,13-17,9791,252,9539,1421,8370
2006,Urban,Haryana,Property Crime,Theft,Male,18-30,9381,7583,1798,8477,904
2006,Rural,Assam,Other Crimes,Corruption,Male,13-17,9808,8890,918,8922,886
2005,Rural,Bihar,Crime Against Men,Extortion,Male,18-30,5429,1590,3839,2760,2669
2007,Urban,Goa,Property Crime,Burglary,Male,13-17,9724,8408,1316,9670,54
2009,Rural,Goa,Property Crime,Theft,Female,31-45,7250,605,6645,6544,706
2003,Rural,Haryana,Crime Against Women,Domestic Violence,Female,46-60,5053,1608,3445,1928,3125
2008,Urban,Maharashtra,Crime Against Children,Child Labor,Female,31-45,3526,2233,1293,2763,763
2010,Urban,Rajasthan,Crime Against Men,Assault,Male,46-60,8582,145,8437,6782,1800
2008,Urban,Punjab,Property Crime,Vandalism,Female,60+,3973,2107,1866,3408,565
2005,Urban,Chhattisgarh,Crime Against Children,Kidnapping,Female,46-60,234,162,72,229,5
2001,Rural,Nagaland,Other Crimes,Cyber Crime,Female,18-30,9914,1550,8364,3513,6401
2001,Urban,Rajasthan,Crime Against Children,Trafficking,Male,18-30,4249,3438,811,3590,659
2001,Urban,Punjab,Crime Against Men,Extortion,Male,18-30,6502,2966,3536,4454,2048
2006,Rural,Himachal Pradesh,Crime Against Children,Child Labor,Male,13-17,6498,6154,344,6279,219
2004,Urban,Manipur,Crime Against Women,Molestation,Male,46-60,6754,5536,1218,5912,842
2007,Urban,Uttarakhand,Crime Against Men,Robbery,Female,31-45,8434,1992,6442,7806,628
2004,Rural,Manipur,Other Crimes,Fraud,Female,46-60,1900,730,1170,1623,277
2007,Urban,Odisha,Crime Against Children,Trafficking,Male,46-60,4116,2094,2022,2563,1553
2005,Urban,West Bengal,Other Crimes,Cyber Crime,Male,18-30,215,141,74,167,48
2010,Rural,Uttar Pradesh,Crime Against Men,Assault,Female,31-45,6341,4164,2177,6126,215
2002,Rural,Uttarakhand,Property Crime,Vandalism,Female,31-45,7868,4010,3858,7668,200
2007,Urban,Manipur,Crime Against Women,Dowry Deaths,Male,18-30,8748,1578,7170,5137,3611
2003,Rural,Sikkim,Crime Against Men,Extortion,Male,18-30,3641,936,2705,2361,1280
2003,Rural,Telangana,Crime Against Women,Domestic Violence,Male,60+,8499,6506,1993,7302,1197
2006,Rural,Delhi,Crime Against Men,Robbery,Female,0-12,7883,5078,2805,5455,2428
2007,Urban,Tamil Nadu,Crime Against Women,Dowry Deaths,Female,0-12,4258,508,3750,2609,1649
2001,Rural,Mizoram,Crime Against Women,Dowry Deaths,Female,31-45,8981,7764,1217,8965,16
2004,Rural,Jammu & Kashmir,Crime Against Women,Molestation,Female,46-60,7506,7055,451,7210,296
2004,Urban,Karnataka,Property Crime,Theft,Male,0-12,1183,1028,155,1156,27
2005,Urban,Assam,Property Crime,Burglary,Female,18-30,7558,1611,5947,2401,5157
2009,Rural,Tamil Nadu,Crime Against Children,Trafficking,Male,18-30,988,870,118,985,3
2010,Rural,Mizoram,Property Crime,Burglary,Female,46-60,1853,513,1340,1582,271
2004,Urban,Uttar Pradesh,Other Crimes,Drug Offense,Female,13-17,1789,403,1386,1156,633
2009,Urban,Manipur,Crime Against Children,Child Abuse,Male,31-45,2773,464,2309,1730,1043
2002,Rural,Kerala,Crime Against Women,Rape,Female,0-12,5178,2733,2445,3488,1690
2006,Rural,Tamil Nadu,Property Crime,Theft,Male,18-30,2320,1799,521,1814,506
2001,Urban,Tamil Nadu,Crime Against Children,Kidnapping,Female,0-12,5607,4628,979,5572,35
2001,Rural,Delhi,Other Crimes,Cyber Crime,Female,31-45,3778,14,3764,3222,556
2006,Rural,Mizoram,Property Crime,Arson,Male,31-45,6206,3226,2980,3824,2382
2008,Urban,Nagaland,Crime Against Men,Robbery,Male,31-45,6063,2373,3690,4935,1128
2010,Rural,Jharkhand,Other Crimes,Drug Offense,Male,31-45,7848,3523,4325,5181,2667
2001,Rural,Nagaland,Crime Against Women,Molestation,Male,18-30,6780,5534,1246,6483,297
2010,Rural,Haryana,Property Crime,Theft,Female,31-45,7879,6829,1050,7312,567
2005,Urban,Himachal Pradesh,Other Crimes,Corruption,Male,31-45,5767,3920,1847,5493,274
2006,Rural,Meghalaya,Crime Against Women,Dowry Deaths,Male,46-60,1951,515,1436,1052,899
2003,Rural,Himachal Pradesh,Property Crime,Burglary,Female,13-17,3332,3121,211,3175,157
2006,Rural,Jammu & Kashmir,Crime Against Children,Trafficking,Female,60+,9787,5277,4510,6833,2954
2010,Rural,Jammu & Kashmir,Property Crime,Vandalism,Female,18-30,1495,24,1471,1286,209
2009,Urban,Meghalaya,Crime Against Children,Kidnapping,Female,13-17,9147,2666,6481,4168,4979
2006,Rural,Sikkim,Crime Against Children,Child Abuse,Male,13-17,1035,946,89,1005,30
2006,Rural,Haryana,Crime Against Women,Domestic Violence,Female,0-12,2523,648,1875,1876,647
2008,Urban,Kerala,Crime Against Women,Domestic Violence,Female,31-45,584,315,269,324,260
2006,Rural,Telangana,Crime Against Men,Extortion,Female,46-60,9147,4967,4180,5447,3700
2001,Rural,Sikkim,Other Crimes,Drug Offense,Male,31-45,2068,216,1852,1826,242
2009,Rural,Jammu & Kashmir,Crime Against Women,Domestic Violence,Female,0-12,3762,2371,1391,3236,526
2008,Urban,Telangana,Crime Against Children,Child Abuse,Male,60+,89,76,13,77,12
2008,Rural,Sikkim,Crime Against Women,Rape,Female,46-60,2095,1284,811,1977,118
2004,Urban,Arunachal Pradesh,Crime Against Children,Child Abuse,Female,13-17,3985,2518,1467,3308,677
2006,Urban,Haryana,Crime Against Children,Child Labor,Female,60+,7807,1658,6149,6733,1074
2005,Urban,Himachal Pradesh,Property Crime,Vandalism,Male,31-45,925,605,320,660,265
2006,Urban,Rajasthan,Crime Against Men,Robbery,Male,31-45,7861,2238,5623,3011,4850
2008,Urban,Rajasthan,Other Crimes,Drug Offense,Female,31-45,7874,6200,1674,7485,389
2009,Urban,Mizoram,Crime Against Children,Kidnapping,Male,31-45,6256,3682,2574,5219,1037
2008,Rural,Chhattisgarh,Crime Against Women,Dowry Deaths,Male,31-45,4797,4212,585,4713,84
2010,Rural,Himachal Pradesh,Crime Against Men,Extortion,Female,0-12,1333,1075,258,1202,131
2003,Rural,Punjab,Other Crimes,Corruption,Male,18-30,2311,1146,1165,1683,628
2006,Rural,Assam,Crime Against Children,Kidnapping,Male,18-30,7720,6985,735,7569,151
2005,Urban,Karnataka,Property Crime,Burglary,Female,60+,450,109,341,186,264
2003,Urban,Jammu & Kashmir,Property Crime,Arson,Male,31-45,3632,1508,2124,2073,1559
2001,Rural,Nagaland,Crime Against Women,Rape,Female,46-60,2187,104,2083,1314,873
2001,Urban,Madhya Pradesh,Crime Against Men,Murder,Male,18-30,4696,1866,2830,4498,198
2009,Rural,Uttarakhand,Other Crimes,Fraud,Male,13-17,1428,1403,25,1413,15
2001,Rural,Delhi,Crime Against Men,Extortion,Male,31-45,969,550,419,910,59
2002,Rural,Sikkim,Crime Against Children,Trafficking,Male,46-60,7422,2689,4733,6213,1209
2002,Rural,Punjab,Property Crime,Arson,Male,60+,6957,6061,896,6511,446
2008,Urban,Meghalaya,Crime Against Children,Child Abuse,Female,18-30,9612,6058,3554,7789,1823
2005,Rural,Gujarat,Crime Against Men,Robbery,Male,18-30,3007,1060,1947,2210,797
2006,Urban,Goa,Crime Against Women,Rape,Male,18-30,1747,384,1363,708,1039
2001,Rural,Chhattisgarh,Crime Against Men,Assault,Male,46-60,9262,5633,3629,7180,2082
2004,Urban,Telangana,Crime Against Women,Dowry Deaths,Male,60+,8789,6429,2360,8022,767
2002,Urban,Gujarat,Crime Against Children,Trafficking,Female,60+,6656,6021,635,6533,123
2009,Rural,Meghalaya,Crime Against Men,Extortion,Female,31-45,3947,3907,40,3944,3
2005,Rural,Manipur,Crime Against Women,Dowry Deaths,Male,18-30,9607,2155,7452,8183,1424
2007,Urban,Jammu & Kashmir,Crime Against Women,Molestation,Male,13-17,7766,186,7580,5922,1844
2004,Rural,Delhi,Other Crimes,Fraud,Female,0-12,4058,96,3962,885,3173
2001,Rural,Jharkhand,Crime Against Children,Child Abuse,Female,31-45,8866,2062,6804,2398,6468
2004,Rural,Uttar Pradesh,Crime Against Women,Molestation,Male,13-17,8486,3097,5389,3607,4879
2009,Rural,Telangana,Crime Against Men,Robbery,Male,46-60,378,221,157,321,57
2001,Rural,Tripura,Crime Against Women,Domestic Violence,Female,0-12,4021,950,3071,2439,1582
2002,Urban,Karnataka,Other Crimes,Drug Offense,Male,46-60,368,117,251,349,19
2003,Urban,Delhi,Other Crimes,Cyber Crime,Female,60+,1236,1039,197,1187,49
2006,Urban,Goa,Crime Against Men,Robbery,Male,13-17,2210,759,1451,2149,61
2006,Rural,Jharkhand,Crime Against Women,Domestic Violence,Male,13-17,5447,4032,1415,4117,1330
2009,Urban,Jharkhand,Other Crimes,Fraud,Female,13-17,9682,5987,3695,8413,1269
2010,Urban,Arunachal Pradesh,Crime Against Men,Extortion,Male,60+,3900,1067,2833,3180,720
2009,Urban,Odisha,Other Crimes,Corruption,Male,60+,5938,2991,2947,4299,1639
2010,Rural,Telangana,Property Crime,Arson,Male,60+,6918,1321,5597,4828,2090
2004,Urban,Uttarakhand,Crime Against Men,Robbery,Male,13-17,7883,1863,6020,4297,3586
2007,Rural,Delhi,Crime Against Men,Extortion,Male,46-60,9903,8672,1231,9821,82
2004,Urban,Uttarakhand,Crime Against Men,Robbery,Male,0-12,5776,1906,3870,4350,1426
2001,Urban,Gujarat,Crime Against Women,Domestic Violence,Male,13-17,2173,1175,998,1858,315
2010,Rural,Mizoram,Crime Against Children,Trafficking,Male,0-12,4355,4354,1,4354,1
2009,Rural,Tamil Nadu,Crime Against Women,Dowry Deaths,Male,60+,871,853,18,863,8
2006,Urban,Delhi,Property Crime,Burglary,Female,18-30,7168,4326,2842,5629,1539
2007,Urban,Arunachal Pradesh,Other Crimes,Fraud,Female,13-17,6509,5905,604,6150,359
2002,Rural,Haryana,Other Crimes,Cyber Crime,Female,18-30,9898,9709,189,9755,143
2005,Rural,Jammu & Kashmir,Crime Against Women,Molestation,Female,46-60,3054,2704,350,2948,106
2001,Rural,Gujarat,Property Crime,Theft,Female,13-17,3852,3850,2,3851,1
2008,Urban,Tripura,Property Crime,Theft,Male,13-17,9014,6933,2081,8998,16
2007,Rural,Gujarat,Crime Against Children,Child Labor,Female,13-17,6928,5594,1334,6528,400
2006,Rural,Meghalaya,Property Crime,Burglary,Female,46-60,3689,1410,2279,2201,1488
2003,Rural,Tamil Nadu,Other Crimes,Corruption,Female,0-12,2537,412,2125,2263,274
2008,Rural,Mizoram,Crime Against Women,Molestation,Male,31-45,891,320,571,755,136
2007,Urban,Manipur,Property Crime,Vandalism,Male,31-45,4166,3731,435,3766,400
2010,Urban,Kerala,Crime Against Women,Molestation,Male,18-30,9005,7703,1302,8425,580
2006,Rural,Himachal Pradesh,Crime Against Women,Domestic Violence,Female,13-17,7867,4700,3167,6273,1594
2007,Rural,Arunachal Pradesh,Crime Against Women,Dowry Deaths,Female,46-60,3513,46,3467,518,2995
2001,Rural,Telangana,Crime Against Children,Child Abuse,Female,46-60,8708,5831,2877,7827,881
2004,Rural,Himachal Pradesh,Property Crime,Vandalism,Male,46-60,1117,948,169,1065,52
2001,Urban,Meghalaya,Property Crime,Theft,Female,18-30,9309,472,8837,7975,1334
2006,Rural,Kerala,Other Crimes,Fraud,Male,46-60,6464,273,6191,3144,3320
2005,Urban,Tamil Nadu,Property Crime,Burglary,Female,31-45,1062,923,139,983,79
2001,Rural,Assam,Crime Against Women,Rape,Male,60+,5276,4309,967,4986,290
2009,Urban,Tamil Nadu,Property Crime,Theft,Female,0-12,4548,1507,3041,2035,2513
2008,Urban,Haryana,Crime Against Men,Murder,Male,31-45,5318,3678,1640,4966,352
2010,Rural,Odisha,Crime Against Women,Dowry Deaths,Female,60+,3792,137,3655,1003,2789
2004,Urban,Jharkhand,Other Crimes,Cyber Crime,Male,18-30,6111,3991,2120,4000,2111
2010,Rural,Odisha,Other Crimes,Fraud,Female,31-45,9141,8936,205,9018,123
2003,Urban,Rajasthan,Crime Against Children,Trafficking,Female,0-12,2212,897,1315,2126,86
2008,Urban,Jharkhand,Crime Against Women,Dowry Deaths,Female,18-30,1186,503,683,786,400
2001,Urban,Madhya Pradesh,Crime Against Children,Kidnapping,Male,18-30,7371,5711,1660,6266,1105
2002,Rural,Goa,Property Crime,Vandalism,Male,46-60,1397,670,727,1246,151
2010,Rural,Manipur,Other Crimes,Cyber Crime,Female,18-30,2458,1402,1056,2227,231
2005,Urban,Rajasthan,Crime Against Children,Child Abuse,Female,46-60,4761,3494,1267,3911,850
2004,Rural,Uttar Pradesh,Crime Against Children,Trafficking,Male,31-45,6904,2621,4283,6095,809
2007,Rural,Bihar,Crime Against Women,Rape,Male,0-12,4951,1536,3415,2017,2934
2008,Rural,Haryana,Property Crime,Arson,Male,31-45,3026,2377,649,2846,180
2010,Urban,Tripura,Crime Against Women,Rape,Female,18-30,5804,3765,2039,5534,270
2004,Urban,Haryana,Other Crimes,Corruption,Male,0-12,4979,4893,86,4915,64
2010,Rural,Assam,Crime Against Children,Child Abuse,Male,0-12,9622,9622,0,9622,0
2004,Rural,Arunachal Pradesh,Other Crimes,Cyber Crime,Male,13-17,2338,191,2147,1742,596
2006,Urban,Assam,Other Crimes,Corruption,Male,46-60,2664,2452,212,2469,195
2002,Rural,Maharashtra,Property Crime,Arson,Female,18-30,9641,2776,6865,3015,6626
2002,Rural,Meghalaya,Crime Against Men,Assault,Male,18-30,6887,898,5989,2313,4574
2004,Urban,Bihar,Crime Against Men,Murder,Female,60+,5661,4352,1309,5562,99
2003,Rural,Haryana,Property Crime,Burglary,Male,0-12,9275,1789,7486,6488,2787
2009,Rural,Bihar,Crime Against Women,Molestation,Female,18-30,5253,2515,2738,3139,2114
2002,Urban,Madhya Pradesh,Crime Against Men,Robbery,Male,13-17,1624,1474,150,1543,81
2010,Urban,Mizoram,Property Crime,Arson,Female,0-12,820,575,245,781,39
2001,Urban,Himachal Pradesh,Property Crime,Arson,Female,46-60,2942,1115,1827,2341,601
2009,Rural,Delhi,Crime Against Women,Dowry Deaths,Male,46-60,9266,2739,6527,3203,6063
2004,Rural,Gujarat,Crime Against Men,Assault,Female,46-60,6375,3015,3360,3440,2935
2001,Rural,Goa,Other Crimes,Fraud,Female,60+,2468,2139,329,2181,287
2010,Rural,Delhi,Other Crimes,Corruption,Female,46-60,6760,4289,2471,5095,1665
2003,Rural,Himachal Pradesh,Property Crime,Burglary,Female,60+,4008,597,3411,1837,2171
2008,Urban,Delhi,Crime Against Men,Extortion,Male,60+,8091,7822,269,8049,42
2003,Rural,Andhra Pradesh,Crime Against Children,Kidnapping,Male,0-12,1063,0,1063,392,671
2008,Urban,Gujarat,Other Crimes,Corruption,Male,31-45,6475,4361,2114,4509,1966
2004,Rural,Jharkhand,Other Crimes,Drug Offense,Female,0-12,3799,1572,2227,3763,36
2004,Rural,Madhya Pradesh,Crime Against Children,Child Labor,Female,0-12,3528,2224,1304,3488,40
2010,Urban,Nagaland,Crime Against Men,Assault,Female,0-12,5823,737,5086,3746,2077
2003,Urban,Delhi,Crime Against Women,Domestic Violence,Female,0-12,5233,1410,3823,3510,1723
2002,Rural,Maharashtra,Crime Against Children,Child Labor,Male,13-17,2055,753,1302,1799,256
2007,Urban,Haryana,Crime Against Men,Assault,Male,18-30,1529,1287,242,1370,159
2009,Rural,Odisha,Crime Against Children,Trafficking,Male,60+,8782,4846,3936,5087,3695
2003,Rural,Rajasthan,Other Crimes,Drug Offense,Female,46-60,1115,81,1034,564,551
2003,Urban,Rajasthan,Crime Against Children,Child Abuse,Male,13-17,4927,3824,1103,3857,1070
2010,Urban,Maharashtra,Crime Against Men,Extortion,Female,18-30,1234,367,867,935,299
2007,Urban,Maharashtra,Other Crimes,Fraud,Male,46-60,994,547,447,665,329
2010,Rural,Rajasthan,Other Crimes,Cyber Crime,Male,31-45,8670,4384,4286,6225,2445
2010,Rural,Andhra Pradesh,Crime Against Men,Murder,Female,18-30,6248,4736,1512,6052,196
2004,Urban,Tamil Nadu,Other Crimes,Cyber Crime,Male,31-45,3041,1269,1772,2379,662
2008,Urban,Karnataka,Other Crimes,Drug Offense,Female,18-30,8141,5974,2167,6363,1778
2003,Rural,Himachal Pradesh,Crime Against Children,Child Labor,Male,0-12,1816,310,1506,1179,637
2004,Urban,Delhi,Crime Against Children,Child Abuse,Male,18-30,3955,2544,1411,3593,362
2006,Urban,Assam,Crime Against Children,Trafficking,Male,31-45,4705,4188,517,4430,275
2007,Rural,Chhattisgarh,Crime Against Children,Child Abuse,Male,60+,2738,1575,1163,1828,910
2002,Rural,Arunachal Pradesh,Crime Against Men,Extortion,Male,13-17,1342,1157,185,1205,137
2002,Urban,Kerala,Property Crime,Burglary,Male,60+,1847,876,971,1344,503
2002,Rural,Chhattisgarh,Property Crime,Arson,Male,31-45,9636,7182,2454,9334,302
2006,Rural,Rajasthan,Crime Against Men,Murder,Male,0-12,9217,2271,6946,8909,308
2008,Urban,Jammu & Kashmir,Property Crime,Vandalism,Male,31-45,3451,2314,1137,2952,499
2006,Rural,Uttarakhand,Other Crimes,Drug Offense,Male,13-17,7501,7029,472,7395,106
2003,Urban,Uttarakhand,Other Crimes,Fraud,Female,18-30,9443,5384,4059,9442,1
2001,Rural,Manipur,Crime Against Men,Murder,Female,31-45,5439,3030,2409,3279,2160
2009,Rural,Goa,Crime Against Men,Extortion,Female,18-30,6998,1666,5332,1955,5043
2009,Urban,Jammu & Kashmir,Other Crimes,Drug Offense,Female,60+,9251,8095,1156,8884,367
2005,Urban,Andhra Pradesh,Crime Against Men,Extortion,Male,13-17,3956,3121,835,3316,640
2005,Rural,West Bengal,Property Crime,Burglary,Male,60+,6067,4574,1493,4792,1275
2008,Rural,Meghalaya,Other Crimes,Corruption,Male,13-17,7232,3010,4222,4075,3157
2010,Urban,Tripura,Crime Against Children,Child Labor,Female,18-30,294,114,180,132,162
2004,Rural,Odisha,Crime Against Women,Rape,Male,31-45,5516,4217,1299,5468,48
2009,Rural,Punjab,Property Crime,Theft,Female,0-12,7102,791,6311,5220,1882
2005,Urban,Delhi,Crime Against Men,Murder,Female,0-12,7459,3291,4168,6616,843
2002,Urban,Himachal Pradesh,Property Crime,Arson,Female,60+,1411,850,561,1396,15
2004,Rural,Bihar,Crime Against Children,Trafficking,Male,13-17,7366,857,6509,3863,3503
2007,Rural,Uttar Pradesh,Other Crimes,Corruption,Male,13-17,9376,591,8785,5544,3832
2005,Urban,Uttarakhand,Crime Against Men,Assault,Male,60+,6723,4537,2186,5240,1483
2002,Rural,Maharashtra,Crime Against Children,Kidnapping,Female,13-17,440,274,166,433,7
2010,Urban,Sikkim,Crime Against Women,Domestic Violence,Male,31-45,7474,1750,5724,4944,2530
2006,Urban,Tamil Nadu,Crime Against Women,Dowry Deaths,Male,13-17,9152,4365,4787,8924,228
2004,Urban,Nagaland,Crime Against Children,Child Labor,Female,60+,7651,642,7009,6915,736
2006,Rural,Meghalaya,Property Crime,Vandalism,Female,13-17,9733,4226,5507,7080,2653
2008,Rural,Jammu & Kashmir,Other Crimes,Drug Offense,Female,18-30,5042,3281,1761,4496,546
2010,Rural,Punjab,Crime Against Women,Rape,Female,13-17,5366,919,4447,3719,1647
2010,Urban,Delhi,Crime Against Men,Robbery,Female,46-60,6402,303,6099,433,5969
2009,Rural,Uttar Pradesh,Crime Against Men,Assault,Female,0-12,4862,1401,3461,2864,1998
2001,Rural,Uttar Pradesh,Crime Against Men,Assault,Male,31-45,9027,5673,3354,5879,3148
2007,Rural,Meghalaya,Other Crimes,Fraud,Female,46-60,2621,2219,402,2452,169
2003,Urban,Uttar Pradesh,Crime Against Women,Rape,Female,60+,2147,1428,719,2058,89
2010,Rural,Meghalaya,Property Crime,Arson,Female,13-17,6871,3566,3305,5326,1545
2003,Urban,Karnataka,Crime Against Children,Trafficking,Male,0-12,9417,753,8664,7676,1741
2009,Rural,Karnataka,Property Crime,Burglary,Male,18-30,7668,919,6749,1877,5791
2001,Urban,Goa,Crime Against Children,Kidnapping,Male,13-17,1334,917,417,1314,20
2005,Urban,Bihar,Crime Against Children,Trafficking,Female,60+,3443,862,2581,1397,2046
2007,Rural,Andhra Pradesh,Property Crime,Burglary,Male,13-17,538,62,476,189,349
2001,Rural,Mizoram,Other Crimes,Fraud,Female,31-45,1513,701,812,1475,38
2006,Urban,Sikkim,Crime Against Women,Rape,Female,60+,9457,6634,2823,9322,135
2005,Urban,Chhattisgarh,Crime Against Men,Assault,Male,31-45,8727,4000,4727,6694,2033
2008,Rural,Meghalaya,Crime Against Men,Extortion,Female,60+,667,330,337,529,138
2004,Urban,Andhra Pradesh,Crime Against Men,Assault,Female,60+,3506,3218,288,3226,280
2005,Rural,Mizoram,Property Crime,Arson,Male,13-17,194,125,69,135,59
2006,Rural,Nagaland,Property Crime,Theft,Female,31-45,3591,95,3496,2183,1408
2007,Rural,Uttarakhand,Other Crimes,Cyber Crime,Female,31-45,3803,2101,1702,2252,1551
2010,Rural,Manipur,Property Crime,Vandalism,Female,0-12,7894,2717,5177,3007,4887
2010,Rural,Kerala,Crime Against Men,Robbery,Female,31-45,1970,1398,572,1903,67
2006,Urban,Jammu & Kashmir,Property Crime,Theft,Male,0-12,9792,1402,8390,4577,5215
2002,Rural,Goa,Crime Against Children,Kidnapping,Female,60+,6169,2508,3661,2533,3636
2003,Urban,Andhra Pradesh,Crime Against Women,Dowry Deaths,Female,13-17,6248,738,5510,3430,2818
2010,Urban,Karnataka,Other Crimes,Corruption,Female,13-17,7644,4160,3484,6478,1166
2002,Rural,Madhya Pradesh,Other Crimes,Corruption,Male,0-12,1096,645,451,851,245
2003,Urban,Assam,Property Crime,Burglary,Male,46-60,8229,7304,925,7454,775
2006,Rural,Haryana,Other Crimes,Drug Offense,Male,31-45,7522,1379,6143,3674,3848
2010,Urban,Uttarakhand,Other Crimes,Cyber Crime,Male,0-12,9739,2007,7732,7569,2170
2008,Urban,Punjab,Crime Against Women,Molestation,Female,46-60,1853,1449,404,1533,320
2006,Rural,Chhattisgarh,Crime Against Men,Murder,Male,46-60,9925,9081,844,9824,101
2008,Urban,Jammu & Kashmir,Property Crime,Arson,Male,60+,6569,6266,303,6422,147
2002,Urban,Sikkim,Crime Against Children,Kidnapping,Female,0-12,8573,2367,6206,5661,2912
2010,Urban,Bihar,Property Crime,Burglary,Male,13-17,4221,583,3638,1886,2335
2003,Urban,Telangana,Crime Against Children,Child Abuse,Female,13-17,879,116,763,399,480
2008,Rural,Punjab,Crime Against Men,Robbery,Male,0-12,7239,1436,5803,3820,3419
2006,Urban,Gujarat,Crime Against Men,Robbery,Male,60+,5836,775,5061,3368,2468
2002,Urban,Odisha,Other Crimes,Fraud,Male,18-30,6955,5906,1049,6908,47
2005,Rural,Assam,Crime Against Women,Molestation,Female,60+,9995,8464,1531,8617,1378
2003,Rural,Uttarakhand,Property Crime,Burglary,Male,60+,1850,657,1193,1061,789
2002,Urban,Andhra Pradesh,Crime Against Women,Dowry Deaths,Male,46-60,6843,1252,5591,2527,4316
2010,Urban,Maharashtra,Crime Against Men,Extortion,Male,18-30,216,150,66,179,37
2008,Urban,Punjab,Crime Against Men,Robbery,Female,18-30,1771,611,1160,1156,615
2009,Urban,Haryana,Other Crimes,Cyber Crime,Male,46-60,8101,6533,1568,7286,815
2008,Rural,Mizoram,Crime Against Women,Dowry Deaths,Female,31-45,3958,1483,2475,2180,1778
2007,Rural,Uttarakhand,Other Crimes,Drug Offense,Female,46-60,3357,2931,426,3052,305
2002,Rural,Himachal Pradesh,Crime Against Men,Extortion,Male,0-12,706,154,552,468,238
2004,Rural,Mizoram,Crime Against Women,Molestation,Male,46-60,7894,5719,2175,7046,848
2002,Rural,Kerala,Crime Against Children,Trafficking,Male,18-30,2255,248,2007,1122,1133
2003,Rural,Jharkhand,Crime Against Women,Molestation,Male,18-30,3643,1862,1781,3060,583
2007,Rural,Assam,Property Crime,Arson,Male,31-45,3559,713,2846,1232,2327
2005,Urban,Telangana,Crime Against Men,Robbery,Male,60+,6053,5460,593,6023,30
2010,Urban,Uttar Pradesh,Crime Against Women,Dowry Deaths,Female,31-45,3234,1023,2211,1114,2120
2001,Rural,Goa,Other Crimes,Cyber Crime,Male,60+,1678,233,1445,1190,488
2007,Urban,Delhi,Crime Against Men,Robbery,Male,13-17,5991,3012,2979,5408,583
2010,Rural,Chhattisgarh,Crime Against Women,Molestation,Male,31-45,266,218,48,252,14
2002,Urban,Chhattisgarh,Crime Against Children,Child Labor,Male,18-30,5306,3887,1419,3910,1396
2009,Urban,Uttar Pradesh,Property Crime,Arson,Female,0-12,1828,903,925,1661,167
2009,Rural,Manipur,Property Crime,Burglary,Male,46-60,5137,570,4567,773,4364
2004,Urban,Sikkim,Crime Against Children,Trafficking,Male,31-45,8218,4077,4141,7709,509
2004,Rural,West Bengal,Crime Against Women,Molestation,Male,13-17,5220,1009,4211,4513,707
2002,Urban,Assam,Other Crimes,Cyber Crime,Male,13-17,292,58,234,249,43
2006,Rural,Karnataka,Property Crime,Vandalism,Male,0-12,9170,59,9111,7480,1690
2006,Rural,Bihar,Other Crimes,Cyber Crime,Male,13-17,526,109,417,391,135
2005,Urban,Nagaland,Property Crime,Theft,Male,60+,612,543,69,545,67
2001,Urban,Uttar Pradesh,Crime Against Women,Domestic Violence,Female,60+,3249,2121,1128,3081,168
2006,Rural,Karnataka,Property Crime,Vandalism,Female,60+,54,50,4,54,0
2003,Urban,Kerala,Property Crime,Vandalism,Female,60+,921,813,108,827,94
2007,Rural,Tripura,Other Crimes,Drug Offense,Female,46-60,8407,5768,2639,6747,1660
2009,Urban,Bihar,Property Crime,Vandalism,Male,46-60,4019,1861,2158,2299,1720
2010,Urban,Meghalaya,Crime Against Children,Kidnapping,Female,60+,3125,491,2634,2898,227
2010,Rural,Meghalaya,Crime Against Children,Trafficking,Male,60+,907,767,140,796,111
2007,Rural,Gujarat,Other Crimes,Cyber Crime,Female,31-45,1022,19,1003,324,698
2002,Urban,Chhattisgarh,Crime Against Women,Dowry Deaths,Female,18-30,5635,2779,2856,4290,1345
2010,Urban,Manipur,Crime Against Women,Molestation,Female,46-60,665,609,56,625,40
2004,Urban,Kerala,Crime Against Children,Trafficking,Female,18-30,9830,8403,1427,9726,104
2007,Rural,Maharashtra,Property Crime,Burglary,Male,13-17,6252,572,5680,3861,2391
2008,Urban,Manipur,Property Crime,Arson,Male,0-12,8533,7147,1386,8240,293
2007,Urban,West Bengal,Crime Against Men,Robbery,Male,13-17,5078,3745,1333,4107,971
2007,Urban,Uttar Pradesh,Crime Against Men,Extortion,Male,18-30,410,228,182,372,38
2007,Urban,Madhya Pradesh,Crime Against Women,Domestic Violence,Male,60+,5572,4596,976,4597,975
2010,Rural,West Bengal,Property Crime,Arson,Female,0-12,8300,1922,6378,4950,3350
2007,Urban,Karnataka,Crime Against Children,Child Labor,Male,0-12,1540,723,817,987,553
2006,Urban,Tripura,Crime Against Men,Extortion,Female,0-12,2974,2589,385,2684,290
2001,Urban,Punjab,Crime Against Children,Child Labor,Male,0-12,6924,4043,2881,6323,601
2005,Urban,Uttarakhand,Crime Against Men,Extortion,Male,31-45,9406,5821,3585,8228,1178
2007,Rural,Punjab,Crime Against Men,Assault,Female,60+,9178,1905,7273,4784,4394
2007,Rural,Goa,Property Crime,Vandalism,Female,18-30,2031,1586,445,1700,331
2004,Rural,Manipur,Crime Against Children,Kidnapping,Male,46-60,6060,2058,4002,4253,1807
2004,Urban,Tamil Nadu,Crime Against Children,Child Labor,Female,18-30,9414,416,8998,603,8811
2008,Urban,Kerala,Crime Against Children,Kidnapping,Female,31-45,1269,649,620,1191,78
2006,Urban,Jammu & Kashmir,Crime Against Children,Kidnapping,Female,18-30,9676,2235,7441,3816,5860
2001,Rural,Haryana,Property Crime,Vandalism,Female,46-60,1258,14,1244,778,480
2003,Urban,Arunachal Pradesh,Property Crime,Arson,Male,60+,1513,976,537,1198,315
2001,Rural,Tripura,Other Crimes,Drug Offense,Female,0-12,8942,6963,1979,7773,1169
2010,Urban,Haryana,Crime Against Men,Robbery,Male,13-17,1234,358,876,1225,9
2007,Urban,Sikkim,Crime Against Children,Trafficking,Male,13-17,1506,355,1151,1417,89
2010,Urban,Telangana,Crime Against Men,Extortion,Female,0-12,3385,434,2951,3161,224
2006,Urban,Meghalaya,Other Crimes,Drug Offense,Male,0-12,6439,4665,1774,5353,1086
2005,Rural,Jammu & Kashmir,Crime Against Children,Kidnapping,Male,46-60,149,93,56,114,35
2010,Urban,Gujarat,Crime Against Children,Kidnapping,Male,13-17,1628,107,1521,1076,552
2001,Urban,Nagaland,Crime Against Women,Molestation,Male,46-60,936,114,822,608,328
2010,Rural,Nagaland,Property Crime,Vandalism,Female,60+,3237,963,2274,1438,1799
2010,Rural,Haryana,Other Crimes,Corruption,Male,0-12,8485,942,7543,5914,2571
2008,Rural,Odisha,Property Crime,Vandalism,Female,13-17,9852,9708,144,9844,8
2006,Urban,Bihar,Property Crime,Theft,Female,0-12,9736,3057,6679,3757,5979
2004,Rural,Goa,Crime Against Children,Kidnapping,Male,46-60,8078,3957,4121,5650,2428
2006,Urban,Assam,Crime Against Men,Robbery,Female,13-17,2047,1889,158,1898,149
2007,Rural,Tamil Nadu,Property Crime,Arson,Male,46-60,401,3,398,348,53
2005,Urban,Haryana,Other Crimes,Drug Offense,Male,60+,3997,2509,1488,3716,281
2003,Rural,Karnataka,Crime Against Men,Assault,Female,13-17,4997,3688,1309,4958,39
2002,Rural,Meghalaya,Crime Against Children,Child Labor,Female,60+,5116,852,4264,2897,2219
2003,Rural,Gujarat,Property Crime,Theft,Female,46-60,8169,3309,4860,5057,3112
2006,Rural,West Bengal,Crime Against Men,Extortion,Male,13-17,2344,1529,815,2268,76
2007,Urban,Uttar Pradesh,Property Crime,Vandalism,Female,31-45,5977,100,5877,3669,2308
2005,Rural,Chhattisgarh,Crime Against Children,Trafficking,Male,46-60,7042,5880,1162,6560,482
2003,Urban,Haryana,Crime Against Women,Domestic Violence,Female,46-60,3470,1285,2185,2886,584
2004,Urban,Maharashtra,Other Crimes,Cyber Crime,Female,0-12,5791,1435,4356,3782,2009
2003,Urban,Uttar Pradesh,Crime Against Children,Child Labor,Female,60+,1792,813,979,1159,633
2010,Urban,Rajasthan,Other Crimes,Drug Offense,Female,60+,5131,1281,3850,2545,2586
2006,Urban,Rajasthan,Crime Against Women,Molestation,Male,60+,4060,1323,2737,3567,493
2005,Urban,Arunachal Pradesh,Crime Against Women,Dowry Deaths,Female,0-12,278,129,149,175,103
2008,Rural,Andhra Pradesh,Property Crime,Burglary,Female,60+,1150,644,506,932,218
2003,Rural,Delhi,Crime Against Men,Murder,Male,46-60,3896,340,3556,1189,2707
2007,Rural,Karnataka,Crime Against Children,Child Abuse,Male,13-17,6847,5965,882,5980,867
2001,Rural,Karnataka,Crime Against Women,Molestation,Female,46-60,1619,539,1080,569,1050
2006,Urban,Jharkhand,Crime Against Men,Extortion,Male,18-30,3606,459,3147,2805,801
2003,Urban,Manipur,Crime Against Children,Child Abuse,Female,60+,2586,820,1766,1493,1093
2001,Urban,Himachal Pradesh,Other Crimes,Corruption,Female,60+,1410,1128,282,1408,2
2001,Urban,Tripura,Crime Against Men,Murder,Female,18-30,8653,5585,3068,6761,1892
2003,Rural,Assam,Crime Against Women,Dowry Deaths,Female,60+,8077,620,7457,741,7336
2009,Urban,Nagaland,Crime Against Children,Child Abuse,Female,0-12,1728,994,734,1482,246
2002,Rural,Andhra Pradesh,Property Crime,Theft,Female,31-45,2856,2745,111,2804,52
2004,Rural,Jammu & Kashmir,Crime Against Women,Dowry Deaths,Female,0-12,5522,1027,4495,5067,455
2004,Rural,Delhi,Property Crime,Theft,Male,31-45,8323,5906,2417,8216,107
2002,Rural,Delhi,Crime Against Women,Dowry Deaths,Female,18-30,1353,733,620,1284,69
2003,Rural,Gujarat,Crime Against Women,Molestation,Female,60+,696,470,226,519,177
2009,Rural,Madhya Pradesh,Property Crime,Vandalism,Female,0-12,7254,6410,844,6986,268
2002,Urban,West Bengal,Crime Against Men,Extortion,Male,60+,8905,7197,1708,8060,845
2005,Rural,Sikkim,Crime Against Children,Child Abuse,Male,0-12,526,132,394,175,351
2002,Urban,Nagaland,Crime Against Women,Dowry Deaths,Male,18-30,9984,9938,46,9951,33
2004,Rural,Rajasthan,Property Crime,Burglary,Male,31-45,9484,5185,4299,5472,4012
2002,Urban,Karnataka,Property Crime,Burglary,Female,46-60,3962,1146,2816,2929,1033
2003,Rural,Mizoram,Crime Against Men,Murder,Female,0-12,5767,1284,4483,3894,1873
2007,Urban,Odisha,Crime Against Women,Molestation,Female,31-45,8343,2258,6085,7407,936
2008,Rural,Assam,Other Crimes,Corruption,Female,0-12,8404,6272,2132,6308,2096
2002,Rural,Maharashtra,Crime Against Children,Child Abuse,Female,60+,5482,4268,1214,4324,1158
2006,Rural,Jharkhand,Crime Against Women,Molestation,Male,18-30,2019,1044,975,1695,324
2004,Urban,Sikkim,Property Crime,Vandalism,Female,46-60,8437,5741,2696,6479,1958
2007,Rural,Uttarakhand,Crime Against Women,Dowry Deaths,Female,13-17,7017,4296,2721,4829,2188
2005,Rural,Arunachal Pradesh,Crime Against Children,Kidnapping,Male,31-45,1340,1056,284,1104,236
2010,Urban,Tripura,Crime Against Women,Rape,Female,60+,5386,2399,2987,4036,1350
2002,Rural,Nagaland,Property Crime,Theft,Male,13-17,996,305,691,327,669
2009,Urban,Maharashtra,Other Crimes,Cyber Crime,Female,31-45,7094,6,7088,3285,3809
2009,Rural,Assam,Crime Against Children,Kidnapping,Male,13-17,6431,4565,1866,5673,758
2006,Rural,Haryana,Crime Against Children,Child Labor,Male,31-45,2992,298,2694,942,2050
2004,Urban,Assam,Property Crime,Vandalism,Male,13-17,4802,393,4409,3612,1190
2004,Rural,Karnataka,Crime Against Women,Dowry Deaths,Female,46-60,8630,2115,6515,5815,2815
2002,Rural,Arunachal Pradesh,Other Crimes,Cyber Crime,Female,46-60,8407,477,7930,8325,82
2009,Urban,Nagaland,Crime Against Women,Rape,Male,13-17,7202,2887,4315,5429,1773
2007,Rural,Chhattisgarh,Other Crimes,Fraud,Female,31-45,7780,717,7063,4350,3430
2010,Rural,Meghalaya,Crime Against Women,Dowry Deaths,Female,13-17,1902,729,1173,1661,241
2010,Rural,Tripura,Crime Against Women,Dowry Deaths,Female,46-60,7790,416,7374,6477,1313
2005,Urban,Tripura,Property Crime,Theft,Male,31-45,4843,3701,1142,3736,1107
2004,Urban,Chhattisgarh,Crime Against Men,Extortion,Female,13-17,8381,458,7923,3029,5352
2002,Rural,Uttar Pradesh,Property Crime,Vandalism,Male,18-30,4520,3524,996,3589,931
2003,Urban,Mizoram,Crime Against Men,Assault,Male,46-60,1129,902,227,975,154
2002,Urban,Mizoram,Crime Against Women,Rape,Female,0-12,3407,2143,1264,2719,688
2001,Urban,Haryana,Crime Against Women,Rape,Male,60+,8023,7492,531,7729,294
2009,Rural,Nagaland,Crime Against Men,Extortion,Female,60+,8711,7869,842,8538,173
2002,Urban,Kerala,Crime Against Men,Extortion,Female,13-17,493,231,262,259,234
2006,Urban,Telangana,Other Crimes,Fraud,Male,18-30,952,530,422,888,64
2003,Urban,Manipur,Other Crimes,Cyber Crime,Male,18-30,5384,3636,1748,4312,1072
2007,Urban,Bihar,Property Crime,Vandalism,Female,0-12,9317,4932,4385,7494,1823
2010,Rural,Nagaland,Crime Against Women,Domestic Violence,Male,60+,6828,6012,816,6674,154
2008,Urban,Sikkim,Other Crimes,Corruption,Male,46-60,9048,2730,6318,4676,4372
2005,Urban,Telangana,Crime Against Women,Dowry Deaths,Male,46-60,1318,825,493,1042,276
2007,Urban,Sikkim,Other Crimes,Cyber Crime,Female,0-12,1444,820,624,1078,366
2003,Rural,Himachal Pradesh,Crime Against Women,Rape,Male,46-60,2164,1981,183,2124,40
2007,Rural,Manipur,Crime Against Women,Molestation,Male,13-17,4033,3169,864,3957,76
2007,Urban,Gujarat,Crime Against Men,Murder,Male,60+,5436,4973,463,5216,220
2008,Rural,Himachal Pradesh,Other Crimes,Drug Offense,Male,0-12,3173,1940,1233,2491,682
2007,Urban,West Bengal,Crime Against Children,Kidnapping,Female,18-30,1922,577,1345,1826,96
2003,Urban,Uttar Pradesh,Property Crime,Arson,Female,0-12,7052,1425,5627,3498,3554
2008,Rural,Kerala,Crime Against Men,Assault,Male,13-17,8430,5729,2701,6443,1987
2002,Rural,Goa,Other Crimes,Drug Offense,Female,46-60,4759,3751,1008,3957,802
2009,Urban,Himachal Pradesh,Crime Against Men,Assault,Female,31-45,1627,276,1351,694,933
2003,Urban,Mizoram,Crime Against Children,Kidnapping,Male,60+,5692,2291,3401,5308,384
2005,Rural,Meghalaya,Crime Against Children,Trafficking,Female,13-17,5851,838,5013,4085,1766
2010,Urban,Jharkhand,Property Crime,Theft,Male,31-45,5278,2488,2790,4064,1214
2010,Rural,Sikkim,Crime Against Men,Extortion,Female,60+,3991,2226,1765,2895,1096
2009,Rural,Telangana,Crime Against Women,Molestation,Male,46-60,4598,2410,2188,3644,954
2006,Rural,Uttar Pradesh,Crime Against Men,Extortion,Female,31-45,1888,704,1184,796,1092
2001,Rural,Madhya Pradesh,Other Crimes,Drug Offense,Female,46-60,5017,4358,659,4418,599
2009,Urban,Kerala,Property Crime,Theft,Female,18-30,837,372,465,772,65
2004,Rural,Jharkhand,Crime Against Women,Molestation,Female,0-12,1320,1223,97,1309,11
2007,Rural,Madhya Pradesh,Crime Against Women,Rape,Female,60+,4573,3965,608,4489,84
2006,Urban,West Bengal,Crime Against Women,Domestic Violence,Male,18-30,866,78,788,744,122
2004,Urban,Tripura,Crime Against Children,Trafficking,Male,46-60,9255,1322,7933,2776,6479
2004,Rural,Rajasthan,Crime Against Women,Molestation,Male,13-17,5770,168,5602,2383,3387
2002,Rural,Haryana,Crime Against Men,Murder,Female,46-60,6459,3512,2947,3857,2602
2010,Rural,Andhra Pradesh,Crime Against Men,Robbery,Female,46-60,670,259,411,624,46
2001,Rural,Meghalaya,Property Crime,Vandalism,Male,31-45,8834,7358,1476,8694,140
2008,Urban,Sikkim,Crime Against Children,Kidnapping,Female,0-12,7622,2394,5228,6926,696
2004,Urban,Haryana,Property Crime,Burglary,Female,18-30,1804,242,1562,1489,315
2007,Urban,Bihar,Property Crime,Vandalism,Male,31-45,2024,793,1231,1346,678
2002,Urban,Delhi,Other Crimes,Fraud,Female,0-12,6638,3762,2876,6516,122
2008,Urban,Tamil Nadu,Other Crimes,Cyber Crime,Male,0-12,164,135,29,143,21
2007,Rural,Meghalaya,Other Crimes,Corruption,Male,60+,1517,1050,467,1275,242
2001,Rural,Assam,Crime Against Women,Domestic Violence,Female,60+,1973,1222,751,1575,398
2002,Rural,Sikkim,Crime Against Men,Assault,Female,60+,4701,1745,2956,3234,1467
2002,Urban,Bihar,Crime Against Children,Child Labor,Male,13-17,1449,1000,449,1122,327
2008,Urban,Gujarat,Crime Against Women,Rape,Male,60+,313,233,80,254,59
2007,Rural,Andhra Pradesh,Crime Against Women,Molestation,Male,46-60,3209,329,2880,590,2619
2001,Urban,Haryana,Property Crime,Burglary,Male,46-60,1924,230,1694,316,1608
2009,Rural,Rajasthan,Crime Against Children,Kidnapping,Female,31-45,3415,2614,801,3341,74
2004,Urban,Uttarakhand,Crime Against Women,Rape,Female,0-12,9190,2749,6441,4821,4369
2008,Urban,Chhattisgarh,Crime Against Men,Assault,Male,31-45,5525,4591,934,5047,478
2002,Urban,Tripura,Other Crimes,Fraud,Male,46-60,4267,531,3736,1444,2823
2002,Urban,Karnataka,Crime Against Women,Dowry Deaths,Male,18-30,6933,1403,5530,6516,417
2009,Rural,Sikkim,Property Crime,Theft,Male,60+,3010,2682,328,2901,109
2010,Rural,Mizoram,Crime Against Women,Domestic Violence,Male,18-30,6910,6471,439,6825,85
2008,Rural,Odisha,Crime Against Children,Child Labor,Female,18-30,9412,5044,4368,6862,2550
2009,Rural,Jharkhand,Crime Against Women,Domestic Violence,Female,46-60,321,15,306,268,53
2001,Rural,Chhattisgarh,Other Crimes,Cyber Crime,Male,13-17,6647,4222,2425,5382,1265
2010,Rural,Punjab,Crime Against Men,Assault,Female,31-45,4536,950,3586,1081,3455
2008,Urban,Tripura,Property Crime,Vandalism,Male,18-30,785,335,450,424,361
2006,Urban,Tripura,Crime Against Men,Assault,Male,60+,754,194,560,464,290
2008,Urban,Nagaland,Crime Against Women,Domestic Violence,Male,31-45,9877,6109,3768,7474,2403
2003,Rural,Haryana,Property Crime,Arson,Male,46-60,8192,5611,2581,5802,2390
2003,Urban,Maharashtra,Crime Against Women,Dowry Deaths,Male,0-12,2701,273,2428,1621,1080
2002,Rural,Jammu & Kashmir,Property Crime,Arson,Male,18-30,858,749,109,792,66
2006,Rural,West Bengal,Other Crimes,Drug Offense,Female,18-30,3585,1592,1993,3293,292
2002,Urban,Kerala,Crime Against Men,Extortion,Female,31-45,7048,2391,4657,4278,2770
2009,Rural,Karnataka,Crime Against Children,Kidnapping,Female,18-30,9818,8135,1683,8920,898
2003,Urban,Kerala,Crime Against Women,Rape,Male,18-30,6753,5742,1011,6239,514
2006,Urban,Jharkhand,Crime Against Children,Child Abuse,Male,18-30,1175,218,957,666,509
2001,Urban,Tripura,Property Crime,Theft,Male,60+,4513,1352,3161,2688,1825
2007,Rural,Kerala,Crime Against Women,Dowry Deaths,Female,18-30,3176,2577,599,2982,194
2009,Rural,Andhra Pradesh,Crime Against Men,Assault,Male,46-60,6064,3571,2493,4598,1466
2010,Urban,Nagaland,Crime Against Children,Child Labor,Female,0-12,5566,5071,495,5545,21
2003,Urban,Jharkhand,Crime Against Men,Extortion,Female,60+,3708,1232,2476,1872,1836
2009,Urban,Odisha,Property Crime,Burglary,Female,31-45,7177,781,6396,4756,2421
2004,Rural,Sikkim,Crime Against Men,Murder,Male,31-45,7486,6297,1189,7438,48
2007,Urban,Haryana,Crime Against Women,Molestation,Male,18-30,7595,1684,5911,6494,1101
2006,Rural,Odisha,Crime Against Men,Assault,Male,0-12,8932,7469,1463,7734,1198
2004,Rural,Sikkim,Crime Against Men,Extortion,Female,31-45,7792,1712,6080,4796,2996
2003,Rural,Jharkhand,Crime Against Men,Robbery,Female,46-60,2017,1394,623,1769,248
2009,Urban,Sikkim,Crime Against Children,Trafficking,Female,60+,234,96,138,210,24
2010,Urban,Himachal Pradesh,Crime Against Children,Trafficking,Male,13-17,4287,3582,705,4001,286
2003,Rural,Kerala,Other Crimes,Drug Offense,Male,31-45,217,16,201,84,133
2003,Urban,Bihar,Crime Against Women,Domestic Violence,Male,0-12,5164,3954,1210,4819,345
2005,Urban,Delhi,Crime Against Women,Dowry Deaths,Female,46-60,2355,736,1619,2202,153
2001,Rural,Telangana,Crime Against Children,Trafficking,Male,46-60,8672,2169,6503,8027,645
2010,Urban,Rajasthan,Property Crime,Vandalism,Female,46-60,9351,7151,2200,7155,2196
2003,Urban,Chhattisgarh,Property Crime,Vandalism,Female,31-45,8475,3288,5187,5060,3415
2004,Urban,Goa,Property Crime,Burglary,Female,46-60,1877,1449,428,1682,195
2002,Rural,Kerala,Other Crimes,Corruption,Male,0-12,776,475,301,683,93
2005,Urban,Telangana,Crime Against Children,Trafficking,Male,46-60,5403,2345,3058,5190,213
2004,Urban,Goa,Property Crime,Theft,Female,13-17,7324,906,6418,6994,330
2001,Urban,Chhattisgarh,Crime Against Children,Child Labor,Male,60+,4810,825,3985,2242,2568
2010,Urban,Meghalaya,Crime Against Women,Molestation,Female,18-30,6193,1248,4945,2022,4171
2008,Urban,Uttar Pradesh,Property Crime,Arson,Male,13-17,1817,734,1083,1761,56
2007,Urban,Chhattisgarh,Crime Against Children,Child Abuse,Female,60+,4578,306,4272,3079,1499
2003,Rural,Chhattisgarh,Crime Against Children,Kidnapping,Female,60+,4681,1646,3035,2384,2297
2010,Rural,Uttar Pradesh,Crime Against Women,Rape,Male,0-12,923,406,517,427,496
2002,Rural,Assam,Crime Against Women,Rape,Male,13-17,3283,1953,1330,2423,860
2010,Urban,Uttar Pradesh,Crime Against Women,Molestation,Female,0-12,5766,1903,3863,2868,2898
2003,Rural,Gujarat,Crime Against Children,Kidnapping,Male,60+,368,200,168,335,33
2005,Urban,Andhra Pradesh,Other Crimes,Fraud,Female,46-60,9693,5911,3782,5933,3760
2003,Rural,Haryana,Property Crime,Burglary,Female,18-30,4827,2361,2466,3115,1712
2010,Rural,Goa,Other Crimes,Cyber Crime,Male,0-12,9442,312,9130,8640,802
2001,Urban,Jharkhand,Other Crimes,Drug Offense,Female,18-30,7404,492,6912,2437,4967
2009,Rural,Bihar,Property Crime,Burglary,Male,60+,5128,1654,3474,2149,2979
2009,Rural,Bihar,Crime Against Women,Dowry Deaths,Female,60+,7255,4530,2725,5169,2086
2008,Urban,Mizoram,Other Crimes,Drug Offense,Male,31-45,9467,230,9237,2944,6523
2002,Urban,Arunachal Pradesh,Other Crimes,Drug Offense,Female,46-60,7847,2245,5602,7294,553
2006,Rural,Tripura,Crime Against Women,Molestation,Male,31-45,2103,643,1460,1682,421
2006,Rural,Goa,Crime Against Women,Rape,Male,0-12,7879,7721,158,7843,36
2009,Urban,Bihar,Crime Against Women,Domestic Violence,Female,0-12,8884,5107,3777,5889,2995
2002,Urban,Arunachal Pradesh,Property Crime,Burglary,Female,31-45,8670,1745,6925,2649,6021
2005,Urban,Manipur,Property Crime,Theft,Male,31-45,759,33,726,396,363
2008,Rural,Goa,Crime Against Women,Domestic Violence,Male,46-60,1170,279,891,1019,151
2001,Rural,Tamil Nadu,Crime Against Children,Child Labor,Female,0-12,4394,360,4034,3238,1156
2009,Rural,Goa,Crime Against Women,Rape,Female,60+,4571,72,4499,1503,3068
2008,Rural,Kerala,Crime Against Men,Extortion,Male,13-17,2793,1238,1555,1480,1313
2001,Rural,Sikkim,Crime Against Children,Trafficking,Male,0-12,9568,3319,6249,8186,1382
2003,Rural,Telangana,Crime Against Men,Murder,Male,13-17,2396,226,2170,1235,1161
2002,Rural,Andhra Pradesh,Crime Against Men,Extortion,Female,60+,5360,1244,4116,4293,1067
2004,Rural,Mizoram,Crime Against Children,Trafficking,Male,31-45,3390,884,2506,1615,1775
2010,Urban,Maharashtra,Crime Against Men,Robbery,Male,18-30,3926,1732,2194,3891,35
2010,Urban,Kerala,Property Crime,Theft,Female,0-12,6191,5368,823,5445,746
2006,Rural,Tamil Nadu,Other Crimes,Fraud,Female,0-12,6422,2809,3613,4006,2416
2007,Urban,Himachal Pradesh,Other Crimes,Fraud,Male,0-12,8847,1421,7426,3196,5651
2005,Rural,Sikkim,Crime Against Women,Molestation,Female,31-45,9373,3855,5518,3986,5387
2010,Urban,Odisha,Other Crimes,Fraud,Female,0-12,4292,3405,887,3653,639
2004,Rural,Bihar,Crime Against Children,Child Labor,Female,13-17,3262,431,2831,1473,1789
2003,Rural,Karnataka,Property Crime,Theft,Female,60+,1820,160,1660,1535,285
2002,Rural,Haryana,Other Crimes,Corruption,Female,31-45,7026,4577,2449,4733,2293
2010,Urban,Haryana,Property Crime,Vandalism,Female,31-45,4829,3123,1706,4453,376
2001,Urban,Nagaland,Crime Against Children,Trafficking,Male,13-17,7988,7583,405,7614,374
2005,Urban,Madhya Pradesh,Crime Against Men,Assault,Male,31-45,6547,838,5709,1813,4734
2005,Urban,Manipur,Crime Against Children,Child Labor,Male,46-60,365,33,332,184,181
2002,Urban,Rajasthan,Property Crime,Arson,Female,60+,1114,372,742,1100,14
2007,Rural,Uttarakhand,Property Crime,Theft,Female,13-17,1935,691,1244,1127,808
2003,Rural,Jharkhand,Crime Against Children,Kidnapping,Male,18-30,8559,7853,706,8401,158
2007,Urban,Goa,Crime Against Children,Child Abuse,Male,13-17,2777,838,1939,1172,1605
2010,Rural,Haryana,Crime Against Children,Child Labor,Female,18-30,5973,5097,876,5565,408
2008,Urban,Chhattisgarh,Crime Against Men,Extortion,Male,60+,4444,423,4021,2427,2017
2004,Rural,Odisha,Crime Against Men,Extortion,Male,18-30,7268,7142,126,7143,125
2007,Urban,Uttar Pradesh,Crime Against Children,Child Labor,Female,18-30,6731,5660,1071,5692,1039
2008,Rural,Tripura,Crime Against Women,Rape,Female,31-45,3390,1157,2233,1733,1657
2008,Urban,Meghalaya,Crime Against Children,Trafficking,Female,0-12,9007,1590,7417,2300,6707
2001,Urban,Maharashtra,Property Crime,Arson,Female,46-60,1226,5,1221,1020,206
2008,Rural,Rajasthan,Crime Against Men,Murder,Female,60+,5928,2927,3001,5024,904
2002,Urban,Chhattisgarh,Crime Against Children,Kidnapping,Female,13-17,3619,3611,8,3619,0
2004,Urban,Himachal Pradesh,Crime Against Men,Murder,Male,0-12,6177,5028,1149,5240,937
2001,Urban,Haryana,Property Crime,Theft,Male,31-45,2212,288,1924,1205,1007
2005,Rural,Uttar Pradesh,Crime Against Women,Dowry Deaths,Female,13-17,4231,1843,2388,3720,511
2002,Urban,Uttarakhand,Property Crime,Burglary,Female,18-30,5542,1696,3846,3666,1876
2005,Urban,Manipur,Crime Against Children,Child Labor,Male,13-17,9437,6389,3048,6446,2991
2010,Urban,Andhra Pradesh,Other Crimes,Corruption,Male,60+,6160,842,5318,6034,126
2008,Rural,Chhattisgarh,Crime Against Men,Extortion,Male,13-17,7815,4848,2967,5017,2798
2004,Rural,Haryana,Crime Against Women,Rape,Female,18-30,2940,2299,641,2304,636
2002,Rural,Kerala,Property Crime,Arson,Female,60+,3435,42,3393,3196,239
2004,Urban,West Bengal,Other Crimes,Corruption,Female,60+,1313,624,689,696,617
2008,Urban,Punjab,Other Crimes,Cyber Crime,Female,46-60,6750,6540,210,6718,32
2003,Rural,Jharkhand,Crime Against Children,Kidnapping,Female,13-17,7359,4758,2601,4928,2431
2001,Urban,Gujarat,Crime Against Men,Extortion,Male,46-60,1693,455,1238,1246,447
2007,Rural,Punjab,Other Crimes,Cyber Crime,Female,46-60,8602,6527,2075,7252,1350
2008,Urban,Jharkhand,Crime Against Children,Trafficking,Female,0-12,2499,1691,808,2398,101
2006,Rural,Himachal Pradesh,Crime Against Men,Extortion,Female,46-60,4818,141,4677,2437,2381
2005,Rural,Telangana,Property Crime,Arson,Female,60+,7723,5778,1945,7392,331
2004,Rural,Andhra Pradesh,Crime Against Children,Trafficking,Male,60+,1678,206,1472,894,784
2002,Urban,Goa,Crime Against Men,Robbery,Male,60+,8393,3720,4673,4183,4210
2010,Rural,Madhya Pradesh,Crime Against Children,Child Labor,Female,0-12,8134,7614,520,7902,232
2001,Rural,Jammu & Kashmir,Other Crimes,Cyber Crime,Male,60+,5983,4776,1207,5347,636
2006,Urban,Tamil Nadu,Other Crimes,Cyber Crime,Male,0-12,5611,2580,3031,3774,1837
2006,Rural,Tripura,Crime Against Children,Child Labor,Female,18-30,1986,1541,445,1578,408
2008,Rural,Tamil Nadu,Other Crimes,Cyber Crime,Female,13-17,1397,483,914,990,407
2007,Urban,Odisha,Crime Against Men,Assault,Female,31-45,6539,2696,3843,5823,716
2007,Rural,Haryana,Property Crime,Vandalism,Male,31-45,5387,2044,3343,4176,1211
2008,Urban,Bihar,Crime Against Children,Kidnapping,Male,46-60,4500,1016,3484,2167,2333
2006,Urban,Jharkhand,Crime Against Women,Rape,Female,13-17,1256,1030,226,1094,162
2004,Urban,Telangana,Crime Against Men,Extortion,Female,0-12,3923,2160,1763,2798,1125
2003,Rural,Mizoram,Other Crimes,Corruption,Male,13-17,8494,7067,1427,8399,95
2007,Urban,Kerala,Crime Against Children,Child Abuse,Male,46-60,286,154,132,270,16
2004,Urban,Karnataka,Crime Against Children,Kidnapping,Female,60+,9241,530,8711,1634,7607
2008,Urban,Punjab,Crime Against Men,Murder,Female,46-60,9072,7015,2057,8390,682
2006,Rural,Chhattisgarh,Crime Against Men,Robbery,Female,46-60,1141,380,761,416,725
2006,Rural,Jharkhand,Crime Against Children,Child Abuse,Male,46-60,6745,586,6159,5615,1130
2002,Rural,Meghalaya,Crime Against Women,Domestic Violence,Female,18-30,891,146,745,289,602
2005,Rural,Jammu & Kashmir,Property Crime,Theft,Female,0-12,806,496,310,667,139
2005,Rural,Odisha,Other Crimes,Corruption,Male,60+,3771,1088,2683,2606,1165
2009,Rural,Delhi,Crime Against Men,Murder,Female,46-60,219,53,166,198,21
2010,Urban,Uttarakhand,Crime Against Men,Extortion,Female,13-17,1845,908,937,969,876
2003,Urban,Andhra Pradesh,Crime Against Children,Child Abuse,Female,18-30,1122,710,412,916,206
2007,Rural,Punjab,Crime Against Women,Dowry Deaths,Male,0-12,3096,866,2230,2914,182
2006,Urban,Himachal Pradesh,Crime Against Women,Domestic Violence,Male,31-45,1786,484,1302,1437,349
2009,Rural,Rajasthan,Crime Against Women,Domestic Violence,Female,13-17,1753,972,781,1224,529
2007,Urban,Gujarat,Crime Against Women,Rape,Female,46-60,4408,2042,2366,2772,1636
2003,Rural,Meghalaya,Crime Against Women,Dowry Deaths,Female,46-60,1121,33,1088,747,374
2001,Urban,Kerala,Crime Against Men,Assault,Female,0-12,1100,428,672,489,611
2008,Rural,Jharkhand,Property Crime,Theft,Male,60+,9752,6634,3118,7484,2268
2002,Rural,Madhya Pradesh,Other Crimes,Fraud,Female,18-30,1208,361,847,743,465
2008,Rural,Punjab,Crime Against Women,Domestic Violence,Female,18-30,7417,374,7043,3738,3679
2007,Rural,Assam,Crime Against Men,Extortion,Female,31-45,2647,1553,1094,2152,495
2002,Urban,Gujarat,Property Crime,Vandalism,Male,18-30,6100,1706,4394,4008,2092
2010,Rural,Arunachal Pradesh,Crime Against Children,Child Abuse,Female,13-17,4482,2317,2165,3563,919
2005,Rural,Odisha,Other Crimes,Cyber Crime,Male,0-12,5930,5846,84,5886,44
2008,Rural,West Bengal,Crime Against Women,Dowry Deaths,Male,46-60,6080,4377,1703,5093,987
2008,Rural,Maharashtra,Crime Against Women,Domestic Violence,Female,60+,2430,2212,218,2213,217
2006,Urban,Bihar,Crime Against Women,Domestic Violence,Female,0-12,987,327,660,404,583
2008,Rural,Assam,Other Crimes,Cyber Crime,Female,46-60,7382,5421,1961,6236,1146
2004,Urban,Chhattisgarh,Crime Against Men,Robbery,Male,31-45,4993,201,4792,980,4013
2009,Rural,Uttarakhand,Crime Against Women,Dowry Deaths,Male,46-60,522,61,461,315,207
2001,Rural,Goa,Crime Against Children,Child Abuse,Male,60+,4561,2916,1645,3627,934
2005,Rural,Punjab,Crime Against Men,Murder,Male,46-60,4304,3804,500,4153,151
2009,Rural,Jammu & Kashmir,Other Crimes,Drug Offense,Male,46-60,1487,1175,312,1380,107
2008,Rural,Meghalaya,Crime Against Children,Kidnapping,Female,0-12,9956,7875,2081,8048,1908
2003,Rural,Haryana,Crime Against Women,Rape,Female,0-12,2989,132,2857,145,2844
2001,Rural,Assam,Crime Against Children,Child Labor,Female,0-12,4444,3373,1071,4077,367
2004,Urban,Punjab,Crime Against Women,Dowry Deaths,Male,13-17,7391,1520,5871,2362,5029
2010,Urban,Jammu & Kashmir,Property Crime,Arson,Female,18-30,9346,5324,4022,9049,297
2001,Urban,Rajasthan,Property Crime,Burglary,Male,46-60,6003,2825,3178,5640,363
2001,Rural,Rajasthan,Crime Against Men,Assault,Male,0-12,4490,4393,97,4447,43
2007,Rural,Rajasthan,Other Crimes,Corruption,Female,60+,5460,4158,1302,5076,384
2006,Urban,Uttarakhand,Crime Against Women,Dowry Deaths,Male,13-17,818,527,291,583,235
2004,Rural,Nagaland,Other Crimes,Cyber Crime,Female,46-60,6739,2709,4030,5004,1735
2002,Urban,Andhra Pradesh,Property Crime,Burglary,Male,18-30,1367,747,620,1033,334
2006,Rural,Nagaland,Crime Against Men,Murder,Male,46-60,2196,945,1251,1489,707
2001,Rural,Mizoram,Property Crime,Arson,Male,46-60,8608,3450,5158,8310,298
2010,Rural,Uttarakhand,Crime Against Children,Kidnapping,Male,0-12,8303,2047,6256,4658,3645
2010,Urban,Jammu & Kashmir,Other Crimes,Corruption,Male,0-12,7375,1264,6111,3500,3875
2006,Rural,Maharashtra,Other Crimes,Fraud,Female,0-12,3561,2364,1197,3193,368
2002,Rural,Sikkim,Crime Against Children,Child Labor,Male,31-45,3453,2544,909,2954,499
2002,Rural,Uttarakhand,Crime Against Men,Extortion,Male,13-17,5892,4738,1154,5571,321
2008,Rural,Bihar,Other Crimes,Drug Offense,Male,13-17,6602,4868,1734,5755,847
2010,Urban,Chhattisgarh,Property Crime,Theft,Male,13-17,9919,5094,4825,9256,663
2006,Rural,Punjab,Other Crimes,Drug Offense,Male,46-60,5575,2459,3116,2891,2684
2005,Rural,Assam,Crime Against Children,Kidnapping,Male,13-17,5448,4408,1040,4564,884
2008,Rural,Manipur,Crime Against Men,Assault,Male,60+,5063,1580,3483,3015,2048
2003,Urban,Arunachal Pradesh,Property Crime,Arson,Male,31-45,1294,242,1052,316,978
2002,Urban,Uttar Pradesh,Property Crime,Theft,Male,0-12,6833,6471,362,6787,46
2009,Urban,Karnataka,Other Crimes,Corruption,Male,13-17,9367,9014,353,9076,291
2010,Urban,Madhya Pradesh,Property Crime,Theft,Female,60+,7028,4186,2842,5600,1428
2006,Rural,Uttar Pradesh,Crime Against Children,Child Labor,Female,18-30,4425,3975,450,4189,236
2008,Rural,Tamil Nadu,Other Crimes,Drug Offense,Female,0-12,2135,290,1845,920,1215
2008,Rural,Madhya Pradesh,Crime Against Children,Child Abuse,Male,18-30,5086,242,4844,1309,3777
2003,Urban,Uttar Pradesh,Crime Against Women,Dowry Deaths,Male,18-30,4990,518,4472,2731,2259
2003,Rural,Maharashtra,Crime Against Children,Trafficking,Male,31-45,2438,2265,173,2293,145
2006,Rural,West Bengal,Property Crime,Burglary,Female,60+,3191,721,2470,3126,65
2003,Rural,Tamil Nadu,Crime Against Men,Assault,Female,0-12,4727,4191,536,4296,431
2004,Rural,Karnataka,Crime Against Children,Child Abuse,Male,0-12,7286,2982,4304,4597,2689
2009,Rural,Jammu & Kashmir,Other Crimes,Fraud,Female,18-30,4051,1180,2871,3233,818
2002,Rural,Nagaland,Crime Against Children,Child Abuse,Male,46-60,4072,2018,2054,2376,1696
2003,Urban,Andhra Pradesh,Crime Against Women,Molestation,Male,46-60,4742,1841,2901,4622,120
2001,Rural,Meghalaya,Other Crimes,Cyber Crime,Male,31-45,6470,346,6124,4605,1865
2009,Urban,Madhya Pradesh,Crime Against Children,Child Abuse,Male,60+,7932,2720,5212,6733,1199
2007,Rural,West Bengal,Property Crime,Vandalism,Female,31-45,9705,3712,5993,8271,1434
2004,Rural,Jharkhand,Property Crime,Vandalism,Female,60+,3085,2586,499,2586,499
2005,Urban,Goa,Other Crimes,Drug Offense,Female,60+,5877,3535,2342,5796,81
2010,Urban,Tripura,Crime Against Men,Murder,Female,18-30,9220,5645,3575,8395,825
2009,Urban,Assam,Crime Against Men,Extortion,Male,18-30,2939,1092,1847,2781,158
2006,Rural,Sikkim,Property Crime,Burglary,Female,46-60,2049,1659,390,1842,207
2008,Rural,Meghalaya,Crime Against Men,Murder,Male,18-30,8400,6795,1605,7316,1084
2007,Urban,Bihar,Crime Against Children,Child Abuse,Female,18-30,7468,3104,4364,5183,2285
2002,Urban,Jharkhand,Crime Against Men,Assault,Male,60+,4322,3439,883,3734,588
2006,Urban,Himachal Pradesh,Other Crimes,Corruption,Male,46-60,6904,975,5929,1384,5520
2003,Urban,Meghalaya,Crime Against Children,Child Abuse,Female,18-30,6437,4222,2215,5103,1334
2001,Urban,Maharashtra,Crime Against Women,Molestation,Female,31-45,4226,2183,2043,2542,1684
2010,Urban,Meghalaya,Crime Against Men,Assault,Male,60+,8989,3284,5705,8233,756
2008,Rural,Delhi,Crime Against Men,Murder,Male,31-45,110,99,11,110,0
2009,Rural,Kerala,Other Crimes,Fraud,Female,60+,8906,517,8389,7597,1309
2009,Urban,Madhya Pradesh,Crime Against Women,Rape,Male,13-17,6015,1173,4842,2658,3357
2008,Rural,Nagaland,Crime Against Children,Trafficking,Male,31-45,121,91,30,92,29
2009,Urban,Mizoram,Crime Against Women,Dowry Deaths,Male,13-17,4664,4236,428,4534,130
2004,Urban,Uttarakhand,Crime Against Men,Murder,Female,31-45,5722,1726,3996,1895,3827
2006,Rural,Uttarakhand,Crime Against Men,Assault,Female,0-12,550,253,297,340,210
2004,Urban,Meghalaya,Crime Against Women,Domestic Violence,Female,60+,2083,1325,758,1915,168
2009,Urban,Rajasthan,Property Crime,Arson,Female,13-17,608,291,317,582,26
2007,Urban,Uttar Pradesh,Crime Against Men,Robbery,Female,31-45,7790,2471,5319,3296,4494
2010,Urban,Maharashtra,Crime Against Women,Molestation,Male,13-17,2657,1296,1361,1622,1035
2006,Rural,Rajasthan,Crime Against Children,Kidnapping,Female,31-45,1892,168,1724,1023,869
2002,Rural,Punjab,Other Crimes,Drug Offense,Female,46-60,4657,4534,123,4550,107
2001,Urban,Arunachal Pradesh,Crime Against Children,Child Labor,Male,46-60,942,498,444,703,239
2006,Urban,Karnataka,Property Crime,Burglary,Male,46-60,2050,1212,838,1518,532
2008,Urban,Uttar Pradesh,Crime Against Children,Child Abuse,Male,31-45,6748,129,6619,4174,2574
2007,Rural,Punjab,Crime Against Men,Extortion,Male,60+,7663,6084,1579,7487,176
2009,Urban,Haryana,Other Crimes,Drug Offense,Male,31-45,9963,6694,3269,7733,2230
2003,Urban,Bihar,Crime Against Children,Child Abuse,Male,13-17,4320,3371,949,3728,592
2001,Urban,Odisha,Property Crime,Theft,Male,13-17,5580,1608,3972,2001,3579
2006,Rural,Telangana,Other Crimes,Drug Offense,Male,60+,1959,621,1338,1158,801
2003,Rural,Mizoram,Crime Against Men,Extortion,Male,13-17,8777,2780,5997,5480,3297
2006,Rural,Madhya Pradesh,Crime Against Women,Molestation,Female,18-30,3898,2837,1061,3810,88
2006,Rural,Uttar Pradesh,Other Crimes,Corruption,Female,13-17,355,282,73,283,72
2010,Urban,Uttarakhand,Crime Against Children,Trafficking,Male,13-17,8890,3944,4946,5037,3853
2006,Rural,Punjab,Property Crime,Burglary,Male,0-12,6348,1040,5308,4352,1996
2006,Urban,Manipur,Other Crimes,Fraud,Male,60+,907,48,859,132,775
2010,Urban,Maharashtra,Crime Against Children,Trafficking,Male,18-30,4701,3368,1333,3513,1188
2008,Urban,Punjab,Crime Against Men,Extortion,Female,13-17,5563,5435,128,5499,64
2010,Rural,Jharkhand,Property Crime,Theft,Male,18-30,8799,7783,1016,8411,388
2003,Urban,Madhya Pradesh,Other Crimes,Fraud,Female,31-45,1206,1068,138,1105,101
2002,Urban,Haryana,Crime Against Children,Trafficking,Male,18-30,6473,6328,145,6420,53
2001,Rural,Delhi,Crime Against Men,Robbery,Male,13-17,871,159,712,860,11
2005,Rural,Delhi,Crime Against Men,Murder,Female,18-30,6952,5966,986,6150,802
2006,Urban,Goa,Crime Against Men,Assault,Male,13-17,8084,7752,332,7867,217
2007,Rural,Uttar Pradesh,Crime Against Children,Child Abuse,Female,46-60,2501,1528,973,1950,551
2010,Rural,Tamil Nadu,Crime Against Children,Trafficking,Male,31-45,6059,1390,4669,1693,4366
2010,Rural,Mizoram,Crime Against Men,Murder,Female,0-12,8327,2851,5476,5068,3259
2008,Urban,Nagaland,Other Crimes,Fraud,Female,31-45,2108,422,1686,1937,171
2003,Urban,Karnataka,Property Crime,Theft,Male,46-60,1082,672,410,700,382
2008,Rural,Maharashtra,Crime Against Women,Dowry Deaths,Male,18-30,5287,705,4582,1982,3305
2009,Rural,Uttarakhand,Other Crimes,Drug Offense,Female,0-12,8393,6600,1793,7146,1247
2004,Urban,Uttarakhand,Crime Against Women,Rape,Male,18-30,2078,1742,336,1864,214
2002,Rural,Arunachal Pradesh,Crime Against Women,Domestic Violence,Male,18-30,878,118,760,594,284
2004,Urban,Manipur,Other Crimes,Cyber Crime,Male,13-17,4951,1816,3135,3937,1014
2001,Rural,Rajasthan,Property Crime,Arson,Male,0-12,2036,868,1168,1109,927
2009,Rural,Madhya Pradesh,Crime Against Men,Robbery,Female,31-45,2256,955,1301,1674,582
2007,Rural,Meghalaya,Crime Against Children,Trafficking,Male,46-60,8511,2770,5741,3036,5475
2004,Urban,Punjab,Crime Against Men,Assault,Male,60+,948,680,268,895,53
2005,Urban,Bihar,Other Crimes,Drug Offense,Male,46-60,2548,2074,474,2279,269
2005,Urban,Andhra Pradesh,Crime Against Men,Murder,Male,13-17,5540,1945,3595,2755,2785
2010,Urban,Mizoram,Crime Against Women,Domestic Violence,Female,60+,1706,1282,424,1381,325
2007,Urban,Jammu & Kashmir,Crime Against Children,Child Labor,Female,60+,7793,4402,3391,6021,1772
2005,Urban,Tamil Nadu,Other Crimes,Fraud,Male,46-60,9944,8163,1781,8737,1207
2008,Urban,Telangana,Property Crime,Vandalism,Male,13-17,9025,4257,4768,7403,1622
2008,Rural,Haryana,Property Crime,Burglary,Female,0-12,7733,5549,2184,6570,1163
2003,Rural,Tamil Nadu,Other Crimes,Drug Offense,Female,31-45,3906,2,3904,1742,2164
2007,Rural,Jharkhand,Other Crimes,Fraud,Female,46-60,315,12,303,282,33
2004,Rural,Uttar Pradesh,Crime Against Children,Child Labor,Male,31-45,539,43,496,268,271
2006,Urban,Arunachal Pradesh,Crime Against Women,Domestic Violence,Male,31-45,2222,989,1233,1717,505
2008,Urban,Manipur,Crime Against Men,Murder,Female,31-45,7450,2060,5390,4438,3012
2008,Urban,Manipur,Other Crimes,Corruption,Female,18-30,643,100,543,573,70
2007,Urban,Maharashtra,Crime Against Men,Robbery,Male,13-17,4643,3107,1536,3240,1403
2001,Rural,Jammu & Kashmir,Crime Against Children,Kidnapping,Female,18-30,4852,1343,3509,4278,574
2003,Urban,Haryana,Crime Against Women,Molestation,Male,13-17,289,262,27,272,17
2009,Urban,Manipur,Property Crime,Arson,Male,0-12,8370,585,7785,3168,5202
2005,Urban,Karnataka,Property Crime,Vandalism,Female,18-30,8905,2355,6550,2428,6477
2003,Urban,West Bengal,Crime Against Women,Domestic Violence,Male,46-60,712,129,583,463,249
2004,Rural,Uttarakhand,Crime Against Children,Child Labor,Male,46-60,8269,6130,2139,6825,1444
2010,Rural,Telangana,Other Crimes,Cyber Crime,Male,46-60,6157,5544,613,5713,444
2004,Urban,Sikkim,Crime Against Children,Kidnapping,Female,13-17,1147,1100,47,1141,6
2009,Rural,Kerala,Crime Against Men,Extortion,Female,0-12,437,162,275,336,101
2010,Urban,Haryana,Crime Against Children,Kidnapping,Female,0-12,4374,4354,20,4369,5
2003,Rural,Tamil Nadu,Property Crime,Arson,Female,0-12,962,98,864,424,538
2005,Rural,Nagaland,Crime Against Children,Child Abuse,Female,18-30,1392,1004,388,1091,301
2009,Rural,Arunachal Pradesh,Crime Against Children,Child Abuse,Male,0-12,5383,450,4933,3734,1649
2002,Rural,Manipur,Crime Against Children,Trafficking,Female,18-30,7671,3783,3888,6672,999
2007,Urban,Nagaland,Crime Against Men,Extortion,Male,31-45,1349,1001,348,1179,170
2006,Urban,Gujarat,Crime Against Women,Domestic Violence,Male,31-45,5709,1261,4448,3585,2124
2004,Urban,Kerala,Other Crimes,Corruption,Female,13-17,5779,1837,3942,4131,1648
2003,Urban,Uttarakhand,Property Crime,Arson,Male,46-60,8598,311,8287,1197,7401
2007,Rural,Rajasthan,Crime Against Children,Trafficking,Male,46-60,85,66,19,68,17
2007,Urban,Telangana,Property Crime,Vandalism,Female,0-12,5145,3090,2055,3368,1777
2006,Urban,Madhya Pradesh,Crime Against Children,Kidnapping,Female,0-12,7994,122,7872,3793,4201
2008,Rural,Bihar,Crime Against Children,Child Abuse,Female,0-12,7725,7527,198,7562,163
2009,Rural,Assam,Property Crime,Theft,Female,18-30,5995,2227,3768,2890,3105
2005,Urban,Bihar,Other Crimes,Fraud,Male,46-60,8308,7455,853,7510,798
2004,Rural,Assam,Crime Against Women,Rape,Female,60+,4109,3346,763,3665,444
2006,Rural,Gujarat,Crime Against Children,Kidnapping,Female,31-45,2728,436,2292,2284,444
2010,Urban,Andhra Pradesh,Crime Against Men,Assault,Male,13-17,3325,2056,1269,2084,1241
2010,Urban,Chhattisgarh,Crime Against Children,Child Labor,Male,60+,9760,7475,2285,8074,1686
2008,Rural,Uttar Pradesh,Other Crimes,Cyber Crime,Female,18-30,2730,149,2581,309,2421
2004,Rural,Tripura,Crime Against Men,Assault,Female,31-45,202,130,72,161,41
2002,Rural,Bihar,Crime Against Children,Child Abuse,Female,0-12,1523,1012,511,1254,269
2007,Urban,Chhattisgarh,Crime Against Women,Dowry Deaths,Male,46-60,4577,2919,1658,3910,667
2002,Rural,Punjab,Crime Against Women,Domestic Violence,Male,18-30,3294,2588,706,2947,347
2007,Urban,Telangana,Property Crime,Theft,Male,46-60,6863,2305,4558,3881,2982
2010,Rural,Gujarat,Crime Against Men,Extortion,Female,46-60,7529,6184,1345,6319,1210
2008,Urban,Mizoram,Other Crimes,Corruption,Male,60+,1095,120,975,883,212
2005,Rural,Delhi,Crime Against Women,Domestic Violence,Male,0-12,494,157,337,223,271
2008,Rural,Rajasthan,Property Crime,Burglary,Female,31-45,9319,3328,5991,8717,602
2006,Rural,Meghalaya,Property Crime,Theft,Female,13-17,4874,2858,2016,3499,1375
2001,Rural,Delhi,Property Crime,Burglary,Male,46-60,8871,8862,9,8863,8
2007,Rural,Uttarakhand,Crime Against Men,Robbery,Female,60+,2948,1845,1103,2653,295
2001,Rural,Rajasthan,Crime Against Men,Murder,Female,46-60,1099,202,897,955,144
2001,Rural,Nagaland,Crime Against Men,Assault,Female,13-17,6820,1282,5538,3773,3047
2005,Rural,Uttar Pradesh,Crime Against Women,Dowry Deaths,Male,0-12,4735,1222,3513,2839,1896
2009,Rural,Gujarat,Crime Against Men,Extortion,Male,0-12,4550,3122,1428,4302,248
2003,Urban,Haryana,Crime Against Men,Extortion,Female,0-12,7020,770,6250,3007,4013
2008,Rural,Uttarakhand,Crime Against Men,Assault,Female,46-60,6041,485,5556,3273,2768
2007,Urban,Meghalaya,Property Crime,Arson,Male,18-30,5154,2148,3006,3168,1986
2002,Urban,Jammu & Kashmir,Crime Against Children,Kidnapping,Female,46-60,8645,4950,3695,6602,2043
2002,Urban,Nagaland,Crime Against Children,Child Abuse,Female,18-30,6435,3382,3053,3918,2517
2007,Rural,Karnataka,Other Crimes,Corruption,Male,0-12,2738,373,2365,877,1861
2007,Rural,Jharkhand,Crime Against Men,Assault,Female,31-45,8873,6200,2673,6371,2502
2009,Rural,Jammu & Kashmir,Crime Against Women,Dowry Deaths,Male,46-60,1372,1080,292,1363,9
2006,Urban,Mizoram,Crime Against Children,Child Labor,Female,46-60,8772,7683,1089,8673,99
2001,Rural,Maharashtra,Crime Against Women,Dowry Deaths,Male,0-12,5355,1843,3512,3518,1837
2008,Rural,Mizoram,Other Crimes,Drug Offense,Male,46-60,193,152,41,192,1
2007,Rural,Assam,Other Crimes,Corruption,Female,60+,3097,1665,1432,3019,78
2001,Urban,Manipur,Crime Against Men,Robbery,Female,13-17,5074,2628,2446,3383,1691
2008,Rural,Gujarat,Property Crime,Burglary,Male,60+,124,54,70,120,4
2010,Urban,West Bengal,Crime Against Women,Domestic Violence,Male,18-30,6841,997,5844,5258,1583
2003,Urban,Sikkim,Crime Against Men,Robbery,Female,0-12,7350,1841,5509,2449,4901
2003,Rural,Goa,Crime Against Men,Assault,Male,13-17,3823,248,3575,3543,280
2009,Rural,Madhya Pradesh,Crime Against Children,Trafficking,Male,46-60,214,123,91,177,37
2006,Urban,Tripura,Other Crimes,Drug Offense,Female,0-12,7098,5395,1703,6836,262
2010,Rural,Nagaland,Other Crimes,Fraud,Female,18-30,3598,2289,1309,2831,767
2005,Rural,Jharkhand,Crime Against Children,Trafficking,Female,18-30,2625,1853,772,2421,204
2003,Urban,Haryana,Crime Against Children,Kidnapping,Male,31-45,5068,1592,3476,2888,2180
2006,Urban,Tripura,Crime Against Children,Trafficking,Female,60+,1720,999,721,1589,131
2007,Rural,Punjab,Crime Against Children,Kidnapping,Male,46-60,1836,1472,364,1692,144
2002,Rural,Jharkhand,Other Crimes,Fraud,Male,18-30,8904,2663,6241,5172,3732
2001,Urban,Madhya Pradesh,Other Crimes,Cyber Crime,Female,46-60,9997,1484,8513,7464,2533
2010,Urban,Manipur,Property Crime,Theft,Male,13-17,1196,751,445,797,399
2003,Urban,Madhya Pradesh,Crime Against Men,Robbery,Female,0-12,1484,538,946,1048,436
2006,Rural,Maharashtra,Crime Against Children,Trafficking,Female,13-17,7339,2972,4367,3209,4130
2002,Rural,West Bengal,Other Crimes,Cyber Crime,Male,31-45,3063,723,2340,2435,628
2004,Urban,Kerala,Property Crime,Vandalism,Female,18-30,8490,3600,4890,4893,3597
2008,Rural,Odisha,Crime Against Men,Robbery,Male,31-45,3391,332,3059,2928,463
2008,Urban,Chhattisgarh,Crime Against Women,Molestation,Female,13-17,5879,4034,1845,4500,1379
2001,Urban,Sikkim,Crime Against Men,Extortion,Male,18-30,2018,1710,308,1953,65
2001,Urban,Arunachal Pradesh,Property Crime,Vandalism,Female,0-12,6010,4107,1903,5078,932
2004,Rural,Chhattisgarh,Property Crime,Burglary,Male,0-12,5300,5223,77,5239,61
2005,Rural,Punjab,Property Crime,Burglary,Female,46-60,8875,2154,6721,3328,5547
2002,Urban,Uttarakhand,Crime Against Children,Trafficking,Female,46-60,3603,1220,2383,3050,553
2006,Rural,Gujarat,Crime Against Men,Robbery,Female,0-12,2777,630,2147,990,1787
2008,Urban,Odisha,Other Crimes,Drug Offense,Female,46-60,907,8,899,180,727
2005,Urban,Odisha,Other Crimes,Drug Offense,Male,46-60,8594,3959,4635,6775,1819
2007,Urban,Andhra Pradesh,Crime Against Men,Assault,Female,18-30,6234,3837,2397,3840,2394
2004,Rural,Kerala,Other Crimes,Fraud,Female,46-60,5160,2429,2731,5081,79
2008,Rural,Meghalaya,Property Crime,Arson,Female,18-30,8584,2386,6198,6471,2113
2004,Rural,Mizoram,Other Crimes,Drug Offense,Female,18-30,1006,703,303,708,298
2004,Rural,Tamil Nadu,Crime Against Women,Dowry Deaths,Female,0-12,3450,548,2902,3101,349
2001,Urban,Madhya Pradesh,Crime Against Women,Rape,Female,0-12,3941,3769,172,3879,62
2006,Rural,Telangana,Property Crime,Arson,Male,60+,9291,5343,3948,5357,3934
2006,Rural,Andhra Pradesh,Property Crime,Vandalism,Male,31-45,8745,477,8268,2122,6623
2004,Urban,Meghalaya,Crime Against Men,Assault,Male,46-60,8007,2051,5956,7425,582
2007,Urban,Uttarakhand,Property Crime,Arson,Female,31-45,6811,2815,3996,2886,3925
2009,Urban,Meghalaya,Crime Against Women,Domestic Violence,Male,13-17,2974,2124,850,2500,474
2007,Urban,Maharashtra,Other Crimes,Fraud,Female,13-17,9905,3943,5962,9781,124
2001,Urban,Arunachal Pradesh,Other Crimes,Drug Offense,Male,60+,5730,3479,2251,4361,1369
2001,Urban,Jammu & Kashmir,Crime Against Women,Dowry Deaths,Female,18-30,4892,3585,1307,3741,1151
2006,Rural,Meghalaya,Property Crime,Vandalism,Female,13-17,8792,363,8429,8514,278
2010,Urban,Bihar,Crime Against Men,Murder,Female,18-30,3823,535,3288,960,2863
2010,Rural,Karnataka,Crime Against Children,Child Abuse,Female,31-45,8999,8598,401,8688,311
2002,Rural,Telangana,Property Crime,Vandalism,Female,31-45,6919,5170,1749,6163,756
2004,Rural,Haryana,Crime Against Women,Domestic Violence,Male,31-45,3373,396,2977,2298,1075
2006,Urban,Tamil Nadu,Property Crime,Arson,Female,60+,8247,779,7468,7337,910
2003,Rural,Goa,Crime Against Men,Murder,Female,13-17,6267,5639,628,6258,9
2006,Urban,Jammu & Kashmir,Crime Against Children,Kidnapping,Female,31-45,2481,2478,3,2478,3
2008,Rural,Karnataka,Crime Against Children,Child Labor,Female,18-30,7507,6818,689,7033,474
2004,Urban,Delhi,Property Crime,Theft,Male,46-60,6335,2781,3554,4622,1713
2004,Urban,Sikkim,Crime Against Women,Molestation,Female,60+,5033,489,4544,1182,3851
2010,Rural,Jharkhand,Crime Against Men,Robbery,Female,60+,8541,2749,5792,8181,360
2005,Rural,Tamil Nadu,Other Crimes,Drug Offense,Female,46-60,5435,1852,3583,4840,595
2010,Rural,Jharkhand,Crime Against Women,Domestic Violence,Male,31-45,4571,131,4440,511,4060
2009,Urban,Mizoram,Property Crime,Arson,Male,31-45,5599,4328,1271,5448,151
2005,Rural,Uttarakhand,Crime Against Children,Trafficking,Female,0-12,7808,1307,6501,5627,2181
2004,Urban,Meghalaya,Crime Against Children,Child Labor,Female,13-17,6795,6516,279,6526,269
2007,Rural,Goa,Crime Against Men,Assault,Male,18-30,6586,2558,4028,4954,1632
2005,Rural,Assam,Crime Against Children,Child Abuse,Female,18-30,1259,554,705,607,652
2004,Rural,Jharkhand,Crime Against Children,Child Abuse,Male,18-30,643,50,593,332,311
2005,Rural,Uttar Pradesh,Crime Against Children,Kidnapping,Female,31-45,4924,3700,1224,4382,542
2004,Urban,Punjab,Other Crimes,Cyber Crime,Female,0-12,824,533,291,779,45
2003,Rural,Maharashtra,Crime Against Women,Dowry Deaths,Male,46-60,6697,3242,3455,6088,609
2007,Urban,Madhya Pradesh,Crime Against Men,Robbery,Female,60+,6617,1894,4723,1918,4699
2007,Rural,Delhi,Other Crimes,Fraud,Female,0-12,2271,1965,306,2060,211
2010,Rural,Tripura,Crime Against Men,Murder,Female,0-12,7309,5072,2237,5556,1753
2002,Urban,Sikkim,Other Crimes,Fraud,Male,13-17,2712,1524,1188,1681,1031
2008,Rural,Assam,Other Crimes,Fraud,Female,60+,7917,2626,5291,7347,570
2004,Rural,Tripura,Other Crimes,Fraud,Male,13-17,4424,1441,2983,3902,522
2007,Rural,Manipur,Crime Against Men,Assault,Male,46-60,9834,613,9221,2439,7395
2001,Rural,Delhi,Crime Against Children,Child Labor,Female,31-45,1430,492,938,1288,142
2003,Urban,Arunachal Pradesh,Crime Against Men,Assault,Female,18-30,6797,2007,4790,2581,4216
2005,Rural,Manipur,Other Crimes,Cyber Crime,Female,60+,5899,3289,2610,3899,2000
2009,Urban,Bihar,Crime Against Women,Domestic Violence,Male,31-45,5899,4747,1152,5235,664
2001,Rural,Mizoram,Other Crimes,Drug Offense,Male,18-30,4290,2444,1846,2568,1722
2007,Rural,Meghalaya,Property Crime,Vandalism,Female,46-60,6653,6243,410,6275,378
2008,Rural,Uttarakhand,Crime Against Children,Child Abuse,Male,13-17,6367,3601,2766,5983,384
2003,Rural,Arunachal Pradesh,Crime Against Women,Molestation,Female,18-30,8724,382,8342,7627,1097
2002,Urban,Himachal Pradesh,Property Crime,Burglary,Male,31-45,1215,453,762,898,317
2007,Urban,Telangana,Crime Against Women,Domestic Violence,Male,13-17,3717,3556,161,3661,56
2007,Rural,Uttar Pradesh,Other Crimes,Drug Offense,Male,31-45,8646,3917,4729,7774,872
2005,Urban,Bihar,Crime Against Women,Domestic Violence,Male,13-17,963,468,495,668,295
2010,Rural,Assam,Property Crime,Theft,Male,18-30,9970,5115,4855,5558,4412
2005,Rural,Andhra Pradesh,Crime Against Men,Robbery,Male,0-12,3790,1753,2037,3375,415
2004,Urban,Odisha,Other Crimes,Corruption,Female,18-30,3665,1324,2341,1587,2078
2009,Rural,Bihar,Crime Against Women,Rape,Male,13-17,3529,2372,1157,3362,167
2009,Rural,Assam,Other Crimes,Drug Offense,Male,13-17,5570,2683,2887,4893,677
2010,Urban,Jammu & Kashmir,Other Crimes,Corruption,Male,13-17,3521,3079,442,3143,378
2010,Rural,Goa,Crime Against Men,Robbery,Female,13-17,1144,584,560,638,506
2001,Rural,Rajasthan,Crime Against Women,Domestic Violence,Male,13-17,8698,3681,5017,4190,4508
2007,Rural,Arunachal Pradesh,Crime Against Women,Domestic Violence,Female,31-45,4563,4377,186,4552,11
2002,Urban,Jharkhand,Crime Against Women,Molestation,Female,0-12,8918,2217,6701,8606,312
2003,Urban,Delhi,Crime Against Men,Extortion,Female,60+,5203,2570,2633,2977,2226
2001,Urban,Delhi,Crime Against Women,Domestic Violence,Male,13-17,7723,6970,753,7421,302
2003,Rural,Madhya Pradesh,Crime Against Men,Extortion,Female,46-60,8641,194,8447,325,8316
2009,Urban,Himachal Pradesh,Property Crime,Vandalism,Female,18-30,861,56,805,828,33
2010,Rural,Odisha,Crime Against Men,Robbery,Male,0-12,4642,1621,3021,4641,1
2009,Urban,Nagaland,Crime Against Children,Kidnapping,Female,0-12,1002,419,583,788,214
2005,Urban,Rajasthan,Property Crime,Burglary,Male,0-12,130,87,43,123,7
2007,Urban,Manipur,Crime Against Women,Dowry Deaths,Male,0-12,3358,835,2523,3199,159
2004,Urban,Chhattisgarh,Other Crimes,Cyber Crime,Male,13-17,3436,1728,1708,2689,747
2001,Rural,Delhi,Crime Against Children,Trafficking,Male,18-30,3615,759,2856,3251,364
2010,Urban,Himachal Pradesh,Other Crimes,Corruption,Female,46-60,6673,2338,4335,3466,3207
2005,Rural,Odisha,Crime Against Women,Domestic Violence,Female,60+,2389,2084,305,2118,271
2002,Urban,Uttar Pradesh,Property Crime,Arson,Female,60+,1750,894,856,1615,135
2005,Urban,Odisha,Property Crime,Arson,Female,18-30,9407,1197,8210,6773,2634
2001,Urban,Manipur,Crime Against Men,Murder,Male,13-17,3451,1993,1458,3338,113
2005,Urban,Madhya Pradesh,Crime Against Men,Assault,Female,13-17,1872,609,1263,704,1168
2001,Urban,Manipur,Crime Against Men,Assault,Male,0-12,4298,348,3950,3574,724
2001,Urban,Uttar Pradesh,Property Crime,Vandalism,Male,46-60,8219,3559,4660,3712,4507
2008,Urban,Tamil Nadu,Crime Against Children,Child Labor,Male,31-45,7443,6372,1071,7245,198
2006,Rural,Mizoram,Property Crime,Burglary,Female,60+,3210,1834,1376,2959,251
2003,Urban,Chhattisgarh,Crime Against Women,Dowry Deaths,Male,46-60,6868,726,6142,1455,5413
2001,Urban,Sikkim,Other Crimes,Fraud,Female,13-17,9503,1978,7525,4430,5073
2005,Urban,Madhya Pradesh,Crime Against Children,Child Abuse,Male,18-30,799,295,504,765,34
2003,Urban,Nagaland,Crime Against Children,Kidnapping,Female,0-12,7112,1537,5575,3196,3916
2005,Rural,Andhra Pradesh,Crime Against Men,Extortion,Male,46-60,6713,2134,4579,2282,4431
2007,Urban,Haryana,Other Crimes,Corruption,Female,18-30,2178,1247,931,2075,103
2002,Rural,Chhattisgarh,Crime Against Children,Kidnapping,Female,13-17,2427,1857,570,1924,503
2006,Rural,Andhra Pradesh,Crime Against Men,Murder,Male,18-30,7618,1944,5674,2445,5173
2010,Rural,Tamil Nadu,Crime Against Women,Domestic Violence,Male,60+,7613,2477,5136,2571,5042
2003,Urban,Assam,Crime Against Men,Assault,Female,60+,2924,2748,176,2800,124
2010,Urban,West Bengal,Crime Against Women,Domestic Violence,Female,0-12,4196,2904,1292,3958,238
2005,Urban,Assam,Crime Against Women,Dowry Deaths,Male,18-30,3800,3471,329,3575,225
2006,Rural,Haryana,Crime Against Children,Child Labor,Female,0-12,7734,2150,5584,6573,1161
2010,Urban,Nagaland,Property Crime,Burglary,Male,46-60,9265,2076,7189,8313,952
2001,Urban,Punjab,Crime Against Men,Robbery,Female,0-12,326,172,154,283,43
2010,Rural,Kerala,Other Crimes,Drug Offense,Male,0-12,366,69,297,77,289
2009,Rural,Punjab,Crime Against Men,Murder,Male,31-45,7863,4267,3596,6382,1481
2004,Rural,Assam,Crime Against Men,Extortion,Male,46-60,7028,5256,1772,6531,497
2006,Rural,Odisha,Crime Against Women,Dowry Deaths,Female,13-17,5618,2117,3501,4130,1488
2005,Rural,West Bengal,Crime Against Men,Assault,Female,0-12,3935,3090,845,3639,296
2008,Rural,Punjab,Crime Against Men,Murder,Male,60+,8581,3056,5525,6135,2446
2007,Urban,Punjab,Crime Against Women,Rape,Female,46-60,6880,4815,2065,6852,28
2005,Rural,Jharkhand,Crime Against Children,Child Abuse,Female,60+,8651,2013,6638,7698,953
2002,Rural,Jharkhand,Property Crime,Burglary,Female,46-60,6621,1190,5431,5266,1355
2008,Rural,Maharashtra,Crime Against Children,Kidnapping,Male,31-45,6025,2449,3576,5963,62
2004,Rural,Tripura,Property Crime,Vandalism,Male,18-30,9617,5943,3674,6295,3322
2002,Urban,Goa,Crime Against Children,Child Labor,Female,31-45,6201,3197,3004,3570,2631
2002,Rural,Jharkhand,Crime Against Men,Murder,Male,13-17,465,163,302,350,115
2008,Rural,Nagaland,Other Crimes,Fraud,Female,60+,8334,6817,1517,8006,328
2010,Rural,Manipur,Property Crime,Arson,Male,18-30,3824,1125,2699,2450,1374
2001,Rural,Madhya Pradesh,Crime Against Men,Extortion,Male,18-30,4279,1497,2782,1837,2442
2005,Urban,Manipur,Crime Against Men,Robbery,Male,60+,4474,1529,2945,3591,883
2005,Rural,Kerala,Crime Against Men,Extortion,Female,60+,8377,957,7420,6723,1654
2010,Urban,Madhya Pradesh,Property Crime,Theft,Female,46-60,8735,2987,5748,3313,5422
2001,Rural,Jammu & Kashmir,Property Crime,Burglary,Male,60+,1785,1750,35,1783,2
2008,Rural,Telangana,Property Crime,Arson,Female,31-45,6653,392,6261,2271,4382
2002,Rural,Chhattisgarh,Property Crime,Theft,Male,0-12,855,17,838,559,296
2003,Urban,Andhra Pradesh,Crime Against Children,Trafficking,Male,60+,1946,1160,786,1427,519
2008,Rural,Kerala,Crime Against Men,Extortion,Female,31-45,2761,1479,1282,1807,954
2010,Rural,Uttar Pradesh,Other Crimes,Cyber Crime,Female,46-60,9303,2718,6585,3635,5668
2001,Rural,Kerala,Property Crime,Arson,Female,0-12,9341,6521,2820,8677,664
2009,Urban,Punjab,Other Crimes,Corruption,Female,46-60,1746,923,823,1137,609
2008,Urban,Tripura,Other Crimes,Corruption,Female,18-30,2733,757,1976,1578,1155
2007,Urban,Goa,Property Crime,Burglary,Male,31-45,896,53,843,750,146
2001,Urban,Jharkhand,Crime Against Men,Assault,Female,18-30,9680,2825,6855,9609,71
2010,Urban,Tripura,Other Crimes,Drug Offense,Male,18-30,6837,5026,1811,5391,1446
2010,Rural,Madhya Pradesh,Crime Against Women,Molestation,Female,13-17,3895,2709,1186,3056,839
2006,Urban,Odisha,Property Crime,Theft,Male,46-60,6247,1844,4403,5980,267
2004,Rural,Rajasthan,Property Crime,Arson,Female,0-12,5088,2398,2690,4163,925
2006,Rural,Nagaland,Crime Against Children,Kidnapping,Female,13-17,7257,770,6487,3393,3864
2003,Rural,Andhra Pradesh,Crime Against Women,Rape,Female,60+,74,36,38,39,35
2003,Rural,Tripura,Crime Against Children,Trafficking,Male,46-60,8791,2258,6533,7305,1486
2001,Rural,Meghalaya,Crime Against Children,Child Abuse,Female,46-60,8461,1664,6797,4630,3831
2005,Rural,Himachal Pradesh,Crime Against Women,Molestation,Female,31-45,1516,341,1175,1414,102
2005,Rural,Punjab,Crime Against Women,Dowry Deaths,Male,46-60,9919,2818,7101,9900,19
2006,Urban,Uttarakhand,Crime Against Women,Domestic Violence,Female,31-45,2106,1012,1094,1173,933
2002,Urban,Karnataka,Property Crime,Vandalism,Female,31-45,1857,1143,714,1818,39
2006,Urban,Tripura,Property Crime,Vandalism,Female,46-60,730,115,615,559,171
2010,Rural,Rajasthan,Crime Against Children,Child Abuse,Female,60+,8796,5856,2940,7236,1560
2003,Rural,Tripura,Crime Against Men,Robbery,Female,31-45,3814,143,3671,3606,208
2008,Rural,Meghalaya,Crime Against Men,Robbery,Male,18-30,8508,1462,7046,4808,3700
2007,Rural,Mizoram,Property Crime,Burglary,Male,0-12,7011,5588,1423,6080,931
2009,Rural,Uttar Pradesh,Property Crime,Burglary,Male,0-12,8492,5983,2509,6097,2395
2003,Urban,Meghalaya,Crime Against Children,Kidnapping,Female,46-60,8812,32,8780,2884,5928
2007,Rural,Uttarakhand,Crime Against Children,Child Abuse,Female,60+,2180,1244,936,1420,760
2002,Rural,Punjab,Crime Against Children,Kidnapping,Male,60+,9637,5359,4278,5810,3827
2001,Rural,Arunachal Pradesh,Crime Against Women,Rape,Female,31-45,4249,3680,569,4176,73
2004,Rural,Himachal Pradesh,Crime Against Children,Child Labor,Male,18-30,88,69,19,87,1
2003,Urban,Goa,Crime Against Women,Molestation,Female,60+,7848,3286,4562,6331,1517
2009,Rural,Tripura,Crime Against Women,Rape,Female,0-12,5835,662,5173,5269,566
2001,Urban,Chhattisgarh,Crime Against Children,Trafficking,Male,60+,2838,435,2403,1530,1308
2010,Rural,Haryana,Crime Against Women,Dowry Deaths,Female,13-17,1208,266,942,983,225
2007,Rural,Uttarakhand,Crime Against Women,Molestation,Female,31-45,9575,7295,2280,7776,1799
2004,Urban,West Bengal,Crime Against Men,Robbery,Female,31-45,9832,6385,3447,9236,596
2010,Urban,Telangana,Crime Against Children,Trafficking,Male,60+,2752,910,1842,965,1787
2005,Urban,Jammu & Kashmir,Crime Against Women,Molestation,Male,46-60,5955,4018,1937,5719,236
2003,Urban,Tamil Nadu,Crime Against Women,Molestation,Female,0-12,1842,544,1298,961,881
2003,Urban,Gujarat,Crime Against Men,Assault,Female,13-17,2413,1436,977,2177,236
2004,Rural,Jharkhand,Crime Against Women,Domestic Violence,Female,13-17,7028,2531,4497,4223,2805
2008,Urban,Gujarat,Crime Against Men,Assault,Female,46-60,1969,1924,45,1950,19
2006,Rural,Jharkhand,Crime Against Children,Trafficking,Male,13-17,3155,2250,905,2724,431
2005,Rural,Chhattisgarh,Property Crime,Vandalism,Male,46-60,9500,4978,4522,8762,738
2007,Rural,West Bengal,Crime Against Men,Robbery,Male,31-45,9238,8903,335,9056,182
2005,Rural,Assam,Other Crimes,Cyber Crime,Male,13-17,9151,7855,1296,8646,505
2009,Rural,Maharashtra,Crime Against Children,Child Abuse,Male,31-45,2496,1621,875,1838,658
2003,Urban,Madhya Pradesh,Other Crimes,Fraud,Male,31-45,4484,2813,1671,4331,153
2010,Rural,Jammu & Kashmir,Crime Against Men,Extortion,Female,13-17,3473,1647,1826,2985,488
2008,Urban,Andhra Pradesh,Crime Against Men,Assault,Male,46-60,5202,2933,2269,4796,406
2002,Rural,Maharashtra,Crime Against Women,Domestic Violence,Female,31-45,2218,1663,555,2000,218
2010,Urban,Punjab,Crime Against Women,Molestation,Female,31-45,6138,4351,1787,4760,1378
2006,Urban,Tamil Nadu,Crime Against Men,Assault,Male,46-60,7204,281,6923,2080,5124
2008,Rural,Jammu & Kashmir,Other Crimes,Cyber Crime,Female,46-60,2648,111,2537,599,2049
2008,Rural,Sikkim,Crime Against Children,Trafficking,Female,46-60,6659,5740,919,5848,811
2003,Rural,Maharashtra,Crime Against Women,Molestation,Male,31-45,7677,5911,1766,7156,521
2001,Urban,Meghalaya,Crime Against Men,Robbery,Female,0-12,5675,794,4881,845,4830
2010,Rural,Chhattisgarh,Other Crimes,Cyber Crime,Female,18-30,6103,2499,3604,5555,548
2009,Rural,Telangana,Crime Against Women,Molestation,Female,13-17,6479,2676,3803,4380,2099
2004,Urban,Rajasthan,Property Crime,Burglary,Male,13-17,5469,1143,4326,4577,892
2002,Rural,Uttarakhand,Other Crimes,Fraud,Female,46-60,8379,931,7448,6220,2159
2004,Urban,Jammu & Kashmir,Crime Against Women,Rape,Female,31-45,9756,3979,5777,7983,1773
2002,Urban,Gujarat,Crime Against Children,Kidnapping,Male,31-45,2841,1520,1321,2222,619
2006,Rural,Uttar Pradesh,Property Crime,Burglary,Male,0-12,3310,788,2522,2479,831
2003,Urban,Gujarat,Crime Against Children,Child Labor,Male,13-17,5039,3558,1481,3757,1282
2010,Rural,Telangana,Other Crimes,Fraud,Female,13-17,1283,510,773,1140,143
2001,Rural,Tripura,Crime Against Children,Child Labor,Male,0-12,7463,147,7316,1738,5725
2004,Rural,Meghalaya,Crime Against Men,Murder,Female,13-17,4904,2055,2849,3101,1803
2009,Urban,Jharkhand,Crime Against Men,Robbery,Male,60+,9682,8301,1381,9581,101
2004,Rural,Delhi,Other Crimes,Fraud,Male,31-45,6719,6099,620,6153,566
2004,Rural,Himachal Pradesh,Crime Against Children,Trafficking,Male,46-60,9387,9235,152,9293,94
2006,Urban,Karnataka,Crime Against Children,Trafficking,Male,13-17,584,298,286,343,241
2008,Rural,Chhattisgarh,Property Crime,Burglary,Male,46-60,9364,6921,2443,8290,1074
2008,Rural,Meghalaya,Crime Against Women,Dowry Deaths,Male,31-45,2036,437,1599,1453,583
2006,Rural,Manipur,Crime Against Children,Child Abuse,Male,13-17,2681,840,1841,1805,876
2009,Urban,Rajasthan,Crime Against Men,Robbery,Male,31-45,6645,2935,3710,4493,2152
2006,Rural,Uttarakhand,Crime Against Children,Child Labor,Female,13-17,9872,6157,3715,7116,2756
2009,Urban,Mizoram,Crime Against Children,Trafficking,Female,18-30,142,75,67,96,46
2009,Rural,Tripura,Property Crime,Burglary,Male,0-12,409,331,78,347,62
2007,Urban,Tripura,Other Crimes,Corruption,Female,0-12,4918,2807,2111,4317,601
2008,Urban,Assam,Property Crime,Arson,Male,0-12,195,189,6,195,0
2002,Urban,Karnataka,Crime Against Children,Child Abuse,Male,18-30,7258,6882,376,7143,115
2002,Urban,Himachal Pradesh,Crime Against Women,Domestic Violence,Male,31-45,3306,430,2876,1324,1982
2006,Rural,Telangana,Other Crimes,Drug Offense,Female,31-45,8009,4775,3234,5767,2242
2010,Urban,Himachal Pradesh,Crime Against Men,Extortion,Male,46-60,7608,6932,676,7324,284
2005,Rural,Gujarat,Crime Against Children,Child Labor,Male,13-17,8145,2981,5164,7094,1051
2001,Urban,Jammu & Kashmir,Crime Against Women,Rape,Female,46-60,9452,8411,1041,9449,3
2010,Urban,Mizoram,Crime Against Children,Trafficking,Female,0-12,3958,2962,996,3572,386
2010,Urban,Jharkhand,Crime Against Children,Child Labor,Female,18-30,337,246,91,282,55
2009,Rural,Kerala,Other Crimes,Corruption,Female,13-17,9140,6999,2141,7733,1407
2003,Urban,Andhra Pradesh,Crime Against Women,Molestation,Female,46-60,4410,1131,3279,3893,517
2010,Rural,Rajasthan,Other Crimes,Fraud,Male,0-12,7611,4988,2623,5776,1835
2002,Urban,Arunachal Pradesh,Crime Against Children,Child Abuse,Female,13-17,6292,1369,4923,5583,709
2005,Rural,Bihar,Property Crime,Vandalism,Female,31-45,149,88,61,105,44
2003,Rural,Maharashtra,Crime Against Men,Assault,Male,18-30,170,73,97,110,60
2001,Urban,Jharkhand,Crime Against Men,Murder,Female,60+,6932,2786,4146,6644,288
2004,Urban,Uttar Pradesh,Other Crimes,Drug Offense,Male,18-30,8456,1512,6944,4107,4349
2009,Rural,Chhattisgarh,Other Crimes,Fraud,Female,0-12,9540,3836,5704,5331,4209
2009,Rural,Uttarakhand,Crime Against Men,Assault,Female,13-17,7889,3749,4140,4085,3804
2001,Rural,West Bengal,Crime Against Women,Rape,Male,13-17,4661,1992,2669,4441,220
2006,Urban,Meghalaya,Crime Against Children,Child Labor,Male,0-12,6108,5945,163,5995,113
2007,Rural,Assam,Crime Against Women,Dowry Deaths,Female,0-12,6521,2926,3595,4768,1753
2004,Rural,Maharashtra,Crime Against Men,Assault,Female,13-17,208,85,123,87,121
2010,Urban,Punjab,Other Crimes,Cyber Crime,Female,13-17,8838,5192,3646,5476,3362
2006,Rural,Rajasthan,Crime Against Men,Assault,Female,18-30,8706,352,8354,7564,1142
2009,Urban,Rajasthan,Property Crime,Theft,Female,18-30,3454,3022,432,3409,45
2008,Urban,Jammu & Kashmir,Other Crimes,Fraud,Female,18-30,4641,2905,1736,4493,148
2003,Urban,West Bengal,Crime Against Children,Kidnapping,Male,31-45,1215,867,348,894,321
2002,Rural,Haryana,Property Crime,Arson,Male,46-60,5397,2803,2594,3763,1634
2006,Rural,Telangana,Crime Against Children,Child Labor,Male,13-17,3129,1647,1482,2880,249
2010,Urban,Madhya Pradesh,Property Crime,Arson,Male,13-17,2044,1474,570,1791,253
2007,Urban,Andhra Pradesh,Crime Against Men,Extortion,Female,18-30,1712,1047,665,1297,415
2002,Urban,Jharkhand,Crime Against Women,Dowry Deaths,Female,13-17,3314,434,2880,2954,360
2009,Urban,Nagaland,Crime Against Women,Domestic Violence,Male,0-12,3901,3156,745,3711,190
2009,Rural,Assam,Property Crime,Burglary,Male,31-45,9504,9126,378,9440,64
2001,Urban,Uttar Pradesh,Crime Against Men,Robbery,Male,60+,5872,2770,3102,4091,1781
2010,Rural,Meghalaya,Property Crime,Burglary,Female,13-17,2878,61,2817,2839,39
2004,Urban,Madhya Pradesh,Other Crimes,Cyber Crime,Female,46-60,4428,4081,347,4193,235
2004,Urban,Meghalaya,Crime Against Men,Assault,Male,13-17,2732,2283,449,2593,139
2007,Urban,Arunachal Pradesh,Crime Against Children,Child Abuse,Male,18-30,4512,4124,388,4397,115
2004,Urban,Uttar Pradesh,Crime Against Children,Child Abuse,Male,60+,2148,374,1774,722,1426
2003,Urban,Karnataka,Other Crimes,Cyber Crime,Female,18-30,7460,4189,3271,5252,2208
2009,Rural,Arunachal Pradesh,Crime Against Women,Molestation,Female,60+,5319,4926,393,4970,349
2004,Rural,Rajasthan,Other Crimes,Drug Offense,Male,18-30,9739,3460,6279,8517,1222
2006,Urban,Odisha,Crime Against Women,Domestic Violence,Female,60+,1358,307,1051,1225,133
2003,Urban,Goa,Crime Against Children,Child Abuse,Male,0-12,8287,2635,5652,5467,2820
2003,Rural,Andhra Pradesh,Crime Against Men,Robbery,Female,13-17,1259,373,886,1218,41
2006,Rural,Madhya Pradesh,Crime Against Children,Child Abuse,Male,60+,8164,3820,4344,5002,3162
2007,Urban,Madhya Pradesh,Other Crimes,Corruption,Male,31-45,2720,735,1985,1660,1060
2009,Urban,Chhattisgarh,Crime Against Children,Trafficking,Male,46-60,8700,3993,4707,6036,2664
2001,Urban,Chhattisgarh,Crime Against Men,Murder,Female,31-45,7791,953,6838,2037,5754
2009,Rural,Assam,Other Crimes,Drug Offense,Female,31-45,2776,2311,465,2677,99
2006,Rural,Assam,Crime Against Children,Kidnapping,Female,18-30,1587,729,858,1404,183
2004,Rural,Maharashtra,Crime Against Women,Dowry Deaths,Male,60+,9510,6091,3419,9465,45
2005,Urban,Mizoram,Crime Against Men,Robbery,Female,46-60,2002,1614,388,1709,293
2001,Rural,Assam,Crime Against Children,Child Labor,Male,46-60,5822,5614,208,5722,100
2006,Rural,Mizoram,Crime Against Men,Robbery,Male,0-12,9135,7037,2098,7947,1188
2009,Rural,Punjab,Crime Against Men,Assault,Male,60+,3130,497,2633,2405,725
2007,Rural,Kerala,Crime Against Men,Murder,Female,46-60,3387,2517,870,3008,379
2009,Urban,Kerala,Other Crimes,Cyber Crime,Female,46-60,5810,5130,680,5443,367
2010,Urban,Telangana,Crime Against Children,Child Abuse,Female,18-30,8418,1089,7329,5087,3331
2006,Urban,Telangana,Crime Against Children,Child Labor,Male,60+,1224,880,344,1126,98
2001,Urban,Mizoram,Crime Against Women,Dowry Deaths,Female,60+,9147,35,9112,5981,3166
2003,Urban,Karnataka,Property Crime,Arson,Male,60+,7940,6862,1078,7373,567
2010,Rural,Meghalaya,Crime Against Men,Assault,Male,13-17,1863,1142,721,1561,302
2008,Rural,Manipur,Property Crime,Theft,Male,0-12,2647,1976,671,2596,51
2002,Urban,Goa,Other Crimes,Corruption,Male,13-17,3837,2771,1066,2911,926
2007,Rural,Mizoram,Other Crimes,Corruption,Male,0-12,5443,5424,19,5426,17
2006,Rural,Mizoram,Crime Against Men,Assault,Female,60+,802,343,459,383,419
2004,Rural,Delhi,Other Crimes,Fraud,Male,13-17,6344,4354,1990,4723,1621
2001,Urban,Mizoram,Other Crimes,Drug Offense,Male,31-45,7259,22,7237,2570,4689
2008,Urban,Chhattisgarh,Crime Against Women,Molestation,Female,18-30,7743,4494,3249,4674,3069
2002,Urban,Tamil Nadu,Property Crime,Arson,Female,0-12,2567,2397,170,2459,108
2005,Rural,Sikkim,Crime Against Children,Child Labor,Male,31-45,8201,7196,1005,8032,169
2009,Urban,Odisha,Property Crime,Vandalism,Female,18-30,2113,557,1556,1335,778
2002,Rural,Jammu & Kashmir,Other Crimes,Corruption,Male,60+,9560,8291,1269,8895,665
2005,Urban,Jharkhand,Crime Against Children,Kidnapping,Male,13-17,3293,2518,775,2566,727
2001,Urban,Goa,Property Crime,Vandalism,Female,13-17,2372,813,1559,1651,721
2002,Rural,Sikkim,Property Crime,Theft,Male,18-30,9569,3839,5730,8955,614
2001,Urban,Himachal Pradesh,Other Crimes,Corruption,Female,13-17,6186,3594,2592,5225,961
2004,Urban,Meghalaya,Crime Against Children,Kidnapping,Female,13-17,2421,890,1531,1919,502
2006,Rural,Jharkhand,Crime Against Women,Molestation,Female,60+,233,87,146,198,35
2007,Rural,Haryana,Property Crime,Burglary,Female,13-17,8090,4889,3201,5015,3075
2007,Rural,Bihar,Property Crime,Arson,Male,31-45,8331,5397,2934,8020,311
2004,Urban,Nagaland,Other Crimes,Drug Offense,Female,18-30,7524,5061,2463,5790,1734
2006,Rural,Telangana,Crime Against Men,Extortion,Male,46-60,6476,406,6070,6315,161
2005,Rural,Delhi,Crime Against Men,Robbery,Female,46-60,5470,2120,3350,3576,1894
2002,Urban,West Bengal,Property Crime,Burglary,Male,0-12,4837,560,4277,3478,1359
2005,Rural,Jharkhand,Crime Against Men,Murder,Male,60+,3818,3509,309,3590,228
2002,Urban,Uttarakhand,Property Crime,Arson,Female,46-60,2128,458,1670,1372,756
2010,Urban,Chhattisgarh,Property Crime,Vandalism,Male,60+,9362,4643,4719,6427,2935
2006,Urban,Odisha,Property Crime,Burglary,Male,18-30,5175,88,5087,4356,819
2004,Urban,Jammu & Kashmir,Crime Against Women,Dowry Deaths,Female,46-60,8072,6162,1910,6495,1577
2003,Rural,Andhra Pradesh,Property Crime,Theft,Female,18-30,909,65,844,158,751
2009,Urban,Tripura,Property Crime,Vandalism,Female,31-45,5677,319,5358,2740,2937
2007,Urban,Chhattisgarh,Crime Against Children,Trafficking,Male,18-30,9523,4350,5173,6990,2533
2002,Rural,Meghalaya,Crime Against Men,Assault,Male,60+,6620,2668,3952,5470,1150
2006,Urban,Mizoram,Crime Against Women,Dowry Deaths,Female,60+,7687,656,7031,2452,5235
2006,Urban,Rajasthan,Crime Against Men,Assault,Female,46-60,418,270,148,360,58
2009,Rural,Uttar Pradesh,Crime Against Children,Trafficking,Male,0-12,2560,1427,1133,1733,827
2004,Rural,Sikkim,Crime Against Men,Assault,Female,60+,3939,388,3551,511,3428
2009,Rural,Uttar Pradesh,Crime Against Children,Kidnapping,Male,0-12,9840,930,8910,6083,3757
2004,Urban,Mizoram,Property Crime,Arson,Female,13-17,2915,484,2431,1440,1475
2006,Urban,Uttar Pradesh,Property Crime,Theft,Male,46-60,6474,3355,3119,5581,893
2003,Rural,Punjab,Property Crime,Arson,Male,60+,2543,621,1922,1020,1523
2001,Urban,Odisha,Crime Against Men,Murder,Male,13-17,7166,1503,5663,6974,192
2010,Rural,Haryana,Property Crime,Burglary,Male,0-12,8057,1125,6932,3125,4932
2002,Rural,Mizoram,Other Crimes,Drug Offense,Female,60+,4400,3973,427,4059,341
2007,Urban,Punjab,Crime Against Children,Kidnapping,Female,60+,5884,2939,2945,3384,2500
2006,Urban,Nagaland,Crime Against Children,Child Abuse,Male,31-45,7083,5143,1940,6638,445
2007,Rural,Nagaland,Crime Against Men,Robbery,Male,46-60,7734,6542,1192,7095,639
2001,Rural,Meghalaya,Property Crime,Arson,Female,31-45,1048,931,117,955,93
2005,Urban,Haryana,Crime Against Children,Kidnapping,Male,18-30,2436,469,1967,525,1911
2001,Urban,Karnataka,Crime Against Men,Extortion,Male,46-60,7281,4493,2788,7261,20
2003,Rural,Haryana,Property Crime,Burglary,Male,46-60,3762,1120,2642,1728,2034
2005,Rural,Nagaland,Other Crimes,Corruption,Female,13-17,3530,2085,1445,3399,131
2004,Urban,Chhattisgarh,Property Crime,Vandalism,Male,46-60,3642,2487,1155,2717,925
2010,Rural,Rajasthan,Other Crimes,Cyber Crime,Female,46-60,5839,5169,670,5240,599
2001,Urban,Goa,Other Crimes,Cyber Crime,Male,31-45,2581,1477,1104,2263,318
2009,Rural,Himachal Pradesh,Crime Against Children,Trafficking,Male,31-45,8684,4221,4463,6277,2407
2001,Urban,Jharkhand,Other Crimes,Corruption,Female,46-60,9767,4140,5627,6003,3764
2007,Rural,Tamil Nadu,Crime Against Women,Molestation,Male,60+,3310,565,2745,3295,15
2007,Urban,Meghalaya,Other Crimes,Drug Offense,Male,60+,9508,3590,5918,5620,3888
2002,Rural,Sikkim,Other Crimes,Cyber Crime,Male,0-12,6581,335,6246,3867,2714
2006,Urban,Himachal Pradesh,Other Crimes,Drug Offense,Male,60+,502,390,112,418,84
2001,Rural,Nagaland,Other Crimes,Drug Offense,Female,46-60,1910,1412,498,1425,485
2009,Urban,Jammu & Kashmir,Crime Against Children,Child Abuse,Female,18-30,1319,379,940,790,529
2002,Urban,Manipur,Crime Against Women,Molestation,Male,13-17,81,8,73,45,36
2008,Urban,Andhra Pradesh,Other Crimes,Corruption,Female,18-30,606,4,602,81,525
2003,Rural,Kerala,Crime Against Women,Dowry Deaths,Female,46-60,8381,7898,483,8129,252
2003,Rural,West Bengal,Crime Against Women,Domestic Violence,Male,60+,5042,3763,1279,4363,679
2005,Rural,Jharkhand,Crime Against Children,Trafficking,Female,46-60,1412,969,443,1173,239
2001,Urban,Rajasthan,Crime Against Women,Dowry Deaths,Male,46-60,5953,1826,4127,5013,940
2007,Urban,Assam,Crime Against Men,Extortion,Male,31-45,8044,1838,6206,6503,1541
2004,Rural,Uttar Pradesh,Crime Against Children,Trafficking,Female,31-45,5822,5436,386,5437,385
2005,Urban,Chhattisgarh,Crime Against Women,Domestic Violence,Female,18-30,7441,2827,4614,4241,3200
2002,Rural,Andhra Pradesh,Crime Against Women,Rape,Male,46-60,1913,698,1215,952,961
2010,Urban,Uttarakhand,Crime Against Women,Dowry Deaths,Male,18-30,4847,177,4670,1743,3104
2004,Rural,Uttarakhand,Crime Against Men,Extortion,Male,31-45,1140,305,835,398,742
2002,Rural,Jammu & Kashmir,Crime Against Women,Domestic Violence,Male,46-60,8102,7170,932,7843,259
2005,Urban,Himachal Pradesh,Crime Against Men,Assault,Male,46-60,3283,2613,670,3257,26
2003,Urban,Nagaland,Crime Against Children,Child Labor,Female,0-12,9806,7159,2647,8649,1157
2004,Rural,Meghalaya,Crime Against Women,Dowry Deaths,Male,0-12,2906,2229,677,2679,227
2009,Urban,Karnataka,Crime Against Women,Rape,Female,31-45,6740,1075,5665,4789,1951
2008,Rural,Odisha,Crime Against Children,Child Labor,Male,46-60,6896,4027,2869,6745,151
2006,Rural,Arunachal Pradesh,Other Crimes,Fraud,Male,18-30,6630,3995,2635,4817,1813
2001,Rural,Bihar,Crime Against Men,Murder,Female,0-12,8447,5191,3256,5210,3237
2007,Rural,Uttar Pradesh,Crime Against Women,Rape,Female,18-30,3957,2014,1943,2200,1757
2005,Rural,Chhattisgarh,Property Crime,Burglary,Female,13-17,2743,830,1913,2272,471
2009,Rural,Mizoram,Crime Against Women,Domestic Violence,Female,60+,7184,40,7144,5638,1546
2003,Rural,Meghalaya,Property Crime,Theft,Female,31-45,1758,502,1256,796,962
2006,Rural,Jammu & Kashmir,Property Crime,Vandalism,Male,0-12,5347,2253,3094,2857,2490
2002,Rural,Tamil Nadu,Crime Against Children,Child Labor,Female,31-45,9426,1267,8159,6954,2472
2007,Rural,Meghalaya,Crime Against Women,Domestic Violence,Male,46-60,311,79,232,211,100
2005,Rural,Himachal Pradesh,Property Crime,Theft,Female,0-12,5029,847,4182,4999,30
2003,Urban,Telangana,Crime Against Men,Murder,Female,0-12,5224,2346,2878,2760,2464
2005,Rural,Rajasthan,Crime Against Men,Robbery,Male,0-12,8968,7542,1426,8701,267
2006,Urban,West Bengal,Crime Against Men,Extortion,Female,60+,2324,1481,843,1846,478
2004,Rural,Arunachal Pradesh,Other Crimes,Cyber Crime,Male,60+,6076,117,5959,5962,114
2010,Rural,Rajasthan,Other Crimes,Fraud,Female,0-12,6812,4696,2116,6629,183
2006,Urban,Delhi,Crime Against Women,Domestic Violence,Female,31-45,2515,90,2425,2288,227
2002,Urban,Uttarakhand,Crime Against Women,Rape,Female,46-60,2434,2356,78,2420,14
2001,Urban,Madhya Pradesh,Crime Against Men,Murder,Female,31-45,3846,2117,1729,3581,265
2005,Urban,Uttarakhand,Crime Against Women,Dowry Deaths,Male,31-45,1827,1611,216,1691,136
2005,Rural,Karnataka,Crime Against Women,Dowry Deaths,Female,46-60,8161,5393,2768,7807,354
2005,Rural,West Bengal,Property Crime,Arson,Female,31-45,2585,392,2193,1927,658
2006,Rural,West Bengal,Crime Against Men,Assault,Male,13-17,8616,5582,3034,5700,2916
2005,Rural,Rajasthan,Property Crime,Theft,Female,31-45,8620,7674,946,8143,477
2003,Rural,Sikkim,Crime Against Children,Trafficking,Male,31-45,1378,1104,274,1182,196
2007,Urban,Punjab,Crime Against Men,Assault,Male,46-60,8227,1099,7128,1776,6451
2007,Rural,Karnataka,Property Crime,Theft,Female,46-60,6983,2603,4380,5598,1385
2004,Rural,Nagaland,Crime Against Children,Child Abuse,Male,13-17,4097,1478,2619,3975,122
2002,Rural,Uttar Pradesh,Other Crimes,Cyber Crime,Male,60+,8238,3144,5094,3913,4325
2003,Urban,Maharashtra,Crime Against Women,Dowry Deaths,Female,13-17,2129,1493,636,1755,374
2002,Rural,Bihar,Crime Against Men,Extortion,Male,46-60,8045,3187,4858,3503,4542
2002,Rural,Gujarat,Crime Against Men,Extortion,Female,60+,8244,4784,3460,7585,659
2009,Urban,Karnataka,Crime Against Children,Child Abuse,Female,13-17,5454,2770,2684,5280,174
2005,Rural,Sikkim,Other Crimes,Fraud,Female,46-60,6306,767,5539,5583,723
2009,Urban,Arunachal Pradesh,Property Crime,Burglary,Male,31-45,5987,5474,513,5667,320
2009,Rural,Mizoram,Crime Against Children,Child Abuse,Male,31-45,8854,1970,6884,5158,3696
2008,Urban,Karnataka,Crime Against Women,Molestation,Male,0-12,1255,1150,105,1164,91
2004,Rural,Mizoram,Property Crime,Vandalism,Female,18-30,2366,689,1677,1798,568
2005,Rural,Meghalaya,Other Crimes,Fraud,Male,46-60,8933,3079,5854,8079,854
2005,Rural,Kerala,Crime Against Men,Assault,Female,31-45,5519,4222,1297,5410,109
2009,Rural,Karnataka,Other Crimes,Fraud,Female,60+,7992,1234,6758,1943,6049
2007,Urban,Meghalaya,Crime Against Men,Murder,Female,46-60,6166,3413,2753,4565,1601
2001,Rural,Bihar,Property Crime,Vandalism,Female,46-60,9718,4703,5015,9314,404
2004,Urban,Bihar,Crime Against Women,Dowry Deaths,Male,0-12,6680,1774,4906,2096,4584
2004,Rural,Sikkim,Property Crime,Vandalism,Male,60+,8609,1063,7546,7496,1113
2004,Rural,Uttarakhand,Crime Against Children,Child Abuse,Female,18-30,6705,6281,424,6404,301
2009,Urban,Meghalaya,Property Crime,Theft,Male,13-17,4302,3494,808,4292,10
2005,Urban,Tamil Nadu,Crime Against Men,Assault,Male,13-17,3394,1183,2211,1596,1798
2003,Urban,Meghalaya,Crime Against Children,Child Abuse,Male,13-17,809,312,497,449,360
2002,Rural,Telangana,Crime Against Men,Murder,Female,31-45,811,562,249,592,219
2004,Urban,Himachal Pradesh,Other Crimes,Drug Offense,Male,60+,1170,461,709,1125,45
2010,Rural,Meghalaya,Crime Against Children,Child Labor,Female,18-30,2672,899,1773,2438,234
2002,Rural,Himachal Pradesh,Crime Against Children,Child Labor,Female,60+,9555,3149,6406,5246,4309
2006,Urban,Uttar Pradesh,Crime Against Children,Child Abuse,Female,60+,5240,2462,2778,5064,176
2002,Rural,Mizoram,Crime Against Children,Trafficking,Male,13-17,745,683,62,705,40
2008,Urban,Maharashtra,Property Crime,Vandalism,Female,18-30,771,311,460,381,390
2006,Rural,Kerala,Property Crime,Theft,Male,13-17,3679,3008,671,3293,386
2009,Rural,Haryana,Other Crimes,Drug Offense,Male,46-60,5441,3091,2350,4908,533
2003,Rural,Bihar,Crime Against Children,Child Labor,Female,60+,5702,3803,1899,4283,1419
2004,Rural,Jammu & Kashmir,Crime Against Men,Extortion,Female,18-30,3423,9,3414,1058,2365
2001,Rural,Madhya Pradesh,Other Crimes,Drug Offense,Male,46-60,9659,2803,6856,8332,1327
2006,Rural,Nagaland,Property Crime,Theft,Male,31-45,8389,1490,6899,3572,4817
2003,Urban,Arunachal Pradesh,Property Crime,Burglary,Female,46-60,4574,551,4023,2553,2021
2001,Urban,West Bengal,Crime Against Men,Assault,Female,60+,1278,329,949,884,394
2002,Rural,Punjab,Crime Against Children,Child Abuse,Male,18-30,2557,1155,1402,2404,153
2004,Rural,Tamil Nadu,Property Crime,Arson,Female,0-12,1358,458,900,924,434
2005,Rural,Maharashtra,Property Crime,Arson,Male,18-30,3977,1060,2917,3130,847
2006,Urban,Rajasthan,Crime Against Women,Molestation,Male,0-12,7523,1736,5787,2046,5477
2004,Urban,Nagaland,Crime Against Men,Murder,Male,18-30,3674,327,3347,2652,1022
2009,Rural,Kerala,Other Crimes,Fraud,Female,31-45,4670,4074,596,4555,115
2008,Urban,Tamil Nadu,Crime Against Children,Kidnapping,Male,60+,8516,8377,139,8409,107
2010,Rural,Rajasthan,Other Crimes,Fraud,Male,46-60,8502,1162,7340,4513,3989
2009,Rural,Delhi,Crime Against Children,Child Abuse,Female,13-17,6340,5181,1159,5756,584
2008,Rural,Punjab,Crime Against Men,Extortion,Male,31-45,9633,6998,2635,8377,1256
2005,Urban,Haryana,Property Crime,Burglary,Male,0-12,2212,1245,967,1369,843
2006,Rural,Andhra Pradesh,Property Crime,Theft,Male,18-30,1079,71,1008,727,352
2009,Urban,Punjab,Crime Against Children,Kidnapping,Male,46-60,4809,2332,2477,4399,410
2009,Urban,Chhattisgarh,Crime Against Men,Robbery,Male,31-45,1979,1450,529,1815,164
2002,Urban,Tripura,Crime Against Children,Child Labor,Male,13-17,7403,5148,2255,5882,1521
2009,Urban,Nagaland,Crime Against Men,Assault,Male,18-30,5746,2804,2942,4144,1602
2009,Urban,Assam,Crime Against Women,Rape,Female,46-60,9459,1278,8181,1290,8169
2001,Urban,Mizoram,Property Crime,Theft,Male,13-17,4828,3677,1151,4263,565
2003,Rural,Madhya Pradesh,Property Crime,Arson,Male,31-45,1312,362,950,832,480
2001,Rural,Assam,Crime Against Children,Child Abuse,Female,31-45,8142,4888,3254,7208,934
2010,Urban,Manipur,Crime Against Men,Assault,Male,18-30,975,716,259,912,63
2007,Rural,Telangana,Crime Against Women,Molestation,Female,31-45,8968,4326,4642,6209,2759
2005,Rural,Delhi,Other Crimes,Cyber Crime,Female,31-45,562,120,442,161,401
2001,Urban,Meghalaya,Crime Against Women,Dowry Deaths,Male,31-45,784,719,65,765,19
2002,Rural,Arunachal Pradesh,Crime Against Men,Robbery,Female,46-60,9493,1447,8046,4523,4970
2002,Urban,Gujarat,Crime Against Children,Trafficking,Male,0-12,2367,1602,765,2237,130
2002,Urban,Maharashtra,Crime Against Women,Domestic Violence,Male,46-60,6290,1169,5121,2395,3895
2005,Urban,Punjab,Crime Against Children,Child Abuse,Male,60+,1691,970,721,1472,219
2002,Rural,Mizoram,Other Crimes,Drug Offense,Female,13-17,4803,3808,995,4556,247
2005,Urban,Odisha,Crime Against Children,Kidnapping,Male,60+,3006,909,2097,1859,1147
2009,Urban,Tripura,Crime Against Women,Molestation,Male,31-45,8717,3751,4966,4431,4286
2007,Urban,Nagaland,Crime Against Men,Murder,Male,18-30,6632,5415,1217,5939,693
2005,Urban,Tripura,Crime Against Women,Domestic Violence,Female,13-17,2426,1912,514,2397,29
2004,Rural,Himachal Pradesh,Crime Against Women,Dowry Deaths,Female,18-30,2854,940,1914,1257,1597
2005,Rural,Maharashtra,Crime Against Children,Child Labor,Male,46-60,3641,1094,2547,2191,1450
2007,Urban,Kerala,Crime Against Women,Molestation,Female,18-30,3542,1140,2402,3397,145
2002,Rural,Telangana,Crime Against Men,Robbery,Male,31-45,7895,6834,1061,7190,705
2002,Urban,Assam,Other Crimes,Drug Offense,Female,13-17,4632,3035,1597,3245,1387
2001,Rural,Telangana,Crime Against Children,Trafficking,Female,31-45,2679,1726,953,1811,868
2008,Rural,West Bengal,Crime Against Children,Child Abuse,Female,60+,6304,2838,3466,5903,401
2003,Urban,Uttarakhand,Crime Against Children,Child Labor,Male,46-60,7072,1404,5668,5795,1277
2005,Rural,Jharkhand,Crime Against Men,Robbery,Male,13-17,230,49,181,107,123
2007,Urban,Kerala,Crime Against Women,Dowry Deaths,Female,18-30,9442,8026,1416,8285,1157
2002,Urban,Bihar,Crime Against Men,Murder,Female,13-17,272,144,128,212,60
2010,Rural,West Bengal,Crime Against Women,Domestic Violence,Male,60+,676,205,471,572,104
2004,Rural,Haryana,Property Crime,Burglary,Male,60+,1823,436,1387,980,843
2008,Rural,Andhra Pradesh,Property Crime,Vandalism,Male,18-30,7043,6958,85,7013,30
2007,Urban,Telangana,Property Crime,Theft,Female,60+,6514,6496,18,6503,11
2002,Urban,Karnataka,Other Crimes,Corruption,Male,46-60,1639,587,1052,915,724
2008,Rural,Haryana,Crime Against Children,Kidnapping,Female,13-17,9860,592,9268,4889,4971
2001,Rural,Gujarat,Property Crime,Arson,Male,60+,8472,1557,6915,8034,438
2008,Urban,Jammu & Kashmir,Crime Against Women,Rape,Male,13-17,9450,6264,3186,6461,2989
2004,Rural,Mizoram,Other Crimes,Cyber Crime,Male,18-30,1388,266,1122,808,580
2009,Urban,Gujarat,Other Crimes,Corruption,Male,13-17,5466,1917,3549,2965,2501
2010,Rural,Nagaland,Other Crimes,Drug Offense,Female,46-60,8532,6957,1575,7803,729
2010,Urban,Jharkhand,Property Crime,Arson,Female,0-12,2165,2050,115,2159,6
2010,Urban,Meghalaya,Property Crime,Theft,Male,46-60,7756,1289,6467,5476,2280
2002,Urban,Tamil Nadu,Crime Against Women,Dowry Deaths,Female,0-12,8706,3218,5488,7332,1374
2001,Urban,Nagaland,Other Crimes,Corruption,Male,46-60,8085,2393,5692,7393,692
2008,Urban,Sikkim,Property Crime,Arson,Male,31-45,6558,1654,4904,4302,2256
2003,Rural,Maharashtra,Crime Against Children,Trafficking,Female,0-12,6026,3580,2446,3646,2380
2006,Urban,West Bengal,Crime Against Men,Extortion,Male,18-30,849,481,368,773,76
2009,Rural,Assam,Crime Against Children,Child Abuse,Male,31-45,8935,801,8134,6878,2057
2001,Rural,Punjab,Crime Against Children,Child Labor,Female,46-60,1099,69,1030,1040,59
2007,Rural,Assam,Crime Against Children,Child Labor,Female,31-45,2884,147,2737,412,2472
2005,Urban,Goa,Other Crimes,Fraud,Male,31-45,2821,882,1939,1230,1591
2006,Urban,Uttarakhand,Crime Against Women,Molestation,Female,60+,5973,2309,3664,5538,435
2004,Urban,Chhattisgarh,Crime Against Women,Rape,Male,46-60,9213,3444,5769,5302,3911
2003,Urban,Madhya Pradesh,Other Crimes,Cyber Crime,Male,46-60,4604,2268,2336,3197,1407
2010,Rural,Telangana,Crime Against Women,Molestation,Male,60+,8055,7937,118,8008,47
2003,Rural,Sikkim,Other Crimes,Fraud,Female,13-17,5561,910,4651,1468,4093
2006,Urban,Manipur,Crime Against Men,Assault,Female,18-30,7829,6201,1628,6652,1177
2010,Urban,Jharkhand,Crime Against Children,Trafficking,Male,13-17,6349,887,5462,1737,4612
2003,Urban,Tripura,Property Crime,Burglary,Male,60+,6678,1221,5457,1333,5345
2010,Rural,Mizoram,Crime Against Women,Dowry Deaths,Female,60+,1621,1576,45,1582,39
2007,Rural,Kerala,Crime Against Children,Kidnapping,Male,13-17,4339,840,3499,1901,2438
2004,Rural,Gujarat,Property Crime,Burglary,Female,60+,1061,661,400,831,230
2004,Rural,Meghalaya,Crime Against Men,Extortion,Female,31-45,5748,3352,2396,5202,546
2001,Urban,Delhi,Crime Against Men,Robbery,Female,60+,6620,5568,1052,5570,1050
2007,Urban,Tamil Nadu,Other Crimes,Fraud,Female,31-45,350,298,52,316,34
2008,Rural,Jammu & Kashmir,Crime Against Women,Rape,Female,31-45,3020,1498,1522,1963,1057
2001,Rural,Gujarat,Crime Against Men,Murder,Female,31-45,9735,7158,2577,8587,1148
2008,Urban,West Bengal,Crime Against Children,Kidnapping,Male,60+,1811,1575,236,1584,227
2001,Urban,Mizoram,Crime Against Men,Extortion,Male,46-60,1508,80,1428,171,1337
2006,Rural,Rajasthan,Crime Against Women,Domestic Violence,Male,0-12,1688,173,1515,1594,94
2004,Urban,Arunachal Pradesh,Crime Against Men,Murder,Male,13-17,2955,1391,1564,1510,1445
2005,Rural,Rajasthan,Crime Against Women,Dowry Deaths,Male,18-30,7310,6337,973,6938,372
2004,Rural,Maharashtra,Crime Against Children,Trafficking,Female,60+,8371,4178,4193,6870,1501
2004,Rural,Rajasthan,Other Crimes,Drug Offense,Male,13-17,8629,8513,116,8557,72
2004,Urban,Jharkhand,Crime Against Women,Domestic Violence,Male,13-17,2550,2291,259,2537,13
2001,Urban,West Bengal,Property Crime,Burglary,Male,18-30,1222,501,721,962,260
2010,Urban,Haryana,Property Crime,Theft,Male,46-60,6165,3419,2746,4318,1847
2005,Rural,Telangana,Crime Against Men,Assault,Female,46-60,8100,7333,767,7739,361
2002,Urban,Mizoram,Crime Against Children,Trafficking,Female,31-45,2313,2059,254,2168,145
2007,Rural,Tamil Nadu,Crime Against Men,Robbery,Female,31-45,1258,682,576,875,383
2001,Rural,Chhattisgarh,Crime Against Children,Child Labor,Male,13-17,2921,2057,864,2399,522
2005,Urban,Arunachal Pradesh,Crime Against Women,Molestation,Female,18-30,3248,1363,1885,3225,23
2005,Rural,Tamil Nadu,Crime Against Men,Extortion,Female,46-60,7947,1441,6506,4558,3389
2001,Urban,Assam,Crime Against Children,Trafficking,Female,0-12,8233,4926,3307,7129,1104
2006,Rural,Madhya Pradesh,Crime Against Men,Robbery,Male,0-12,7910,1861,6049,6740,1170
2006,Urban,West Bengal,Crime Against Children,Kidnapping,Female,60+,1712,1188,524,1642,70
2007,Urban,Meghalaya,Property Crime,Theft,Female,46-60,3417,2213,1204,2342,1075
2005,Rural,Manipur,Other Crimes,Cyber Crime,Female,60+,5846,4068,1778,4721,1125
2001,Urban,Tripura,Crime Against Men,Murder,Male,46-60,6979,6829,150,6909,70
2002,Urban,Rajasthan,Crime Against Children,Trafficking,Male,0-12,8434,5951,2483,8106,328
2005,Rural,Delhi,Property Crime,Vandalism,Female,18-30,3512,880,2632,2869,643
2002,Rural,Maharashtra,Crime Against Women,Molestation,Female,0-12,9179,5979,3200,6952,2227
2006,Rural,Punjab,Property Crime,Arson,Female,18-30,5067,1936,3131,2617,2450
2008,Urban,Kerala,Crime Against Men,Robbery,Female,13-17,1812,837,975,1132,680
2008,Rural,Maharashtra,Other Crimes,Drug Offense,Male,0-12,2809,3,2806,857,1952
2010,Urban,Assam,Crime Against Women,Rape,Female,18-30,3109,61,3048,1147,1962
2001,Rural,Gujarat,Crime Against Children,Child Labor,Female,13-17,8454,4247,4207,5047,3407
2010,Rural,Jammu & Kashmir,Other Crimes,Fraud,Female,13-17,5435,82,5353,4425,1010
2007,Rural,Uttarakhand,Other Crimes,Corruption,Female,0-12,6415,2572,3843,2923,3492
2006,Urban,Uttar Pradesh,Property Crime,Vandalism,Female,46-60,9679,35,9644,1260,8419
2003,Rural,Gujarat,Crime Against Men,Extortion,Male,0-12,3425,2182,1243,2514,911
2004,Urban,Tripura,Crime Against Women,Domestic Violence,Male,60+,5115,4819,296,5002,113
2004,Rural,Manipur,Other Crimes,Cyber Crime,Female,18-30,8412,850,7562,4944,3468
2003,Urban,Telangana,Property Crime,Vandalism,Female,18-30,803,776,27,778,25
2003,Rural,Jammu & Kashmir,Crime Against Women,Domestic Violence,Male,0-12,8822,10,8812,7879,943
2009,Rural,Nagaland,Crime Against Women,Molestation,Female,46-60,4968,472,4496,3608,1360
2002,Urban,Chhattisgarh,Crime Against Children,Kidnapping,Female,18-30,8664,740,7924,2269,6395
2004,Rural,Gujarat,Crime Against Children,Child Labor,Male,46-60,4534,4342,192,4447,87
2010,Urban,West Bengal,Other Crimes,Drug Offense,Female,46-60,5796,3274,2522,5218,578
2001,Urban,Telangana,Crime Against Children,Child Labor,Female,60+,3810,3063,747,3610,200
2008,Rural,Rajasthan,Property Crime,Burglary,Female,18-30,5220,401,4819,4730,490
2010,Rural,Kerala,Crime Against Women,Molestation,Female,13-17,5591,4217,1374,5125,466
2001,Rural,Jharkhand,Other Crimes,Drug Offense,Female,46-60,9962,4368,5594,8325,1637
2007,Urban,Arunachal Pradesh,Crime Against Children,Trafficking,Female,13-17,617,416,201,524,93
2002,Rural,Tripura,Crime Against Men,Murder,Female,18-30,6238,3189,3049,4301,1937
2001,Urban,Tamil Nadu,Crime Against Men,Assault,Female,60+,7694,6431,1263,7418,276
2008,Rural,Manipur,Crime Against Children,Child Labor,Male,60+,2209,1148,1061,1348,861
2007,Rural,Mizoram,Other Crimes,Cyber Crime,Male,0-12,5262,3373,1889,4416,846
2002,Rural,Gujarat,Crime Against Men,Extortion,Male,0-12,4889,373,4516,2747,2142
2004,Urban,Karnataka,Crime Against Women,Dowry Deaths,Male,18-30,1791,59,1732,273,1518
2008,Rural,Chhattisgarh,Other Crimes,Fraud,Female,0-12,6367,5330,1037,6181,186
2006,Rural,Sikkim,Crime Against Children,Kidnapping,Male,13-17,7874,4378,3496,6501,1373
2002,Rural,Maharashtra,Crime Against Children,Kidnapping,Female,46-60,1348,187,1161,235,1113
2001,Urban,Mizoram,Crime Against Men,Extortion,Female,0-12,9116,8108,1008,8512,604
2005,Urban,Uttarakhand,Crime Against Children,Child Labor,Female,13-17,5946,655,5291,3957,1989
2010,Rural,Odisha,Crime Against Women,Rape,Female,18-30,2710,800,1910,963,1747
2010,Rural,Bihar,Property Crime,Burglary,Male,0-12,7346,5545,1801,6125,1221
2001,Rural,Himachal Pradesh,Other Crimes,Fraud,Female,60+,388,75,313,257,131
2001,Urban,Telangana,Property Crime,Theft,Male,31-45,5188,3614,1574,3645,1543
2001,Rural,Rajasthan,Other Crimes,Corruption,Female,18-30,1366,88,1278,460,906
2005,Urban,Assam,Crime Against Children,Trafficking,Female,31-45,2376,1867,509,2271,105
2010,Rural,Meghalaya,Crime Against Children,Trafficking,Male,0-12,5174,2245,2929,3839,1335
2008,Rural,Punjab,Crime Against Children,Kidnapping,Female,60+,8324,5720,2604,7183,1141
2006,Rural,Haryana,Crime Against Men,Extortion,Female,31-45,3692,1348,2344,2257,1435
2010,Rural,Punjab,Crime Against Women,Rape,Male,31-45,158,0,158,63,95
2002,Rural,Kerala,Crime Against Women,Rape,Male,60+,1691,1040,651,1587,104
2006,Urban,Meghalaya,Other Crimes,Cyber Crime,Female,60+,5470,2593,2877,5303,167
2005,Urban,Chhattisgarh,Crime Against Women,Molestation,Female,60+,7155,7058,97,7106,49
2001,Urban,Karnataka,Crime Against Women,Rape,Male,46-60,433,327,106,398,35
2003,Urban,Assam,Crime Against Women,Domestic Violence,Female,60+,4045,2225,1820,3707,338
2001,Urban,Gujarat,Crime Against Children,Child Abuse,Male,60+,4987,2801,2186,3465,1522
2005,Rural,Assam,Crime Against Children,Trafficking,Male,60+,431,48,383,196,235
2004,Urban,Punjab,Crime Against Women,Molestation,Female,0-12,4429,2701,1728,4131,298
2001,Urban,Chhattisgarh,Crime Against Men,Robbery,Male,0-12,5602,1167,4435,2783,2819
2010,Urban,Chhattisgarh,Crime Against Women,Molestation,Female,31-45,4683,2210,2473,3662,1021
2006,Urban,Sikkim,Crime Against Children,Trafficking,Female,13-17,9998,3682,6316,5632,4366
2004,Rural,Sikkim,Crime Against Children,Kidnapping,Female,18-30,6558,1256,5302,5136,1422
2002,Rural,Goa,Crime Against Men,Robbery,Female,0-12,4445,2463,1982,3058,1387
2002,Rural,Punjab,Other Crimes,Fraud,Female,31-45,3922,264,3658,690,3232
2010,Rural,Maharashtra,Other Crimes,Drug Offense,Male,60+,6286,3277,3009,5379,907
2003,Rural,Arunachal Pradesh,Other Crimes,Fraud,Female,31-45,9225,3878,5347,7554,1671
2004,Urban,Assam,Property Crime,Theft,Female,60+,4117,2504,1613,2543,1574
2009,Rural,Telangana,Other Crimes,Fraud,Male,0-12,8069,1317,6752,2633,5436
2010,Urban,Uttar Pradesh,Crime Against Women,Molestation,Female,46-60,5002,4493,509,4649,353
2010,Urban,Arunachal Pradesh,Other Crimes,Drug Offense,Male,18-30,8953,3039,5914,7820,1133
2009,Urban,Sikkim,Crime Against Children,Child Abuse,Male,31-45,4415,210,4205,3529,886
2009,Rural,Arunachal Pradesh,Crime Against Women,Rape,Male,13-17,8120,1128,6992,5696,2424
2005,Rural,Goa,Crime Against Men,Murder,Male,0-12,498,409,89,490,8
2004,Rural,Jammu & Kashmir,Crime Against Men,Robbery,Male,46-60,8936,2490,6446,6927,2009
2004,Urban,Haryana,Crime Against Women,Rape,Female,0-12,6511,2618,3893,4637,1874
2002,Rural,Manipur,Other Crimes,Cyber Crime,Female,18-30,2470,1616,854,2045,425
2007,Urban,Bihar,Crime Against Women,Dowry Deaths,Female,46-60,4405,2686,1719,3640,765
2004,Urban,Odisha,Property Crime,Arson,Female,13-17,3916,933,2983,1985,1931
2001,Urban,Meghalaya,Property Crime,Burglary,Female,31-45,1839,1711,128,1727,112
2002,Urban,Odisha,Other Crimes,Fraud,Female,0-12,7858,1713,6145,3393,4465
2008,Urban,Manipur,Other Crimes,Drug Offense,Female,60+,608,528,80,597,11
2004,Rural,Uttar Pradesh,Crime Against Children,Trafficking,Male,0-12,7646,6121,1525,6669,977
2010,Rural,Bihar,Other Crimes,Drug Offense,Female,46-60,9607,7423,2184,9130,477
2003,Rural,Bihar,Other Crimes,Corruption,Male,0-12,7469,3072,4397,3393,4076
2003,Urban,Telangana,Crime Against Women,Dowry Deaths,Male,0-12,9549,3819,5730,7226,2323
2005,Urban,Nagaland,Property Crime,Vandalism,Male,46-60,9840,6596,3244,7693,2147
2006,Urban,Delhi,Crime Against Children,Trafficking,Male,60+,621,373,248,444,177
2002,Urban,West Bengal,Property Crime,Arson,Female,60+,8139,2786,5353,7423,716
2010,Urban,Tripura,Crime Against Men,Murder,Female,31-45,2725,2026,699,2131,594
2003,Rural,Nagaland,Crime Against Men,Robbery,Male,60+,9035,6095,2940,6670,2365
2004,Urban,Telangana,Crime Against Children,Kidnapping,Male,46-60,6471,411,6060,3103,3368
2004,Rural,Sikkim,Other Crimes,Cyber Crime,Male,31-45,6423,4052,2371,5444,979
2010,Rural,Manipur,Crime Against Women,Domestic Violence,Female,31-45,5743,903,4840,1798,3945
2010,Urban,West Bengal,Crime Against Men,Robbery,Male,60+,3035,837,2198,1373,1662
2003,Urban,Gujarat,Crime Against Men,Murder,Female,46-60,6983,5029,1954,5954,1029
2004,Urban,Arunachal Pradesh,Crime Against Women,Dowry Deaths,Male,0-12,1675,1577,98,1595,80
2007,Urban,Rajasthan,Property Crime,Arson,Male,18-30,8862,3644,5218,7820,1042
2007,Rural,Kerala,Crime Against Men,Extortion,Female,0-12,4397,848,3549,1851,2546
2007,Rural,Punjab,Other Crimes,Drug Offense,Female,0-12,2569,2441,128,2502,67
2006,Rural,Meghalaya,Crime Against Women,Molestation,Female,13-17,2649,1868,781,1960,689
2002,Rural,Jharkhand,Crime Against Women,Molestation,Male,46-60,1574,211,1363,243,1331
2004,Rural,Manipur,Crime Against Women,Rape,Female,0-12,9781,6442,3339,8570,1211
2007,Urban,Bihar,Other Crimes,Corruption,Male,0-12,8578,7376,1202,7539,1039
2004,Urban,Rajasthan,Crime Against Children,Child Abuse,Male,13-17,5983,2583,3400,3865,2118
2002,Rural,Telangana,Crime Against Men,Murder,Male,46-60,993,578,415,779,214
2004,Urban,Tamil Nadu,Crime Against Women,Domestic Violence,Female,46-60,346,37,309,314,32
2002,Rural,Bihar,Property Crime,Burglary,Female,13-17,5982,464,5518,5410,572
2005,Rural,West Bengal,Crime Against Children,Child Abuse,Female,60+,9732,2072,7660,7738,1994
2002,Rural,Andhra Pradesh,Crime Against Women,Dowry Deaths,Male,31-45,6322,2143,4179,4779,1543
2001,Rural,Andhra Pradesh,Other Crimes,Drug Offense,Female,18-30,7157,6862,295,7082,75
2004,Rural,Gujarat,Crime Against Children,Kidnapping,Male,60+,6791,6740,51,6749,42
2009,Urban,Rajasthan,Crime Against Men,Extortion,Female,0-12,918,383,535,630,288
2006,Urban,Rajasthan,Crime Against Women,Rape,Male,31-45,7027,1817,5210,3029,3998
2010,Rural,Telangana,Crime Against Women,Molestation,Female,31-45,3327,1902,1425,2562,765
2001,Rural,Uttarakhand,Crime Against Children,Child Labor,Male,60+,1969,1032,937,1887,82
2009,Urban,Madhya Pradesh,Property Crime,Burglary,Male,18-30,3585,2029,1556,2961,624
2002,Urban,Assam,Other Crimes,Corruption,Female,13-17,8096,4862,3234,6950,1146
2003,Urban,Delhi,Crime Against Men,Robbery,Female,46-60,4908,4457,451,4478,430
2010,Urban,Sikkim,Crime Against Men,Murder,Female,0-12,9409,1980,7429,6383,3026
2006,Urban,Tamil Nadu,Crime Against Men,Assault,Female,60+,5403,696,4707,2423,2980
2006,Urban,Telangana,Other Crimes,Fraud,Male,46-60,3637,2902,735,2925,712
2004,Rural,Gujarat,Other Crimes,Corruption,Female,46-60,893,230,663,856,37
2010,Urban,West Bengal,Crime Against Women,Rape,Male,31-45,8623,277,8346,4457,4166
2006,Rural,Haryana,Crime Against Women,Domestic Violence,Male,60+,8411,3766,4645,6962,1449
2007,Urban,Sikkim,Property Crime,Theft,Male,31-45,5026,4342,684,4440,586
2010,Rural,Tripura,Property Crime,Burglary,Female,13-17,369,14,355,195,174
2007,Rural,Haryana,Other Crimes,Fraud,Female,46-60,1454,1216,238,1406,48
2004,Urban,Mizoram,Crime Against Men,Extortion,Female,60+,7748,4771,2977,7659,89
2002,Rural,Maharashtra,Other Crimes,Corruption,Male,18-30,5374,337,5037,4210,1164
2010,Rural,Nagaland,Crime Against Children,Kidnapping,Female,13-17,6677,2247,4430,3089,3588
2010,Urban,Kerala,Crime Against Women,Rape,Female,31-45,6419,6376,43,6390,29
2003,Rural,Uttar Pradesh,Property Crime,Arson,Female,13-17,9898,6385,3513,8357,1541
2006,Rural,Maharashtra,Property Crime,Arson,Male,13-17,2690,297,2393,1738,952
2003,Rural,Bihar,Crime Against Women,Molestation,Female,46-60,7084,681,6403,2007,5077
2002,Urban,Mizoram,Crime Against Men,Extortion,Female,60+,8630,6093,2537,7846,784
2007,Rural,Nagaland,Crime Against Women,Domestic Violence,Female,46-60,4689,3076,1613,3910,779
2001,Rural,West Bengal,Other Crimes,Drug Offense,Male,31-45,1424,271,1153,1232,192
2009,Rural,Manipur,Property Crime,Arson,Male,0-12,8835,6102,2733,6121,2714
2007,Rural,Tripura,Crime Against Men,Assault,Male,46-60,993,505,488,618,375
2009,Rural,Andhra Pradesh,Crime Against Men,Murder,Male,18-30,6568,6078,490,6196,372
2005,Rural,Andhra Pradesh,Crime Against Women,Domestic Violence,Female,31-45,3436,2573,863,3073,363
2008,Urban,Assam,Crime Against Children,Trafficking,Female,18-30,3092,817,2275,1898,1194
2006,Urban,Odisha,Crime Against Children,Child Labor,Female,46-60,3780,3756,24,3770,10
2008,Urban,Himachal Pradesh,Property Crime,Arson,Female,0-12,3385,27,3358,1085,2300
2006,Rural,Delhi,Crime Against Men,Extortion,Female,31-45,7865,1734,6131,5586,2279
2002,Rural,Bihar,Crime Against Men,Assault,Female,0-12,5641,1251,4390,4829,812
2010,Rural,West Bengal,Crime Against Women,Rape,Female,60+,4748,1735,3013,2778,1970
2009,Rural,Andhra Pradesh,Crime Against Women,Domestic Violence,Female,31-45,2728,515,2213,2098,630
2005,Rural,Madhya Pradesh,Crime Against Women,Rape,Male,0-12,9496,6178,3318,8880,616
2007,Urban,Sikkim,Crime Against Children,Trafficking,Male,60+,3703,3354,349,3528,175
2009,Rural,Arunachal Pradesh,Other Crimes,Corruption,Female,60+,7406,787,6619,4939,2467
2007,Rural,Haryana,Property Crime,Arson,Female,31-45,726,160,566,164,562
2005,Rural,Himachal Pradesh,Crime Against Men,Robbery,Female,0-12,3116,460,2656,2488,628
2010,Urban,Himachal Pradesh,Crime Against Women,Rape,Female,0-12,1127,398,729,934,193
2008,Urban,Maharashtra,Property Crime,Vandalism,Male,60+,3195,270,2925,1795,1400
2008,Rural,Karnataka,Crime Against Men,Extortion,Female,13-17,6594,556,6038,3917,2677
2001,Urban,Meghalaya,Property Crime,Arson,Female,60+,2891,2037,854,2523,368
2009,Rural,Goa,Crime Against Women,Domestic Violence,Male,18-30,1803,123,1680,936,867
2002,Urban,Maharashtra,Crime Against Children,Child Labor,Male,46-60,7499,3799,3700,6837,662
2006,Urban,Uttarakhand,Crime Against Children,Kidnapping,Female,18-30,6327,4246,2081,5086,1241
2010,Urban,Uttar Pradesh,Property Crime,Arson,Male,31-45,4843,3042,1801,3855,988
2005,Urban,Goa,Crime Against Children,Trafficking,Female,0-12,2544,1926,618,2336,208
2004,Urban,Nagaland,Other Crimes,Fraud,Female,46-60,3060,1091,1969,2446,614
2010,Urban,Chhattisgarh,Other Crimes,Fraud,Male,60+,5611,250,5361,5424,187
2010,Rural,Tripura,Crime Against Women,Molestation,Male,60+,3459,982,2477,2747,712
2003,Rural,Delhi,Crime Against Children,Trafficking,Female,31-45,2995,2127,868,2609,386
2009,Rural,Andhra Pradesh,Other Crimes,Cyber Crime,Male,0-12,357,258,99,343,14
2003,Rural,Punjab,Crime Against Men,Extortion,Female,18-30,5705,1261,4444,5704,1
2005,Urban,Kerala,Crime Against Children,Kidnapping,Male,46-60,3683,3516,167,3601,82
2001,Rural,Jharkhand,Other Crimes,Fraud,Female,31-45,5507,3316,2191,4819,688
2003,Urban,Haryana,Crime Against Men,Murder,Male,46-60,3579,1460,2119,2861,718
2002,Urban,Telangana,Property Crime,Burglary,Female,13-17,4597,2779,1818,2984,1613
2002,Urban,Manipur,Property Crime,Theft,Female,18-30,5710,2717,2993,3045,2665
2004,Urban,Uttarakhand,Crime Against Men,Extortion,Female,31-45,2106,1625,481,1781,325
2004,Rural,Madhya Pradesh,Property Crime,Burglary,Male,46-60,8832,8292,540,8493,339
2001,Rural,Bihar,Crime Against Men,Extortion,Male,31-45,6596,6457,139,6481,115
2009,Urban,Kerala,Crime Against Children,Kidnapping,Male,60+,5928,2772,3156,4297,1631
2010,Urban,Jammu & Kashmir,Crime Against Men,Robbery,Male,18-30,7998,6614,1384,6931,1067
2005,Rural,Telangana,Property Crime,Vandalism,Female,0-12,6464,1747,4717,3183,3281
2004,Urban,Madhya Pradesh,Other Crimes,Cyber Crime,Male,0-12,4964,2239,2725,2716,2248
2001,Rural,Manipur,Crime Against Men,Extortion,Male,60+,5021,2225,2796,4866,155
2008,Rural,Maharashtra,Crime Against Children,Kidnapping,Female,46-60,9992,1149,8843,1756,8236
2010,Urban,Uttarakhand,Crime Against Children,Kidnapping,Female,18-30,4186,3,4183,3273,913
2007,Rural,Andhra Pradesh,Other Crimes,Fraud,Female,60+,838,46,792,317,521
2005,Rural,Punjab,Crime Against Women,Dowry Deaths,Female,0-12,2260,773,1487,2049,211
2010,Urban,Assam,Crime Against Children,Child Labor,Male,46-60,6460,5764,696,6197,263
2002,Rural,Telangana,Crime Against Children,Kidnapping,Male,13-17,1606,1326,280,1366,240
2008,Urban,Meghalaya,Crime Against Children,Trafficking,Female,0-12,1379,1001,378,1075,304
2002,Rural,Rajasthan,Property Crime,Burglary,Male,18-30,7044,376,6668,6930,114
2002,Urban,Madhya Pradesh,Other Crimes,Fraud,Male,0-12,8711,1045,7666,3570,5141
2002,Rural,Kerala,Other Crimes,Drug Offense,Male,31-45,1228,414,814,704,524
2004,Urban,Delhi,Property Crime,Arson,Male,46-60,4739,2460,2279,4421,318
2006,Urban,Nagaland,Property Crime,Burglary,Male,18-30,6153,1290,4863,4178,1975
2006,Urban,Assam,Crime Against Women,Dowry Deaths,Male,46-60,1609,797,812,848,761
2004,Rural,Tripura,Crime Against Men,Assault,Female,60+,1426,1357,69,1417,9
2003,Rural,Rajasthan,Property Crime,Arson,Male,60+,5523,466,5057,3519,2004
2008,Urban,Delhi,Crime Against Men,Assault,Female,13-17,1558,1141,417,1214,344
2003,Urban,Karnataka,Crime Against Women,Rape,Male,18-30,3386,2599,787,3358,28
2006,Rural,Punjab,Other Crimes,Corruption,Male,46-60,3744,1057,2687,3708,36
2006,Urban,Delhi,Crime Against Children,Trafficking,Female,46-60,4249,3345,904,3652,597
2001,Urban,Bihar,Property Crime,Theft,Female,31-45,1514,848,666,921,593
2007,Rural,Punjab,Crime Against Children,Trafficking,Female,18-30,7611,3677,3934,6178,1433
2009,Urban,Maharashtra,Crime Against Children,Trafficking,Male,0-12,2995,728,2267,1096,1899
2002,Urban,Bihar,Crime Against Women,Molestation,Male,0-12,6422,1670,4752,3949,2473
2010,Urban,Manipur,Crime Against Women,Molestation,Female,60+,233,140,93,215,18
2007,Rural,Goa,Crime Against Men,Assault,Female,60+,5251,3339,1912,5192,59
2003,Rural,Odisha,Crime Against Women,Dowry Deaths,Male,46-60,9859,904,8955,1242,8617
2008,Urban,Chhattisgarh,Other Crimes,Drug Offense,Female,13-17,4413,1385,3028,2568,1845
2001,Rural,Rajasthan,Crime Against Men,Murder,Male,60+,8196,3305,4891,6870,1326
2003,Urban,Telangana,Property Crime,Vandalism,Male,13-17,7245,4871,2374,5812,1433
2007,Urban,Himachal Pradesh,Crime Against Women,Rape,Female,18-30,1389,698,691,1342,47
2007,Rural,Rajasthan,Crime Against Men,Extortion,Female,31-45,4088,984,3104,3676,412
2002,Rural,Haryana,Property Crime,Burglary,Male,46-60,7707,5458,2249,5667,2040
2003,Rural,Odisha,Crime Against Men,Murder,Male,31-45,7634,850,6784,7312,322
2010,Urban,Goa,Crime Against Women,Molestation,Male,13-17,2937,546,2391,1568,1369
2002,Urban,Karnataka,Crime Against Women,Molestation,Female,0-12,9485,170,9315,5152,4333
2002,Urban,Uttar Pradesh,Other Crimes,Corruption,Female,0-12,5651,5381,270,5412,239
2009,Rural,Maharashtra,Crime Against Children,Trafficking,Male,13-17,3302,955,2347,1095,2207
2001,Rural,Meghalaya,Crime Against Women,Rape,Female,18-30,5469,3118,2351,4737,732
2008,Rural,Maharashtra,Crime Against Women,Rape,Male,46-60,8510,4651,3859,7262,1248
2006,Rural,Sikkim,Property Crime,Arson,Female,31-45,1646,484,1162,977,669
2007,Urban,Himachal Pradesh,Other Crimes,Corruption,Male,18-30,6527,4504,2023,6123,404
2009,Urban,Jharkhand,Crime Against Women,Domestic Violence,Male,60+,1547,923,624,1105,442
2003,Urban,Manipur,Property Crime,Arson,Female,60+,9497,1175,8322,2950,6547
2001,Urban,Tripura,Property Crime,Theft,Female,18-30,546,381,165,511,35
2004,Rural,Bihar,Other Crimes,Drug Offense,Female,0-12,2563,1206,1357,2373,190
2007,Urban,Manipur,Crime Against Men,Assault,Female,13-17,2008,854,1154,1804,204
2010,Urban,Meghalaya,Crime Against Women,Rape,Male,46-60,7391,1641,5750,7366,25
2001,Urban,Nagaland,Crime Against Men,Robbery,Male,18-30,7964,2019,5945,2627,5337
2005,Urban,Manipur,Crime Against Children,Trafficking,Female,0-12,2284,1390,894,2280,4
2007,Urban,Delhi,Crime Against Men,Murder,Female,18-30,3033,2694,339,3024,9
2003,Urban,Sikkim,Property Crime,Vandalism,Male,60+,1379,301,1078,702,677
2004,Urban,Sikkim,Crime Against Children,Trafficking,Female,60+,2347,1883,464,2241,106
2010,Rural,Manipur,Crime Against Women,Dowry Deaths,Female,0-12,1559,837,722,1535,24
2007,Urban,Haryana,Crime Against Men,Robbery,Male,60+,4511,2183,2328,2836,1675
2005,Urban,Kerala,Crime Against Children,Child Abuse,Female,18-30,8703,7556,1147,8039,664
2001,Urban,Goa,Crime Against Women,Molestation,Female,31-45,5672,2565,3107,5615,57
2009,Urban,Goa,Property Crime,Vandalism,Male,18-30,4868,1677,3191,4189,679
2008,Urban,Madhya Pradesh,Property Crime,Arson,Male,60+,7138,366,6772,5292,1846
2001,Rural,Kerala,Other Crimes,Fraud,Male,31-45,2309,1090,1219,1256,1053
2006,Urban,Chhattisgarh,Property Crime,Theft,Female,46-60,7146,6707,439,7070,76
2008,Rural,Nagaland,Other Crimes,Cyber Crime,Female,46-60,1872,1175,697,1426,446
2007,Rural,Odisha,Crime Against Women,Domestic Violence,Male,60+,6302,906,5396,922,5380
2007,Urban,Gujarat,Property Crime,Theft,Male,46-60,8177,5222,2955,5491,2686
2004,Rural,Himachal Pradesh,Property Crime,Theft,Male,13-17,1949,301,1648,1033,916
2001,Rural,Himachal Pradesh,Crime Against Women,Molestation,Male,0-12,3155,913,2242,1382,1773
2001,Rural,Tripura,Property Crime,Theft,Male,31-45,3858,1202,2656,2033,1825
2007,Urban,Manipur,Other Crimes,Corruption,Female,0-12,9699,2328,7371,5730,3969
2009,Urban,West Bengal,Property Crime,Arson,Male,46-60,7654,64,7590,2846,4808
2003,Rural,Tripura,Crime Against Women,Rape,Male,18-30,5517,379,5138,1582,3935
2008,Rural,Maharashtra,Crime Against Children,Child Labor,Female,0-12,2676,82,2594,2312,364
2006,Rural,Arunachal Pradesh,Other Crimes,Drug Offense,Female,60+,1868,996,872,1856,12
2007,Rural,West Bengal,Property Crime,Burglary,Male,46-60,8983,3765,5218,6793,2190
2009,Rural,Punjab,Crime Against Women,Domestic Violence,Female,13-17,7193,899,6294,2751,4442
2004,Rural,Haryana,Crime Against Children,Child Labor,Male,13-17,3665,2857,808,3330,335
2008,Urban,Chhattisgarh,Crime Against Children,Kidnapping,Male,46-60,6693,2600,4093,5872,821
2001,Rural,West Bengal,Crime Against Men,Extortion,Male,0-12,6045,3244,2801,6033,12
2001,Rural,Punjab,Other Crimes,Fraud,Female,60+,1983,502,1481,998,985
2007,Rural,Andhra Pradesh,Crime Against Children,Trafficking,Male,13-17,3191,658,2533,2903,288
2009,Rural,Telangana,Crime Against Children,Kidnapping,Male,0-12,3901,1706,2195,3186,715
2004,Urban,Andhra Pradesh,Other Crimes,Corruption,Male,31-45,4345,2539,1806,3959,386
2009,Urban,Tripura,Crime Against Women,Domestic Violence,Female,46-60,8465,6979,1486,7550,915
2008,Urban,Sikkim,Other Crimes,Cyber Crime,Male,60+,6328,5418,910,6171,157
2009,Urban,Jharkhand,Other Crimes,Drug Offense,Male,60+,473,448,25,470,3
2010,Rural,Gujarat,Crime Against Children,Child Labor,Female,18-30,1264,460,804,1006,258
2007,Urban,Assam,Other Crimes,Cyber Crime,Male,0-12,1068,592,476,849,219
2001,Rural,Tripura,Other Crimes,Corruption,Male,31-45,3261,771,2490,2117,1144
2010,Rural,Rajasthan,Other Crimes,Corruption,Female,60+,4540,1951,2589,2807,1733
2004,Rural,Assam,Crime Against Children,Child Abuse,Female,60+,1096,914,182,947,149
2004,Urban,Tripura,Crime Against Women,Domestic Violence,Female,13-17,3476,2517,959,2646,830
2008,Rural,Himachal Pradesh,Crime Against Men,Robbery,Female,0-12,6078,6009,69,6050,28
2006,Rural,Haryana,Crime Against Women,Rape,Female,60+,4134,2086,2048,3567,567
2009,Rural,Assam,Property Crime,Arson,Male,13-17,8257,930,7327,5752,2505
2002,Rural,Delhi,Other Crimes,Drug Offense,Female,0-12,3841,2758,1083,3074,767
2003,Rural,Madhya Pradesh,Crime Against Men,Murder,Male,0-12,3791,1417,2374,3507,284
2010,Rural,Nagaland,Crime Against Men,Robbery,Female,46-60,7949,4567,3382,5454,2495
2006,Rural,Sikkim,Property Crime,Theft,Male,13-17,9645,2136,7509,7120,2525
2004,Rural,Haryana,Crime Against Men,Extortion,Female,46-60,7425,373,7052,1238,6187
2010,Rural,West Bengal,Crime Against Men,Assault,Male,31-45,5299,1950,3349,4213,1086
2005,Rural,Manipur,Other Crimes,Fraud,Female,13-17,5791,5776,15,5785,6
2007,Urban,Punjab,Property Crime,Burglary,Male,18-30,9384,4380,5004,8316,1068
2009,Urban,Jammu & Kashmir,Crime Against Children,Child Abuse,Female,0-12,138,80,58,130,8
2009,Rural,Nagaland,Other Crimes,Fraud,Female,31-45,602,61,541,164,438
2002,Urban,Uttarakhand,Other Crimes,Corruption,Female,18-30,7473,3189,4284,6128,1345
2004,Rural,Meghalaya,Other Crimes,Corruption,Male,60+,8567,8130,437,8232,335
2005,Urban,Sikkim,Crime Against Women,Domestic Violence,Male,60+,5970,4305,1665,5742,228
2002,Urban,Arunachal Pradesh,Crime Against Women,Molestation,Male,0-12,7370,6293,1077,6833,537
2002,Rural,Assam,Crime Against Men,Murder,Male,18-30,1165,95,1070,491,674
2010,Rural,Maharashtra,Crime Against Women,Molestation,Male,13-17,7547,1689,5858,4081,3466
2004,Rural,Chhattisgarh,Other Crimes,Cyber Crime,Female,31-45,3132,1074,2058,1426,1706
2008,Urban,Tripura,Other Crimes,Fraud,Male,31-45,2374,1568,806,1813,561
2006,Rural,Haryana,Crime Against Children,Child Abuse,Male,46-60,8978,3306,5672,4749,4229
2010,Rural,Andhra Pradesh,Crime Against Men,Extortion,Male,31-45,5894,3779,2115,4575,1319
2007,Rural,Arunachal Pradesh,Crime Against Women,Domestic Violence,Female,0-12,4719,1917,2802,1961,2758
2002,Urban,Arunachal Pradesh,Crime Against Men,Extortion,Female,13-17,5808,2175,3633,2789,3019
2010,Rural,West Bengal,Other Crimes,Fraud,Male,13-17,6538,1912,4626,2489,4049
2008,Rural,Karnataka,Other Crimes,Drug Offense,Female,31-45,4452,3101,1351,4285,167
2002,Urban,Meghalaya,Other Crimes,Corruption,Female,46-60,5441,94,5347,5156,285
2001,Urban,Uttarakhand,Other Crimes,Corruption,Male,46-60,3175,2330,845,2616,559
2006,Rural,West Bengal,Crime Against Men,Extortion,Female,0-12,1344,499,845,587,757
2007,Urban,Maharashtra,Property Crime,Theft,Female,0-12,3590,2839,751,3263,327
2007,Rural,Maharashtra,Crime Against Men,Robbery,Male,18-30,5593,1692,3901,2400,3193
2003,Urban,Bihar,Crime Against Children,Child Labor,Male,31-45,3780,2018,1762,2082,1698
2010,Rural,Punjab,Crime Against Children,Kidnapping,Male,13-17,3847,326,3521,1744,2103
2003,Rural,Uttarakhand,Crime Against Women,Molestation,Male,31-45,697,430,267,589,108
2008,Urban,Kerala,Property Crime,Arson,Male,46-60,4456,449,4007,3499,957
2002,Rural,Karnataka,Crime Against Children,Child Labor,Female,46-60,8227,4918,3309,6589,1638
2005,Rural,Uttar Pradesh,Crime Against Children,Kidnapping,Male,46-60,5183,2086,3097,4492,691
2006,Urban,Madhya Pradesh,Crime Against Women,Domestic Violence,Female,46-60,1085,233,852,669,416
2010,Urban,Kerala,Property Crime,Vandalism,Female,31-45,7875,353,7522,7766,109
2006,Rural,Jammu & Kashmir,Property Crime,Arson,Female,0-12,1466,526,940,806,660
2002,Urban,Manipur,Other Crimes,Cyber Crime,Male,13-17,1907,647,1260,1078,829
2002,Rural,Himachal Pradesh,Property Crime,Vandalism,Male,0-12,4080,2912,1168,3570,510
2002,Rural,Rajasthan,Crime Against Men,Assault,Female,18-30,806,218,588,769,37
2004,Urban,Uttar Pradesh,Crime Against Women,Domestic Violence,Male,0-12,1098,199,899,722,376
2009,Rural,Telangana,Other Crimes,Fraud,Female,46-60,5058,385,4673,1017,4041
2005,Rural,Haryana,Crime Against Men,Assault,Female,18-30,6034,4801,1233,5063,971
2006,Urban,Mizoram,Crime Against Women,Dowry Deaths,Male,31-45,7667,3324,4343,6787,880
2003,Rural,Uttar Pradesh,Crime Against Men,Extortion,Male,60+,4121,3130,991,3688,433
2007,Rural,Tripura,Property Crime,Burglary,Female,46-60,5310,5063,247,5233,77
2009,Urban,Mizoram,Crime Against Women,Molestation,Male,46-60,3560,1421,2139,1915,1645
2002,Urban,Maharashtra,Crime Against Children,Child Labor,Male,0-12,1004,533,471,838,166
2001,Urban,Karnataka,Other Crimes,Fraud,Female,46-60,3305,431,2874,2489,816
2004,Rural,Andhra Pradesh,Other Crimes,Fraud,Female,13-17,9698,3641,6057,3790,5908
2005,Urban,Nagaland,Crime Against Women,Molestation,Male,0-12,2470,56,2414,1642,828
2010,Rural,Meghalaya,Property Crime,Vandalism,Female,60+,1983,914,1069,1857,126
2010,Rural,Tamil Nadu,Other Crimes,Drug Offense,Male,0-12,1735,1446,289,1464,271
2010,Urban,Maharashtra,Crime Against Women,Molestation,Male,13-17,3362,247,3115,2121,1241
2010,Urban,Meghalaya,Crime Against Women,Molestation,Female,18-30,4419,3531,888,4237,182
2009,Rural,West Bengal,Crime Against Children,Trafficking,Male,60+,3222,2431,791,2493,729
2003,Urban,Mizoram,Crime Against Children,Trafficking,Female,60+,5742,4053,1689,4117,1625
2002,Urban,Uttarakhand,Property Crime,Arson,Female,0-12,9817,7071,2746,7630,2187
2004,Rural,Jammu & Kashmir,Crime Against Women,Molestation,Male,46-60,3008,2133,875,2817,191
2005,Urban,Manipur,Crime Against Children,Child Labor,Female,46-60,2774,1689,1085,2745,29
2001,Urban,Mizoram,Other Crimes,Fraud,Male,46-60,8486,220,8266,7217,1269
2009,Urban,Gujarat,Crime Against Children,Child Labor,Male,46-60,9962,3967,5995,6662,3300
2010,Rural,Rajasthan,Property Crime,Burglary,Female,13-17,3158,2918,240,3034,124
2010,Urban,Himachal Pradesh,Crime Against Women,Molestation,Male,0-12,8396,2402,5994,6554,1842
2003,Rural,Mizoram,Crime Against Women,Domestic Violence,Female,13-17,5057,5030,27,5042,15
2003,Rural,Madhya Pradesh,Property Crime,Burglary,Female,31-45,1917,1137,780,1760,157
2008,Urban,Rajasthan,Crime Against Children,Child Abuse,Male,0-12,9340,4419,4921,7478,1862
2002,Rural,Delhi,Other Crimes,Fraud,Female,18-30,214,1,213,106,108
2006,Urban,Andhra Pradesh,Crime Against Men,Assault,Male,46-60,1263,962,301,1203,60
2008,Rural,Sikkim,Crime Against Men,Robbery,Female,31-45,933,365,568,556,377
2006,Urban,Arunachal Pradesh,Other Crimes,Drug Offense,Male,60+,9680,2142,7538,2533,7147
2005,Urban,Arunachal Pradesh,Other Crimes,Cyber Crime,Female,31-45,7356,2703,4653,6018,1338
2008,Urban,Nagaland,Other Crimes,Drug Offense,Male,46-60,7037,6001,1036,6055,982
2003,Urban,Himachal Pradesh,Crime Against Men,Robbery,Female,0-12,6652,2071,4581,6426,226
2004,Urban,Himachal Pradesh,Property Crime,Burglary,Male,13-17,3073,90,2983,1717,1356
2005,Urban,Tamil Nadu,Other Crimes,Drug Offense,Male,46-60,8333,370,7963,1260,7073
2009,Rural,Maharashtra,Crime Against Children,Trafficking,Male,13-17,7281,6660,621,7223,58
2002,Urban,Goa,Property Crime,Theft,Male,46-60,5833,4146,1687,5785,48
2007,Rural,Arunachal Pradesh,Crime Against Men,Murder,Male,31-45,1427,1359,68,1415,12
2007,Urban,Nagaland,Other Crimes,Corruption,Male,0-12,2181,1697,484,1938,243
2010,Urban,Kerala,Property Crime,Vandalism,Male,46-60,9008,1698,7310,4992,4016
2010,Urban,Punjab,Crime Against Women,Dowry Deaths,Female,13-17,6537,4112,2425,5714,823
2004,Rural,Chhattisgarh,Other Crimes,Drug Offense,Male,60+,5134,256,4878,2596,2538
2001,Rural,Manipur,Crime Against Women,Rape,Female,0-12,5879,4851,1028,4927,952
2007,Urban,Uttarakhand,Crime Against Men,Murder,Female,0-12,5011,1746,3265,2296,2715
2001,Rural,Himachal Pradesh,Crime Against Children,Child Labor,Male,31-45,8308,3840,4468,6826,1482
2010,Urban,Telangana,Crime Against Children,Kidnapping,Female,31-45,750,18,732,321,429
2004,Rural,Kerala,Crime Against Women,Domestic Violence,Male,60+,3874,1957,1917,3042,832
2003,Rural,Jharkhand,Other Crimes,Fraud,Male,31-45,2902,2833,69,2870,32
2010,Urban,Goa,Other Crimes,Corruption,Male,31-45,3969,2352,1617,3960,9
2001,Urban,Sikkim,Crime Against Men,Assault,Male,13-17,7493,2264,5229,5878,1615
2004,Rural,Telangana,Crime Against Women,Molestation,Female,60+,8964,8523,441,8660,304
2006,Urban,Punjab,Property Crime,Theft,Female,18-30,1301,1222,79,1233,68
2009,Urban,Himachal Pradesh,Other Crimes,Corruption,Male,46-60,9183,7187,1996,8101,1082
2001,Rural,Delhi,Crime Against Men,Extortion,Male,60+,1501,1382,119,1396,105
2001,Urban,Haryana,Crime Against Women,Rape,Male,13-17,9881,7750,2131,8156,1725
2005,Rural,Karnataka,Crime Against Men,Robbery,Male,60+,5269,4620,649,5120,149
2001,Urban,Nagaland,Other Crimes,Drug Offense,Female,13-17,6734,2233,4501,5029,1705
2003,Urban,Himachal Pradesh,Property Crime,Arson,Male,46-60,7036,3456,3580,5335,1701
2002,Urban,Jharkhand,Crime Against Men,Robbery,Male,31-45,2440,700,1740,1605,835
2006,Rural,Haryana,Crime Against Men,Murder,Male,13-17,4603,3186,1417,4015,588
2005,Rural,Sikkim,Property Crime,Burglary,Female,31-45,3941,94,3847,440,3501
2008,Rural,Meghalaya,Crime Against Children,Child Labor,Male,60+,5850,5532,318,5574,276
2006,Rural,Jharkhand,Crime Against Men,Extortion,Female,31-45,9301,8332,969,9204,97
2005,Rural,Bihar,Other Crimes,Fraud,Male,31-45,8369,240,8129,1141,7228
2003,Rural,Himachal Pradesh,Other Crimes,Drug Offense,Female,0-12,7868,1966,5902,2170,5698
2001,Rural,Punjab,Other Crimes,Corruption,Male,60+,6525,1621,4904,3812,2713
2008,Urban,Telangana,Crime Against Women,Molestation,Male,0-12,1749,1559,190,1687,62
2008,Urban,Gujarat,Property Crime,Vandalism,Female,31-45,6035,4214,1821,5473,562
2006,Rural,Madhya Pradesh,Other Crimes,Fraud,Male,31-45,8382,7542,840,7662,720
2002,Rural,Karnataka,Property Crime,Vandalism,Male,31-45,150,58,92,114,36
2001,Urban,Assam,Crime Against Children,Trafficking,Female,13-17,2560,1047,1513,2240,320
2010,Rural,Karnataka,Crime Against Children,Kidnapping,Female,13-17,8500,7216,1284,7454,1046
2010,Rural,Madhya Pradesh,Crime Against Men,Murder,Female,13-17,3169,2011,1158,2016,1153
2003,Rural,Chhattisgarh,Other Crimes,Drug Offense,Male,13-17,8161,4774,3387,7471,690
2006,Urban,Andhra Pradesh,Crime Against Men,Extortion,Male,46-60,2688,2184,504,2384,304
2007,Rural,Mizoram,Property Crime,Arson,Male,31-45,7829,3079,4750,4945,2884
2005,Rural,Kerala,Crime Against Men,Robbery,Male,46-60,6813,1858,4955,2916,3897
2001,Rural,Bihar,Crime Against Children,Kidnapping,Female,18-30,2050,442,1608,662,1388
2001,Rural,Rajasthan,Crime Against Children,Child Abuse,Male,13-17,2562,1152,1410,2115,447
2006,Urban,Haryana,Other Crimes,Corruption,Female,46-60,1374,1125,249,1195,179
2003,Urban,Arunachal Pradesh,Crime Against Women,Dowry Deaths,Male,18-30,7617,7617,0,7617,0
2009,Urban,Madhya Pradesh,Crime Against Men,Assault,Female,0-12,2521,1942,579,2300,221
2008,Rural,Tripura,Other Crimes,Fraud,Female,18-30,2207,1571,636,1816,391
2003,Rural,Maharashtra,Crime Against Children,Kidnapping,Female,18-30,7411,2700,4711,3734,3677
2007,Urban,Uttar Pradesh,Property Crime,Vandalism,Female,31-45,8361,7157,1204,7896,465
2002,Rural,Tripura,Property Crime,Vandalism,Male,0-12,6457,2933,3524,6211,246
2003,Rural,West Bengal,Crime Against Men,Assault,Female,13-17,4240,4053,187,4217,23
2007,Urban,Telangana,Property Crime,Theft,Male,18-30,884,631,253,840,44
2008,Urban,Assam,Crime Against Men,Assault,Female,18-30,2445,2172,273,2340,105
2003,Rural,Haryana,Crime Against Women,Rape,Female,60+,8629,7075,1554,8152,477
2009,Urban,Rajasthan,Crime Against Children,Kidnapping,Female,0-12,1491,1232,259,1301,190
2004,Urban,Andhra Pradesh,Crime Against Children,Child Labor,Male,18-30,191,159,32,179,12
2009,Urban,Bihar,Crime Against Men,Robbery,Female,31-45,1589,1106,483,1490,99
2009,Rural,Madhya Pradesh,Crime Against Children,Kidnapping,Female,46-60,6640,3373,3267,5986,654
2009,Rural,Kerala,Other Crimes,Cyber Crime,Female,46-60,1958,423,1535,1191,767
2010,Rural,Chhattisgarh,Other Crimes,Cyber Crime,Male,31-45,925,661,264,910,15
2002,Rural,Meghalaya,Other Crimes,Corruption,Male,46-60,2724,225,2499,709,2015
2006,Urban,Andhra Pradesh,Property Crime,Arson,Male,0-12,5869,3723,2146,4986,883
2009,Urban,Uttarakhand,Crime Against Women,Rape,Female,46-60,279,237,42,263,16
2003,Rural,Meghalaya,Property Crime,Arson,Male,31-45,2829,83,2746,2450,379
2005,Urban,Uttarakhand,Crime Against Men,Assault,Male,0-12,1488,1400,88,1449,39
2005,Rural,Odisha,Crime Against Men,Robbery,Male,60+,5183,1450,3733,4955,228
2001,Rural,Madhya Pradesh,Other Crimes,Corruption,Female,18-30,8343,5345,2998,7138,1205
2010,Urban,Meghalaya,Crime Against Women,Rape,Female,0-12,5409,3421,1988,4986,423
2008,Rural,Gujarat,Property Crime,Theft,Male,18-30,8602,8550,52,8565,37
2006,Rural,Arunachal Pradesh,Property Crime,Burglary,Male,60+,1989,1950,39,1981,8
2010,Urban,Jharkhand,Crime Against Men,Robbery,Male,60+,2852,268,2584,1688,1164
2009,Urban,Mizoram,Other Crimes,Cyber Crime,Female,46-60,9226,3503,5723,5924,3302
2007,Rural,Telangana,Other Crimes,Corruption,Female,60+,4748,681,4067,1853,2895
2007,Rural,Mizoram,Crime Against Men,Assault,Male,46-60,5406,1122,4284,4404,1002
2005,Rural,West Bengal,Crime Against Children,Child Labor,Male,60+,5377,506,4871,4350,1027
2003,Rural,Mizoram,Crime Against Women,Molestation,Female,0-12,8217,4669,3548,6830,1387
2006,Urban,Jammu & Kashmir,Other Crimes,Fraud,Male,60+,2425,2367,58,2372,53
2010,Urban,Haryana,Other Crimes,Fraud,Female,13-17,2256,1704,552,1946,310
2005,Rural,Nagaland,Property Crime,Theft,Female,0-12,5088,209,4879,2983,2105
2002,Rural,Mizoram,Crime Against Men,Murder,Female,60+,3734,1778,1956,2131,1603
2006,Rural,Andhra Pradesh,Property Crime,Theft,Male,31-45,1609,453,1156,998,611
2004,Urban,Tamil Nadu,Property Crime,Burglary,Male,13-17,1600,533,1067,1560,40
2009,Urban,Himachal Pradesh,Other Crimes,Corruption,Female,31-45,9720,7186,2534,9692,28
2001,Rural,Telangana,Other Crimes,Corruption,Female,13-17,652,96,556,647,5
2002,Rural,Arunachal Pradesh,Property Crime,Vandalism,Female,18-30,6793,488,6305,5063,1730
2003,Urban,Mizoram,Crime Against Men,Robbery,Female,18-30,4326,744,3582,3970,356
2002,Urban,Gujarat,Property Crime,Burglary,Female,0-12,3784,2761,1023,3372,412
2009,Urban,Maharashtra,Property Crime,Vandalism,Male,18-30,9599,6339,3260,8278,1321
2005,Urban,Uttarakhand,Crime Against Men,Extortion,Female,0-12,6654,5340,1314,5711,943
2007,Urban,Mizoram,Other Crimes,Cyber Crime,Male,13-17,8885,1961,6924,5934,2951
2010,Urban,Nagaland,Other Crimes,Cyber Crime,Male,46-60,5456,3183,2273,3301,2155
2006,Urban,Karnataka,Other Crimes,Drug Offense,Male,18-30,6200,2193,4007,2855,3345
2005,Urban,Chhattisgarh,Property Crime,Burglary,Female,13-17,9786,9772,14,9780,6
2010,Urban,Punjab,Property Crime,Burglary,Male,60+,5234,2316,2918,4987,247
2007,Rural,Manipur,Crime Against Men,Extortion,Female,13-17,1078,191,887,933,145
2007,Urban,Maharashtra,Other Crimes,Fraud,Male,13-17,2935,1440,1495,1989,946
2002,Rural,Odisha,Property Crime,Theft,Female,13-17,2971,2757,214,2943,28
2004,Urban,Nagaland,Property Crime,Burglary,Male,31-45,2340,516,1824,2014,326
2004,Rural,Arunachal Pradesh,Property Crime,Arson,Female,31-45,602,142,460,173,429
2004,Rural,Tripura,Crime Against Children,Child Abuse,Female,18-30,3114,397,2717,696,2418
2006,Urban,Goa,Crime Against Men,Murder,Male,13-17,4060,1899,2161,4048,12
2009,Urban,Jammu & Kashmir,Property Crime,Theft,Female,18-30,686,191,495,518,168
2005,Rural,West Bengal,Other Crimes,Cyber Crime,Male,46-60,4632,3262,1370,4457,175
2008,Rural,Sikkim,Crime Against Men,Robbery,Female,31-45,9404,5021,4383,5870,3534
2006,Rural,Manipur,Other Crimes,Fraud,Male,46-60,1967,1779,188,1872,95
2001,Urban,Tripura,Crime Against Children,Trafficking,Female,0-12,4519,1557,2962,2963,1556
2007,Urban,Delhi,Crime Against Women,Rape,Female,18-30,7843,902,6941,1082,6761
2006,Rural,Karnataka,Crime Against Men,Robbery,Male,46-60,4396,1414,2982,3909,487
2005,Rural,Haryana,Crime Against Men,Murder,Male,0-12,4014,2772,1242,3779,235
2008,Urban,Tripura,Crime Against Children,Kidnapping,Male,46-60,3633,3004,629,3280,353
2002,Urban,Assam,Other Crimes,Fraud,Male,18-30,3549,425,3124,2349,1200
2001,Urban,Nagaland,Crime Against Men,Robbery,Female,31-45,900,750,150,805,95
2004,Rural,Chhattisgarh,Other Crimes,Fraud,Female,46-60,1563,641,922,1387,176
2004,Rural,Bihar,Property Crime,Burglary,Male,31-45,7439,3933,3506,5131,2308
2008,Rural,West Bengal,Crime Against Children,Kidnapping,Female,60+,1850,601,1249,1674,176
2004,Rural,Uttarakhand,Crime Against Children,Child Abuse,Male,60+,6494,1937,4557,5515,979
2006,Rural,Assam,Crime Against Men,Robbery,Female,18-30,3320,503,2817,2505,815
2005,Rural,Sikkim,Crime Against Men,Extortion,Female,60+,7088,3720,3368,6586,502
2001,Rural,Meghalaya,Property Crime,Arson,Female,18-30,2141,457,1684,651,1490
2008,Rural,Tamil Nadu,Crime Against Women,Rape,Male,31-45,1236,1226,10,1227,9
2009,Rural,Tripura,Crime Against Men,Robbery,Male,0-12,1380,8,1372,880,500
2004,Rural,Madhya Pradesh,Crime Against Women,Molestation,Male,13-17,5798,822,4976,4753,1045
2006,Rural,Gujarat,Crime Against Men,Murder,Female,18-30,3678,1941,1737,2324,1354
2007,Rural,Haryana,Crime Against Men,Extortion,Female,60+,6298,5768,530,5871,427
2010,Rural,Tamil Nadu,Crime Against Men,Assault,Female,60+,700,666,34,675,25
2008,Rural,Kerala,Other Crimes,Drug Offense,Male,13-17,430,173,257,253,177
2006,Rural,Assam,Other Crimes,Corruption,Male,13-17,8148,8010,138,8119,29
2005,Urban,Odisha,Crime Against Men,Murder,Male,31-45,4918,3775,1143,4532,386
2010,Rural,Assam,Crime Against Children,Kidnapping,Female,31-45,6328,3151,3177,5658,670
2002,Rural,Meghalaya,Other Crimes,Cyber Crime,Male,0-12,816,548,268,587,229
2005,Urban,Nagaland,Crime Against Men,Robbery,Male,60+,1161,269,892,387,774
2003,Rural,Sikkim,Crime Against Children,Kidnapping,Male,18-30,9749,1257,8492,6426,3323
2005,Rural,Jammu & Kashmir,Property Crime,Theft,Female,46-60,4696,3477,1219,4199,497
2009,Urban,Kerala,Property Crime,Arson,Male,60+,2279,1678,601,1738,541
2009,Urban,Madhya Pradesh,Other Crimes,Drug Offense,Female,46-60,8543,1984,6559,3952,4591
2002,Urban,Uttar Pradesh,Crime Against Children,Child Labor,Female,60+,6225,2866,3359,3056,3169
2002,Rural,Meghalaya,Property Crime,Theft,Male,46-60,1793,1705,88,1793,0
2002,Urban,Jammu & Kashmir,Crime Against Children,Kidnapping,Female,0-12,2134,1489,645,1859,275
2002,Rural,Kerala,Crime Against Women,Domestic Violence,Female,31-45,8774,446,8328,5158,3616
2004,Rural,Bihar,Crime Against Women,Molestation,Female,13-17,9291,4146,5145,5433,3858
2001,Rural,Uttarakhand,Crime Against Men,Extortion,Male,0-12,7036,3678,3358,4224,2812
2002,Urban,Jharkhand,Crime Against Women,Dowry Deaths,Female,18-30,2356,1533,823,2242,114
2003,Rural,Maharashtra,Crime Against Children,Child Labor,Male,31-45,3182,2689,493,2848,334
2001,Urban,Telangana,Crime Against Women,Domestic Violence,Male,46-60,3950,1933,2017,2312,1638
2003,Urban,Goa,Crime Against Women,Domestic Violence,Female,0-12,2794,40,2754,95,2699
2001,Rural,Haryana,Property Crime,Arson,Male,31-45,9900,9814,86,9849,51
2010,Urban,Goa,Crime Against Women,Dowry Deaths,Male,18-30,1508,1457,51,1468,40
2003,Urban,Andhra Pradesh,Crime Against Women,Rape,Male,46-60,7209,2876,4333,3982,3227
2004,Rural,Tamil Nadu,Other Crimes,Fraud,Female,31-45,8367,3206,5161,3966,4401
2004,Rural,Goa,Other Crimes,Drug Offense,Female,46-60,9332,4422,4910,8368,964
2001,Urban,Rajasthan,Other Crimes,Fraud,Male,13-17,4766,4140,626,4506,260
2006,Urban,Bihar,Crime Against Men,Murder,Female,0-12,1808,1730,78,1735,73
2001,Urban,Gujarat,Crime Against Women,Domestic Violence,Female,46-60,8531,3311,5220,5408,3123
2004,Rural,Kerala,Crime Against Men,Murder,Male,18-30,1543,83,1460,1278,265
2001,Rural,Punjab,Crime Against Children,Child Labor,Male,13-17,3210,1725,1485,2727,483
2008,Rural,Goa,Other Crimes,Cyber Crime,Male,31-45,7234,498,6736,3335,3899
2006,Rural,Manipur,Crime Against Women,Domestic Violence,Male,0-12,9744,1903,7841,4464,5280
2008,Urban,Karnataka,Other Crimes,Fraud,Female,46-60,1154,527,627,881,273
2006,Rural,Jammu & Kashmir,Crime Against Women,Dowry Deaths,Female,0-12,3695,3612,83,3623,72
2008,Rural,Goa,Property Crime,Burglary,Male,13-17,2332,446,1886,1511,821
2009,Rural,Madhya Pradesh,Other Crimes,Drug Offense,Female,18-30,5953,154,5799,3548,2405
2010,Rural,Nagaland,Crime Against Women,Domestic Violence,Female,18-30,4484,3362,1122,3503,981
2005,Urban,Odisha,Crime Against Children,Child Abuse,Male,31-45,9465,7557,1908,8213,1252
2003,Rural,Jammu & Kashmir,Crime Against Children,Kidnapping,Female,31-45,6359,6346,13,6358,1
2006,Rural,Arunachal Pradesh,Crime Against Children,Child Labor,Male,18-30,3372,2398,974,3073,299
2010,Rural,Assam,Property Crime,Burglary,Male,46-60,5871,1509,4362,4501,1370
2008,Urban,Haryana,Crime Against Children,Child Labor,Female,13-17,2557,18,2539,2346,211
2003,Rural,Haryana,Crime Against Men,Assault,Female,60+,524,496,28,524,0
2006,Rural,Uttarakhand,Crime Against Men,Extortion,Female,31-45,3507,1262,2245,2637,870
2004,Urban,Tamil Nadu,Crime Against Women,Domestic Violence,Male,46-60,3972,104,3868,3511,461
2004,Urban,Chhattisgarh,Crime Against Children,Kidnapping,Female,0-12,4402,2012,2390,3483,919
2010,Urban,Punjab,Crime Against Children,Child Abuse,Female,13-17,3988,3292,696,3734,254
2004,Urban,Tamil Nadu,Crime Against Men,Extortion,Female,0-12,4529,4040,489,4389,140
2004,Rural,Kerala,Crime Against Children,Child Labor,Female,46-60,6918,1377,5541,5530,1388
2010,Rural,Jharkhand,Crime Against Men,Extortion,Male,31-45,9095,6368,2727,6492,2603
2008,Urban,Uttar Pradesh,Crime Against Children,Kidnapping,Female,60+,4203,3599,604,3723,480
2010,Urban,Punjab,Crime Against Children,Child Labor,Male,13-17,6165,5139,1026,5636,529
2010,Urban,Assam,Other Crimes,Cyber Crime,Male,0-12,2092,138,1954,1779,313
2010,Rural,Uttar Pradesh,Crime Against Women,Molestation,Male,18-30,4001,3280,721,3733,268
2009,Rural,Sikkim,Crime Against Children,Trafficking,Male,31-45,5399,4080,1319,4721,678
2002,Urban,Tamil Nadu,Crime Against Women,Dowry Deaths,Male,0-12,6012,7,6005,2096,3916
2006,Rural,Jammu & Kashmir,Crime Against Children,Trafficking,Female,18-30,9798,4176,5622,8134,1664
2005,Urban,Karnataka,Crime Against Children,Trafficking,Female,46-60,6321,2179,4142,2381,3940
2008,Rural,Punjab,Other Crimes,Corruption,Male,60+,5248,3558,1690,4006,1242
2002,Urban,Rajasthan,Crime Against Children,Child Labor,Male,0-12,8723,392,8331,4216,4507
2010,Rural,Chhattisgarh,Crime Against Women,Molestation,Female,13-17,3062,2059,1003,2448,614
2005,Urban,Karnataka,Crime Against Men,Extortion,Male,46-60,9829,5744,4085,5887,3942
2005,Urban,Bihar,Crime Against Children,Child Labor,Male,46-60,5276,1340,3936,4354,922
2005,Urban,Assam,Property Crime,Vandalism,Male,60+,1491,434,1057,1380,111
2003,Rural,Karnataka,Other Crimes,Fraud,Male,0-12,1746,1549,197,1690,56
2009,Rural,Bihar,Other Crimes,Drug Offense,Female,60+,7159,125,7034,6738,421
2001,Rural,Sikkim,Crime Against Children,Trafficking,Male,31-45,2951,2155,796,2564,387
2009,Urban,Rajasthan,Other Crimes,Cyber Crime,Female,46-60,8509,1919,6590,3518,4991
2005,Urban,Assam,Crime Against Women,Dowry Deaths,Male,31-45,8446,1975,6471,4401,4045
2004,Urban,Goa,Property Crime,Vandalism,Female,0-12,7445,6744,701,7252,193
2008,Rural,Maharashtra,Crime Against Children,Child Abuse,Female,31-45,137,115,22,137,0
2004,Rural,Manipur,Crime Against Children,Child Abuse,Female,13-17,6355,5743,612,6194,161
2009,Rural,Tamil Nadu,Crime Against Children,Kidnapping,Male,46-60,9641,8270,1371,9621,20
2007,Urban,Nagaland,Crime Against Children,Kidnapping,Male,0-12,1855,825,1030,1084,771
2005,Urban,Chhattisgarh,Crime Against Children,Child Abuse,Female,46-60,8835,1673,7162,3442,5393
2004,Urban,Uttarakhand,Crime Against Women,Dowry Deaths,Male,18-30,3507,1673,1834,2514,993
2004,Urban,West Bengal,Crime Against Men,Robbery,Male,46-60,6523,1470,5053,1845,4678
2001,Rural,Telangana,Crime Against Men,Extortion,Male,18-30,8743,6241,2502,8031,712
2005,Urban,Madhya Pradesh,Other Crimes,Corruption,Male,0-12,8673,4337,4336,6515,2158
2001,Urban,Sikkim,Crime Against Men,Murder,Female,31-45,3826,522,3304,2787,1039
2009,Urban,Haryana,Crime Against Children,Trafficking,Female,46-60,7992,997,6995,7677,315
2009,Rural,Bihar,Crime Against Women,Domestic Violence,Male,0-12,4071,1467,2604,2222,1849
2009,Urban,Kerala,Property Crime,Vandalism,Male,0-12,58,54,4,58,0
2005,Rural,Telangana,Property Crime,Theft,Female,13-17,2730,1653,1077,2513,217
2005,Urban,Jammu & Kashmir,Crime Against Women,Rape,Male,46-60,4534,381,4153,1000,3534
2006,Urban,Haryana,Crime Against Women,Dowry Deaths,Female,60+,8303,1437,6866,8109,194
2004,Rural,Punjab,Crime Against Men,Assault,Female,31-45,9290,6177,3113,7323,1967
2002,Urban,Haryana,Property Crime,Vandalism,Female,31-45,5065,2576,2489,3617,1448
2002,Rural,Kerala,Crime Against Women,Molestation,Female,31-45,1302,495,807,584,718
2010,Rural,Tamil Nadu,Crime Against Women,Molestation,Male,60+,5386,3444,1942,4264,1122
2002,Rural,Madhya Pradesh,Crime Against Men,Robbery,Female,46-60,9309,6109,3200,8948,361
2010,Urban,Tripura,Crime Against Women,Molestation,Male,13-17,7601,3673,3928,7517,84
2007,Rural,Manipur,Other Crimes,Corruption,Female,0-12,9621,1065,8556,3768,5853
2009,Rural,West Bengal,Crime Against Men,Murder,Female,46-60,1075,925,150,997,78
2003,Urban,Jharkhand,Crime Against Men,Murder,Female,18-30,9279,7881,1398,9059,220
2001,Urban,Himachal Pradesh,Crime Against Women,Molestation,Male,13-17,5673,3068,2605,4475,1198
2009,Urban,Nagaland,Crime Against Women,Molestation,Male,60+,5713,3050,2663,4655,1058
2008,Urban,Goa,Other Crimes,Corruption,Female,18-30,4837,4395,442,4490,347
2003,Rural,Himachal Pradesh,Crime Against Children,Child Abuse,Male,31-45,3600,231,3369,698,2902
2001,Urban,Punjab,Crime Against Men,Extortion,Male,46-60,2136,1008,1128,2007,129
2006,Rural,Goa,Crime Against Men,Assault,Male,46-60,4625,3504,1121,3732,893
2004,Urban,Uttar Pradesh,Crime Against Children,Child Abuse,Female,60+,7579,3474,4105,4903,2676
2007,Rural,Punjab,Crime Against Men,Murder,Male,60+,2644,807,1837,2594,50
2007,Rural,Meghalaya,Other Crimes,Cyber Crime,Female,0-12,4815,4327,488,4544,271
2003,Rural,Uttarakhand,Crime Against Women,Rape,Male,31-45,5547,4110,1437,5316,231
2010,Rural,Uttar Pradesh,Crime Against Children,Child Abuse,Female,31-45,758,366,392,617,141
2002,Urban,Nagaland,Other Crimes,Drug Offense,Female,0-12,1941,1268,673,1554,387
2001,Rural,Andhra Pradesh,Property Crime,Arson,Male,0-12,952,711,241,828,124
2010,Rural,Sikkim,Other Crimes,Corruption,Female,31-45,6747,2571,4176,3605,3142
2005,Rural,Madhya Pradesh,Property Crime,Theft,Male,60+,5328,3053,2275,3175,2153
2009,Urban,Odisha,Other Crimes,Drug Offense,Female,13-17,8765,4189,4576,7415,1350
2005,Urban,Jammu & Kashmir,Crime Against Children,Kidnapping,Female,60+,2707,914,1793,2375,332
2005,Rural,Uttarakhand,Crime Against Children,Child Abuse,Male,18-30,2924,2772,152,2910,14
2003,Rural,Madhya Pradesh,Crime Against Women,Domestic Violence,Female,31-45,1347,465,882,693,654
2004,Rural,Odisha,Crime Against Men,Assault,Male,13-17,2766,1130,1636,1694,1072
2004,Urban,Karnataka,Other Crimes,Fraud,Female,13-17,3831,3705,126,3708,123
2007,Urban,Odisha,Property Crime,Vandalism,Female,31-45,4418,1630,2788,2398,2020
2005,Urban,Uttarakhand,Other Crimes,Corruption,Male,31-45,671,410,261,447,224
2002,Rural,Uttarakhand,Crime Against Women,Dowry Deaths,Male,31-45,2549,255,2294,1640,909
2003,Rural,Maharashtra,Other Crimes,Cyber Crime,Female,60+,3665,1519,2146,3334,331
2006,Rural,Nagaland,Property Crime,Vandalism,Female,46-60,3370,1390,1980,1574,1796
2006,Urban,Karnataka,Property Crime,Arson,Male,60+,3559,3515,44,3556,3
2007,Rural,Manipur,Property Crime,Arson,Female,0-12,7124,6555,569,7001,123
2006,Rural,Bihar,Crime Against Men,Murder,Male,31-45,9965,1708,8257,7161,2804
2004,Rural,Odisha,Crime Against Men,Extortion,Female,46-60,1683,268,1415,1676,7
2001,Urban,Madhya Pradesh,Other Crimes,Fraud,Female,0-12,3495,449,3046,2635,860
2005,Urban,Arunachal Pradesh,Property Crime,Arson,Female,13-17,6747,98,6649,192,6555
2010,Rural,Goa,Crime Against Women,Dowry Deaths,Male,0-12,2445,1347,1098,1797,648
2002,Rural,Jammu & Kashmir,Crime Against Men,Assault,Female,18-30,1264,998,266,1186,78
2006,Rural,Goa,Crime Against Women,Dowry Deaths,Male,18-30,7078,6540,538,6639,439
2008,Urban,Andhra Pradesh,Other Crimes,Cyber Crime,Male,46-60,6642,3588,3054,5532,1110
2006,Urban,Punjab,Property Crime,Theft,Female,60+,192,64,128,143,49
2007,Rural,Mizoram,Other Crimes,Fraud,Male,13-17,6037,481,5556,5352,685
2005,Urban,Arunachal Pradesh,Crime Against Men,Robbery,Female,18-30,9876,3056,6820,3057,6819
2010,Urban,Rajasthan,Property Crime,Arson,Female,0-12,4122,4037,85,4071,51
2008,Urban,Uttarakhand,Crime Against Women,Domestic Violence,Male,31-45,4825,3571,1254,4554,271
2009,Rural,Manipur,Property Crime,Burglary,Female,46-60,3341,1841,1500,2092,1249
2002,Rural,Meghalaya,Crime Against Women,Rape,Male,13-17,7072,5343,1729,6522,550
2004,Urban,Assam,Crime Against Women,Rape,Female,13-17,5942,4112,1830,4135,1807
2009,Rural,Assam,Other Crimes,Fraud,Male,46-60,5072,1501,3571,3845,1227
2009,Urban,Delhi,Property Crime,Arson,Female,18-30,3318,3194,124,3283,35
2006,Urban,Arunachal Pradesh,Property Crime,Theft,Male,18-30,386,229,157,254,132
2009,Urban,Karnataka,Crime Against Women,Dowry Deaths,Female,31-45,3240,546,2694,2504,736
2010,Urban,Goa,Property Crime,Arson,Male,18-30,9096,5485,3611,8718,378
2008,Rural,Maharashtra,Crime Against Children,Trafficking,Male,46-60,6146,454,5692,548,5598
2007,Urban,Chhattisgarh,Other Crimes,Fraud,Male,60+,2443,914,1529,1799,644
2005,Urban,Punjab,Crime Against Men,Robbery,Female,0-12,8622,311,8311,3086,5536
2005,Rural,Gujarat,Property Crime,Burglary,Female,31-45,254,19,235,237,17
2001,Urban,Mizoram,Crime Against Men,Extortion,Female,60+,7085,5214,1871,6244,841
2005,Urban,Assam,Other Crimes,Corruption,Female,18-30,4907,2029,2878,4241,666
2005,Urban,Meghalaya,Crime Against Women,Molestation,Male,0-12,4034,2991,1043,3818,216
2002,Rural,Haryana,Crime Against Men,Extortion,Male,13-17,2794,2670,124,2715,79
2001,Rural,Meghalaya,Crime Against Children,Kidnapping,Male,0-12,4429,4021,408,4247,182
2009,Rural,Kerala,Other Crimes,Fraud,Male,13-17,2387,465,1922,1133,1254
2002,Rural,Punjab,Crime Against Children,Kidnapping,Male,13-17,1824,1039,785,1334,490
2008,Rural,West Bengal,Crime Against Women,Molestation,Male,18-30,6447,140,6307,1209,5238
2004,Rural,Mizoram,Crime Against Men,Assault,Female,31-45,5385,2752,2633,4697,688
2003,Rural,Chhattisgarh,Crime Against Women,Molestation,Female,60+,9451,3909,5542,4741,4710
2003,Rural,Andhra Pradesh,Crime Against Children,Child Labor,Male,46-60,3536,3485,51,3494,42
2010,Rural,Bihar,Crime Against Children,Child Abuse,Female,60+,7205,1927,5278,2986,4219
2010,Urban,Kerala,Crime Against Children,Child Abuse,Male,46-60,9663,6620,3043,8181,1482
2010,Rural,Delhi,Other Crimes,Fraud,Male,18-30,9437,1892,7545,7488,1949
2004,Rural,Jharkhand,Property Crime,Theft,Male,46-60,791,364,427,497,294
2002,Urban,Tripura,Other Crimes,Fraud,Female,46-60,5435,2738,2697,4402,1033
2008,Urban,Sikkim,Property Crime,Arson,Male,18-30,7638,5689,1949,6699,939
2006,Rural,Tripura,Crime Against Men,Murder,Male,0-12,7920,2533,5387,3541,4379
2008,Urban,Madhya Pradesh,Crime Against Men,Extortion,Male,13-17,1581,1412,169,1561,20
2004,Urban,Uttar Pradesh,Crime Against Women,Rape,Female,18-30,3064,1451,1613,2000,1064
2001,Rural,Manipur,Crime Against Women,Molestation,Male,13-17,9527,3836,5691,6152,3375
2003,Rural,Punjab,Crime Against Children,Child Abuse,Female,18-30,9977,7691,2286,8175,1802
2005,Rural,Telangana,Crime Against Men,Assault,Female,60+,2733,2426,307,2631,102
2004,Rural,Bihar,Property Crime,Vandalism,Female,31-45,4539,577,3962,1074,3465
2008,Urban,Uttar Pradesh,Other Crimes,Corruption,Female,18-30,1246,1005,241,1151,95
2005,Rural,Telangana,Property Crime,Vandalism,Male,60+,9174,691,8483,4505,4669
2007,Rural,Bihar,Other Crimes,Drug Offense,Female,31-45,333,150,183,181,152
2003,Urban,Andhra Pradesh,Other Crimes,Drug Offense,Female,0-12,2823,367,2456,1669,1154
2007,Urban,Punjab,Crime Against Men,Robbery,Male,46-60,2731,1898,833,2658,73
2003,Urban,Arunachal Pradesh,Crime Against Children,Trafficking,Male,0-12,6667,1441,5226,6571,96
2001,Urban,Bihar,Crime Against Children,Child Labor,Male,31-45,7224,5941,1283,6043,1181
2001,Urban,Tamil Nadu,Crime Against Children,Trafficking,Male,0-12,5136,2035,3101,4821,315
2007,Urban,Punjab,Crime Against Women,Domestic Violence,Female,18-30,8431,3427,5004,7843,588
2008,Urban,Telangana,Other Crimes,Cyber Crime,Male,18-30,1879,1514,365,1760,119
2007,Urban,Uttar Pradesh,Property Crime,Burglary,Male,31-45,3133,180,2953,3120,13
2002,Urban,Mizoram,Other Crimes,Drug Offense,Male,46-60,8570,6024,2546,6805,1765
2002,Rural,West Bengal,Crime Against Men,Extortion,Male,60+,5480,4193,1287,4326,1154
2008,Rural,Haryana,Crime Against Women,Dowry Deaths,Male,13-17,4109,906,3203,2394,1715
2004,Rural,Rajasthan,Property Crime,Vandalism,Male,18-30,2095,1643,452,1862,233
2005,Rural,Delhi,Crime Against Men,Robbery,Female,13-17,2037,1141,896,1662,375
2005,Urban,Gujarat,Other Crimes,Corruption,Male,0-12,6059,4201,1858,5555,504
2001,Urban,Nagaland,Property Crime,Burglary,Female,60+,6577,3081,3496,6245,332
2003,Urban,West Bengal,Other Crimes,Fraud,Male,18-30,6721,1269,5452,3234,3487
2009,Rural,Bihar,Crime Against Women,Rape,Female,46-60,1175,955,220,986,189
2001,Urban,Delhi,Property Crime,Burglary,Male,46-60,5336,787,4549,4063,1273
2001,Rural,Maharashtra,Other Crimes,Cyber Crime,Male,0-12,4858,2415,2443,3955,903
2008,Rural,Arunachal Pradesh,Crime Against Women,Molestation,Female,13-17,429,117,312,236,193
2006,Urban,Jharkhand,Crime Against Men,Murder,Female,31-45,326,62,264,269,57
2006,Urban,Arunachal Pradesh,Other Crimes,Fraud,Female,13-17,9449,332,9117,8940,509
2009,Rural,Assam,Crime Against Women,Dowry Deaths,Male,18-30,7213,705,6508,3285,3928
2001,Rural,Gujarat,Other Crimes,Cyber Crime,Female,46-60,937,414,523,696,241
2001,Urban,Madhya Pradesh,Property Crime,Theft,Male,0-12,6750,1605,5145,3717,3033
2005,Rural,Meghalaya,Crime Against Women,Domestic Violence,Female,0-12,1009,790,219,835,174
2003,Rural,Telangana,Other Crimes,Drug Offense,Female,13-17,7923,3822,4101,6167,1756
2004,Urban,Chhattisgarh,Crime Against Children,Child Labor,Male,60+,4834,2431,2403,2658,2176
2003,Rural,Telangana,Crime Against Women,Rape,Male,60+,8213,2263,5950,6584,1629
2010,Rural,Tamil Nadu,Crime Against Children,Child Abuse,Female,18-30,4451,3638,813,4095,356
2009,Rural,Uttarakhand,Crime Against Women,Molestation,Female,13-17,1047,975,72,1034,13
2003,Rural,Odisha,Property Crime,Arson,Male,46-60,474,417,57,426,48
2004,Urban,Delhi,Other Crimes,Cyber Crime,Male,18-30,7489,1080,6409,2298,5191
2008,Urban,Himachal Pradesh,Property Crime,Vandalism,Male,0-12,588,354,234,494,94
2005,Urban,Madhya Pradesh,Crime Against Men,Assault,Male,60+,5807,2507,3300,3773,2034
2009,Rural,Goa,Property Crime,Theft,Female,60+,4159,3635,524,3943,216
2008,Rural,Manipur,Crime Against Children,Trafficking,Male,0-12,3322,2161,1161,2323,999
2001,Rural,Karnataka,Other Crimes,Drug Offense,Female,13-17,2325,1264,1061,1485,840
2006,Urban,Gujarat,Crime Against Women,Molestation,Female,31-45,6403,5199,1204,5547,856
2010,Urban,Sikkim,Other Crimes,Fraud,Male,60+,67,59,8,63,4
2009,Urban,Rajasthan,Crime Against Men,Robbery,Female,46-60,7966,5993,1973,6149,1817
2009,Urban,Uttarakhand,Crime Against Children,Kidnapping,Male,18-30,5251,5154,97,5180,71
2006,Rural,Rajasthan,Other Crimes,Drug Offense,Male,18-30,1246,1022,224,1125,121
2009,Urban,Bihar,Crime Against Men,Murder,Female,46-60,9101,2571,6530,6845,2256
2003,Rural,Karnataka,Crime Against Men,Extortion,Female,46-60,2792,1748,1044,2130,662
2009,Rural,Meghalaya,Crime Against Men,Assault,Female,60+,1166,777,389,1018,148
2005,Rural,Goa,Crime Against Children,Trafficking,Male,31-45,7385,4697,2688,5732,1653
2009,Rural,Arunachal Pradesh,Other Crimes,Cyber Crime,Female,60+,5067,300,4767,905,4162
2006,Rural,Tamil Nadu,Crime Against Women,Domestic Violence,Male,60+,4153,870,3283,3621,532
2003,Rural,Andhra Pradesh,Other Crimes,Corruption,Male,46-60,676,100,576,409,267
2010,Urban,Uttarakhand,Property Crime,Vandalism,Female,60+,2884,103,2781,1051,1833
2006,Urban,Jharkhand,Other Crimes,Fraud,Male,31-45,7929,3072,4857,4896,3033
2003,Rural,Arunachal Pradesh,Property Crime,Theft,Male,0-12,5224,381,4843,3786,1438
2003,Rural,Jammu & Kashmir,Crime Against Women,Molestation,Male,46-60,9350,217,9133,4249,5101
2010,Urban,Tripura,Property Crime,Burglary,Female,46-60,8258,5022,3236,7635,623
2008,Urban,Kerala,Property Crime,Burglary,Female,31-45,8942,4667,4275,7618,1324
2008,Rural,Kerala,Crime Against Women,Rape,Female,18-30,2557,288,2269,2433,124
2009,Rural,West Bengal,Crime Against Children,Kidnapping,Female,46-60,8159,616,7543,5415,2744
2003,Rural,Sikkim,Crime Against Women,Domestic Violence,Male,46-60,9606,2341,7265,2526,7080
2001,Urban,Uttarakhand,Crime Against Children,Kidnapping,Female,0-12,8552,3958,4594,5895,2657
2002,Urban,Tamil Nadu,Property Crime,Theft,Female,0-12,5643,3270,2373,5321,322
2001,Urban,Haryana,Crime Against Men,Extortion,Male,18-30,3293,3197,96,3250,43
2004,Rural,Uttarakhand,Crime Against Children,Child Labor,Female,31-45,8987,4402,4585,7836,1151
2007,Rural,Haryana,Crime Against Men,Extortion,Male,31-45,5668,4793,875,4812,856
2006,Urban,Nagaland,Property Crime,Burglary,Female,0-12,838,97,741,426,412
2004,Urban,Chhattisgarh,Other Crimes,Drug Offense,Male,0-12,8234,565,7669,1322,6912
2003,Urban,Manipur,Crime Against Men,Extortion,Female,60+,4849,939,3910,2866,1983
2003,Urban,Goa,Crime Against Children,Child Abuse,Male,0-12,5606,3112,2494,4373,1233
2008,Rural,Telangana,Crime Against Men,Assault,Female,0-12,1419,231,1188,1052,367
2010,Rural,Telangana,Crime Against Women,Domestic Violence,Female,46-60,548,363,185,396,152
2010,Urban,Mizoram,Crime Against Children,Trafficking,Male,13-17,836,817,19,836,0
2002,Rural,Rajasthan,Other Crimes,Cyber Crime,Female,31-45,1863,1618,245,1717,146
2007,Urban,Maharashtra,Other Crimes,Corruption,Male,31-45,2930,655,2275,2127,803
2005,Urban,Tripura,Property Crime,Arson,Male,13-17,4928,2615,2313,3915,1013
2009,Urban,Tamil Nadu,Property Crime,Vandalism,Male,46-60,972,131,841,386,586
2010,Urban,Andhra Pradesh,Crime Against Men,Robbery,Male,60+,1420,714,706,1076,344
2007,Urban,Jharkhand,Other Crimes,Fraud,Female,31-45,8430,1172,7258,4044,4386
2005,Urban,Goa,Crime Against Men,Murder,Female,46-60,5031,80,4951,4824,207
2003,Urban,Goa,Crime Against Children,Child Abuse,Male,18-30,8401,4738,3663,8239,162
2009,Rural,Delhi,Property Crime,Theft,Male,0-12,2186,1362,824,1577,609
2008,Rural,Gujarat,Crime Against Children,Child Abuse,Male,13-17,497,288,209,329,168
2001,Urban,Himachal Pradesh,Crime Against Men,Robbery,Male,0-12,4683,3397,1286,4079,604
2010,Rural,Sikkim,Other Crimes,Drug Offense,Male,0-12,9537,9021,516,9037,500
2002,Urban,Sikkim,Crime Against Women,Dowry Deaths,Female,13-17,7066,6157,909,6904,162
2010,Urban,Tripura,Property Crime,Arson,Female,18-30,6279,5678,601,6037,242
2006,Rural,Assam,Other Crimes,Fraud,Female,31-45,1254,1030,224,1066,188
2002,Rural,West Bengal,Other Crimes,Fraud,Male,46-60,6301,3928,2373,5132,1169
2002,Urban,Sikkim,Crime Against Men,Robbery,Male,46-60,3401,2329,1072,2515,886
2004,Rural,Arunachal Pradesh,Crime Against Women,Molestation,Male,31-45,4513,549,3964,3741,772
2004,Urban,Maharashtra,Crime Against Children,Child Abuse,Male,13-17,2973,369,2604,846,2127
2001,Urban,Rajasthan,Crime Against Men,Murder,Male,46-60,7495,5736,1759,6904,591
2006,Urban,Karnataka,Crime Against Women,Molestation,Male,0-12,5960,2598,3362,4816,1144
2006,Urban,Sikkim,Other Crimes,Corruption,Male,0-12,5486,296,5190,1098,4388
2004,Rural,Tamil Nadu,Other Crimes,Drug Offense,Male,46-60,5658,1059,4599,4685,973
2001,Urban,Meghalaya,Crime Against Men,Assault,Male,13-17,1498,1188,310,1438,60
2008,Urban,Uttarakhand,Property Crime,Burglary,Female,31-45,3941,3557,384,3705,236
2001,Urban,Maharashtra,Other Crimes,Cyber Crime,Male,46-60,5201,884,4317,3267,1934
2010,Rural,Arunachal Pradesh,Crime Against Children,Child Abuse,Female,46-60,9490,3080,6410,9101,389
2007,Rural,Telangana,Other Crimes,Drug Offense,Female,46-60,5731,5663,68,5708,23
2009,Rural,Haryana,Property Crime,Burglary,Male,18-30,9893,5663,4230,9223,670
2007,Rural,Haryana,Property Crime,Theft,Male,31-45,6908,4392,2516,6451,457
2010,Urban,Assam,Crime Against Children,Trafficking,Male,31-45,314,93,221,292,22
2006,Urban,Tamil Nadu,Crime Against Women,Domestic Violence,Female,31-45,4668,2274,2394,3045,1623
2007,Rural,Haryana,Other Crimes,Fraud,Female,13-17,1929,510,1419,676,1253
2001,Urban,West Bengal,Property Crime,Burglary,Male,60+,7023,5125,1898,5277,1746
2007,Urban,Madhya Pradesh,Other Crimes,Corruption,Male,13-17,4610,3697,913,4460,150
2006,Urban,Jharkhand,Crime Against Children,Child Abuse,Male,13-17,8022,4245,3777,4632,3390
2008,Rural,Kerala,Other Crimes,Cyber Crime,Female,13-17,6768,1191,5577,5116,1652
2005,Rural,Goa,Property Crime,Arson,Male,0-12,5179,2943,2236,5034,145
2006,Urban,Uttarakhand,Other Crimes,Drug Offense,Male,46-60,9346,3789,5557,7374,1972
2010,Urban,Manipur,Crime Against Women,Domestic Violence,Male,46-60,7938,1193,6745,6146,1792
2001,Rural,Kerala,Crime Against Women,Dowry Deaths,Female,18-30,9352,5574,3778,9312,40
2006,Rural,Madhya Pradesh,Crime Against Men,Extortion,Female,0-12,9797,2727,7070,8273,1524
2006,Urban,Goa,Other Crimes,Fraud,Female,13-17,5681,4377,1304,4989,692
2006,Rural,Assam,Property Crime,Theft,Female,0-12,6104,2736,3368,4291,1813
2007,Urban,Arunachal Pradesh,Crime Against Men,Assault,Female,60+,9874,2700,7174,3272,6602
2001,Rural,Nagaland,Property Crime,Theft,Female,18-30,9780,4613,5167,7865,1915
2002,Rural,Tamil Nadu,Crime Against Children,Trafficking,Male,31-45,3226,1456,1770,2868,358
2006,Rural,Gujarat,Other Crimes,Fraud,Male,31-45,3795,2853,942,3128,667
2009,Rural,Karnataka,Property Crime,Arson,Male,0-12,6482,5391,1091,6287,195
2005,Urban,Karnataka,Crime Against Children,Kidnapping,Male,13-17,9364,5103,4261,6669,2695
2004,Urban,Uttarakhand,Property Crime,Burglary,Male,60+,7590,215,7375,1143,6447
2005,Urban,Tripura,Property Crime,Burglary,Male,60+,7125,666,6459,6373,752
2006,Rural,Assam,Crime Against Men,Murder,Female,31-45,3591,3565,26,3565,26
2003,Rural,Manipur,Crime Against Children,Child Abuse,Male,18-30,7268,709,6559,6496,772
2005,Urban,Karnataka,Property Crime,Arson,Male,0-12,3529,2403,1126,2685,844
2007,Rural,Madhya Pradesh,Crime Against Women,Dowry Deaths,Male,31-45,852,316,536,648,204
2003,Urban,Kerala,Crime Against Children,Child Abuse,Male,46-60,6167,1653,4514,3552,2615
2003,Urban,Karnataka,Crime Against Men,Assault,Female,31-45,5349,5180,169,5285,64
2010,Urban,Haryana,Crime Against Men,Robbery,Male,31-45,3555,2209,1346,2904,651
2010,Urban,Arunachal Pradesh,Other Crimes,Fraud,Female,18-30,519,109,410,488,31
2002,Rural,Tripura,Crime Against Women,Dowry Deaths,Male,13-17,7493,1302,6191,3866,3627
2009,Rural,Jammu & Kashmir,Crime Against Women,Rape,Male,13-17,2391,12,2379,586,1805
2005,Urban,Mizoram,Crime Against Women,Rape,Male,13-17,5036,2998,2038,3289,1747
2002,Rural,Haryana,Other Crimes,Fraud,Female,18-30,4144,1040,3104,3008,1136
2007,Rural,Telangana,Crime Against Children,Trafficking,Male,18-30,1524,451,1073,1070,454
2002,Rural,Haryana,Other Crimes,Corruption,Female,0-12,2207,1930,277,2185,22
2003,Urban,West Bengal,Property Crime,Arson,Female,31-45,7091,1939,5152,3494,3597
2007,Urban,Manipur,Crime Against Men,Murder,Female,60+,4487,259,4228,4419,68
2004,Rural,Uttarakhand,Property Crime,Vandalism,Male,13-17,6019,892,5127,2061,3958
2009,Urban,Odisha,Crime Against Women,Dowry Deaths,Male,13-17,2694,1836,858,1861,833
2004,Urban,Arunachal Pradesh,Crime Against Children,Child Abuse,Male,46-60,7806,6519,1287,7593,213
2002,Rural,Karnataka,Other Crimes,Drug Offense,Female,18-30,4370,1085,3285,2439,1931
2002,Urban,Kerala,Property Crime,Burglary,Female,60+,1580,1385,195,1388,192
2005,Rural,Manipur,Crime Against Men,Murder,Female,31-45,792,193,599,719,73
2004,Urban,Tamil Nadu,Crime Against Women,Molestation,Female,60+,2168,177,1991,237,1931
2003,Rural,Mizoram,Crime Against Women,Domestic Violence,Male,46-60,2211,1835,376,1926,285
2004,Urban,Chhattisgarh,Crime Against Women,Domestic Violence,Male,31-45,9350,7420,1930,8530,820
2008,Urban,Manipur,Crime Against Men,Assault,Female,46-60,386,18,368,273,113
2005,Rural,Chhattisgarh,Other Crimes,Corruption,Female,31-45,6837,200,6637,521,6316
2003,Rural,Chhattisgarh,Crime Against Children,Child Labor,Female,60+,3594,3278,316,3481,113
2010,Rural,Tripura,Crime Against Men,Murder,Female,18-30,8332,6783,1549,7559,773
2001,Urban,Madhya Pradesh,Other Crimes,Cyber Crime,Male,0-12,2988,672,2316,2078,910
2008,Urban,Nagaland,Other Crimes,Corruption,Female,0-12,2891,476,2415,2731,160
2005,Rural,West Bengal,Crime Against Men,Extortion,Male,18-30,6916,982,5934,4715,2201
2009,Rural,Meghalaya,Property Crime,Burglary,Female,46-60,6166,4356,1810,5710,456
2002,Urban,Goa,Property Crime,Arson,Female,46-60,1364,602,762,1042,322
2009,Rural,Andhra Pradesh,Crime Against Children,Trafficking,Male,60+,3664,671,2993,1973,1691
2004,Rural,Rajasthan,Crime Against Women,Molestation,Female,13-17,3185,1485,1700,1648,1537
2004,Rural,Punjab,Crime Against Women,Domestic Violence,Female,60+,8480,6783,1697,8313,167
2008,Urban,Delhi,Other Crimes,Corruption,Male,18-30,6970,2702,4268,6925,45
2003,Urban,Telangana,Crime Against Children,Child Abuse,Female,31-45,9733,3472,6261,3654,6079
2006,Urban,Manipur,Crime Against Women,Rape,Female,0-12,4102,1882,2220,3986,116
2007,Urban,Sikkim,Other Crimes,Drug Offense,Male,46-60,8150,7567,583,8121,29
2010,Rural,Rajasthan,Other Crimes,Fraud,Female,31-45,9107,5314,3793,8863,244
2007,Urban,Maharashtra,Crime Against Men,Assault,Female,60+,9770,3211,6559,6187,3583
2002,Urban,Nagaland,Other Crimes,Drug Offense,Female,46-60,6772,3512,3260,3672,3100
2010,Rural,Haryana,Crime Against Children,Kidnapping,Female,18-30,7996,6893,1103,6973,1023
2007,Rural,Sikkim,Crime Against Children,Trafficking,Female,60+,1430,1058,372,1285,145
2004,Urban,Telangana,Other Crimes,Fraud,Male,60+,6060,4092,1968,4529,1531
2010,Urban,Gujarat,Crime Against Men,Extortion,Male,46-60,529,246,283,427,102
2008,Urban,Chhattisgarh,Crime Against Men,Murder,Female,18-30,8437,2968,5469,6927,1510
2004,Rural,Uttar Pradesh,Crime Against Children,Child Labor,Male,60+,638,342,296,393,245
2008,Rural,Punjab,Crime Against Children,Trafficking,Male,46-60,5825,4011,1814,4641,1184
2001,Rural,Assam,Other Crimes,Cyber Crime,Female,18-30,4114,2428,1686,3982,132
2009,Rural,Karnataka,Property Crime,Vandalism,Female,60+,3039,2072,967,2111,928
2006,Rural,Punjab,Property Crime,Vandalism,Female,31-45,8962,3860,5102,7956,1006
2001,Rural,Bihar,Crime Against Children,Child Labor,Female,60+,7280,2013,5267,2525,4755
2008,Urban,Telangana,Other Crimes,Corruption,Female,46-60,6216,133,6083,4682,1534
2005,Rural,Punjab,Other Crimes,Drug Offense,Female,13-17,3950,1287,2663,1382,2568
2009,Urban,Gujarat,Crime Against Children,Trafficking,Male,0-12,9053,8862,191,8883,170
2007,Urban,Tripura,Property Crime,Theft,Male,13-17,7724,7665,59,7709,15
2008,Rural,Chhattisgarh,Other Crimes,Fraud,Male,31-45,1669,1602,67,1644,25
2007,Rural,Haryana,Crime Against Men,Extortion,Male,46-60,3375,2759,616,2782,593
2004,Rural,Jammu & Kashmir,Other Crimes,Fraud,Male,13-17,8042,4174,3868,5159,2883
2010,Rural,Haryana,Crime Against Men,Murder,Male,18-30,1121,795,326,811,310
2003,Urban,Maharashtra,Other Crimes,Fraud,Male,60+,1256,559,697,718,538
2003,Urban,Punjab,Crime Against Men,Extortion,Female,46-60,2501,1130,1371,1240,1261
2007,Rural,Tripura,Crime Against Children,Trafficking,Male,60+,4216,3394,822,3629,587
2010,Urban,Kerala,Crime Against Men,Robbery,Male,13-17,6291,539,5752,5874,417
2003,Urban,Bihar,Property Crime,Burglary,Female,18-30,8043,1456,6587,5710,2333
2001,Urban,Telangana,Property Crime,Arson,Female,13-17,4629,2013,2616,3754,875
2001,Urban,Mizoram,Other Crimes,Fraud,Female,31-45,4169,2896,1273,3860,309
2007,Urban,West Bengal,Crime Against Children,Child Labor,Female,60+,5889,860,5029,3061,2828
2007,Urban,Jammu & Kashmir,Crime Against Men,Extortion,Female,60+,6791,6301,490,6661,130
2008,Rural,Jharkhand,Other Crimes,Fraud,Female,13-17,9982,6802,3180,8221,1761
2007,Rural,Madhya Pradesh,Crime Against Children,Child Abuse,Male,0-12,2910,640,2270,844,2066
2009,Rural,Manipur,Crime Against Men,Assault,Male,60+,9714,7,9707,8842,872
2008,Urban,Uttar Pradesh,Property Crime,Theft,Female,31-45,1408,589,819,1385,23
2005,Urban,Manipur,Other Crimes,Drug Offense,Female,31-45,774,293,481,379,395
2003,Rural,Mizoram,Property Crime,Arson,Female,60+,4974,4428,546,4842,132
2001,Urban,Himachal Pradesh,Other Crimes,Drug Offense,Male,13-17,7004,1461,5543,4709,2295
2009,Urban,Uttarakhand,Crime Against Children,Child Abuse,Female,0-12,7541,675,6866,705,6836
2009,Rural,Telangana,Other Crimes,Drug Offense,Female,46-60,1163,19,1144,636,527
2006,Urban,Andhra Pradesh,Crime Against Children,Trafficking,Male,46-60,8390,1770,6620,5079,3311
2004,Urban,Rajasthan,Crime Against Men,Murder,Male,13-17,1251,351,900,424,827
2001,Rural,Telangana,Crime Against Men,Murder,Female,13-17,9503,441,9062,8466,1037
2005,Rural,Jharkhand,Crime Against Men,Robbery,Female,0-12,582,175,407,284,298
2006,Rural,Goa,Crime Against Children,Child Abuse,Male,46-60,6597,1362,5235,6366,231
2009,Urban,Tamil Nadu,Crime Against Children,Child Labor,Female,18-30,5789,1259,4530,4621,1168
2005,Urban,Punjab,Crime Against Men,Murder,Female,46-60,3367,2268,1099,2504,863
2008,Urban,Andhra Pradesh,Crime Against Women,Dowry Deaths,Male,0-12,414,254,160,324,90
2002,Rural,Jammu & Kashmir,Other Crimes,Cyber Crime,Male,18-30,866,620,246,645,221
2004,Urban,Manipur,Other Crimes,Cyber Crime,Male,13-17,1258,375,883,745,513
2002,Urban,Madhya Pradesh,Crime Against Men,Robbery,Female,13-17,8708,3905,4803,5448,3260
2001,Urban,Himachal Pradesh,Property Crime,Arson,Female,0-12,9205,7442,1763,8657,548
2009,Urban,Rajasthan,Crime Against Women,Dowry Deaths,Male,46-60,6502,4569,1933,5691,811
2010,Rural,Uttarakhand,Crime Against Men,Robbery,Male,13-17,9652,1846,7806,9164,488
2004,Urban,Jharkhand,Property Crime,Burglary,Female,31-45,6973,176,6797,3429,3544
2005,Urban,Assam,Crime Against Children,Trafficking,Male,13-17,2013,101,1912,1991,22
2007,Rural,Jharkhand,Property Crime,Theft,Female,0-12,2441,1039,1402,2268,173
2002,Rural,Mizoram,Crime Against Children,Kidnapping,Female,31-45,5889,2786,3103,4123,1766
2010,Rural,Nagaland,Property Crime,Vandalism,Male,31-45,4939,1063,3876,1515,3424
2010,Rural,Karnataka,Crime Against Women,Rape,Female,46-60,6075,3627,2448,4789,1286
2010,Urban,Uttar Pradesh,Crime Against Children,Trafficking,Female,31-45,2440,96,2344,1836,604
2003,Urban,Andhra Pradesh,Other Crimes,Fraud,Female,18-30,2200,589,1611,1661,539
2004,Urban,Assam,Property Crime,Theft,Female,46-60,5989,5192,797,5860,129
2003,Rural,Jharkhand,Crime Against Men,Assault,Male,0-12,1009,62,947,270,739
2004,Urban,Uttarakhand,Crime Against Women,Rape,Female,18-30,8922,1015,7907,1916,7006
2001,Urban,Delhi,Crime Against Women,Dowry Deaths,Female,60+,4391,491,3900,2079,2312
2001,Urban,Assam,Other Crimes,Corruption,Male,46-60,7156,6890,266,6944,212
2010,Rural,Chhattisgarh,Property Crime,Vandalism,Male,0-12,535,350,185,531,4
2002,Urban,Chhattisgarh,Property Crime,Theft,Female,60+,528,189,339,401,127
2009,Urban,Himachal Pradesh,Crime Against Men,Murder,Female,60+,9506,2547,6959,8626,880
2001,Rural,Uttarakhand,Crime Against Women,Dowry Deaths,Female,31-45,1530,984,546,1200,330
2006,Rural,Mizoram,Other Crimes,Drug Offense,Male,46-60,4127,341,3786,3560,567
2003,Urban,Karnataka,Property Crime,Burglary,Male,31-45,5227,386,4841,840,4387
2004,Rural,Meghalaya,Crime Against Men,Extortion,Male,18-30,5038,1030,4008,2377,2661
2001,Urban,Maharashtra,Other Crimes,Fraud,Female,0-12,6617,1175,5442,5445,1172
2002,Urban,West Bengal,Crime Against Men,Murder,Male,13-17,5631,5547,84,5603,28
2001,Rural,Odisha,Crime Against Children,Child Abuse,Female,46-60,1734,1233,501,1433,301
2003,Urban,Bihar,Other Crimes,Fraud,Female,31-45,352,17,335,317,35
2003,Rural,Mizoram,Crime Against Men,Assault,Female,46-60,572,499,73,510,62
2003,Rural,Telangana,Other Crimes,Corruption,Female,0-12,1282,338,944,512,770
2010,Rural,Jharkhand,Crime Against Children,Trafficking,Male,31-45,8840,1800,7040,7733,1107
2004,Urban,Nagaland,Crime Against Women,Rape,Female,46-60,1803,1427,376,1461,342
2002,Urban,Rajasthan,Property Crime,Arson,Female,46-60,5119,877,4242,1153,3966
2006,Urban,Karnataka,Other Crimes,Cyber Crime,Male,18-30,4631,1054,3577,3468,1163
2002,Urban,Uttarakhand,Property Crime,Vandalism,Male,31-45,156,74,82,112,44
2008,Urban,Maharashtra,Crime Against Women,Dowry Deaths,Female,18-30,4922,142,4780,1872,3050
2007,Rural,Odisha,Crime Against Women,Dowry Deaths,Male,46-60,752,472,280,724,28
2001,Urban,Meghalaya,Other Crimes,Fraud,Male,13-17,8483,4386,4097,6544,1939
2005,Urban,Arunachal Pradesh,Crime Against Women,Molestation,Female,46-60,9822,5545,4277,8578,1244
2005,Rural,Tamil Nadu,Crime Against Children,Kidnapping,Male,46-60,6588,2103,4485,2523,4065
2008,Rural,Odisha,Crime Against Children,Kidnapping,Female,46-60,757,544,213,756,1
2002,Urban,Manipur,Other Crimes,Cyber Crime,Female,31-45,350,43,307,159,191
2006,Rural,Maharashtra,Crime Against Women,Rape,Female,13-17,8523,5450,3073,6962,1561
2010,Urban,Mizoram,Crime Against Children,Kidnapping,Female,60+,4321,1027,3294,1752,2569
2009,Rural,Uttar Pradesh,Crime Against Children,Kidnapping,Female,31-45,202,152,50,168,34
2001,Rural,Haryana,Crime Against Women,Dowry Deaths,Female,46-60,3737,2819,918,3379,358
2009,Urban,Tripura,Other Crimes,Cyber Crime,Male,60+,365,124,241,208,157
2002,Rural,Chhattisgarh,Other Crimes,Drug Offense,Female,46-60,4762,3340,1422,3631,1131
2010,Rural,Andhra Pradesh,Property Crime,Burglary,Male,31-45,4404,3276,1128,4211,193
2006,Urban,Sikkim,Crime Against Men,Assault,Male,18-30,8029,4625,3404,7732,297
2003,Rural,Karnataka,Other Crimes,Cyber Crime,Female,13-17,7351,4205,3146,5808,1543
2003,Rural,West Bengal,Other Crimes,Fraud,Male,18-30,1677,1452,225,1453,224
2007,Rural,Tamil Nadu,Other Crimes,Corruption,Male,0-12,1878,1330,548,1344,534
2007,Urban,Rajasthan,Crime Against Men,Murder,Female,18-30,7310,1983,5327,2664,4646
2009,Rural,Bihar,Other Crimes,Corruption,Male,46-60,5977,1066,4911,3543,2434
2001,Rural,Uttar Pradesh,Crime Against Men,Murder,Female,13-17,804,163,641,353,451
2007,Rural,Nagaland,Crime Against Women,Dowry Deaths,Female,46-60,3316,455,2861,2296,1020
2001,Rural,Jammu & Kashmir,Property Crime,Arson,Male,31-45,7649,5333,2316,6487,1162
2010,Urban,Mizoram,Other Crimes,Fraud,Male,46-60,6863,297,6566,3834,3029
2008,Urban,Jharkhand,Property Crime,Burglary,Male,13-17,3780,3340,440,3599,181
2007,Rural,Uttarakhand,Other Crimes,Fraud,Female,13-17,9996,6356,3640,7383,2613
2001,Urban,Andhra Pradesh,Other Crimes,Cyber Crime,Male,18-30,4697,857,3840,1382,3315
2009,Rural,Sikkim,Crime Against Children,Trafficking,Male,18-30,6979,5427,1552,6377,602
2004,Rural,Chhattisgarh,Crime Against Men,Robbery,Male,18-30,7011,1118,5893,2026,4985
2006,Urban,Haryana,Property Crime,Burglary,Male,18-30,4290,312,3978,3522,768
2001,Urban,Delhi,Crime Against Women,Molestation,Male,0-12,9280,6222,3058,6406,2874
2008,Urban,Meghalaya,Crime Against Children,Child Labor,Female,31-45,106,34,72,106,0
2002,Urban,Manipur,Crime Against Men,Assault,Female,18-30,8748,8262,486,8352,396
2001,Rural,Mizoram,Crime Against Women,Dowry Deaths,Male,46-60,683,250,433,396,287
2010,Urban,Jammu & Kashmir,Other Crimes,Corruption,Female,31-45,6565,792,5773,3793,2772
2009,Urban,Himachal Pradesh,Crime Against Men,Murder,Male,46-60,1756,1375,381,1674,82
2004,Rural,Punjab,Other Crimes,Cyber Crime,Male,31-45,1380,1022,358,1117,263
2002,Urban,Uttar Pradesh,Crime Against Women,Domestic Violence,Female,60+,3729,2349,1380,2939,790
2006,Rural,Karnataka,Crime Against Men,Assault,Female,31-45,5398,630,4768,5068,330
2005,Urban,Tamil Nadu,Crime Against Children,Child Labor,Female,18-30,8101,3483,4618,5968,2133
2002,Urban,West Bengal,Crime Against Men,Murder,Male,46-60,231,220,11,225,6
2004,Rural,Chhattisgarh,Other Crimes,Drug Offense,Male,46-60,4582,1022,3560,2671,1911
2010,Urban,Telangana,Crime Against Women,Domestic Violence,Male,13-17,1755,598,1157,611,1144
2003,Rural,Punjab,Property Crime,Theft,Female,13-17,8009,6175,1834,6929,1080
2001,Rural,Gujarat,Crime Against Women,Domestic Violence,Male,31-45,4418,2186,2232,3662,756
2002,Rural,Telangana,Property Crime,Theft,Female,31-45,3132,2811,321,2986,146
2004,Urban,Punjab,Crime Against Women,Rape,Female,18-30,1421,884,537,1240,181
2004,Urban,Maharashtra,Crime Against Women,Rape,Female,0-12,1790,699,1091,1012,778
2002,Rural,Tripura,Crime Against Men,Extortion,Male,60+,1146,1145,1,1146,0
2007,Urban,Gujarat,Crime Against Children,Child Labor,Male,31-45,8770,7297,1473,8712,58
2002,Rural,Haryana,Crime Against Children,Kidnapping,Female,13-17,8645,3855,4790,4672,3973
2009,Rural,Rajasthan,Crime Against Men,Extortion,Male,31-45,8740,3620,5120,7187,1553
2006,Urban,Assam,Crime Against Children,Child Abuse,Female,13-17,1613,532,1081,714,899
2001,Urban,Haryana,Crime Against Men,Assault,Female,31-45,4098,4075,23,4081,17
2010,Urban,Bihar,Crime Against Women,Dowry Deaths,Male,60+,7066,4110,2956,4543,2523
2008,Rural,Tripura,Crime Against Children,Kidnapping,Male,31-45,8642,423,8219,7049,1593
2001,Rural,Delhi,Crime Against Women,Domestic Violence,Female,46-60,8440,2524,5916,4807,3633
2004,Rural,Jharkhand,Property Crime,Theft,Female,13-17,7023,5568,1455,6127,896
2007,Rural,Haryana,Crime Against Women,Molestation,Male,31-45,5674,3209,2465,5256,418
2004,Urban,Maharashtra,Crime Against Children,Kidnapping,Male,31-45,8264,169,8095,853,7411
2001,Urban,Himachal Pradesh,Crime Against Women,Domestic Violence,Female,18-30,5105,1374,3731,1680,3425
2010,Rural,Mizoram,Crime Against Women,Molestation,Female,13-17,9591,3888,5703,7545,2046
2004,Urban,Mizoram,Crime Against Women,Dowry Deaths,Male,31-45,3823,2275,1548,3367,456
2005,Rural,Chhattisgarh,Crime Against Children,Kidnapping,Female,13-17,9154,8187,967,8499,655
2008,Rural,Meghalaya,Crime Against Children,Child Abuse,Male,0-12,492,328,164,421,71
2003,Rural,Manipur,Crime Against Women,Molestation,Female,31-45,8775,6176,2599,7461,1314
2009,Rural,Punjab,Other Crimes,Corruption,Female,31-45,5725,2135,3590,4382,1343
2003,Urban,Rajasthan,Property Crime,Burglary,Male,46-60,9805,49,9756,9694,111
2004,Urban,Sikkim,Crime Against Women,Dowry Deaths,Female,13-17,3678,3238,440,3268,410
2006,Rural,Tamil Nadu,Other Crimes,Fraud,Male,18-30,551,460,91,468,83
2007,Urban,Himachal Pradesh,Other Crimes,Corruption,Male,0-12,8205,6025,2180,6813,1392
2009,Urban,Haryana,Property Crime,Arson,Female,60+,8139,6573,1566,7172,967
2006,Urban,Sikkim,Crime Against Men,Extortion,Male,31-45,80,70,10,77,3
2006,Urban,Jharkhand,Property Crime,Burglary,Male,13-17,4367,1153,3214,3006,1361
2007,Rural,Chhattisgarh,Other Crimes,Cyber Crime,Female,13-17,906,611,295,621,285
2001,Urban,Assam,Other Crimes,Fraud,Male,31-45,8371,4799,3572,8129,242
2002,Urban,Arunachal Pradesh,Crime Against Children,Child Labor,Male,60+,2606,887,1719,1887,719
2007,Urban,Goa,Other Crimes,Corruption,Female,0-12,6145,3935,2210,3966,2179
2002,Urban,Odisha,Crime Against Women,Rape,Male,31-45,2319,1848,471,2174,145
2005,Urban,Himachal Pradesh,Crime Against Men,Murder,Male,31-45,4541,997,3544,1026,3515
2005,Urban,Karnataka,Crime Against Women,Molestation,Female,18-30,5188,4710,478,4891,297
2009,Rural,Punjab,Crime Against Women,Dowry Deaths,Female,31-45,9623,2314,7309,6954,2669
2006,Rural,Meghalaya,Crime Against Children,Trafficking,Male,31-45,9701,5628,4073,5791,3910
2004,Rural,Tamil Nadu,Crime Against Women,Dowry Deaths,Female,46-60,7403,3146,4257,6978,425
2002,Urban,Delhi,Crime Against Women,Dowry Deaths,Male,31-45,7132,6953,179,7118,14
2003,Urban,Uttarakhand,Crime Against Women,Rape,Female,46-60,5020,295,4725,1306,3714
2003,Rural,Delhi,Crime Against Men,Assault,Male,46-60,6924,4816,2108,5951,973
2004,Urban,Punjab,Crime Against Children,Child Labor,Male,18-30,573,108,465,452,121
2003,Urban,Jharkhand,Crime Against Men,Murder,Male,60+,5031,4733,298,4770,261
2010,Rural,Manipur,Crime Against Children,Trafficking,Male,18-30,5832,2825,3007,5185,647
2006,Urban,Assam,Other Crimes,Corruption,Male,18-30,7847,2797,5050,4389,3458
2005,Urban,Rajasthan,Other Crimes,Corruption,Female,0-12,880,540,340,595,285
2007,Urban,Karnataka,Other Crimes,Corruption,Female,0-12,3476,229,3247,1634,1842
2010,Urban,Uttarakhand,Property Crime,Theft,Female,18-30,2369,4,2365,155,2214
2003,Urban,Maharashtra,Crime Against Women,Dowry Deaths,Male,13-17,1212,500,712,782,430
2002,Rural,Rajasthan,Crime Against Men,Extortion,Male,46-60,631,498,133,556,75
2004,Urban,Andhra Pradesh,Other Crimes,Drug Offense,Male,18-30,352,312,40,347,5
2008,Rural,Punjab,Crime Against Men,Murder,Male,31-45,1540,234,1306,816,724
2008,Urban,Punjab,Crime Against Children,Trafficking,Female,60+,4610,3521,1089,3772,838
2003,Urban,Gujarat,Property Crime,Theft,Female,31-45,8308,1811,6497,4088,4220
2007,Rural,Rajasthan,Crime Against Women,Rape,Female,18-30,1690,507,1183,1516,174
2007,Urban,Uttar Pradesh,Crime Against Men,Robbery,Female,60+,7934,3876,4058,6880,1054
2006,Urban,Himachal Pradesh,Crime Against Men,Assault,Male,0-12,1748,762,986,1477,271
2010,Rural,Arunachal Pradesh,Crime Against Children,Trafficking,Female,0-12,730,128,602,168,562
2009,Urban,Rajasthan,Crime Against Children,Trafficking,Female,46-60,5992,1617,4375,4071,1921
2001,Rural,Andhra Pradesh,Property Crime,Arson,Male,46-60,1247,660,587,809,438
2008,Rural,Uttar Pradesh,Crime Against Men,Robbery,Female,18-30,3094,2365,729,2897,197
2009,Urban,Tripura,Property Crime,Arson,Male,60+,366,352,14,362,4
2004,Urban,Manipur,Property Crime,Theft,Female,13-17,2347,1164,1183,1597,750
2004,Rural,Meghalaya,Crime Against Men,Extortion,Male,13-17,1860,1380,480,1557,303
2007,Urban,Odisha,Property Crime,Burglary,Male,31-45,8709,4313,4396,4843,3866
2010,Rural,Sikkim,Other Crimes,Cyber Crime,Female,31-45,1900,133,1767,1689,211
2007,Rural,Haryana,Other Crimes,Drug Offense,Female,31-45,9155,6154,3001,8921,234
2009,Rural,Madhya Pradesh,Other Crimes,Cyber Crime,Male,18-30,9230,1305,7925,7502,1728
2001,Rural,Uttarakhand,Other Crimes,Cyber Crime,Male,0-12,4488,3934,554,4285,203
2007,Urban,Jharkhand,Property Crime,Arson,Male,18-30,1495,97,1398,354,1141
2006,Urban,Goa,Crime Against Men,Assault,Male,46-60,3411,3099,312,3370,41
2002,Rural,Uttarakhand,Crime Against Women,Rape,Male,60+,4741,2543,2198,4690,51
2001,Rural,Bihar,Other Crimes,Drug Offense,Female,13-17,9543,5112,4431,6582,2961
2001,Urban,Bihar,Property Crime,Vandalism,Male,0-12,3782,3649,133,3649,133
2001,Rural,Telangana,Crime Against Women,Domestic Violence,Male,31-45,9384,3734,5650,5542,3842
2002,Urban,Delhi,Property Crime,Theft,Female,0-12,4315,1831,2484,2023,2292
2006,Urban,Delhi,Property Crime,Theft,Female,13-17,5109,2569,2540,3680,1429
2001,Urban,Delhi,Crime Against Men,Robbery,Female,18-30,8215,6542,1673,6587,1628
2004,Urban,Meghalaya,Crime Against Women,Rape,Male,31-45,8349,7657,692,8028,321
2002,Rural,Telangana,Crime Against Children,Trafficking,Male,31-45,5857,5756,101,5768,89
2008,Urban,Chhattisgarh,Property Crime,Burglary,Male,13-17,1615,1146,469,1223,392
2001,Rural,Gujarat,Crime Against Women,Rape,Female,60+,3754,2041,1713,3551,203
2001,Urban,Rajasthan,Crime Against Children,Kidnapping,Male,0-12,2781,1750,1031,2207,574
2007,Rural,Kerala,Crime Against Children,Kidnapping,Male,31-45,8278,1097,7181,6902,1376
2007,Rural,Gujarat,Other Crimes,Cyber Crime,Male,0-12,5620,4176,1444,4517,1103
2006,Rural,Tripura,Property Crime,Arson,Male,0-12,2445,1872,573,2375,70
2006,Rural,Rajasthan,Crime Against Men,Robbery,Male,31-45,4909,1339,3570,4155,754
2002,Urban,Meghalaya,Property Crime,Theft,Female,46-60,9492,6190,3302,7717,1775
2001,Urban,Rajasthan,Property Crime,Arson,Male,31-45,4085,2684,1401,4005,80
2003,Rural,Odisha,Crime Against Women,Dowry Deaths,Female,60+,1263,309,954,1147,116
2008,Urban,Tamil Nadu,Other Crimes,Corruption,Female,46-60,3614,2188,1426,2620,994
2010,Urban,Karnataka,Crime Against Women,Rape,Female,18-30,990,296,694,517,473
2006,Urban,Delhi,Crime Against Women,Domestic Violence,Male,60+,7232,3280,3952,4401,2831
2006,Urban,Telangana,Crime Against Men,Murder,Female,13-17,4079,303,3776,1551,2528
2001,Urban,Gujarat,Crime Against Men,Assault,Male,46-60,6444,4604,1840,4942,1502
2001,Urban,Uttar Pradesh,Crime Against Men,Robbery,Male,13-17,755,579,176,596,159
2004,Rural,Uttarakhand,Crime Against Men,Assault,Female,46-60,5975,1729,4246,2871,3104
2004,Rural,Chhattisgarh,Property Crime,Theft,Female,18-30,4018,1361,2657,2200,1818
2002,Urban,West Bengal,Crime Against Women,Dowry Deaths,Female,13-17,7288,5054,2234,6542,746
2010,Rural,Uttarakhand,Crime Against Children,Child Labor,Male,31-45,9731,6827,2904,6848,2883
2006,Urban,Mizoram,Crime Against Children,Child Labor,Female,60+,3709,610,3099,1969,1740
2008,Rural,Goa,Property Crime,Theft,Male,60+,4000,2192,1808,2979,1021
2002,Rural,Maharashtra,Crime Against Men,Murder,Female,13-17,6368,5515,853,6352,16
2004,Rural,Uttarakhand,Crime Against Women,Rape,Male,31-45,1464,747,717,884,580
2006,Urban,Meghalaya,Property Crime,Burglary,Male,18-30,6154,4886,1268,5714,440
2006,Rural,Manipur,Crime Against Men,Extortion,Female,60+,8046,3812,4234,4127,3919
2007,Urban,Odisha,Other Crimes,Fraud,Female,18-30,1653,1359,294,1545,108
2006,Urban,Nagaland,Property Crime,Burglary,Female,0-12,5468,3703,1765,4310,1158
2007,Rural,Uttar Pradesh,Other Crimes,Drug Offense,Male,31-45,3080,1407,1673,1952,1128
2007,Rural,Delhi,Crime Against Women,Domestic Violence,Female,0-12,9473,1960,7513,6126,3347
2009,Rural,Bihar,Crime Against Men,Extortion,Male,13-17,1821,1768,53,1810,11
2007,Urban,Goa,Other Crimes,Drug Offense,Male,13-17,3849,3380,469,3512,337
2009,Urban,Goa,Crime Against Children,Child Abuse,Female,0-12,9592,1687,7905,6441,3151
2009,Urban,Madhya Pradesh,Crime Against Children,Child Abuse,Female,60+,2626,1455,1171,2157,469
2002,Rural,Delhi,Crime Against Men,Murder,Female,31-45,2862,770,2092,1941,921
2004,Urban,Mizoram,Crime Against Men,Assault,Male,46-60,3882,3317,565,3388,494
2010,Rural,Sikkim,Other Crimes,Corruption,Male,31-45,4387,2269,2118,4039,348
2007,Urban,Tamil Nadu,Property Crime,Vandalism,Female,13-17,970,69,901,284,686
2006,Rural,Goa,Property Crime,Vandalism,Male,46-60,2452,1583,869,1742,710
2006,Rural,Rajasthan,Other Crimes,Corruption,Male,60+,4877,0,4877,3868,1009
2004,Rural,Mizoram,Crime Against Men,Assault,Male,31-45,7785,5558,2227,7677,108
2010,Rural,Delhi,Crime Against Men,Murder,Male,46-60,2977,1757,1220,1944,1033
2006,Rural,Andhra Pradesh,Crime Against Men,Assault,Male,13-17,1634,1202,432,1395,239
2010,Urban,Haryana,Property Crime,Vandalism,Male,13-17,1798,874,924,1037,761
2003,Urban,Punjab,Crime Against Women,Domestic Violence,Male,0-12,9923,2040,7883,5348,4575
2005,Rural,Uttar Pradesh,Crime Against Men,Murder,Female,18-30,6776,2998,3778,3817,2959
2005,Rural,Goa,Property Crime,Theft,Female,18-30,8069,1310,6759,3558,4511
2007,Urban,Chhattisgarh,Property Crime,Arson,Female,0-12,5372,4888,484,5250,122
2005,Rural,Himachal Pradesh,Other Crimes,Fraud,Male,18-30,318,18,300,182,136
2005,Urban,Tamil Nadu,Property Crime,Burglary,Male,0-12,5472,896,4576,2620,2852
2007,Rural,West Bengal,Crime Against Children,Child Abuse,Female,0-12,9944,7853,2091,9418,526
2008,Urban,Punjab,Crime Against Women,Domestic Violence,Female,0-12,3810,1241,2569,1788,2022
2006,Rural,Himachal Pradesh,Crime Against Women,Molestation,Male,60+,450,137,313,177,273
2007,Urban,Telangana,Crime Against Children,Kidnapping,Male,46-60,3519,2521,998,3419,100
2008,Rural,Uttar Pradesh,Crime Against Men,Assault,Female,18-30,1179,309,870,907,272
2002,Rural,Bihar,Other Crimes,Fraud,Male,18-30,9996,9861,135,9879,117
2001,Urban,Meghalaya,Property Crime,Arson,Female,60+,7351,4046,3305,6409,942
2008,Rural,Haryana,Crime Against Women,Rape,Female,31-45,9509,5241,4268,5279,4230
2003,Urban,Goa,Crime Against Children,Kidnapping,Female,46-60,704,6,698,68,636
2009,Urban,Uttarakhand,Crime Against Women,Rape,Male,31-45,2617,226,2391,2603,14
2007,Urban,Chhattisgarh,Other Crimes,Corruption,Female,46-60,9967,470,9497,5445,4522
2004,Rural,Rajasthan,Crime Against Children,Trafficking,Female,0-12,7597,5958,1639,6392,1205
2008,Urban,Delhi,Crime Against Children,Trafficking,Male,60+,6212,5672,540,5885,327
2010,Rural,Nagaland,Crime Against Women,Domestic Violence,Male,46-60,8574,807,7767,7021,1553
2006,Rural,Punjab,Property Crime,Theft,Male,60+,670,303,367,636,34
2005,Urban,West Bengal,Crime Against Men,Robbery,Female,31-45,8339,2403,5936,6788,1551
2003,Rural,Assam,Crime Against Women,Molestation,Female,18-30,9918,3406,6512,6413,3505
2001,Urban,Odisha,Property Crime,Vandalism,Female,13-17,2057,972,1085,1289,768
2006,Rural,Punjab,Crime Against Women,Dowry Deaths,Male,0-12,7957,1300,6657,4054,3903
2008,Urban,Goa,Crime Against Women,Rape,Female,60+,5386,1958,3428,3431,1955
2009,Rural,Madhya Pradesh,Property Crime,Arson,Female,18-30,1806,110,1696,1518,288
2008,Rural,Andhra Pradesh,Crime Against Children,Kidnapping,Female,13-17,8162,5825,2337,6380,1782
2003,Urban,Odisha,Property Crime,Theft,Male,13-17,9698,5663,4035,6418,3280
2009,Urban,Punjab,Crime Against Children,Trafficking,Female,13-17,2552,325,2227,1469,1083
2002,Rural,Bihar,Crime Against Children,Trafficking,Female,31-45,2409,403,2006,1257,1152
2001,Urban,Karnataka,Other Crimes,Fraud,Male,13-17,3406,2580,826,2916,490
2010,Rural,Himachal Pradesh,Crime Against Men,Assault,Female,60+,581,20,561,232,349
2005,Rural,Andhra Pradesh,Other Crimes,Drug Offense,Male,18-30,9156,1965,7191,8928,228
2003,Urban,Delhi,Crime Against Women,Domestic Violence,Female,46-60,3375,3155,220,3200,175
2003,Rural,Punjab,Crime Against Men,Robbery,Female,60+,9352,1962,7390,7280,2072
2009,Urban,Jharkhand,Property Crime,Theft,Female,46-60,2307,1749,558,1857,450
2002,Urban,Uttarakhand,Property Crime,Vandalism,Female,0-12,8071,5039,3032,7767,304
2007,Urban,Nagaland,Crime Against Men,Robbery,Male,18-30,3866,3420,446,3846,20
2010,Rural,Sikkim,Other Crimes,Drug Offense,Male,18-30,6297,5653,644,5875,422
2008,Urban,Andhra Pradesh,Crime Against Children,Child Abuse,Male,60+,6513,4480,2033,4940,1573
2008,Rural,Karnataka,Property Crime,Theft,Female,18-30,2950,1930,1020,2572,378
2008,Urban,Rajasthan,Property Crime,Burglary,Male,0-12,3513,1156,2357,1188,2325
2008,Rural,Andhra Pradesh,Property Crime,Theft,Male,18-30,7530,621,6909,1856,5674
2007,Rural,Arunachal Pradesh,Crime Against Children,Child Labor,Male,60+,9268,4497,4771,5530,3738
2010,Urban,Manipur,Crime Against Men,Robbery,Male,18-30,8980,7072,1908,7181,1799
2001,Rural,Jammu & Kashmir,Crime Against Children,Kidnapping,Female,18-30,4183,3567,616,3718,465
2009,Urban,Jammu & Kashmir,Crime Against Women,Rape,Female,46-60,5743,373,5370,4762,981
2003,Rural,Maharashtra,Crime Against Women,Molestation,Male,13-17,2357,432,1925,672,1685
2009,Rural,Madhya Pradesh,Other Crimes,Fraud,Male,46-60,9845,792,9053,1088,8757
2006,Urban,Tamil Nadu,Property Crime,Vandalism,Male,18-30,4952,1322,3630,1775,3177
2007,Urban,Goa,Crime Against Children,Child Labor,Female,31-45,5447,2328,3119,3910,1537
2005,Rural,Meghalaya,Crime Against Men,Robbery,Female,31-45,9807,1915,7892,3560,6247
2009,Urban,Assam,Property Crime,Burglary,Male,13-17,8035,5552,2483,6539,1496
2006,Urban,Delhi,Crime Against Children,Child Labor,Female,46-60,9127,3809,5318,7803,1324
2010,Rural,Mizoram,Property Crime,Vandalism,Female,31-45,8646,5847,2799,5990,2656
2010,Rural,Andhra Pradesh,Crime Against Children,Trafficking,Female,18-30,6629,192,6437,928,5701
2002,Rural,Manipur,Crime Against Children,Trafficking,Male,46-60,1499,1354,145,1415,84
2006,Rural,Gujarat,Crime Against Women,Rape,Female,60+,7030,6475,555,6594,436
2007,Rural,Odisha,Other Crimes,Cyber Crime,Male,31-45,8547,2385,6162,2463,6084
2007,Rural,Punjab,Crime Against Children,Child Labor,Male,0-12,7806,4528,3278,7774,32
2001,Urban,Arunachal Pradesh,Crime Against Children,Child Labor,Female,31-45,6006,1045,4961,2202,3804
2004,Urban,Himachal Pradesh,Crime Against Men,Robbery,Male,31-45,7043,2262,4781,6231,812
2003,Urban,West Bengal,Other Crimes,Drug Offense,Female,60+,7641,286,7355,4469,3172
2002,Rural,Manipur,Crime Against Children,Child Labor,Female,31-45,1774,742,1032,1592,182
2002,Urban,Bihar,Crime Against Men,Robbery,Female,18-30,2632,703,1929,1964,668
2007,Urban,Gujarat,Crime Against Men,Murder,Male,31-45,8626,4452,4174,5951,2675
2010,Urban,Uttar Pradesh,Crime Against Women,Dowry Deaths,Female,60+,2601,1364,1237,2090,511
2010,Urban,Himachal Pradesh,Crime Against Women,Dowry Deaths,Male,18-30,8138,4780,3358,4973,3165
2006,Rural,Gujarat,Crime Against Men,Robbery,Female,13-17,2541,2191,350,2289,252
2007,Urban,Goa,Other Crimes,Drug Offense,Female,60+,8615,4828,3787,7396,1219
2009,Rural,Delhi,Other Crimes,Cyber Crime,Female,0-12,7464,2347,5117,6162,1302
2008,Urban,Jammu & Kashmir,Crime Against Women,Molestation,Male,60+,3447,2718,729,2761,686
2004,Urban,Tamil Nadu,Other Crimes,Cyber Crime,Male,60+,3420,2054,1366,2871,549
2007,Rural,Punjab,Crime Against Women,Domestic Violence,Male,60+,2156,759,1397,1720,436
2003,Urban,Uttarakhand,Crime Against Women,Domestic Violence,Male,0-12,4054,338,3716,2835,1219
2003,Rural,Jammu & Kashmir,Crime Against Men,Assault,Female,0-12,798,322,476,571,227
2004,Urban,Tripura,Crime Against Women,Rape,Male,31-45,9971,4522,5449,4748,5223
2003,Rural,Telangana,Crime Against Women,Dowry Deaths,Male,46-60,97,46,51,66,31
2010,Rural,West Bengal,Crime Against Children,Kidnapping,Male,13-17,6072,2029,4043,2603,3469
2006,Urban,Jammu & Kashmir,Crime Against Men,Robbery,Female,31-45,6472,2973,3499,6240,232
2009,Rural,Telangana,Crime Against Women,Dowry Deaths,Male,13-17,1643,1448,195,1481,162
2002,Urban,Himachal Pradesh,Crime Against Women,Molestation,Female,31-45,9464,8364,1100,8774,690
2007,Urban,Himachal Pradesh,Crime Against Women,Dowry Deaths,Female,31-45,6591,5385,1206,5563,1028
2008,Rural,Kerala,Crime Against Women,Dowry Deaths,Male,60+,6315,4936,1379,5836,479
2010,Rural,Kerala,Property Crime,Arson,Female,13-17,8758,2782,5976,5210,3548
2007,Urban,Uttar Pradesh,Property Crime,Arson,Female,18-30,1336,1075,261,1263,73
2006,Urban,Andhra Pradesh,Crime Against Children,Child Abuse,Female,60+,8832,5433,3399,7181,1651
2010,Urban,Bihar,Other Crimes,Cyber Crime,Female,60+,6846,3747,3099,4335,2511
2004,Urban,Jharkhand,Crime Against Women,Domestic Violence,Male,60+,2741,1993,748,2364,377
2002,Rural,Arunachal Pradesh,Crime Against Men,Extortion,Female,18-30,2027,1061,966,1343,684
2002,Rural,Arunachal Pradesh,Crime Against Children,Kidnapping,Female,31-45,2462,1097,1365,2176,286
2008,Urban,Bihar,Other Crimes,Cyber Crime,Male,0-12,6754,810,5944,5202,1552
2006,Urban,Himachal Pradesh,Crime Against Children,Child Labor,Male,13-17,6070,4720,1350,5102,968
2005,Rural,Sikkim,Crime Against Men,Extortion,Female,46-60,7786,3057,4729,5802,1984
2010,Urban,Sikkim,Other Crimes,Cyber Crime,Female,31-45,7425,7024,401,7253,172
2009,Urban,Telangana,Crime Against Women,Molestation,Female,18-30,8091,6828,1263,7515,576
2009,Urban,Uttarakhand,Crime Against Men,Robbery,Male,60+,8862,6389,2473,7918,944
2002,Urban,Mizoram,Property Crime,Burglary,Female,0-12,732,613,119,724,8
2004,Rural,Uttar Pradesh,Other Crimes,Drug Offense,Male,31-45,1871,687,1184,849,1022
2004,Urban,Bihar,Property Crime,Arson,Female,13-17,5016,2248,2768,4626,390
2009,Rural,Nagaland,Crime Against Men,Murder,Male,60+,7788,2645,5143,4104,3684
2003,Urban,Delhi,Crime Against Men,Extortion,Male,31-45,7588,679,6909,1615,5973
2006,Urban,Madhya Pradesh,Property Crime,Arson,Male,13-17,4947,2372,2575,4302,645
2002,Urban,Uttarakhand,Crime Against Men,Assault,Male,18-30,9065,6998,2067,8506,559
2007,Urban,Tamil Nadu,Property Crime,Arson,Male,46-60,6329,5727,602,5942,387
2004,Urban,Andhra Pradesh,Crime Against Women,Rape,Male,46-60,8351,7281,1070,7631,720
2010,Rural,Nagaland,Crime Against Women,Rape,Male,60+,8977,4842,4135,5375,3602
2001,Rural,Himachal Pradesh,Crime Against Children,Child Labor,Female,0-12,2239,2186,53,2227,12
2004,Rural,Himachal Pradesh,Crime Against Women,Rape,Male,13-17,5121,4334,787,4372,749
2004,Urban,Jharkhand,Crime Against Men,Extortion,Female,0-12,4385,2832,1553,3540,845
2006,Rural,Andhra Pradesh,Crime Against Women,Dowry Deaths,Female,0-12,6765,2169,4596,2443,4322
2010,Urban,West Bengal,Crime Against Men,Robbery,Female,31-45,9929,4124,5805,6128,3801
2004,Rural,Uttar Pradesh,Other Crimes,Drug Offense,Male,60+,3729,784,2945,1213,2516
2002,Urban,Punjab,Property Crime,Vandalism,Female,13-17,3869,629,3240,2350,1519
2001,Rural,Andhra Pradesh,Crime Against Women,Rape,Female,31-45,5250,5137,113,5144,106
2003,Urban,Himachal Pradesh,Crime Against Men,Murder,Female,13-17,3092,2997,95,3058,34
2005,Rural,Kerala,Crime Against Men,Robbery,Female,46-60,3736,1270,2466,2964,772
2007,Urban,Andhra Pradesh,Property Crime,Arson,Female,60+,5333,2287,3046,4899,434
2009,Rural,Chhattisgarh,Crime Against Children,Trafficking,Female,60+,3253,779,2474,908,2345
2004,Urban,Kerala,Crime Against Men,Extortion,Female,60+,7340,5232,2108,6822,518
2003,Rural,West Bengal,Crime Against Women,Dowry Deaths,Male,31-45,5644,2480,3164,2858,2786
2005,Rural,Madhya Pradesh,Crime Against Men,Assault,Male,46-60,7108,2203,4905,6811,297
2008,Rural,Arunachal Pradesh,Crime Against Women,Rape,Male,31-45,7096,2874,4222,5470,1626
2006,Rural,West Bengal,Crime Against Women,Domestic Violence,Male,46-60,9209,1941,7268,6644,2565
2001,Urban,West Bengal,Other Crimes,Corruption,Female,0-12,3715,3304,411,3638,77
2007,Rural,Tamil Nadu,Crime Against Children,Child Labor,Male,31-45,9663,2427,7236,9271,392
2010,Rural,Punjab,Other Crimes,Fraud,Male,31-45,364,134,230,231,133
2007,Rural,Goa,Crime Against Women,Molestation,Female,60+,8828,3581,5247,5259,3569
2003,Urban,Nagaland,Crime Against Children,Child Labor,Female,13-17,4877,1233,3644,2780,2097
2010,Rural,Jammu & Kashmir,Property Crime,Arson,Female,46-60,9593,6075,3518,8159,1434
2006,Rural,Arunachal Pradesh,Other Crimes,Fraud,Female,31-45,1275,144,1131,625,650
2005,Urban,Haryana,Other Crimes,Cyber Crime,Female,31-45,2675,480,2195,2568,107
2010,Urban,Tamil Nadu,Property Crime,Theft,Female,18-30,5200,262,4938,3861,1339
2001,Rural,Chhattisgarh,Other Crimes,Corruption,Female,0-12,7448,184,7264,4218,3230
2007,Urban,Uttar Pradesh,Other Crimes,Drug Offense,Female,13-17,7195,620,6575,6620,575
2008,Urban,Manipur,Crime Against Women,Molestation,Male,60+,3586,3342,244,3459,127
2001,Urban,Tripura,Crime Against Women,Domestic Violence,Female,46-60,5706,2828,2878,4115,1591
2005,Urban,Delhi,Crime Against Women,Dowry Deaths,Male,0-12,5085,3063,2022,3089,1996
2007,Urban,Jharkhand,Crime Against Men,Murder,Female,46-60,8489,8226,263,8291,198
2001,Rural,Manipur,Crime Against Men,Murder,Female,46-60,7931,1042,6889,4853,3078
2005,Urban,Manipur,Crime Against Men,Robbery,Female,0-12,2340,1734,606,2205,135
2001,Urban,Tripura,Crime Against Children,Child Abuse,Male,18-30,6145,971,5174,4895,1250
2008,Rural,Delhi,Crime Against Women,Domestic Violence,Female,31-45,7902,152,7750,7693,209
2008,Urban,Punjab,Crime Against Women,Domestic Violence,Male,60+,8688,5296,3392,8668,20
2002,Urban,Assam,Crime Against Children,Trafficking,Male,46-60,7525,963,6562,3998,3527
2008,Urban,Telangana,Other Crimes,Fraud,Female,18-30,9879,6999,2880,9783,96
2009,Rural,Delhi,Other Crimes,Fraud,Female,18-30,5390,3048,2342,3836,1554
2007,Rural,Assam,Other Crimes,Cyber Crime,Female,13-17,8582,6779,1803,7779,803
2004,Rural,Delhi,Crime Against Children,Trafficking,Female,0-12,6793,5429,1364,6257,536
2001,Rural,Mizoram,Property Crime,Burglary,Male,46-60,4135,3367,768,3978,157
2006,Urban,Uttar Pradesh,Property Crime,Burglary,Female,0-12,8520,4963,3557,5096,3424
2006,Rural,Madhya Pradesh,Crime Against Men,Extortion,Male,13-17,9829,3572,6257,5894,3935
2009,Rural,Kerala,Crime Against Women,Dowry Deaths,Male,18-30,6464,5116,1348,5784,680
2001,Urban,Himachal Pradesh,Crime Against Women,Dowry Deaths,Female,18-30,6932,2133,4799,3630,3302
2004,Rural,Tripura,Crime Against Men,Assault,Female,46-60,4107,1868,2239,3007,1100
2006,Rural,Meghalaya,Crime Against Children,Kidnapping,Female,0-12,1382,1334,48,1356,26
2004,Rural,Assam,Crime Against Children,Kidnapping,Male,31-45,8480,6572,1908,6828,1652
2009,Rural,Maharashtra,Other Crimes,Fraud,Female,13-17,7937,4079,3858,7162,775
2008,Rural,Chhattisgarh,Crime Against Women,Dowry Deaths,Female,31-45,9673,2697,6976,9232,441
2008,Urban,Punjab,Crime Against Men,Assault,Female,31-45,2032,536,1496,539,1493
2002,Urban,Maharashtra,Crime Against Men,Robbery,Female,46-60,2278,917,1361,1539,739
2008,Rural,Uttarakhand,Crime Against Men,Murder,Female,31-45,4453,4056,397,4127,326
2008,Urban,Uttarakhand,Crime Against Men,Murder,Male,13-17,2234,306,1928,865,1369
2001,Rural,Arunachal Pradesh,Other Crimes,Corruption,Female,13-17,8615,93,8522,2036,6579
2003,Rural,Meghalaya,Property Crime,Vandalism,Male,13-17,9107,8046,1061,8325,782
2009,Rural,Bihar,Crime Against Women,Molestation,Female,0-12,2353,278,2075,317,2036
2010,Urban,Odisha,Crime Against Men,Extortion,Female,31-45,6846,1757,5089,6162,684
2001,Urban,Manipur,Crime Against Men,Murder,Male,31-45,8497,8023,474,8349,148
2003,Urban,Tamil Nadu,Crime Against Children,Kidnapping,Female,31-45,6939,4180,2759,5753,1186
2002,Rural,Delhi,Crime Against Children,Child Labor,Female,60+,5933,3502,2431,3735,2198
2009,Rural,Gujarat,Crime Against Children,Trafficking,Male,13-17,2049,491,1558,910,1139
2005,Rural,Telangana,Other Crimes,Cyber Crime,Male,60+,6164,839,5325,4163,2001
2003,Urban,Maharashtra,Crime Against Women,Rape,Male,60+,6038,3208,2830,3632,2406
2002,Urban,Uttar Pradesh,Crime Against Men,Extortion,Male,18-30,3644,1579,2065,2245,1399
2004,Rural,Goa,Property Crime,Theft,Male,31-45,2865,377,2488,526,2339
2006,Rural,Haryana,Other Crimes,Cyber Crime,Female,46-60,9855,1172,8683,7160,2695
2002,Rural,Uttar Pradesh,Crime Against Women,Rape,Male,60+,6098,5458,640,5838,260
2001,Urban,Sikkim,Crime Against Men,Robbery,Male,46-60,9081,2026,7055,2428,6653
2007,Urban,Delhi,Crime Against Men,Assault,Male,31-45,5475,1491,3984,3908,1567
2002,Urban,Meghalaya,Crime Against Women,Molestation,Female,31-45,9500,155,9345,742,8758
2005,Urban,Uttarakhand,Crime Against Men,Murder,Male,0-12,2584,1332,1252,2033,551
2006,Urban,Gujarat,Other Crimes,Corruption,Female,31-45,2651,1839,812,1899,752
2004,Urban,Jharkhand,Property Crime,Theft,Male,31-45,8882,5873,3009,6854,2028
2004,Rural,Kerala,Other Crimes,Corruption,Female,46-60,3551,360,3191,2855,696
2009,Rural,Mizoram,Crime Against Children,Child Abuse,Female,18-30,8967,8058,909,8685,282
2003,Urban,Andhra Pradesh,Crime Against Children,Child Labor,Female,13-17,7236,2915,4321,4920,2316
2010,Rural,Tripura,Other Crimes,Drug Offense,Male,46-60,3301,581,2720,713,2588
2003,Urban,Karnataka,Crime Against Children,Child Abuse,Female,0-12,8137,307,7830,2513,5624
2004,Rural,Tripura,Crime Against Women,Molestation,Male,60+,5760,2369,3391,3329,2431
2009,Urban,Assam,Property Crime,Arson,Female,31-45,2632,2357,275,2507,125
2001,Rural,Meghalaya,Crime Against Men,Assault,Female,31-45,6675,5018,1657,6631,44
2006,Rural,Andhra Pradesh,Crime Against Children,Child Abuse,Male,18-30,6892,353,6539,2577,4315
2007,Urban,Maharashtra,Property Crime,Arson,Female,46-60,8078,1299,6779,4410,3668
2002,Rural,West Bengal,Property Crime,Burglary,Female,13-17,3243,2455,788,3064,179
2004,Rural,Odisha,Crime Against Children,Trafficking,Female,31-45,877,308,569,831,46
2008,Urban,Arunachal Pradesh,Crime Against Men,Assault,Female,60+,3053,2245,808,2756,297
2006,Urban,Andhra Pradesh,Property Crime,Theft,Male,46-60,2485,2045,440,2085,400
2001,Rural,Chhattisgarh,Crime Against Women,Molestation,Male,18-30,2351,1713,638,1965,386
2007,Urban,Tamil Nadu,Crime Against Women,Molestation,Male,13-17,6067,3776,2291,5982,85
2002,Urban,Himachal Pradesh,Crime Against Men,Murder,Male,13-17,8659,6688,1971,7112,1547
2010,Rural,Arunachal Pradesh,Other Crimes,Cyber Crime,Male,31-45,9310,1737,7573,2737,6573
2006,Urban,Karnataka,Property Crime,Theft,Male,18-30,6319,1440,4879,5736,583
2003,Rural,Uttarakhand,Other Crimes,Drug Offense,Female,46-60,8263,3379,4884,7598,665
2002,Urban,Madhya Pradesh,Crime Against Men,Murder,Male,18-30,5308,3656,1652,4523,785
2009,Rural,Manipur,Other Crimes,Cyber Crime,Male,18-30,6220,1036,5184,4131,2089
2004,Rural,Nagaland,Property Crime,Theft,Male,46-60,1010,7,1003,372,638
2009,Rural,Meghalaya,Property Crime,Vandalism,Female,13-17,4880,2761,2119,3994,886
2003,Urban,West Bengal,Property Crime,Burglary,Female,46-60,2684,72,2612,384,2300
2003,Rural,Meghalaya,Property Crime,Vandalism,Female,0-12,3864,3205,659,3442,422
2007,Urban,Rajasthan,Crime Against Men,Robbery,Male,60+,7023,6857,166,6928,95
2003,Urban,Kerala,Other Crimes,Corruption,Female,18-30,465,69,396,268,197
2004,Rural,Uttar Pradesh,Crime Against Children,Kidnapping,Female,46-60,3955,2863,1092,3155,800
2002,Urban,Karnataka,Other Crimes,Fraud,Female,18-30,4442,2391,2051,4387,55
2004,Urban,Mizoram,Other Crimes,Cyber Crime,Male,0-12,3107,635,2472,941,2166
2008,Urban,Punjab,Other Crimes,Drug Offense,Male,13-17,8558,1248,7310,3098,5460
2005,Urban,Andhra Pradesh,Property Crime,Burglary,Male,60+,9812,7223,2589,9797,15
2001,Urban,Assam,Crime Against Women,Dowry Deaths,Male,13-17,5789,1492,4297,4640,1149
2009,Urban,Maharashtra,Crime Against Children,Child Labor,Male,31-45,2141,1569,572,1975,166
2002,Urban,Arunachal Pradesh,Property Crime,Theft,Female,18-30,1697,1054,643,1603,94
2010,Urban,Mizoram,Crime Against Women,Rape,Female,60+,167,146,21,155,12
2001,Rural,Uttarakhand,Crime Against Women,Domestic Violence,Female,31-45,4419,717,3702,1727,2692
2006,Urban,Meghalaya,Other Crimes,Drug Offense,Female,18-30,6990,4982,2008,6711,279
2010,Urban,Haryana,Crime Against Men,Robbery,Male,0-12,6559,5990,569,6009,550
2005,Urban,Jharkhand,Crime Against Children,Child Abuse,Male,0-12,498,350,148,373,125
2005,Urban,Maharashtra,Crime Against Women,Rape,Male,31-45,5699,2954,2745,4397,1302
2004,Urban,West Bengal,Crime Against Women,Rape,Male,46-60,4341,2508,1833,3438,903
2006,Urban,Punjab,Crime Against Women,Domestic Violence,Female,60+,4143,2766,1377,3987,156
2008,Rural,Bihar,Crime Against Men,Murder,Male,60+,5287,1281,4006,4870,417
2007,Urban,Tamil Nadu,Crime Against Women,Domestic Violence,Female,46-60,8978,5850,3128,7740,1238
2003,Rural,Karnataka,Crime Against Children,Trafficking,Male,60+,1492,1174,318,1262,230
2009,Urban,Meghalaya,Crime Against Men,Extortion,Female,0-12,6790,6513,277,6663,127
2006,Urban,Assam,Other Crimes,Drug Offense,Female,13-17,3182,698,2484,1527,1655
2003,Urban,Rajasthan,Crime Against Women,Rape,Female,18-30,3500,2777,723,3046,454
2001,Rural,Himachal Pradesh,Crime Against Men,Extortion,Female,60+,6730,6214,516,6256,474
2002,Rural,Odisha,Crime Against Children,Child Labor,Male,13-17,1982,610,1372,1344,638
2003,Urban,Himachal Pradesh,Property Crime,Arson,Male,60+,9903,1190,8713,3734,6169
2005,Rural,Odisha,Crime Against Men,Robbery,Male,0-12,7590,4434,3156,6827,763
2009,Urban,Jammu & Kashmir,Crime Against Children,Kidnapping,Female,31-45,4174,2603,1571,3611,563
2004,Rural,Tripura,Crime Against Women,Domestic Violence,Female,46-60,5856,1035,4821,5631,225
2007,Rural,Chhattisgarh,Other Crimes,Drug Offense,Female,46-60,6750,6185,565,6201,549
2007,Urban,Assam,Crime Against Children,Child Labor,Female,13-17,1122,497,625,945,177
2003,Rural,Karnataka,Crime Against Children,Trafficking,Female,18-30,3236,876,2360,1865,1371
2006,Urban,Madhya Pradesh,Crime Against Children,Kidnapping,Male,60+,735,451,284,469,266
2001,Rural,Tamil Nadu,Crime Against Children,Trafficking,Male,13-17,1830,722,1108,1464,366
2009,Urban,Maharashtra,Other Crimes,Drug Offense,Female,18-30,8931,6024,2907,8696,235
2002,Rural,Kerala,Property Crime,Arson,Female,60+,8264,6072,2192,7923,341
2004,Urban,Goa,Crime Against Men,Murder,Female,60+,5726,4481,1245,4878,848
2003,Urban,Himachal Pradesh,Property Crime,Vandalism,Female,18-30,9806,3750,6056,9415,391
2005,Rural,Maharashtra,Crime Against Women,Domestic Violence,Male,60+,2247,722,1525,1098,1149
2007,Rural,Arunachal Pradesh,Crime Against Children,Kidnapping,Male,60+,7256,126,7130,6130,1126
2007,Rural,Arunachal Pradesh,Property Crime,Arson,Male,13-17,7623,4053,3570,6200,1423
2001,Rural,Goa,Crime Against Men,Extortion,Male,46-60,8592,6915,1677,8292,300
2009,Rural,Tamil Nadu,Crime Against Men,Assault,Female,13-17,548,128,420,328,220
2005,Rural,Manipur,Other Crimes,Cyber Crime,Male,60+,4736,1890,2846,1943,2793
2002,Urban,Gujarat,Crime Against Children,Child Labor,Female,13-17,9405,186,9219,2900,6505
2001,Urban,Madhya Pradesh,Crime Against Men,Murder,Female,60+,2125,648,1477,999,1126
2007,Rural,Karnataka,Crime Against Women,Dowry Deaths,Female,31-45,8974,2358,6616,4340,4634
2004,Urban,Madhya Pradesh,Other Crimes,Corruption,Male,18-30,9546,8629,917,8992,554
2005,Rural,Kerala,Crime Against Men,Robbery,Male,46-60,4173,958,3215,2196,1977
2001,Rural,Nagaland,Crime Against Children,Child Labor,Female,18-30,5111,3528,1583,3831,1280
2002,Urban,Meghalaya,Property Crime,Burglary,Female,60+,9307,235,9072,8788,519
2005,Urban,Arunachal Pradesh,Crime Against Children,Child Labor,Male,60+,3581,2252,1329,3128,453
2002,Rural,Arunachal Pradesh,Crime Against Men,Robbery,Male,60+,518,513,5,515,3
2005,Rural,Assam,Crime Against Children,Kidnapping,Female,0-12,5500,1124,4376,5079,421
2002,Rural,Madhya Pradesh,Other Crimes,Fraud,Female,18-30,1675,1005,670,1595,80
2008,Urban,Andhra Pradesh,Crime Against Women,Rape,Female,0-12,8614,3689,4925,6915,1699
2009,Rural,Madhya Pradesh,Crime Against Women,Dowry Deaths,Male,60+,5050,4127,923,4514,536
2006,Rural,Rajasthan,Crime Against Children,Child Labor,Female,60+,2382,130,2252,994,1388
2010,Rural,Tripura,Crime Against Men,Assault,Female,0-12,790,23,767,643,147
2010,Rural,Manipur,Crime Against Women,Rape,Male,18-30,9008,7220,1788,7978,1030
2004,Rural,Madhya Pradesh,Crime Against Men,Robbery,Male,18-30,7402,3799,3603,4335,3067
2007,Urban,Jharkhand,Crime Against Children,Child Abuse,Male,18-30,5654,3092,2562,4703,951
2002,Urban,Goa,Crime Against Children,Child Labor,Male,18-30,112,4,108,112,0
2006,Urban,Chhattisgarh,Property Crime,Vandalism,Male,0-12,8523,7818,705,8116,407
2002,Rural,Telangana,Crime Against Children,Kidnapping,Male,0-12,3219,2811,408,2881,338
2003,Urban,Chhattisgarh,Crime Against Men,Assault,Male,60+,5874,3292,2582,4135,1739
2002,Urban,Arunachal Pradesh,Property Crime,Theft,Male,60+,2940,2486,454,2924,16
2001,Rural,Nagaland,Crime Against Men,Murder,Male,18-30,1983,113,1870,1179,804
2001,Urban,Delhi,Crime Against Women,Molestation,Male,46-60,1663,1023,640,1534,129
2008,Rural,Madhya Pradesh,Crime Against Children,Trafficking,Male,31-45,4549,1242,3307,2876,1673
2006,Urban,Meghalaya,Property Crime,Vandalism,Female,13-17,3175,1578,1597,3157,18
2010,Urban,Goa,Other Crimes,Cyber Crime,Male,18-30,732,498,234,712,20
2003,Urban,Delhi,Crime Against Men,Extortion,Female,18-30,5525,2374,3151,4436,1089
2009,Urban,Kerala,Crime Against Men,Assault,Female,46-60,9394,3063,6331,4182,5212
2003,Urban,Nagaland,Property Crime,Theft,Female,18-30,4034,3046,988,3523,511
2004,Rural,Kerala,Property Crime,Arson,Male,31-45,3514,763,2751,812,2702
2008,Urban,Haryana,Crime Against Men,Extortion,Female,46-60,7067,6602,465,6878,189
2005,Urban,Rajasthan,Crime Against Women,Rape,Male,60+,5564,172,5392,398,5166
2002,Rural,Telangana,Property Crime,Vandalism,Female,46-60,891,474,417,660,231
2002,Urban,Andhra Pradesh,Other Crimes,Cyber Crime,Female,13-17,3008,1667,1341,2792,216
2009,Rural,Madhya Pradesh,Crime Against Children,Child Abuse,Male,13-17,3516,3056,460,3467,49
2006,Urban,Odisha,Crime Against Children,Child Abuse,Male,18-30,5292,2379,2913,4285,1007
2002,Urban,Meghalaya,Other Crimes,Fraud,Female,31-45,2340,2302,38,2337,3
2005,Rural,Madhya Pradesh,Property Crime,Arson,Male,46-60,4743,2581,2162,3738,1005
2008,Urban,Jharkhand,Crime Against Women,Rape,Male,31-45,2222,1472,750,2133,89
2001,Urban,Assam,Crime Against Children,Kidnapping,Male,46-60,9355,3799,5556,6389,2966
2006,Urban,Kerala,Crime Against Children,Child Abuse,Female,31-45,525,494,31,495,30
2002,Urban,Uttar Pradesh,Crime Against Men,Extortion,Female,0-12,799,539,260,546,253
2002,Urban,Sikkim,Crime Against Women,Dowry Deaths,Female,13-17,3760,2765,995,3586,174
2007,Urban,Assam,Crime Against Women,Molestation,Male,60+,1370,1228,142,1271,99
2003,Rural,Tamil Nadu,Crime Against Children,Child Abuse,Male,18-30,8280,8119,161,8208,72
2002,Rural,Odisha,Crime Against Women,Domestic Violence,Male,31-45,1027,432,595,607,420
2001,Urban,Kerala,Property Crime,Theft,Male,60+,612,218,394,303,309
2009,Rural,Maharashtra,Crime Against Men,Murder,Male,18-30,4581,3381,1200,4543,38
2002,Rural,Tripura,Property Crime,Vandalism,Male,31-45,5313,2274,3039,3157,2156
2005,Urban,Telangana,Crime Against Men,Robbery,Female,46-60,9788,8333,1455,8774,1014
2006,Urban,Meghalaya,Crime Against Women,Domestic Violence,Female,0-12,670,15,655,47,623
2005,Urban,Karnataka,Property Crime,Arson,Female,46-60,456,323,133,386,70
2001,Rural,Assam,Crime Against Women,Dowry Deaths,Female,31-45,2978,2391,587,2844,134
2001,Rural,Uttarakhand,Property Crime,Arson,Male,0-12,5750,1853,3897,5544,206
2002,Rural,Gujarat,Crime Against Children,Child Labor,Male,13-17,6329,3856,2473,4753,1576
2007,Rural,Tripura,Crime Against Children,Child Abuse,Male,31-45,4885,3887,998,4767,118
2010,Rural,Andhra Pradesh,Property Crime,Arson,Male,13-17,5773,4249,1524,5654,119
2010,Urban,Jammu & Kashmir,Crime Against Children,Kidnapping,Male,13-17,9762,4310,5452,7983,1779
2005,Urban,Madhya Pradesh,Crime Against Men,Extortion,Male,46-60,2511,1862,649,1911,600
2010,Urban,Jammu & Kashmir,Other Crimes,Cyber Crime,Male,18-30,3654,1820,1834,1856,1798
2006,Urban,Uttar Pradesh,Crime Against Children,Trafficking,Female,18-30,1638,612,1026,1250,388
2008,Rural,Sikkim,Other Crimes,Drug Offense,Male,46-60,8848,6522,2326,8723,125
2010,Rural,Sikkim,Crime Against Men,Robbery,Female,60+,4755,3307,1448,3496,1259
2007,Rural,Himachal Pradesh,Property Crime,Burglary,Female,46-60,5991,4102,1889,5099,892
2007,Urban,Meghalaya,Crime Against Children,Kidnapping,Male,18-30,8700,7548,1152,8342,358
2001,Rural,Gujarat,Crime Against Men,Extortion,Male,13-17,4403,2350,2053,2609,1794
2004,Rural,Jharkhand,Property Crime,Theft,Male,60+,5603,3301,2302,3998,1605
2008,Rural,Madhya Pradesh,Property Crime,Burglary,Female,31-45,6217,64,6153,2668,3549
2001,Urban,Bihar,Property Crime,Burglary,Male,0-12,537,249,288,520,17
2009,Rural,Jharkhand,Crime Against Children,Kidnapping,Male,13-17,8043,4692,3351,5014,3029
2002,Urban,Mizoram,Crime Against Children,Child Labor,Male,0-12,8490,1163,7327,2479,6011
2007,Urban,Delhi,Other Crimes,Fraud,Female,0-12,752,70,682,632,120
2005,Urban,Mizoram,Other Crimes,Cyber Crime,Female,0-12,9240,1762,7478,7927,1313
2003,Rural,Tamil Nadu,Other Crimes,Corruption,Male,60+,7828,2732,5096,7587,241
2010,Urban,Odisha,Crime Against Women,Rape,Male,46-60,3073,2107,966,2348,725
2006,Urban,Mizoram,Crime Against Children,Child Labor,Male,0-12,5455,2959,2496,4829,626
2007,Urban,Rajasthan,Property Crime,Burglary,Female,31-45,561,363,198,519,42
2008,Rural,Uttarakhand,Crime Against Children,Child Labor,Male,18-30,9910,6131,3779,8785,1125
2005,Rural,Tamil Nadu,Other Crimes,Fraud,Male,0-12,8615,6190,2425,8492,123
2007,Urban,Maharashtra,Crime Against Children,Child Abuse,Female,60+,3851,1280,2571,1673,2178
2005,Rural,Maharashtra,Crime Against Men,Murder,Male,46-60,7284,4367,2917,4556,2728
2001,Rural,Madhya Pradesh,Other Crimes,Cyber Crime,Female,13-17,9979,4099,5880,6477,3502
2003,Rural,Uttar Pradesh,Crime Against Women,Dowry Deaths,Male,46-60,6505,2771,3734,3639,2866
2005,Rural,Chhattisgarh,Other Crimes,Corruption,Male,13-17,279,155,124,185,94
2005,Rural,Jammu & Kashmir,Crime Against Women,Domestic Violence,Male,60+,6722,4150,2572,6192,530
2009,Urban,Delhi,Other Crimes,Fraud,Male,18-30,9537,4893,4644,6321,3216
2002,Urban,Delhi,Crime Against Women,Dowry Deaths,Male,13-17,615,216,399,482,133
2010,Rural,Kerala,Property Crime,Arson,Male,0-12,5681,2356,3325,2708,2973
2009,Rural,West Bengal,Crime Against Men,Assault,Male,18-30,9914,5942,3972,8848,1066
2007,Urban,Sikkim,Crime Against Children,Trafficking,Female,13-17,385,211,174,232,153
2006,Rural,Chhattisgarh,Crime Against Children,Child Labor,Female,18-30,8938,6842,2096,8843,95
2004,Urban,Tamil Nadu,Other Crimes,Cyber Crime,Male,46-60,3268,1998,1270,2558,710
2010,Rural,Punjab,Crime Against Men,Extortion,Female,31-45,309,146,163,229,80
2009,Rural,Odisha,Crime Against Children,Trafficking,Female,0-12,2681,140,2541,2297,384
2006,Rural,Haryana,Crime Against Men,Extortion,Male,13-17,657,298,359,323,334
2008,Urban,Sikkim,Property Crime,Burglary,Female,18-30,8396,1946,6450,4633,3763
2006,Urban,Maharashtra,Crime Against Men,Extortion,Female,46-60,661,368,293,454,207
2001,Urban,Kerala,Other Crimes,Drug Offense,Male,0-12,2405,324,2081,2064,341
2003,Rural,Madhya Pradesh,Crime Against Women,Molestation,Female,13-17,6169,5774,395,6109,60
2003,Urban,Goa,Property Crime,Arson,Male,0-12,5041,407,4634,3561,1480
2008,Urban,Uttar Pradesh,Other Crimes,Fraud,Female,13-17,2619,2539,80,2587,32
2002,Urban,West Bengal,Other Crimes,Fraud,Male,46-60,9565,9562,3,9562,3
2010,Rural,Sikkim,Crime Against Men,Extortion,Female,31-45,7524,7392,132,7519,5
2002,Urban,Goa,Other Crimes,Drug Offense,Female,31-45,2841,2590,251,2757,84
2002,Urban,Jharkhand,Property Crime,Theft,Male,31-45,8178,7210,968,7992,186
2004,Urban,Jharkhand,Crime Against Women,Domestic Violence,Female,13-17,4957,4088,869,4541,416
2007,Urban,Punjab,Crime Against Children,Kidnapping,Female,31-45,4834,2511,2323,2834,2000
2004,Urban,Kerala,Property Crime,Burglary,Female,60+,273,30,243,199,74
2009,Rural,Haryana,Crime Against Men,Robbery,Female,0-12,9741,6249,3492,8125,1616
2008,Rural,Rajasthan,Other Crimes,Cyber Crime,Male,13-17,9413,2876,6537,8164,1249
2008,Rural,Arunachal Pradesh,Crime Against Children,Child Labor,Male,46-60,7730,5744,1986,6807,923
2004,Urban,Gujarat,Crime Against Men,Extortion,Male,60+,144,91,53,100,44
2004,Rural,Maharashtra,Crime Against Men,Robbery,Male,60+,3694,1577,2117,1762,1932
2004,Urban,Assam,Other Crimes,Fraud,Male,18-30,9755,425,9330,1821,7934
2004,Rural,Chhattisgarh,Property Crime,Theft,Male,18-30,3082,980,2102,1911,1171
2006,Rural,Uttarakhand,Crime Against Men,Murder,Female,0-12,2877,1715,1162,2561,316
2008,Rural,Karnataka,Crime Against Men,Robbery,Male,31-45,2236,1895,341,1909,327
2008,Urban,Sikkim,Crime Against Children,Trafficking,Female,31-45,5183,4325,858,4369,814
2004,Urban,Sikkim,Crime Against Women,Rape,Male,46-60,967,357,610,393,574
2010,Urban,Assam,Other Crimes,Fraud,Female,13-17,7833,469,7364,7366,467
2009,Urban,Rajasthan,Crime Against Women,Domestic Violence,Male,31-45,5495,196,5299,2563,2932
2010,Urban,West Bengal,Other Crimes,Corruption,Female,60+,3676,245,3431,3639,37
2007,Urban,Jammu & Kashmir,Crime Against Children,Child Abuse,Male,13-17,3999,2254,1745,3207,792
2007,Rural,Rajasthan,Crime Against Women,Dowry Deaths,Male,31-45,5010,2084,2926,2289,2721
2005,Rural,Manipur,Other Crimes,Corruption,Male,13-17,5535,927,4608,4514,1021
2010,Rural,Assam,Other Crimes,Cyber Crime,Male,13-17,2080,1196,884,1661,419
2004,Urban,Goa,Other Crimes,Cyber Crime,Male,18-30,4420,1890,2530,3027,1393
2008,Urban,Maharashtra,Crime Against Women,Dowry Deaths,Male,31-45,6795,4775,2020,6585,210
2008,Urban,Mizoram,Crime Against Men,Robbery,Male,31-45,1512,1194,318,1444,68
2004,Rural,Uttarakhand,Other Crimes,Fraud,Female,0-12,7755,1149,6606,6978,777
2002,Urban,West Bengal,Property Crime,Burglary,Male,31-45,5554,1361,4193,1412,4142
2005,Rural,Uttar Pradesh,Property Crime,Theft,Male,31-45,8445,3209,5236,6118,2327
2009,Rural,Maharashtra,Property Crime,Burglary,Male,0-12,1272,391,881,586,686
2004,Urban,Tamil Nadu,Crime Against Women,Molestation,Male,60+,2978,611,2367,2086,892
2003,Urban,Tamil Nadu,Crime Against Women,Domestic Violence,Female,13-17,2679,2349,330,2393,286
2007,Rural,Andhra Pradesh,Property Crime,Vandalism,Female,46-60,2604,2504,100,2553,51
2002,Rural,Punjab,Property Crime,Arson,Male,18-30,5769,3795,1974,5699,70
2004,Rural,Jammu & Kashmir,Crime Against Men,Murder,Female,0-12,6841,4723,2118,6785,56
2002,Rural,Rajasthan,Crime Against Women,Dowry Deaths,Male,13-17,6184,811,5373,4168,2016
2002,Rural,Andhra Pradesh,Other Crimes,Drug Offense,Male,13-17,9477,6967,2510,8122,1355
2010,Urban,Tripura,Property Crime,Theft,Male,46-60,4441,218,4223,1966,2475
2005,Urban,Gujarat,Crime Against Children,Child Abuse,Male,60+,7090,1906,5184,3157,3933
2007,Urban,Goa,Property Crime,Theft,Male,31-45,9718,1970,7748,2700,7018
2002,Rural,Manipur,Other Crimes,Drug Offense,Female,0-12,6613,4538,2075,4589,2024
2004,Rural,Karnataka,Other Crimes,Corruption,Male,13-17,109,107,2,108,1
2006,Rural,Rajasthan,Other Crimes,Corruption,Female,0-12,6046,5320,726,5970,76
2004,Urban,Andhra Pradesh,Crime Against Children,Child Abuse,Male,13-17,3042,1576,1466,2961,81
2006,Urban,Rajasthan,Property Crime,Arson,Male,46-60,9125,8775,350,9082,43
2005,Rural,Assam,Other Crimes,Corruption,Female,13-17,1697,1521,176,1600,97
2007,Rural,Chhattisgarh,Crime Against Children,Kidnapping,Male,13-17,3125,110,3015,2271,854
2008,Urban,Rajasthan,Other Crimes,Drug Offense,Male,13-17,6085,143,5942,1565,4520
2007,Rural,Karnataka,Crime Against Women,Rape,Female,60+,7094,5288,1806,5724,1370
2004,Rural,Tamil Nadu,Crime Against Men,Murder,Female,46-60,6013,2759,3254,3857,2156
2001,Rural,Bihar,Crime Against Women,Domestic Violence,Male,46-60,2447,1009,1438,2280,167
2008,Urban,Telangana,Crime Against Women,Domestic Violence,Male,46-60,5338,881,4457,1177,4161
2001,Rural,Haryana,Crime Against Children,Kidnapping,Male,31-45,2174,1560,614,1919,255
2001,Rural,Jammu & Kashmir,Other Crimes,Fraud,Female,31-45,3537,1458,2079,2048,1489
2004,Urban,Jammu & Kashmir,Crime Against Men,Assault,Male,46-60,1685,536,1149,667,1018
2001,Urban,Nagaland,Other Crimes,Fraud,Female,18-30,3365,2737,628,2818,547
2006,Urban,Haryana,Crime Against Women,Molestation,Female,18-30,4924,4831,93,4842,82
2008,Rural,Jammu & Kashmir,Other Crimes,Cyber Crime,Male,0-12,8480,7577,903,8082,398
2004,Urban,Maharashtra,Crime Against Men,Robbery,Male,31-45,531,487,44,494,37
2006,Rural,Nagaland,Other Crimes,Corruption,Male,18-30,9458,5965,3493,7171,2287
2001,Urban,Sikkim,Crime Against Women,Rape,Female,0-12,8059,2333,5726,6146,1913
2010,Urban,Kerala,Crime Against Children,Child Abuse,Female,60+,415,225,190,237,178
2006,Rural,Jharkhand,Other Crimes,Corruption,Male,18-30,3398,131,3267,449,2949
2005,Urban,West Bengal,Crime Against Children,Kidnapping,Male,31-45,7350,1011,6339,3486,3864
2001,Urban,Goa,Crime Against Children,Trafficking,Female,60+,5666,1457,4209,2705,2961
2003,Rural,Andhra Pradesh,Crime Against Men,Assault,Male,0-12,5879,1410,4469,5442,437
2002,Rural,Nagaland,Property Crime,Arson,Female,60+,840,209,631,396,444
2002,Urban,Tamil Nadu,Crime Against Women,Domestic Violence,Female,0-12,675,603,72,606,69
2007,Urban,Jharkhand,Crime Against Men,Murder,Male,18-30,1434,558,876,784,650
2007,Rural,Madhya Pradesh,Crime Against Men,Extortion,Male,31-45,2298,729,1569,1841,457
2009,Rural,Uttarakhand,Crime Against Children,Child Abuse,Male,13-17,5334,285,5049,1843,3491
2007,Rural,Kerala,Other Crimes,Drug Offense,Female,60+,8969,2349,6620,4130,4839
2010,Rural,Jammu & Kashmir,Crime Against Women,Molestation,Female,18-30,1029,651,378,664,365
2001,Urban,Nagaland,Crime Against Women,Dowry Deaths,Male,0-12,3387,2835,552,3285,102
2008,Urban,Arunachal Pradesh,Crime Against Men,Extortion,Male,18-30,9588,1076,8512,2436,7152
2010,Urban,Odisha,Crime Against Women,Domestic Violence,Female,18-30,4238,902,3336,3803,435
2007,Urban,Kerala,Crime Against Men,Assault,Male,46-60,6188,5307,881,6041,147
2004,Urban,Jammu & Kashmir,Crime Against Children,Kidnapping,Male,13-17,9847,7492,2355,8600,1247
2006,Urban,Karnataka,Crime Against Children,Child Labor,Female,18-30,9891,284,9607,5248,4643
2003,Rural,West Bengal,Property Crime,Burglary,Male,13-17,6183,2170,4013,4737,1446
2007,Rural,Mizoram,Crime Against Men,Murder,Female,31-45,5569,2857,2712,3030,2539
2001,Rural,Manipur,Crime Against Children,Child Abuse,Female,0-12,4982,806,4176,2103,2879
2005,Urban,Rajasthan,Property Crime,Vandalism,Female,60+,6682,1209,5473,4196,2486
2003,Rural,West Bengal,Crime Against Children,Child Abuse,Male,31-45,7307,3715,3592,7095,212
2008,Urban,Mizoram,Crime Against Men,Extortion,Female,60+,3465,1540,1925,2294,1171
2001,Rural,Sikkim,Other Crimes,Cyber Crime,Male,46-60,6467,4521,1946,5049,1418
2010,Rural,Odisha,Other Crimes,Drug Offense,Female,13-17,2640,1610,1030,2366,274
2009,Urban,Maharashtra,Crime Against Men,Murder,Female,31-45,1842,1421,421,1704,138
2008,Urban,Kerala,Crime Against Women,Molestation,Female,60+,2017,124,1893,573,1444
2006,Rural,Himachal Pradesh,Other Crimes,Corruption,Male,0-12,630,299,331,386,244
2007,Rural,Rajasthan,Other Crimes,Drug Offense,Male,46-60,3795,2449,1346,3115,680
2009,Urban,Haryana,Crime Against Men,Robbery,Female,18-30,8601,699,7902,5708,2893
2010,Urban,Telangana,Crime Against Women,Rape,Female,13-17,889,781,108,798,91
2006,Rural,Sikkim,Crime Against Children,Child Labor,Male,46-60,8608,2674,5934,6358,2250
2002,Urban,Assam,Crime Against Men,Murder,Male,13-17,4448,303,4145,2022,2426
2003,Rural,Telangana,Crime Against Children,Child Labor,Male,46-60,4664,1208,3456,4573,91
2004,Rural,Madhya Pradesh,Property Crime,Vandalism,Female,31-45,5901,1887,4014,3192,2709
2010,Urban,Uttar Pradesh,Crime Against Children,Child Labor,Female,0-12,3391,244,3147,2947,444
2006,Rural,Meghalaya,Crime Against Women,Dowry Deaths,Female,60+,4609,1067,3542,3261,1348
2008,Rural,Odisha,Other Crimes,Drug Offense,Female,31-45,368,136,232,333,35
2008,Rural,Meghalaya,Crime Against Men,Murder,Male,13-17,4704,4225,479,4688,16
2002,Urban,Tamil Nadu,Property Crime,Vandalism,Male,13-17,427,356,71,406,21
2008,Urban,Andhra Pradesh,Crime Against Children,Child Abuse,Male,18-30,9434,998,8436,3432,6002
2003,Urban,Rajasthan,Other Crimes,Corruption,Male,60+,5211,1511,3700,4045,1166
2002,Urban,Odisha,Crime Against Women,Dowry Deaths,Female,13-17,7800,6670,1130,7264,536
2009,Rural,Himachal Pradesh,Crime Against Women,Molestation,Male,60+,7593,1823,5770,6621,972
2003,Urban,Himachal Pradesh,Crime Against Women,Dowry Deaths,Female,13-17,8030,3454,4576,6364,1666
2003,Urban,Jharkhand,Crime Against Women,Dowry Deaths,Female,13-17,3270,2772,498,3223,47
2010,Urban,Delhi,Crime Against Women,Dowry Deaths,Male,18-30,6062,4887,1175,5918,144
2009,Rural,Tripura,Other Crimes,Fraud,Female,31-45,9054,6661,2393,8733,321
2006,Rural,Meghalaya,Crime Against Children,Trafficking,Female,18-30,5692,4914,778,5280,412
2002,Rural,Mizoram,Other Crimes,Cyber Crime,Male,0-12,3423,1392,2031,2592,831
2006,Rural,Telangana,Property Crime,Theft,Female,18-30,921,633,288,871,50
2003,Urban,Assam,Other Crimes,Corruption,Male,60+,5505,3781,1724,4495,1010
2006,Urban,Karnataka,Crime Against Women,Rape,Female,0-12,4599,440,4159,1223,3376
2002,Rural,Nagaland,Property Crime,Theft,Male,31-45,4556,224,4332,2742,1814
2007,Urban,Punjab,Property Crime,Vandalism,Female,31-45,9451,8930,521,9031,420
2001,Rural,Jharkhand,Other Crimes,Cyber Crime,Female,18-30,981,121,860,693,288
2002,Urban,Bihar,Other Crimes,Drug Offense,Male,18-30,3922,1078,2844,3745,177
2007,Urban,Maharashtra,Crime Against Men,Extortion,Male,46-60,7661,2139,5522,3174,4487
2010,Rural,Sikkim,Property Crime,Theft,Female,31-45,5136,3980,1156,4209,927
2007,Rural,Mizoram,Crime Against Women,Rape,Female,18-30,3276,2324,952,2584,692
2006,Urban,Meghalaya,Property Crime,Arson,Female,13-17,4264,1345,2919,1858,2406
2002,Urban,Madhya Pradesh,Crime Against Women,Dowry Deaths,Male,18-30,6111,4602,1509,4817,1294
2007,Urban,Telangana,Crime Against Women,Rape,Female,18-30,3638,662,2976,1388,2250
2005,Urban,Punjab,Crime Against Men,Murder,Male,46-60,2976,1464,1512,2818,158
2003,Rural,Punjab,Crime Against Women,Molestation,Female,46-60,6192,1206,4986,4476,1716
2006,Rural,West Bengal,Crime Against Women,Domestic Violence,Male,46-60,3239,1746,1493,1806,1433
2008,Rural,Uttarakhand,Crime Against Children,Trafficking,Female,13-17,7637,1527,6110,5247,2390
2005,Urban,Haryana,Crime Against Men,Assault,Male,31-45,1478,1068,410,1345,133
2007,Urban,Karnataka,Other Crimes,Drug Offense,Male,18-30,332,207,125,223,109
2008,Urban,Delhi,Crime Against Children,Child Labor,Female,60+,3705,888,2817,1073,2632
2003,Urban,Uttarakhand,Other Crimes,Corruption,Female,46-60,5204,1761,3443,2742,2462
2007,Urban,Tamil Nadu,Property Crime,Theft,Female,60+,8523,3858,4665,6599,1924
2005,Rural,Maharashtra,Crime Against Men,Murder,Male,46-60,1702,646,1056,1270,432
2007,Rural,Mizoram,Crime Against Women,Rape,Female,60+,3230,2859,371,3117,113
2009,Rural,West Bengal,Property Crime,Vandalism,Male,18-30,8799,8394,405,8577,222
2006,Rural,Uttar Pradesh,Property Crime,Theft,Female,0-12,1352,328,1024,935,417
2003,Urban,Goa,Property Crime,Arson,Female,13-17,5251,1338,3913,4420,831
2001,Rural,Jharkhand,Property Crime,Burglary,Male,60+,3965,2672,1293,3246,719
2007,Urban,West Bengal,Crime Against Children,Trafficking,Female,18-30,7687,4917,2770,5339,2348
2002,Rural,Nagaland,Crime Against Women,Dowry Deaths,Male,31-45,8747,5372,3375,5993,2754
2002,Rural,Delhi,Crime Against Children,Child Abuse,Female,0-12,2043,1500,543,1939,104
2008,Urban,Delhi,Other Crimes,Corruption,Male,18-30,7245,3763,3482,4054,3191
2005,Urban,Mizoram,Other Crimes,Cyber Crime,Female,18-30,9697,1816,7881,9258,439
2009,Urban,Karnataka,Crime Against Women,Domestic Violence,Female,13-17,7535,603,6932,6425,1110
2003,Urban,Uttar Pradesh,Other Crimes,Cyber Crime,Male,0-12,3482,331,3151,3278,204
2007,Urban,Telangana,Crime Against Men,Murder,Female,46-60,8963,4185,4778,7116,1847
2007,Urban,Madhya Pradesh,Crime Against Children,Trafficking,Male,46-60,4979,4236,743,4978,1
2007,Rural,Andhra Pradesh,Other Crimes,Corruption,Female,46-60,7708,2141,5567,3845,3863
2003,Rural,Himachal Pradesh,Crime Against Children,Trafficking,Male,0-12,8968,1986,6982,2405,6563
2008,Urban,Jammu & Kashmir,Property Crime,Theft,Female,13-17,4868,4391,477,4607,261
2001,Rural,Jammu & Kashmir,Crime Against Men,Assault,Female,0-12,383,191,192,278,105
2004,Urban,Sikkim,Other Crimes,Fraud,Female,46-60,4120,2825,1295,3151,969
2001,Rural,West Bengal,Property Crime,Burglary,Female,60+,367,280,87,331,36
2004,Rural,Goa,Crime Against Men,Murder,Female,0-12,1984,1063,921,1342,642
2004,Urban,West Bengal,Property Crime,Theft,Female,18-30,1513,1411,102,1441,72
2002,Urban,Kerala,Other Crimes,Drug Offense,Male,18-30,7612,6245,1367,7345,267
2005,Urban,Jharkhand,Crime Against Women,Rape,Male,13-17,6702,6696,6,6699,3
2009,Urban,Nagaland,Crime Against Children,Kidnapping,Female,46-60,5454,718,4736,5180,274
2006,Rural,Karnataka,Crime Against Children,Trafficking,Female,18-30,3014,2779,235,2800,214
2008,Urban,Karnataka,Crime Against Women,Domestic Violence,Male,46-60,3680,3672,8,3679,1
2008,Urban,Kerala,Crime Against Women,Molestation,Male,60+,1455,366,1089,654,801
2003,Rural,Himachal Pradesh,Property Crime,Burglary,Female,18-30,1831,1706,125,1716,115
2009,Rural,Jharkhand,Crime Against Women,Molestation,Female,0-12,8224,6868,1356,7985,239
2002,Rural,Andhra Pradesh,Crime Against Women,Domestic Violence,Female,31-45,6039,2103,3936,5527,512
2007,Rural,Rajasthan,Crime Against Men,Murder,Female,46-60,6498,5483,1015,5934,564
2003,Urban,Odisha,Crime Against Women,Dowry Deaths,Male,46-60,7311,1863,5448,3204,4107
2008,Urban,Sikkim,Other Crimes,Corruption,Male,18-30,8353,1944,6409,5847,2506
2010,Urban,Nagaland,Other Crimes,Corruption,Female,0-12,2604,2051,553,2411,193
2004,Rural,Rajasthan,Crime Against Men,Robbery,Male,60+,2033,519,1514,1128,905
2007,Rural,Uttar Pradesh,Property Crime,Arson,Male,0-12,9712,7233,2479,8196,1516
2002,Urban,Meghalaya,Other Crimes,Fraud,Female,60+,2062,804,1258,943,1119
2005,Urban,Andhra Pradesh,Crime Against Men,Robbery,Male,46-60,5758,2936,2822,4816,942
2003,Rural,Odisha,Crime Against Children,Child Abuse,Female,18-30,167,27,140,142,25
2004,Urban,Andhra Pradesh,Crime Against Men,Murder,Female,18-30,5560,3087,2473,4888,672
2004,Urban,Bihar,Property Crime,Vandalism,Male,31-45,6708,595,6113,5727,981
2008,Urban,West Bengal,Crime Against Children,Trafficking,Male,60+,6076,1821,4255,3533,2543
2008,Urban,Telangana,Property Crime,Theft,Male,60+,1314,609,705,835,479
2010,Rural,Jharkhand,Crime Against Men,Murder,Male,60+,8778,930,7848,8506,272
2003,Urban,Uttarakhand,Property Crime,Vandalism,Male,13-17,1833,1600,233,1779,54
2007,Rural,Tamil Nadu,Crime Against Women,Dowry Deaths,Female,13-17,8841,5796,3045,6558,2283
2001,Urban,Bihar,Crime Against Children,Child Labor,Male,31-45,7899,5594,2305,6299,1600
2004,Rural,Jammu & Kashmir,Crime Against Men,Murder,Female,18-30,9798,9671,127,9728,70
2008,Rural,Chhattisgarh,Crime Against Children,Kidnapping,Male,18-30,5056,1225,3831,3075,1981
2006,Urban,Haryana,Crime Against Women,Molestation,Male,60+,3918,1679,2239,2679,1239
2003,Rural,Delhi,Crime Against Children,Child Labor,Male,18-30,2840,110,2730,2230,610
2004,Rural,Chhattisgarh,Crime Against Women,Domestic Violence,Male,18-30,260,89,171,182,78
2001,Rural,Mizoram,Crime Against Men,Assault,Male,0-12,7970,5614,2356,6347,1623
2006,Urban,Chhattisgarh,Other Crimes,Drug Offense,Female,18-30,5554,4265,1289,4913,641
2006,Urban,Telangana,Property Crime,Theft,Female,60+,5081,259,4822,3340,1741
2007,Rural,West Bengal,Crime Against Women,Domestic Violence,Female,0-12,8839,5879,2960,6512,2327
2009,Urban,Rajasthan,Property Crime,Vandalism,Male,60+,1356,1032,324,1218,138
2008,Urban,Mizoram,Other Crimes,Cyber Crime,Male,13-17,5372,3060,2312,4469,903
2003,Urban,Maharashtra,Crime Against Children,Child Abuse,Male,18-30,3329,1953,1376,2853,476
2002,Rural,Mizoram,Crime Against Women,Dowry Deaths,Female,0-12,3440,2229,1211,2608,832
2007,Urban,Manipur,Crime Against Children,Child Labor,Male,31-45,9495,8086,1409,9456,39
2006,Rural,Andhra Pradesh,Crime Against Women,Dowry Deaths,Female,18-30,8226,1409,6817,7608,618
2007,Rural,Tamil Nadu,Crime Against Women,Molestation,Female,60+,5156,4769,387,4826,330
2001,Urban,Sikkim,Crime Against Children,Child Abuse,Female,60+,5308,2895,2413,4704,604
2001,Rural,Nagaland,Property Crime,Vandalism,Female,0-12,2802,336,2466,638,2164
2009,Rural,Punjab,Property Crime,Theft,Female,13-17,6276,4858,1418,6074,202
2005,Rural,Gujarat,Crime Against Women,Dowry Deaths,Male,31-45,5861,4312,1549,4462,1399
2009,Rural,Bihar,Other Crimes,Drug Offense,Female,31-45,1457,616,841,1244,213
2004,Rural,West Bengal,Other Crimes,Drug Offense,Male,46-60,5155,571,4584,4177,978
2003,Rural,Chhattisgarh,Crime Against Men,Murder,Female,18-30,4405,2411,1994,3953,452
2001,Urban,Jammu & Kashmir,Crime Against Women,Domestic Violence,Male,46-60,8897,5882,3015,6537,2360
2010,Urban,West Bengal,Crime Against Men,Extortion,Female,46-60,169,25,144,107,62
2010,Urban,Karnataka,Crime Against Children,Kidnapping,Female,31-45,5425,4327,1098,4543,882
2005,Urban,Jharkhand,Crime Against Children,Kidnapping,Female,0-12,7029,4312,2717,4441,2588
2003,Urban,Tripura,Crime Against Men,Assault,Male,13-17,8921,7343,1578,8612,309
2009,Urban,Goa,Crime Against Children,Child Labor,Male,0-12,7011,6044,967,7003,8
2002,Urban,Maharashtra,Crime Against Women,Molestation,Female,0-12,2269,1934,335,1960,309
2004,Rural,Sikkim,Crime Against Women,Domestic Violence,Female,31-45,8421,1551,6870,5259,3162
2008,Urban,Delhi,Crime Against Children,Trafficking,Female,18-30,7628,6316,1312,6736,892
2008,Rural,Goa,Property Crime,Burglary,Female,31-45,8997,2418,6579,6730,2267
2008,Rural,Sikkim,Other Crimes,Fraud,Male,0-12,1522,1439,83,1493,29
2007,Urban,West Bengal,Crime Against Children,Kidnapping,Female,46-60,9112,1796,7316,5886,3226
2004,Rural,Bihar,Crime Against Women,Domestic Violence,Female,46-60,4687,3760,927,4661,26
2008,Rural,Uttarakhand,Other Crimes,Drug Offense,Female,13-17,956,730,226,848,108
2004,Urban,Uttar Pradesh,Crime Against Men,Robbery,Female,31-45,9999,1036,8963,8715,1284
2006,Urban,Chhattisgarh,Other Crimes,Fraud,Male,60+,1245,634,611,1085,160
2003,Rural,Tripura,Crime Against Men,Assault,Female,60+,7686,2777,4909,4288,3398
2003,Urban,Assam,Crime Against Women,Domestic Violence,Female,60+,5041,1775,3266,2785,2256
2009,Urban,Kerala,Crime Against Men,Murder,Female,60+,4181,482,3699,4086,95
2001,Rural,Madhya Pradesh,Other Crimes,Corruption,Female,46-60,7786,5720,2066,7352,434
2009,Rural,Andhra Pradesh,Property Crime,Theft,Female,13-17,6740,2908,3832,5947,793
2003,Rural,Chhattisgarh,Property Crime,Theft,Female,18-30,4879,3661,1218,4551,328
2003,Urban,Himachal Pradesh,Crime Against Children,Trafficking,Female,0-12,7190,2129,5061,5636,1554
2007,Rural,Meghalaya,Crime Against Men,Assault,Female,18-30,4946,1072,3874,3457,1489
2003,Rural,Uttarakhand,Property Crime,Theft,Male,0-12,4693,1095,3598,3211,1482
2003,Rural,Haryana,Crime Against Children,Child Labor,Female,60+,9402,5103,4299,9339,63
2010,Rural,Nagaland,Crime Against Women,Dowry Deaths,Female,0-12,978,627,351,964,14
2005,Urban,Manipur,Crime Against Women,Rape,Female,0-12,6210,1726,4484,4442,1768
2004,Rural,Kerala,Other Crimes,Cyber Crime,Male,46-60,3546,653,2893,2448,1098
2010,Rural,Punjab,Crime Against Women,Domestic Violence,Male,46-60,4637,1560,3077,1685,2952
2001,Urban,Arunachal Pradesh,Crime Against Men,Extortion,Male,18-30,2590,28,2562,309,2281
2010,Urban,Goa,Other Crimes,Drug Offense,Female,13-17,8160,2811,5349,6765,1395
2010,Rural,Mizoram,Property Crime,Burglary,Female,31-45,1190,1062,128,1117,73
2009,Urban,Delhi,Property Crime,Arson,Male,18-30,7230,3256,3974,4116,3114
2006,Urban,Uttarakhand,Crime Against Women,Dowry Deaths,Female,13-17,1090,1080,10,1082,8
2001,Urban,Meghalaya,Other Crimes,Fraud,Female,46-60,192,118,74,183,9
2009,Rural,Rajasthan,Crime Against Children,Kidnapping,Male,18-30,8464,7183,1281,7810,654
2006,Rural,West Bengal,Other Crimes,Corruption,Female,18-30,1695,122,1573,1365,330
2005,Rural,Rajasthan,Property Crime,Arson,Female,0-12,9757,3789,5968,7486,2271
2009,Rural,Madhya Pradesh,Other Crimes,Fraud,Male,18-30,6686,4943,1743,6196,490
2005,Urban,Tamil Nadu,Other Crimes,Drug Offense,Male,18-30,1086,725,361,883,203
2005,Urban,Tripura,Crime Against Women,Domestic Violence,Male,46-60,2517,195,2322,1209,1308
2007,Urban,Meghalaya,Crime Against Women,Molestation,Female,0-12,9114,5180,3934,6334,2780
2006,Rural,Odisha,Crime Against Women,Molestation,Female,46-60,9236,1253,7983,2111,7125
2001,Rural,Sikkim,Other Crimes,Corruption,Female,46-60,55,30,25,32,23
2007,Rural,Assam,Crime Against Men,Robbery,Female,0-12,6475,1085,5390,4565,1910
2009,Urban,Meghalaya,Crime Against Children,Child Labor,Male,18-30,9008,6167,2841,7171,1837
2006,Urban,Mizoram,Property Crime,Burglary,Male,13-17,4788,2543,2245,3410,1378
2010,Urban,Uttar Pradesh,Crime Against Women,Rape,Male,0-12,4050,3232,818,3528,522
2010,Rural,Bihar,Other Crimes,Fraud,Female,13-17,8441,4978,3463,7437,1004
2005,Urban,Jharkhand,Crime Against Men,Robbery,Male,60+,2847,2597,250,2678,169
2010,Rural,Tamil Nadu,Property Crime,Arson,Male,18-30,5072,3194,1878,3578,1494
2005,Rural,Maharashtra,Other Crimes,Corruption,Female,0-12,3260,2421,839,2901,359
2003,Rural,Assam,Property Crime,Vandalism,Female,60+,9570,8360,1210,9429,141
2001,Rural,Delhi,Property Crime,Vandalism,Female,13-17,4432,2539,1893,2629,1803
2009,Rural,Maharashtra,Crime Against Women,Molestation,Male,60+,2163,1757,406,1796,367
2007,Urban,Gujarat,Property Crime,Burglary,Male,0-12,3635,1557,2078,2142,1493
2002,Rural,Chhattisgarh,Crime Against Women,Domestic Violence,Male,60+,6756,5622,1134,6270,486
2009,Rural,Kerala,Crime Against Men,Extortion,Male,46-60,8423,4219,4204,5800,2623
2009,Rural,Bihar,Other Crimes,Drug Offense,Male,0-12,3306,1494,1812,1868,1438
2001,Rural,Uttarakhand,Crime Against Women,Dowry Deaths,Female,18-30,2717,1465,1252,2614,103
2009,Urban,Maharashtra,Property Crime,Vandalism,Male,60+,2299,244,2055,2196,103
2005,Rural,Kerala,Crime Against Women,Domestic Violence,Female,13-17,7594,3411,4183,6165,1429
2009,Rural,Rajasthan,Property Crime,Vandalism,Female,18-30,3561,1542,2019,2797,764
2002,Rural,Mizoram,Crime Against Children,Child Abuse,Female,18-30,5161,2564,2597,3332,1829
2001,Rural,Punjab,Crime Against Women,Molestation,Male,0-12,5384,260,5124,3339,2045
2001,Urban,Karnataka,Crime Against Children,Child Abuse,Male,31-45,1549,118,1431,174,1375
2003,Rural,Delhi,Other Crimes,Corruption,Female,60+,4993,3207,1786,3943,1050
2009,Urban,West Bengal,Crime Against Women,Rape,Female,46-60,5502,2195,3307,3581,1921
2007,Rural,Chhattisgarh,Other Crimes,Cyber Crime,Male,13-17,4040,3954,86,3962,78
2001,Urban,Rajasthan,Crime Against Children,Child Labor,Female,13-17,4455,1441,3014,1579,2876
2001,Urban,Assam,Crime Against Men,Assault,Female,46-60,5432,1293,4139,5205,227
2006,Rural,Arunachal Pradesh,Crime Against Children,Child Labor,Female,60+,5812,3707,2105,5197,615
2009,Rural,Himachal Pradesh,Crime Against Women,Domestic Violence,Female,0-12,6059,5687,372,5931,128
2007,Rural,Manipur,Other Crimes,Drug Offense,Male,31-45,8485,5553,2932,7942,543
2002,Rural,Sikkim,Property Crime,Arson,Female,31-45,3338,1871,1467,3113,225
2006,Urban,Kerala,Crime Against Men,Robbery,Female,18-30,5998,1082,4916,1452,4546
2010,Urban,Uttarakhand,Crime Against Men,Assault,Male,13-17,1454,545,909,779,675
2007,Rural,Maharashtra,Property Crime,Vandalism,Female,13-17,7343,4766,2577,5291,2052
2009,Rural,Andhra Pradesh,Crime Against Women,Rape,Male,13-17,1424,397,1027,795,629
2010,Rural,Manipur,Property Crime,Vandalism,Male,13-17,8575,5808,2767,7310,1265
2006,Rural,Tripura,Crime Against Children,Kidnapping,Male,18-30,8779,3536,5243,6785,1994
2010,Urban,Bihar,Crime Against Women,Molestation,Female,13-17,3129,2018,1111,2505,624
2004,Urban,Mizoram,Property Crime,Vandalism,Female,60+,4187,3565,622,3657,530
2003,Rural,Kerala,Property Crime,Vandalism,Female,46-60,3692,582,3110,833,2859
2005,Rural,Assam,Crime Against Men,Murder,Female,60+,6455,6226,229,6270,185
2006,Urban,Goa,Property Crime,Burglary,Female,0-12,2444,2259,185,2333,111
2005,Urban,Goa,Crime Against Women,Domestic Violence,Female,60+,793,71,722,492,301
2002,Rural,Odisha,Crime Against Children,Child Labor,Female,60+,4659,1241,3418,1974,2685
2004,Rural,Manipur,Crime Against Men,Extortion,Male,46-60,631,452,179,476,155
2001,Rural,Andhra Pradesh,Crime Against Women,Domestic Violence,Female,60+,1967,1657,310,1952,15
2004,Urban,Arunachal Pradesh,Property Crime,Burglary,Male,31-45,2005,1228,777,1982,23
2003,Rural,Jammu & Kashmir,Crime Against Women,Molestation,Male,31-45,9860,8992,868,9714,146
2006,Urban,West Bengal,Crime Against Children,Kidnapping,Male,18-30,5268,4312,956,4884,384
2010,Rural,Maharashtra,Crime Against Men,Assault,Male,60+,1786,1068,718,1774,12
2006,Rural,Punjab,Property Crime,Vandalism,Female,0-12,2054,1162,892,1519,535
2001,Rural,Uttarakhand,Crime Against Women,Molestation,Female,18-30,9360,8855,505,9256,104
2001,Rural,Gujarat,Other Crimes,Corruption,Female,18-30,6443,3282,3161,3354,3089
2010,Rural,Uttar Pradesh,Property Crime,Vandalism,Male,60+,9520,9130,390,9205,315
2002,Rural,Tripura,Crime Against Children,Child Labor,Female,46-60,9596,8446,1150,9116,480
2003,Urban,Bihar,Property Crime,Theft,Male,46-60,391,346,45,388,3
2009,Urban,Meghalaya,Crime Against Children,Child Abuse,Female,60+,6542,60,6482,5279,1263
2007,Rural,Chhattisgarh,Crime Against Children,Trafficking,Female,0-12,9458,4753,4705,8455,1003
2005,Urban,Uttarakhand,Crime Against Women,Molestation,Male,31-45,2998,1983,1015,2338,660
2005,Rural,Himachal Pradesh,Property Crime,Arson,Female,18-30,5751,1347,4404,2719,3032
2005,Rural,Tripura,Crime Against Men,Murder,Female,0-12,1565,81,1484,866,699
2003,Rural,Mizoram,Other Crimes,Cyber Crime,Male,46-60,2458,480,1978,1220,1238
2002,Rural,Telangana,Property Crime,Theft,Female,18-30,4366,4224,142,4307,59
2007,Urban,Telangana,Crime Against Men,Robbery,Male,0-12,2427,1814,613,2112,315
2009,Rural,Uttarakhand,Crime Against Men,Murder,Male,31-45,6197,2775,3422,3712,2485
2006,Urban,Sikkim,Crime Against Men,Assault,Male,0-12,4874,4092,782,4379,495
2005,Urban,Uttar Pradesh,Crime Against Women,Domestic Violence,Female,60+,6731,5356,1375,6411,320
2003,Rural,Jammu & Kashmir,Crime Against Children,Child Abuse,Male,18-30,2364,2027,337,2162,202
2004,Urban,Nagaland,Property Crime,Burglary,Male,13-17,7391,4806,2585,5004,2387
2006,Urban,Uttarakhand,Property Crime,Vandalism,Female,31-45,4655,2314,2341,2841,1814
2003,Urban,Mizoram,Crime Against Women,Molestation,Male,0-12,7454,6791,663,6855,599
2002,Urban,Punjab,Property Crime,Arson,Male,31-45,5446,4210,1236,4495,951
2004,Rural,Tamil Nadu,Other Crimes,Cyber Crime,Male,46-60,2153,355,1798,1516,637
2001,Urban,Nagaland,Crime Against Children,Kidnapping,Female,60+,258,57,201,94,164
2008,Urban,Himachal Pradesh,Property Crime,Arson,Female,18-30,2467,871,1596,2413,54
2008,Rural,West Bengal,Crime Against Children,Child Labor,Female,13-17,5524,3084,2440,4171,1353
2008,Urban,West Bengal,Crime Against Men,Extortion,Male,13-17,97,96,1,97,0
2003,Urban,West Bengal,Property Crime,Theft,Male,60+,7621,2526,5095,5343,2278
2007,Urban,West Bengal,Other Crimes,Cyber Crime,Female,18-30,9360,9175,185,9300,60
2010,Rural,Odisha,Crime Against Men,Assault,Female,31-45,5112,4305,807,4467,645
2007,Urban,Chhattisgarh,Other Crimes,Drug Offense,Female,46-60,6176,5617,559,6032,144
2005,Urban,Uttarakhand,Crime Against Children,Kidnapping,Male,0-12,2521,476,2045,2091,430
2003,Urban,Delhi,Property Crime,Arson,Female,46-60,3953,2306,1647,3164,789
2005,Urban,Kerala,Other Crimes,Cyber Crime,Male,13-17,4219,589,3630,1070,3149
2004,Rural,Mizoram,Other Crimes,Cyber Crime,Female,46-60,2545,1316,1229,1931,614
2002,Rural,Jharkhand,Other Crimes,Drug Offense,Male,13-17,2794,2066,728,2600,194
2002,Rural,Meghalaya,Property Crime,Burglary,Female,13-17,3667,2458,1209,3359,308
2008,Rural,Uttar Pradesh,Crime Against Children,Kidnapping,Female,18-30,1691,408,1283,1147,544
2010,Rural,Chhattisgarh,Property Crime,Burglary,Female,0-12,8218,276,7942,5205,3013
2009,Rural,Kerala,Crime Against Women,Molestation,Male,18-30,5007,4225,782,4680,327
2004,Rural,Manipur,Property Crime,Vandalism,Female,18-30,5954,1741,4213,5469,485
2003,Rural,Uttarakhand,Property Crime,Vandalism,Female,46-60,6489,4126,2363,5442,1047
2003,Urban,Jharkhand,Property Crime,Arson,Male,18-30,242,208,34,220,22
2010,Rural,Jammu & Kashmir,Crime Against Men,Robbery,Female,13-17,8577,4377,4200,4845,3732
2003,Urban,Andhra Pradesh,Property Crime,Arson,Male,31-45,2041,1583,458,1660,381
2008,Rural,West Bengal,Crime Against Children,Trafficking,Male,13-17,8103,253,7850,7676,427
2005,Rural,Madhya Pradesh,Other Crimes,Corruption,Female,60+,4693,1685,3008,4646,47
2010,Rural,Madhya Pradesh,Crime Against Women,Rape,Female,13-17,6070,4003,2067,5080,990
2004,Urban,Jharkhand,Other Crimes,Corruption,Female,31-45,7449,5680,1769,7266,183
2004,Urban,Madhya Pradesh,Crime Against Women,Domestic Violence,Female,46-60,9542,4170,5372,7776,1766
2010,Rural,Gujarat,Crime Against Children,Child Labor,Female,46-60,3736,1500,2236,1585,2151
2010,Urban,Sikkim,Other Crimes,Cyber Crime,Female,31-45,3245,2809,436,3193,52
2008,Urban,Odisha,Crime Against Men,Murder,Female,46-60,6039,2863,3176,4817,1222
2006,Urban,Uttarakhand,Crime Against Women,Molestation,Male,18-30,2582,1278,1304,1835,747
2004,Urban,Tamil Nadu,Property Crime,Burglary,Male,18-30,1751,58,1693,956,795
2009,Rural,Assam,Property Crime,Arson,Female,60+,8649,8564,85,8611,38
2006,Rural,Tamil Nadu,Crime Against Women,Domestic Violence,Female,31-45,7924,6170,1754,6553,1371
2002,Rural,Gujarat,Crime Against Children,Kidnapping,Female,18-30,6946,6016,930,6535,411
2003,Urban,Mizoram,Other Crimes,Cyber Crime,Female,31-45,5567,4761,806,5060,507
2002,Urban,Tripura,Property Crime,Vandalism,Male,13-17,3013,201,2812,2588,425
2009,Rural,Madhya Pradesh,Crime Against Women,Molestation,Male,18-30,9487,8835,652,9366,121
2005,Urban,Chhattisgarh,Crime Against Men,Assault,Female,46-60,9219,3867,5352,4503,4716
2006,Rural,Manipur,Property Crime,Theft,Male,0-12,1913,1697,216,1775,138
2010,Rural,Chhattisgarh,Crime Against Men,Assault,Male,18-30,6629,303,6326,5127,1502
2007,Urban,Punjab,Other Crimes,Drug Offense,Male,46-60,165,36,129,108,57
2004,Rural,West Bengal,Property Crime,Arson,Female,60+,7056,640,6416,1494,5562
2009,Urban,Chhattisgarh,Crime Against Men,Murder,Male,46-60,798,265,533,469,329
2010,Rural,Tripura,Crime Against Men,Murder,Female,18-30,5684,4777,907,5424,260
2001,Rural,Rajasthan,Crime Against Women,Domestic Violence,Female,13-17,918,302,616,646,272
2003,Rural,Kerala,Crime Against Men,Extortion,Male,18-30,6518,519,5999,1847,4671
2007,Urban,Andhra Pradesh,Property Crime,Arson,Male,46-60,8273,5458,2815,5475,2798
2004,Urban,Gujarat,Property Crime,Vandalism,Male,18-30,2906,2600,306,2799,107
2004,Urban,Kerala,Crime Against Women,Rape,Female,46-60,4914,1661,3253,3816,1098
2009,Rural,Maharashtra,Property Crime,Vandalism,Male,18-30,5753,1203,4550,5039,714
2001,Urban,Sikkim,Crime Against Women,Molestation,Female,13-17,6655,1577,5078,2402,4253
2001,Urban,Assam,Crime Against Children,Kidnapping,Male,0-12,8076,2027,6049,6877,1199
2006,Urban,Bihar,Other Crimes,Corruption,Male,31-45,7917,67,7850,571,7346
2004,Urban,Odisha,Property Crime,Theft,Female,31-45,5428,4083,1345,4951,477
2001,Rural,Madhya Pradesh,Crime Against Children,Child Labor,Female,46-60,9002,2037,6965,5349,3653
2005,Urban,Maharashtra,Crime Against Women,Domestic Violence,Female,60+,7010,139,6871,3965,3045
2005,Rural,Odisha,Crime Against Women,Dowry Deaths,Male,60+,2091,572,1519,707,1384
2004,Rural,Uttarakhand,Crime Against Women,Dowry Deaths,Male,13-17,3412,2693,719,3029,383
2007,Urban,Maharashtra,Crime Against Men,Assault,Female,31-45,2582,2494,88,2530,52
2004,Urban,Mizoram,Crime Against Men,Assault,Female,0-12,4405,524,3881,1104,3301
2001,Rural,Nagaland,Other Crimes,Corruption,Male,46-60,2352,1307,1045,1655,697
2004,Urban,Jammu & Kashmir,Crime Against Men,Robbery,Male,13-17,1548,1487,61,1498,50
2003,Rural,Delhi,Property Crime,Burglary,Male,46-60,1670,1310,360,1585,85
2008,Urban,Punjab,Other Crimes,Corruption,Male,18-30,3389,2263,1126,2649,740
2002,Urban,Telangana,Crime Against Men,Assault,Male,60+,3135,358,2777,748,2387
2002,Rural,Tamil Nadu,Other Crimes,Cyber Crime,Female,46-60,7779,2802,4977,4675,3104
2003,Rural,Chhattisgarh,Property Crime,Arson,Male,31-45,5897,684,5213,2495,3402
2005,Rural,Jammu & Kashmir,Other Crimes,Fraud,Female,60+,3159,1560,1599,2778,381
2008,Rural,Uttarakhand,Other Crimes,Cyber Crime,Male,13-17,7569,5880,1689,6886,683
2009,Rural,Kerala,Crime Against Men,Extortion,Male,13-17,819,351,468,476,343
2008,Urban,Andhra Pradesh,Crime Against Women,Dowry Deaths,Male,13-17,2421,772,1649,2293,128
2002,Rural,Telangana,Crime Against Men,Murder,Male,60+,5662,3987,1675,4442,1220
2005,Urban,Uttar Pradesh,Crime Against Women,Rape,Female,0-12,5560,4020,1540,5341,219
2002,Urban,West Bengal,Crime Against Women,Molestation,Female,31-45,5607,5163,444,5396,211
2004,Rural,Telangana,Other Crimes,Cyber Crime,Female,18-30,7044,938,6106,6073,971
2010,Urban,Punjab,Crime Against Children,Kidnapping,Male,18-30,3811,1955,1856,3238,573
2001,Rural,Jammu & Kashmir,Property Crime,Theft,Female,31-45,1285,877,408,1070,215
2006,Urban,Jharkhand,Property Crime,Burglary,Female,31-45,1882,1193,689,1233,649
2003,Rural,Goa,Crime Against Women,Rape,Female,46-60,6981,2706,4275,4444,2537
2001,Urban,Uttar Pradesh,Crime Against Men,Extortion,Male,60+,9882,5121,4761,7861,2021
2003,Rural,Kerala,Crime Against Women,Domestic Violence,Female,60+,6823,2924,3899,3818,3005
2007,Rural,Maharashtra,Crime Against Children,Child Labor,Female,31-45,4736,693,4043,2102,2634
2007,Urban,Arunachal Pradesh,Crime Against Children,Child Labor,Male,60+,4225,588,3637,1916,2309
2003,Urban,Manipur,Crime Against Men,Murder,Male,18-30,9534,6420,3114,9437,97
2004,Rural,Jharkhand,Other Crimes,Fraud,Male,31-45,4909,2558,2351,4794,115
2007,Urban,Tripura,Property Crime,Vandalism,Male,60+,260,51,209,204,56
2007,Rural,Jharkhand,Other Crimes,Drug Offense,Male,18-30,7237,4507,2730,5397,1840
2002,Rural,Haryana,Crime Against Men,Extortion,Female,0-12,9304,3733,5571,7628,1676
2007,Rural,Bihar,Crime Against Men,Murder,Female,18-30,7689,4439,3250,5977,1712
2008,Rural,Telangana,Other Crimes,Drug Offense,Female,60+,8924,5945,2979,8324,600
2007,Urban,Tamil Nadu,Property Crime,Arson,Female,0-12,4565,2285,2280,3610,955
2009,Rural,Telangana,Property Crime,Theft,Male,18-30,9590,91,9499,1878,7712
2006,Urban,Himachal Pradesh,Property Crime,Theft,Male,46-60,4788,3990,798,4217,571
2009,Urban,Punjab,Other Crimes,Cyber Crime,Male,18-30,9003,1894,7109,2442,6561
2008,Urban,Tripura,Crime Against Children,Trafficking,Female,60+,6976,4127,2849,6704,272
2001,Urban,Goa,Property Crime,Arson,Male,60+,1463,1185,278,1339,124
2004,Urban,Karnataka,Other Crimes,Corruption,Male,13-17,9707,6481,3226,9217,490
2009,Urban,Uttarakhand,Crime Against Women,Dowry Deaths,Male,0-12,9749,5566,4183,7826,1923
2001,Urban,Meghalaya,Property Crime,Arson,Female,31-45,3276,2074,1202,2488,788
2002,Urban,West Bengal,Crime Against Men,Assault,Male,0-12,9434,4577,4857,5370,4064
2002,Rural,Goa,Property Crime,Arson,Male,60+,8815,5680,3135,7960,855
2003,Urban,Delhi,Property Crime,Theft,Male,13-17,6738,3304,3434,6042,696
2009,Rural,Mizoram,Crime Against Men,Robbery,Female,13-17,7359,1438,5921,7006,353
2004,Urban,Rajasthan,Crime Against Women,Rape,Male,13-17,9301,906,8395,3866,5435
2008,Urban,Telangana,Crime Against Men,Assault,Male,31-45,5456,2621,2835,3007,2449
2006,Urban,Uttar Pradesh,Crime Against Women,Domestic Violence,Female,60+,9546,5215,4331,5783,3763
2007,Urban,Jammu & Kashmir,Crime Against Men,Robbery,Female,46-60,6991,1368,5623,4185,2806
2008,Urban,Punjab,Crime Against Children,Child Labor,Male,18-30,1227,848,379,1049,178
2001,Urban,Maharashtra,Property Crime,Vandalism,Male,60+,8843,3145,5698,5133,3710
2006,Rural,Andhra Pradesh,Crime Against Children,Child Labor,Male,46-60,8716,1200,7516,4898,3818
2008,Urban,Mizoram,Property Crime,Vandalism,Female,31-45,1691,487,1204,1282,409
2002,Urban,Goa,Other Crimes,Fraud,Female,18-30,9521,1517,8004,5358,4163
2006,Rural,Tripura,Crime Against Men,Extortion,Female,0-12,1565,1162,403,1268,297
2010,Rural,Odisha,Property Crime,Vandalism,Female,60+,7170,5659,1511,6759,411
2008,Urban,Assam,Property Crime,Theft,Male,18-30,3341,2725,616,2983,358
2001,Urban,Sikkim,Other Crimes,Cyber Crime,Male,13-17,424,392,32,406,18
2004,Urban,Goa,Crime Against Children,Child Labor,Female,60+,9381,918,8463,2881,6500
2005,Urban,Telangana,Crime Against Women,Domestic Violence,Female,13-17,5920,370,5550,3860,2060
2004,Rural,West Bengal,Property Crime,Burglary,Male,46-60,7446,6751,695,7004,442
2009,Rural,Rajasthan,Crime Against Children,Child Abuse,Female,18-30,1504,491,1013,721,783
2007,Urban,Rajasthan,Crime Against Women,Rape,Female,0-12,1009,480,529,561,448
2005,Urban,Himachal Pradesh,Other Crimes,Drug Offense,Female,46-60,5409,459,4950,1509,3900
2008,Rural,Bihar,Crime Against Women,Rape,Male,0-12,996,673,323,760,236
2010,Urban,Rajasthan,Property Crime,Vandalism,Female,0-12,2501,868,1633,1609,892
2010,Rural,Sikkim,Crime Against Women,Dowry Deaths,Male,31-45,8717,5051,3666,5477,3240
2003,Rural,Andhra Pradesh,Other Crimes,Cyber Crime,Female,46-60,7771,4766,3005,6358,1413
2009,Rural,Madhya Pradesh,Crime Against Children,Child Labor,Female,46-60,2651,691,1960,1233,1418
2010,Rural,Arunachal Pradesh,Property Crime,Arson,Female,13-17,6198,1201,4997,4129,2069
2005,Rural,Manipur,Crime Against Men,Assault,Female,60+,9066,8788,278,8900,166
2007,Rural,Tripura,Property Crime,Vandalism,Female,31-45,2422,1551,871,1872,550
2009,Rural,Mizoram,Crime Against Men,Extortion,Male,60+,8231,172,8059,8069,162
2003,Rural,Rajasthan,Crime Against Women,Dowry Deaths,Male,31-45,6409,447,5962,2502,3907
2010,Urban,Telangana,Other Crimes,Drug Offense,Male,0-12,5220,3412,1808,3419,1801
2008,Rural,Mizoram,Crime Against Men,Assault,Male,18-30,5361,3645,1716,3873,1488
2003,Rural,Sikkim,Crime Against Children,Child Abuse,Female,46-60,5531,5014,517,5058,473
2003,Rural,Goa,Crime Against Women,Rape,Female,31-45,438,374,64,417,21
2001,Urban,Punjab,Property Crime,Theft,Male,46-60,3082,1182,1900,2880,202
2003,Urban,Telangana,Crime Against Women,Dowry Deaths,Female,46-60,5634,1252,4382,4920,714
2001,Rural,Jammu & Kashmir,Crime Against Children,Kidnapping,Female,18-30,2600,835,1765,2361,239
2003,Urban,Delhi,Crime Against Children,Kidnapping,Male,46-60,2806,1619,1187,2655,151
2007,Urban,Odisha,Crime Against Women,Domestic Violence,Female,60+,7553,6374,1179,7526,27
2005,Rural,Kerala,Other Crimes,Fraud,Female,46-60,559,464,95,478,81
2006,Urban,Uttarakhand,Property Crime,Theft,Female,60+,7814,4697,3117,5929,1885
2003,Rural,Tamil Nadu,Property Crime,Burglary,Female,31-45,9660,9634,26,9659,1
2003,Rural,Andhra Pradesh,Other Crimes,Corruption,Female,13-17,3947,2052,1895,2258,1689
2006,Urban,Sikkim,Crime Against Children,Kidnapping,Male,18-30,79,13,66,65,14
2009,Urban,West Bengal,Other Crimes,Corruption,Male,18-30,8901,5057,3844,7367,1534
2003,Urban,Kerala,Crime Against Men,Assault,Female,60+,4335,688,3647,4312,23
2009,Urban,Maharashtra,Crime Against Men,Extortion,Male,0-12,6754,5973,781,6248,506
2002,Urban,Andhra Pradesh,Crime Against Children,Kidnapping,Female,31-45,3403,2051,1352,2935,468
2006,Urban,Meghalaya,Other Crimes,Fraud,Male,60+,5299,4703,596,4971,328
2006,Rural,Uttarakhand,Other Crimes,Cyber Crime,Male,18-30,8585,8266,319,8298,287
2010,Urban,Maharashtra,Property Crime,Vandalism,Female,46-60,415,320,95,409,6
2001,Rural,Kerala,Crime Against Men,Robbery,Male,60+,1216,730,486,1202,14
2007,Rural,Goa,Crime Against Men,Extortion,Female,13-17,8886,813,8073,6553,2333
2010,Rural,Uttarakhand,Crime Against Children,Trafficking,Male,18-30,7522,1203,6319,7490,32
2010,Urban,West Bengal,Crime Against Children,Trafficking,Male,31-45,7969,1719,6250,4582,3387
2002,Urban,Nagaland,Property Crime,Vandalism,Male,31-45,2687,806,1881,932,1755
2009,Rural,Mizoram,Property Crime,Burglary,Male,0-12,3602,479,3123,1247,2355
2003,Urban,Odisha,Other Crimes,Fraud,Female,0-12,8570,3428,5142,4688,3882
2010,Rural,West Bengal,Crime Against Children,Child Abuse,Male,46-60,3825,427,3398,1598,2227
2004,Urban,Andhra Pradesh,Crime Against Women,Molestation,Female,46-60,6897,4929,1968,6559,338
2007,Rural,Punjab,Property Crime,Burglary,Female,60+,3162,2826,336,2902,260
2008,Urban,Uttarakhand,Crime Against Men,Assault,Female,46-60,4510,446,4064,1234,3276
2010,Rural,Jharkhand,Property Crime,Arson,Male,60+,1037,994,43,1004,33
2001,Rural,Andhra Pradesh,Other Crimes,Cyber Crime,Female,46-60,3415,1094,2321,2235,1180
2003,Rural,Rajasthan,Other Crimes,Corruption,Female,18-30,3763,548,3215,3505,258
2010,Rural,Goa,Property Crime,Vandalism,Male,60+,4482,276,4206,1240,3242
2005,Urban,Meghalaya,Other Crimes,Fraud,Female,31-45,5627,4622,1005,5190,437
2006,Rural,Maharashtra,Property Crime,Arson,Male,18-30,1627,995,632,1023,604
2006,Urban,Bihar,Property Crime,Burglary,Male,46-60,87,42,45,51,36
2001,Rural,Haryana,Crime Against Men,Robbery,Male,13-17,3795,2493,1302,2908,887
2005,Rural,Meghalaya,Crime Against Men,Robbery,Female,60+,3644,516,3128,3123,521
2004,Rural,Tamil Nadu,Property Crime,Burglary,Female,13-17,9136,1041,8095,2286,6850
2006,Rural,Arunachal Pradesh,Crime Against Children,Child Abuse,Female,13-17,4617,69,4548,3773,844
2010,Urban,Uttarakhand,Property Crime,Arson,Female,46-60,9309,5406,3903,5633,3676
2008,Urban,Tamil Nadu,Other Crimes,Corruption,Male,0-12,9622,6243,3379,7425,2197
2002,Urban,Goa,Crime Against Men,Extortion,Male,13-17,2250,2134,116,2247,3
2008,Rural,Chhattisgarh,Crime Against Children,Trafficking,Female,13-17,4891,1272,3619,1400,3491
2006,Rural,Telangana,Property Crime,Burglary,Female,0-12,397,5,392,320,77
2003,Urban,Rajasthan,Crime Against Men,Assault,Male,31-45,267,181,86,222,45
2004,Urban,Arunachal Pradesh,Crime Against Children,Child Labor,Female,0-12,916,657,259,698,218
2005,Rural,Himachal Pradesh,Crime Against Women,Dowry Deaths,Female,18-30,8626,5188,3438,6424,2202
2008,Urban,Nagaland,Crime Against Men,Extortion,Female,18-30,7324,5969,1355,6498,826
2007,Rural,Telangana,Property Crime,Burglary,Female,46-60,1031,805,226,934,97
2004,Rural,Bihar,Other Crimes,Drug Offense,Male,13-17,7432,6683,749,7303,129
2010,Rural,Jharkhand,Crime Against Men,Assault,Female,18-30,1830,1604,226,1717,113
2002,Rural,Punjab,Other Crimes,Fraud,Female,60+,7023,4737,2286,5224,1799
2010,Urban,Meghalaya,Crime Against Women,Rape,Male,46-60,5179,1091,4088,4560,619
2008,Urban,Jharkhand,Other Crimes,Cyber Crime,Male,31-45,6976,3099,3877,4386,2590
2003,Urban,Sikkim,Other Crimes,Corruption,Female,31-45,5226,2720,2506,4448,778
2006,Urban,Chhattisgarh,Property Crime,Burglary,Female,46-60,4727,2098,2629,2968,1759
2003,Rural,Arunachal Pradesh,Property Crime,Vandalism,Female,0-12,215,166,49,180,35
2004,Rural,Chhattisgarh,Other Crimes,Corruption,Male,46-60,485,324,161,354,131
2004,Rural,Uttar Pradesh,Crime Against Women,Rape,Male,13-17,8251,3799,4452,4316,3935
2006,Urban,Karnataka,Property Crime,Vandalism,Male,31-45,3476,1794,1682,2004,1472
2002,Urban,Maharashtra,Crime Against Women,Rape,Female,13-17,8752,6628,2124,7505,1247
2004,Urban,Nagaland,Crime Against Women,Dowry Deaths,Male,46-60,7392,4685,2707,6199,1193
2004,Urban,Kerala,Property Crime,Vandalism,Female,0-12,2932,2412,520,2665,267
2008,Urban,Himachal Pradesh,Other Crimes,Fraud,Male,31-45,2481,2267,214,2372,109
2008,Urban,Sikkim,Crime Against Women,Dowry Deaths,Male,60+,2591,655,1936,1204,1387
2004,Urban,Nagaland,Crime Against Men,Extortion,Female,18-30,3789,1339,2450,3098,691
2009,Urban,Nagaland,Crime Against Women,Dowry Deaths,Female,18-30,8113,2001,6112,3192,4921
2010,Urban,Chhattisgarh,Crime Against Men,Robbery,Female,31-45,2680,1379,1301,1847,833
2002,Rural,Maharashtra,Crime Against Children,Kidnapping,Female,60+,3836,3581,255,3624,212
2001,Urban,Bihar,Property Crime,Burglary,Female,18-30,4968,1141,3827,4958,10
2006,Rural,West Bengal,Other Crimes,Fraud,Male,46-60,3996,344,3652,2909,1087
2010,Rural,Meghalaya,Property Crime,Burglary,Female,46-60,4348,2172,2176,4091,257
2009,Urban,West Bengal,Crime Against Women,Domestic Violence,Male,31-45,7120,157,6963,5163,1957
2007,Urban,Assam,Other Crimes,Corruption,Female,18-30,3903,2694,1209,3233,670
2008,Rural,Maharashtra,Crime Against Men,Extortion,Female,13-17,3463,347,3116,503,2960
2007,Rural,Goa,Other Crimes,Fraud,Female,60+,9981,7240,2741,9929,52
2009,Urban,Himachal Pradesh,Property Crime,Burglary,Male,18-30,9884,2368,7516,8025,1859
2005,Urban,Tripura,Crime Against Children,Child Labor,Female,46-60,4119,3954,165,4106,13
2007,Rural,Telangana,Property Crime,Theft,Male,18-30,8028,655,7373,7731,297
2005,Urban,Meghalaya,Crime Against Women,Domestic Violence,Female,13-17,2036,1973,63,2023,13
2008,Urban,Bihar,Crime Against Men,Robbery,Male,60+,5131,3669,1462,3859,1272
2007,Rural,Himachal Pradesh,Other Crimes,Cyber Crime,Female,31-45,3369,3199,170,3207,162
2006,Rural,Tamil Nadu,Crime Against Women,Rape,Female,60+,4481,102,4379,3193,1288
2010,Urban,West Bengal,Crime Against Children,Trafficking,Female,31-45,7982,1613,6369,6221,1761
2008,Urban,Rajasthan,Other Crimes,Fraud,Female,18-30,4987,141,4846,4599,388
2009,Urban,Haryana,Other Crimes,Cyber Crime,Female,60+,4961,4918,43,4960,1
2008,Rural,Andhra Pradesh,Other Crimes,Drug Offense,Female,31-45,4404,128,4276,3442,962
2001,Urban,West Bengal,Crime Against Children,Trafficking,Male,18-30,9413,4447,4966,5976,3437
2009,Rural,Maharashtra,Crime Against Children,Trafficking,Male,0-12,1537,897,640,913,624
2010,Urban,Sikkim,Crime Against Men,Assault,Female,60+,8819,684,8135,1205,7614
2010,Urban,Uttar Pradesh,Property Crime,Theft,Female,0-12,6180,3551,2629,4823,1357
2004,Rural,Jharkhand,Other Crimes,Corruption,Male,46-60,6354,303,6051,1867,4487
2005,Urban,Chhattisgarh,Other Crimes,Cyber Crime,Male,60+,8941,2091,6850,2242,6699
2010,Urban,Manipur,Other Crimes,Cyber Crime,Female,18-30,9042,4902,4140,8568,474
2005,Rural,Arunachal Pradesh,Property Crime,Vandalism,Female,60+,9405,7012,2393,8776,629
2003,Urban,Uttar Pradesh,Property Crime,Theft,Female,0-12,235,45,190,161,74
2001,Rural,Telangana,Crime Against Children,Child Abuse,Female,13-17,2909,249,2660,1056,1853
2001,Urban,Andhra Pradesh,Crime Against Women,Rape,Female,0-12,4287,2513,1774,4012,275
2004,Urban,Sikkim,Crime Against Children,Child Abuse,Male,13-17,291,175,116,239,52
2001,Urban,Andhra Pradesh,Crime Against Men,Murder,Female,46-60,3972,582,3390,1658,2314
2004,Urban,Arunachal Pradesh,Crime Against Men,Murder,Female,18-30,6327,2625,3702,4690,1637
2006,Rural,Gujarat,Crime Against Men,Assault,Female,0-12,228,27,201,71,157
2002,Rural,Goa,Crime Against Children,Child Abuse,Male,13-17,3700,3401,299,3430,270
2010,Rural,Kerala,Property Crime,Burglary,Female,46-60,8184,71,8113,6988,1196
2007,Urban,Uttarakhand,Crime Against Men,Assault,Male,0-12,456,376,80,416,40
2001,Rural,Odisha,Crime Against Children,Child Abuse,Female,46-60,4307,3441,866,4099,208
2010,Rural,Goa,Crime Against Men,Murder,Male,0-12,9932,604,9328,7173,2759
2006,Urban,Chhattisgarh,Crime Against Men,Assault,Male,13-17,3432,1874,1558,2388,1044
2005,Rural,Jharkhand,Crime Against Children,Child Abuse,Female,18-30,1131,438,693,706,425
2003,Urban,Tripura,Crime Against Women,Rape,Female,31-45,186,54,132,118,68
2009,Rural,Kerala,Other Crimes,Fraud,Female,0-12,9963,1507,8456,2348,7615
2006,Rural,Meghalaya,Crime Against Men,Assault,Female,31-45,7371,5873,1498,7288,83
2008,Urban,Himachal Pradesh,Crime Against Women,Dowry Deaths,Male,18-30,3194,2846,348,3096,98
2008,Urban,Assam,Crime Against Children,Trafficking,Male,0-12,71,28,43,62,9
2003,Rural,Odisha,Crime Against Children,Kidnapping,Female,46-60,4184,2876,1308,3842,342
2010,Rural,Jammu & Kashmir,Property Crime,Arson,Female,0-12,3777,1802,1975,2199,1578
2005,Urban,Meghalaya,Other Crimes,Corruption,Male,0-12,1921,780,1141,1029,892
2005,Urban,Rajasthan,Crime Against Children,Child Abuse,Female,13-17,1372,875,497,1143,229
2010,Urban,Gujarat,Property Crime,Burglary,Female,0-12,2306,1563,743,1645,661
2005,Urban,Madhya Pradesh,Crime Against Children,Child Labor,Female,18-30,7441,2057,5384,3200,4241
2010,Rural,Manipur,Crime Against Children,Child Abuse,Female,0-12,8972,1554,7418,6596,2376
2010,Urban,Mizoram,Crime Against Men,Extortion,Male,31-45,8235,1392,6843,3721,4514
2001,Rural,Bihar,Crime Against Children,Child Abuse,Male,13-17,8640,5696,2944,5785,2855
2001,Urban,Goa,Crime Against Men,Extortion,Female,60+,2900,1303,1597,2702,198
2001,Urban,Uttar Pradesh,Crime Against Men,Extortion,Male,31-45,7654,1791,5863,1906,5748
2005,Rural,Delhi,Other Crimes,Corruption,Female,13-17,4058,1219,2839,3149,909
2010,Rural,Chhattisgarh,Crime Against Children,Child Labor,Female,60+,7121,6430,691,6573,548
2009,Rural,Arunachal Pradesh,Property Crime,Theft,Male,13-17,7305,2131,5174,5210,2095
2003,Urban,Goa,Crime Against Men,Robbery,Female,0-12,2754,2205,549,2365,389
2002,Urban,Goa,Other Crimes,Cyber Crime,Female,31-45,7036,3125,3911,5732,1304
2001,Urban,Meghalaya,Other Crimes,Corruption,Male,31-45,4702,76,4626,1953,2749
2007,Rural,Telangana,Other Crimes,Drug Offense,Female,60+,8472,37,8435,156,8316
2005,Rural,Mizoram,Crime Against Children,Kidnapping,Female,31-45,7228,6754,474,7171,57
2005,Rural,Odisha,Crime Against Men,Extortion,Female,31-45,4059,2135,1924,3567,492
2004,Urban,Delhi,Other Crimes,Cyber Crime,Female,60+,6463,5314,1149,5371,1092
2004,Urban,Haryana,Property Crime,Vandalism,Male,31-45,7524,453,7071,1980,5544
2009,Rural,Uttarakhand,Property Crime,Burglary,Male,31-45,7667,1664,6003,5027,2640
2005,Urban,Bihar,Property Crime,Burglary,Female,13-17,9574,9035,539,9475,99
2002,Urban,Manipur,Property Crime,Vandalism,Male,60+,9039,2855,6184,5329,3710
2007,Urban,Punjab,Other Crimes,Fraud,Male,13-17,6781,3278,3503,3697,3084
2001,Rural,Arunachal Pradesh,Crime Against Men,Extortion,Male,60+,8666,3014,5652,7715,951
2008,Urban,Himachal Pradesh,Crime Against Children,Child Labor,Female,0-12,8204,2156,6048,2976,5228
2007,Urban,Bihar,Other Crimes,Cyber Crime,Female,13-17,5726,136,5590,1163,4563
2007,Urban,Tripura,Other Crimes,Corruption,Male,31-45,6349,2139,4210,4153,2196
2003,Rural,Jharkhand,Property Crime,Arson,Female,46-60,8198,7241,957,7445,753
2007,Rural,Uttarakhand,Crime Against Men,Robbery,Female,18-30,2710,464,2246,2650,60
2003,Rural,Assam,Other Crimes,Fraud,Female,60+,542,358,184,506,36
2010,Rural,West Bengal,Other Crimes,Drug Offense,Female,0-12,1287,424,863,709,578
2005,Urban,Uttar Pradesh,Crime Against Children,Child Abuse,Female,18-30,6295,1419,4876,4479,1816
2004,Urban,Telangana,Property Crime,Vandalism,Female,13-17,5741,589,5152,1271,4470
2008,Urban,Madhya Pradesh,Other Crimes,Cyber Crime,Male,0-12,4503,362,4141,3736,767
2006,Rural,Jammu & Kashmir,Crime Against Children,Trafficking,Female,0-12,1788,959,829,1407,381
2002,Urban,Nagaland,Property Crime,Arson,Female,46-60,3006,667,2339,1996,1010
2007,Urban,Himachal Pradesh,Property Crime,Theft,Female,31-45,3654,3555,99,3571,83
2004,Urban,Punjab,Crime Against Women,Molestation,Female,18-30,1507,1505,2,1506,1
2003,Urban,Jharkhand,Property Crime,Vandalism,Female,0-12,9066,4506,4560,7346,1720
2009,Rural,Andhra Pradesh,Crime Against Women,Domestic Violence,Male,0-12,7829,3507,4322,5161,2668
2010,Rural,Tripura,Other Crimes,Fraud,Male,18-30,1397,941,456,955,442
2008,Rural,Himachal Pradesh,Property Crime,Burglary,Female,18-30,7983,5923,2060,5964,2019
2006,Rural,Gujarat,Property Crime,Theft,Male,13-17,3445,2283,1162,2519,926
2007,Urban,Bihar,Other Crimes,Fraud,Female,13-17,4498,2892,1606,3683,815
2008,Urban,Sikkim,Crime Against Men,Robbery,Female,31-45,7356,4399,2957,6533,823
2009,Urban,Chhattisgarh,Crime Against Men,Extortion,Female,0-12,8481,637,7844,7036,1445
2006,Urban,Odisha,Crime Against Men,Robbery,Female,60+,8817,1255,7562,1350,7467
2009,Rural,Manipur,Crime Against Men,Robbery,Male,13-17,8082,2296,5786,5577,2505
2009,Rural,Jharkhand,Property Crime,Burglary,Male,13-17,3046,2613,433,2879,167
2002,Urban,Assam,Crime Against Women,Molestation,Female,0-12,4484,1751,2733,3620,864
2002,Rural,Maharashtra,Crime Against Men,Extortion,Male,31-45,1754,354,1400,689,1065
2003,Rural,Jammu & Kashmir,Other Crimes,Cyber Crime,Female,31-45,4343,3943,400,4131,212
2002,Rural,Chhattisgarh,Crime Against Children,Kidnapping,Male,46-60,3233,155,3078,2115,1118
2009,Rural,Arunachal Pradesh,Property Crime,Theft,Female,13-17,1745,1031,714,1052,693
2005,Rural,Mizoram,Crime Against Children,Child Abuse,Female,31-45,8895,289,8606,5317,3578
2005,Urban,Jammu & Kashmir,Property Crime,Arson,Female,46-60,2803,2289,514,2499,304
2009,Urban,Meghalaya,Crime Against Women,Dowry Deaths,Male,13-17,3745,1036,2709,2696,1049
2007,Rural,Haryana,Crime Against Men,Robbery,Female,31-45,3569,1338,2231,3217,352
2003,Urban,Uttarakhand,Crime Against Children,Kidnapping,Female,18-30,5855,2035,3820,4963,892
2001,Rural,Chhattisgarh,Property Crime,Burglary,Female,0-12,6125,3286,2839,5879,246
2009,Rural,Uttar Pradesh,Crime Against Children,Child Labor,Female,31-45,2293,1048,1245,2196,97
2002,Urban,Haryana,Other Crimes,Fraud,Female,0-12,7173,4047,3126,4491,2682
2008,Urban,Karnataka,Property Crime,Vandalism,Female,0-12,5693,1737,3956,2512,3181
2009,Urban,Karnataka,Crime Against Women,Molestation,Male,18-30,3952,2321,1631,3024,928
2010,Rural,Karnataka,Crime Against Children,Child Labor,Male,0-12,3359,3121,238,3334,25
2003,Urban,Jharkhand,Crime Against Women,Dowry Deaths,Male,46-60,4763,1195,3568,4582,181
2002,Urban,Sikkim,Crime Against Men,Assault,Male,18-30,3353,158,3195,909,2444
2006,Urban,Manipur,Crime Against Women,Domestic Violence,Female,0-12,2836,52,2784,1102,1734
2009,Rural,Punjab,Property Crime,Burglary,Female,31-45,9587,2204,7383,6308,3279
2001,Urban,Haryana,Crime Against Children,Child Labor,Female,60+,784,752,32,768,16
2004,Rural,Odisha,Crime Against Women,Molestation,Male,0-12,3177,1432,1745,3141,36
2008,Urban,Bihar,Other Crimes,Fraud,Male,0-12,4111,368,3743,4053,58
2004,Urban,Nagaland,Crime Against Women,Dowry Deaths,Female,31-45,3832,2043,1789,3328,504
2009,Rural,Assam,Property Crime,Arson,Male,31-45,8201,2167,6034,4753,3448
2002,Urban,Madhya Pradesh,Other Crimes,Fraud,Female,31-45,9226,8051,1175,9043,183
2009,Urban,Sikkim,Crime Against Men,Murder,Female,46-60,4522,3023,1499,3458,1064
2003,Urban,Mizoram,Crime Against Children,Child Labor,Male,46-60,1472,1140,332,1304,168
2001,Urban,Arunachal Pradesh,Crime Against Men,Extortion,Male,60+,4884,190,4694,266,4618
2007,Urban,Telangana,Property Crime,Burglary,Male,13-17,9680,5128,4552,9185,495
2003,Urban,Manipur,Crime Against Men,Extortion,Female,18-30,3656,2236,1420,3003,653
2003,Urban,Punjab,Crime Against Children,Trafficking,Male,46-60,9064,6211,2853,8543,521
2008,Rural,Jharkhand,Crime Against Women,Domestic Violence,Male,60+,1590,132,1458,1194,396
2009,Rural,Rajasthan,Crime Against Men,Extortion,Male,13-17,7702,2736,4966,3391,4311
2004,Urban,Uttarakhand,Property Crime,Burglary,Female,13-17,4130,1410,2720,3883,247
2002,Rural,Tripura,Crime Against Children,Kidnapping,Male,46-60,4691,477,4214,2288,2403
2006,Urban,Gujarat,Crime Against Children,Trafficking,Male,60+,4805,1509,3296,4691,114
2002,Rural,Arunachal Pradesh,Crime Against Men,Assault,Male,0-12,9876,5257,4619,6508,3368
2002,Rural,Mizoram,Crime Against Women,Molestation,Female,60+,9943,7268,2675,8987,956
2001,Urban,Uttar Pradesh,Property Crime,Burglary,Female,31-45,2645,722,1923,1744,901
2002,Rural,Jharkhand,Crime Against Children,Child Labor,Female,60+,5178,2888,2290,3473,1705
2004,Rural,Assam,Property Crime,Vandalism,Male,18-30,5491,3605,1886,4298,1193
2006,Rural,West Bengal,Other Crimes,Corruption,Male,0-12,9857,2680,7177,9674,183
2010,Rural,Assam,Crime Against Children,Child Abuse,Female,13-17,5525,527,4998,3107,2418
2005,Rural,Jammu & Kashmir,Crime Against Children,Trafficking,Female,13-17,8791,5814,2977,8563,228
2002,Rural,Mizoram,Crime Against Women,Dowry Deaths,Male,18-30,6641,3511,3130,5749,892
2003,Urban,Chhattisgarh,Crime Against Women,Molestation,Female,46-60,6401,722,5679,5131,1270
2003,Urban,Andhra Pradesh,Property Crime,Burglary,Female,60+,4419,791,3628,4293,126
2002,Rural,Assam,Crime Against Men,Robbery,Male,18-30,4645,4346,299,4401,244
2009,Rural,Tripura,Crime Against Men,Robbery,Female,18-30,3328,1246,2082,2834,494
2008,Rural,Jammu & Kashmir,Crime Against Women,Domestic Violence,Female,13-17,2994,2765,229,2981,13
2006,Rural,Goa,Other Crimes,Cyber Crime,Male,0-12,7229,2385,4844,6594,635
2001,Rural,Kerala,Other Crimes,Fraud,Female,31-45,3509,2746,763,3442,67
2006,Urban,Bihar,Crime Against Women,Rape,Male,0-12,735,699,36,716,19
2009,Rural,Punjab,Property Crime,Vandalism,Female,31-45,9504,6612,2892,9185,319
2005,Rural,Tamil Nadu,Property Crime,Burglary,Female,60+,6010,412,5598,4033,1977
2010,Urban,Mizoram,Crime Against Women,Dowry Deaths,Male,31-45,6349,776,5573,6173,176
2002,Urban,Jammu & Kashmir,Property Crime,Burglary,Male,46-60,3022,1007,2015,2431,591
2003,Rural,Rajasthan,Property Crime,Vandalism,Female,46-60,1488,454,1034,471,1017
2004,Urban,Himachal Pradesh,Crime Against Women,Domestic Violence,Female,13-17,3226,582,2644,2061,1165
2009,Urban,Himachal Pradesh,Crime Against Children,Kidnapping,Male,18-30,3230,2611,619,3078,152
2002,Rural,Karnataka,Property Crime,Arson,Female,60+,7066,2913,4153,5214,1852
2001,Rural,Gujarat,Other Crimes,Corruption,Male,60+,7096,6739,357,6871,225
2002,Urban,Nagaland,Other Crimes,Fraud,Male,0-12,4044,356,3688,3134,910
2006,Rural,Jammu & Kashmir,Property Crime,Vandalism,Male,31-45,4043,895,3148,3830,213
2006,Urban,Manipur,Property Crime,Burglary,Male,60+,218,51,167,114,104
2005,Rural,Tamil Nadu,Crime Against Women,Molestation,Female,46-60,7043,3593,3450,4200,2843
2004,Rural,Mizoram,Property Crime,Theft,Female,18-30,4877,1109,3768,2602,2275
2001,Rural,Karnataka,Other Crimes,Drug Offense,Female,60+,4923,2989,1934,3859,1064
2006,Urban,Karnataka,Crime Against Children,Kidnapping,Male,13-17,4507,1946,2561,3870,637
2002,Rural,Tripura,Property Crime,Vandalism,Male,31-45,1792,1548,244,1625,167
2005,Rural,Rajasthan,Other Crimes,Corruption,Female,31-45,2990,2035,955,2700,290
2006,Urban,Telangana,Crime Against Men,Robbery,Male,13-17,1410,247,1163,835,575
2002,Rural,Jammu & Kashmir,Other Crimes,Fraud,Male,0-12,7047,6307,740,6790,257
2008,Rural,Jammu & Kashmir,Crime Against Children,Child Abuse,Male,60+,2180,681,1499,1538,642
2010,Urban,Bihar,Property Crime,Theft,Female,31-45,9652,7729,1923,9200,452
2001,Urban,Telangana,Property Crime,Arson,Male,31-45,114,22,92,31,83
2008,Rural,Tripura,Other Crimes,Drug Offense,Female,31-45,5102,5022,80,5065,37
2001,Urban,Tamil Nadu,Crime Against Men,Assault,Female,0-12,6099,4910,1189,5250,849
2007,Urban,Tripura,Other Crimes,Fraud,Male,13-17,8062,2206,5856,7459,603
2008,Urban,Manipur,Property Crime,Theft,Female,18-30,2134,58,2076,1740,394
2001,Rural,Chhattisgarh,Crime Against Men,Robbery,Female,18-30,5980,1491,4489,5065,915
2010,Rural,Meghalaya,Crime Against Men,Extortion,Male,46-60,6952,894,6058,3532,3420
2008,Urban,Meghalaya,Crime Against Children,Child Abuse,Male,18-30,1674,1090,584,1630,44
2003,Urban,Uttar Pradesh,Crime Against Women,Dowry Deaths,Female,60+,4778,4309,469,4319,459
2010,Urban,Kerala,Crime Against Women,Domestic Violence,Male,31-45,3499,3046,453,3239,260
2008,Urban,West Bengal,Crime Against Men,Robbery,Female,31-45,3059,2915,144,3052,7
2002,Rural,Delhi,Property Crime,Arson,Female,18-30,3287,1506,1781,2028,1259
2008,Rural,Delhi,Other Crimes,Drug Offense,Female,46-60,5874,5738,136,5749,125
2008,Rural,Gujarat,Property Crime,Burglary,Female,0-12,2534,1587,947,1886,648
2005,Urban,Karnataka,Crime Against Children,Kidnapping,Female,46-60,628,564,64,577,51
2008,Rural,Nagaland,Crime Against Women,Dowry Deaths,Female,18-30,8341,4691,3650,5366,2975
2009,Rural,Chhattisgarh,Crime Against Women,Molestation,Female,46-60,4000,1899,2101,3519,481
2005,Rural,Delhi,Crime Against Children,Child Abuse,Female,31-45,7101,1808,5293,4058,3043
2001,Rural,Haryana,Crime Against Children,Trafficking,Male,13-17,9440,9157,283,9340,100
2006,Rural,Jharkhand,Crime Against Women,Domestic Violence,Male,31-45,1658,600,1058,1335,323
2010,Urban,Sikkim,Property Crime,Vandalism,Male,31-45,8445,8303,142,8370,75
2010,Rural,West Bengal,Property Crime,Burglary,Male,46-60,9696,2311,7385,6407,3289
2005,Rural,Arunachal Pradesh,Other Crimes,Fraud,Female,18-30,2231,2081,150,2145,86
2001,Urban,Jharkhand,Crime Against Children,Kidnapping,Female,31-45,4821,4618,203,4802,19
2007,Rural,Gujarat,Crime Against Men,Murder,Male,13-17,1276,664,612,803,473
2009,Rural,Odisha,Property Crime,Vandalism,Male,60+,1274,921,353,954,320
2007,Urban,Odisha,Property Crime,Arson,Female,18-30,2265,1500,765,1917,348
2003,Rural,Mizoram,Property Crime,Arson,Male,0-12,9707,3362,6345,4556,5151
2005,Rural,Haryana,Crime Against Men,Murder,Female,60+,319,229,90,284,35
2010,Urban,Jammu & Kashmir,Crime Against Men,Robbery,Male,13-17,8024,4897,3127,6622,1402
2001,Rural,Assam,Crime Against Women,Domestic Violence,Female,46-60,7811,4879,2932,7030,781
2010,Urban,Tamil Nadu,Crime Against Women,Domestic Violence,Male,31-45,3294,1601,1693,1822,1472
2005,Rural,Karnataka,Crime Against Children,Child Labor,Female,18-30,3434,100,3334,1337,2097
2003,Urban,Himachal Pradesh,Crime Against Men,Robbery,Female,46-60,4989,152,4837,177,4812
2009,Rural,Maharashtra,Property Crime,Burglary,Male,13-17,1350,975,375,1061,289
2008,Rural,Andhra Pradesh,Other Crimes,Cyber Crime,Male,46-60,3434,2262,1172,3213,221
2005,Rural,Goa,Other Crimes,Drug Offense,Male,13-17,8775,71,8704,933,7842
2010,Urban,Rajasthan,Property Crime,Theft,Male,0-12,9411,7498,1913,7944,1467
2003,Urban,Tamil Nadu,Other Crimes,Corruption,Male,0-12,1608,1087,521,1272,336
2003,Urban,Delhi,Crime Against Women,Rape,Male,0-12,3807,3250,557,3616,191
2004,Urban,Nagaland,Crime Against Men,Robbery,Male,13-17,1075,759,316,1055,20
2001,Urban,Tripura,Crime Against Children,Child Labor,Female,0-12,5448,334,5114,4551,897
2005,Urban,Tamil Nadu,Crime Against Women,Dowry Deaths,Female,13-17,6988,5880,1108,6805,183
2004,Urban,Sikkim,Property Crime,Burglary,Male,46-60,1855,375,1480,1224,631
2009,Rural,Tripura,Crime Against Men,Extortion,Male,46-60,2706,444,2262,2697,9
2007,Rural,Delhi,Crime Against Women,Dowry Deaths,Female,13-17,2005,491,1514,1117,888
2010,Rural,Goa,Crime Against Men,Robbery,Male,31-45,2017,1727,290,1842,175
2005,Urban,Uttar Pradesh,Crime Against Men,Murder,Male,18-30,112,61,51,99,13
2003,Rural,Rajasthan,Crime Against Women,Rape,Female,60+,7418,4598,2820,5944,1474
2003,Urban,Nagaland,Crime Against Women,Dowry Deaths,Female,31-45,5660,4444,1216,4830,830
2009,Urban,Meghalaya,Crime Against Men,Robbery,Male,46-60,5301,4,5297,2747,2554
2010,Urban,Andhra Pradesh,Other Crimes,Fraud,Female,60+,715,621,94,642,73
2007,Urban,Kerala,Crime Against Men,Murder,Female,18-30,5463,5130,333,5216,247
2009,Urban,Telangana,Crime Against Men,Extortion,Male,60+,9064,6186,2878,7721,1343
2005,Urban,Andhra Pradesh,Crime Against Children,Trafficking,Female,13-17,7583,3710,3873,6091,1492
2008,Rural,Manipur,Crime Against Women,Dowry Deaths,Female,0-12,271,187,84,204,67
2002,Rural,Tamil Nadu,Crime Against Women,Domestic Violence,Male,60+,8202,4294,3908,5867,2335
2003,Rural,Assam,Crime Against Women,Rape,Male,18-30,190,46,144,68,122
2008,Rural,Rajasthan,Crime Against Women,Dowry Deaths,Male,18-30,9417,3329,6088,6168,3249
2009,Rural,Punjab,Crime Against Men,Extortion,Female,46-60,5160,4733,427,4807,353
2010,Urban,Andhra Pradesh,Property Crime,Burglary,Male,60+,3662,661,3001,2603,1059
2001,Rural,Andhra Pradesh,Crime Against Women,Rape,Male,46-60,2868,1577,1291,2515,353
2004,Rural,Uttar Pradesh,Crime Against Children,Kidnapping,Female,46-60,3206,106,3100,2265,941
2006,Urban,Madhya Pradesh,Crime Against Women,Rape,Male,13-17,8158,1446,6712,2648,5510
2001,Urban,Tripura,Property Crime,Vandalism,Male,31-45,7465,3812,3653,6643,822
2004,Rural,Himachal Pradesh,Crime Against Men,Assault,Male,31-45,7461,2997,4464,6382,1079
2003,Urban,Uttarakhand,Crime Against Women,Dowry Deaths,Male,13-17,3809,2451,1358,2936,873
2008,Rural,Uttar Pradesh,Property Crime,Burglary,Female,46-60,5565,4197,1368,5391,174
2001,Rural,Karnataka,Other Crimes,Fraud,Female,13-17,7234,1763,5471,5968,1266
2001,Rural,Chhattisgarh,Crime Against Men,Assault,Female,13-17,2148,1605,543,1697,451
2003,Rural,Arunachal Pradesh,Other Crimes,Drug Offense,Male,46-60,2301,669,1632,1524,777
2007,Rural,Goa,Crime Against Women,Molestation,Male,46-60,6450,6048,402,6210,240
2002,Rural,Uttarakhand,Crime Against Children,Child Labor,Female,0-12,8950,3713,5237,3839,5111
2002,Rural,Arunachal Pradesh,Crime Against Men,Assault,Male,0-12,2063,664,1399,1333,730
2006,Urban,Chhattisgarh,Crime Against Men,Extortion,Female,31-45,4625,3071,1554,4159,466
2005,Rural,Meghalaya,Crime Against Men,Robbery,Male,18-30,3229,573,2656,2082,1147
2006,Rural,Himachal Pradesh,Crime Against Men,Assault,Female,13-17,7864,1230,6634,1773,6091
2004,Rural,Madhya Pradesh,Crime Against Men,Extortion,Male,18-30,6145,900,5245,5388,757
2002,Rural,Himachal Pradesh,Crime Against Children,Child Labor,Female,13-17,9235,7299,1936,7745,1490
2006,Rural,Haryana,Crime Against Men,Assault,Female,0-12,8785,6030,2755,7464,1321
2009,Urban,Madhya Pradesh,Other Crimes,Corruption,Female,60+,1763,1316,447,1324,439
2010,Urban,Punjab,Crime Against Men,Assault,Male,60+,5187,1807,3380,4877,310
2009,Rural,Jammu & Kashmir,Crime Against Children,Child Abuse,Male,13-17,492,26,466,304,188
2003,Rural,Tamil Nadu,Other Crimes,Cyber Crime,Female,60+,9784,4550,5234,5479,4305
2006,Rural,Tripura,Property Crime,Theft,Male,18-30,603,242,361,552,51
2007,Rural,Uttar Pradesh,Property Crime,Vandalism,Female,60+,9294,6844,2450,8841,453
2010,Urban,Haryana,Crime Against Men,Extortion,Male,31-45,9931,8867,1064,9272,659
2003,Rural,Madhya Pradesh,Crime Against Men,Assault,Male,31-45,3249,2209,1040,2846,403
2002,Rural,Bihar,Crime Against Men,Murder,Female,0-12,7112,5148,1964,5666,1446
2010,Urban,Uttarakhand,Crime Against Women,Dowry Deaths,Female,18-30,5361,4086,1275,4675,686
2003,Rural,Gujarat,Other Crimes,Fraud,Female,0-12,5237,1112,4125,3544,1693
2002,Rural,Goa,Other Crimes,Fraud,Male,13-17,910,157,753,693,217
2001,Urban,Rajasthan,Crime Against Children,Kidnapping,Female,18-30,8299,1824,6475,2346,5953
2006,Rural,Himachal Pradesh,Crime Against Children,Child Abuse,Male,13-17,6619,5084,1535,5649,970
2006,Urban,Andhra Pradesh,Crime Against Children,Kidnapping,Female,13-17,7344,3060,4284,4475,2869
2004,Rural,Arunachal Pradesh,Crime Against Women,Rape,Female,60+,3437,1640,1797,3177,260
2005,Rural,Telangana,Crime Against Women,Domestic Violence,Male,60+,3990,3801,189,3903,87
2006,Urban,Himachal Pradesh,Crime Against Women,Dowry Deaths,Male,46-60,9177,6545,2632,7363,1814
2001,Rural,Tamil Nadu,Crime Against Women,Dowry Deaths,Male,18-30,467,323,144,370,97
2008,Urban,Goa,Property Crime,Theft,Female,31-45,253,243,10,248,5
2007,Rural,Delhi,Other Crimes,Drug Offense,Male,46-60,9690,1719,7971,4744,4946
2003,Urban,Goa,Other Crimes,Corruption,Male,31-45,9445,1508,7937,7834,1611
2004,Rural,Jharkhand,Crime Against Women,Domestic Violence,Female,0-12,8191,344,7847,1948,6243
2006,Rural,Tamil Nadu,Crime Against Women,Rape,Female,18-30,480,21,459,292,188
2003,Urban,Arunachal Pradesh,Crime Against Men,Extortion,Male,31-45,2433,1220,1213,1242,1191
2004,Urban,Tripura,Property Crime,Theft,Male,46-60,1164,718,446,1022,142
2004,Rural,Telangana,Crime Against Children,Child Abuse,Male,46-60,239,112,127,151,88
2006,Urban,Meghalaya,Crime Against Children,Child Labor,Female,0-12,2655,1843,812,2450,205
2007,Urban,Odisha,Crime Against Women,Molestation,Male,60+,9830,8998,832,9097,733
2005,Urban,Madhya Pradesh,Other Crimes,Cyber Crime,Female,13-17,4313,3910,403,3918,395
2008,Urban,Arunachal Pradesh,Property Crime,Vandalism,Male,60+,531,42,489,51,480
2006,Rural,Arunachal Pradesh,Crime Against Children,Child Abuse,Female,13-17,5974,394,5580,2157,3817
2003,Rural,Meghalaya,Property Crime,Theft,Female,60+,8835,4669,4166,6664,2171
2004,Urban,Manipur,Crime Against Women,Molestation,Female,18-30,662,249,413,635,27
2009,Urban,Uttar Pradesh,Crime Against Women,Rape,Male,46-60,8536,5303,3233,5980,2556
2003,Urban,Tamil Nadu,Crime Against Women,Molestation,Male,0-12,573,59,514,425,148
2005,Urban,Haryana,Crime Against Children,Child Abuse,Female,13-17,2142,1718,424,2119,23
2010,Urban,Maharashtra,Crime Against Women,Rape,Male,0-12,7406,3930,3476,5123,2283
2008,Rural,Meghalaya,Crime Against Children,Child Labor,Female,31-45,2012,1355,657,1442,570
2001,Rural,West Bengal,Crime Against Children,Trafficking,Female,31-45,8260,426,7834,3338,4922
2007,Urban,Uttar Pradesh,Crime Against Women,Rape,Female,0-12,5169,4460,709,4765,404
2007,Rural,Jammu & Kashmir,Other Crimes,Fraud,Female,13-17,2967,593,2374,1156,1811
2008,Rural,Manipur,Property Crime,Vandalism,Male,18-30,1347,39,1308,558,789
2009,Rural,Jammu & Kashmir,Crime Against Children,Kidnapping,Male,60+,143,2,141,70,73
2004,Urban,Rajasthan,Property Crime,Arson,Male,46-60,5539,2073,3466,3633,1906
2005,Urban,Odisha,Crime Against Men,Murder,Female,31-45,9128,2570,6558,4953,4175
2002,Rural,Manipur,Crime Against Men,Assault,Male,46-60,9027,4371,4656,5025,4002
2005,Urban,Delhi,Property Crime,Burglary,Male,31-45,8541,8199,342,8314,227
2002,Rural,Goa,Crime Against Men,Extortion,Male,60+,2279,162,2117,788,1491
2008,Rural,Meghalaya,Property Crime,Vandalism,Female,31-45,9377,2181,7196,8677,700
2007,Urban,Bihar,Crime Against Children,Trafficking,Male,60+,2093,1595,498,1790,303
2004,Urban,Mizoram,Property Crime,Vandalism,Male,13-17,3179,2156,1023,3006,173
2006,Rural,Chhattisgarh,Crime Against Men,Robbery,Male,46-60,488,200,288,365,123
2002,Rural,Uttar Pradesh,Crime Against Men,Robbery,Male,13-17,6580,2724,3856,3910,2670
2009,Urban,Andhra Pradesh,Crime Against Men,Murder,Female,60+,6258,736,5522,5249,1009
2005,Rural,Mizoram,Crime Against Women,Domestic Violence,Female,18-30,6967,410,6557,864,6103
2003,Urban,Tripura,Crime Against Men,Murder,Female,13-17,6303,1363,4940,5094,1209
2008,Rural,Telangana,Crime Against Women,Dowry Deaths,Male,31-45,2194,1272,922,1490,704
2005,Urban,Kerala,Crime Against Men,Assault,Male,31-45,1420,1402,18,1404,16
2009,Rural,Manipur,Crime Against Children,Child Labor,Female,13-17,2120,867,1253,1110,1010
2009,Urban,Maharashtra,Crime Against Men,Murder,Female,46-60,2698,320,2378,1883,815
2002,Rural,Assam,Other Crimes,Drug Offense,Female,13-17,4547,1698,2849,2632,1915
2002,Rural,Kerala,Property Crime,Burglary,Female,46-60,6461,5531,930,6098,363
2003,Rural,Uttarakhand,Crime Against Men,Extortion,Male,60+,5708,2947,2761,5695,13
2005,Rural,Jammu & Kashmir,Crime Against Children,Child Labor,Male,60+,7725,3933,3792,5545,2180
2005,Rural,Gujarat,Crime Against Women,Dowry Deaths,Male,60+,463,260,203,387,76
2008,Rural,Telangana,Other Crimes,Corruption,Female,46-60,9055,6609,2446,7466,1589
2001,Urban,Nagaland,Crime Against Women,Molestation,Male,13-17,4482,3385,1097,4453,29
2003,Urban,West Bengal,Crime Against Children,Child Labor,Female,0-12,8988,7497,1491,8459,529
2006,Urban,Jharkhand,Property Crime,Vandalism,Male,18-30,1947,576,1371,1404,543
2001,Rural,Bihar,Crime Against Men,Robbery,Female,13-17,813,174,639,804,9
2005,Urban,Meghalaya,Crime Against Children,Child Labor,Female,0-12,3453,1126,2327,1219,2234
2003,Rural,Arunachal Pradesh,Other Crimes,Corruption,Female,46-60,964,833,131,850,114
2001,Urban,Madhya Pradesh,Crime Against Women,Molestation,Female,60+,9275,2705,6570,4682,4593
2005,Rural,Andhra Pradesh,Crime Against Men,Extortion,Female,31-45,8386,5978,2408,7199,1187
2002,Urban,Telangana,Crime Against Men,Extortion,Female,18-30,9693,5,9688,9284,409
2001,Rural,West Bengal,Crime Against Men,Assault,Female,18-30,8678,4865,3813,5755,2923
2005,Urban,Madhya Pradesh,Property Crime,Theft,Male,46-60,7103,2577,4526,5180,1923
2006,Urban,Madhya Pradesh,Crime Against Women,Rape,Male,13-17,4801,577,4224,2564,2237
2004,Urban,Uttarakhand,Other Crimes,Cyber Crime,Female,13-17,1738,41,1697,594,1144
2008,Rural,Bihar,Crime Against Women,Dowry Deaths,Female,60+,4235,2895,1340,3674,561
2008,Rural,Chhattisgarh,Crime Against Men,Assault,Female,60+,2606,521,2085,2316,290
2008,Rural,Maharashtra,Crime Against Children,Trafficking,Male,31-45,4992,1959,3033,3523,1469
2010,Rural,Meghalaya,Other Crimes,Corruption,Female,13-17,9005,3929,5076,6617,2388
2008,Rural,Telangana,Crime Against Men,Extortion,Male,13-17,2375,399,1976,945,1430
2005,Urban,Nagaland,Crime Against Women,Domestic Violence,Male,18-30,6524,1136,5388,5706,818
2007,Urban,Nagaland,Other Crimes,Corruption,Female,18-30,8255,1751,6504,2645,5610
2008,Urban,Meghalaya,Crime Against Men,Murder,Male,13-17,239,22,217,41,198
2005,Urban,Uttarakhand,Other Crimes,Drug Offense,Female,60+,1052,802,250,848,204
2003,Rural,Uttar Pradesh,Crime Against Women,Dowry Deaths,Male,13-17,9742,9616,126,9689,53
2003,Rural,Punjab,Other Crimes,Drug Offense,Female,13-17,684,661,23,680,4
2002,Rural,Andhra Pradesh,Property Crime,Burglary,Male,0-12,1956,169,1787,1866,90
2004,Urban,Jharkhand,Property Crime,Vandalism,Male,0-12,8205,825,7380,1750,6455
2008,Urban,Himachal Pradesh,Other Crimes,Cyber Crime,Male,13-17,3560,2284,1276,2990,570
2009,Rural,Kerala,Crime Against Men,Robbery,Male,0-12,7165,3147,4018,5651,1514
2002,Rural,Odisha,Other Crimes,Fraud,Female,46-60,8498,335,8163,5518,2980
2001,Rural,Tripura,Other Crimes,Drug Offense,Female,46-60,3607,2848,759,2904,703
2006,Rural,Sikkim,Crime Against Men,Extortion,Female,13-17,4009,2128,1881,3613,396
2001,Urban,Chhattisgarh,Crime Against Women,Molestation,Female,18-30,7839,5950,1889,6226,1613
2010,Rural,Uttar Pradesh,Crime Against Men,Murder,Male,46-60,5176,2292,2884,4365,811
2006,Urban,Nagaland,Other Crimes,Cyber Crime,Male,46-60,3908,1359,2549,3054,854
2003,Rural,Kerala,Crime Against Women,Dowry Deaths,Female,13-17,7214,5493,1721,5850,1364
2009,Urban,Himachal Pradesh,Property Crime,Vandalism,Male,18-30,4725,1796,2929,4612,113
2005,Rural,Madhya Pradesh,Crime Against Men,Extortion,Male,46-60,4698,2093,2605,2447,2251
2008,Urban,Manipur,Property Crime,Arson,Female,13-17,3002,1251,1751,2429,573
2003,Rural,Tamil Nadu,Property Crime,Arson,Male,0-12,1520,1198,322,1445,75
2003,Rural,Haryana,Other Crimes,Drug Offense,Female,18-30,758,371,387,428,330
2007,Urban,Delhi,Other Crimes,Fraud,Male,31-45,6926,1515,5411,4222,2704
2001,Rural,Odisha,Crime Against Children,Trafficking,Male,46-60,1494,1033,461,1245,249
2005,Urban,Maharashtra,Crime Against Children,Child Abuse,Male,46-60,8803,1586,7217,4555,4248
2005,Urban,Odisha,Crime Against Children,Kidnapping,Male,31-45,4817,3294,1523,4361,456
2003,Urban,Assam,Property Crime,Vandalism,Female,18-30,5733,1350,4383,4357,1376
2005,Urban,Uttar Pradesh,Property Crime,Vandalism,Male,13-17,6005,4064,1941,5994,11
2004,Rural,Telangana,Property Crime,Burglary,Female,18-30,5927,5587,340,5730,197
2005,Rural,Manipur,Crime Against Women,Rape,Female,18-30,7367,1576,5791,2822,4545
2003,Rural,West Bengal,Crime Against Men,Assault,Female,0-12,5610,4341,1269,4727,883
2003,Urban,Telangana,Crime Against Men,Extortion,Female,60+,5008,2514,2494,4351,657
2004,Rural,Tripura,Crime Against Women,Rape,Male,18-30,3232,1427,1805,2866,366
2010,Rural,Tamil Nadu,Other Crimes,Fraud,Female,60+,627,538,89,576,51
2010,Rural,Andhra Pradesh,Crime Against Children,Child Labor,Female,31-45,5493,3272,2221,5083,410
2006,Urban,Uttar Pradesh,Property Crime,Burglary,Male,31-45,4494,1757,2737,3498,996
2009,Rural,Andhra Pradesh,Other Crimes,Corruption,Female,13-17,2709,2642,67,2677,32
2009,Rural,Sikkim,Crime Against Women,Dowry Deaths,Male,46-60,9193,246,8947,827,8366
2005,Urban,West Bengal,Crime Against Men,Extortion,Female,46-60,52,44,8,47,5
2007,Rural,Mizoram,Crime Against Women,Molestation,Male,0-12,4084,1748,2336,2883,1201
2006,Urban,Meghalaya,Crime Against Women,Molestation,Female,46-60,8474,4016,4458,6794,1680
2002,Urban,Delhi,Crime Against Men,Assault,Female,46-60,2322,1495,827,2018,304
2004,Urban,Madhya Pradesh,Crime Against Women,Rape,Female,60+,363,134,229,150,213
2010,Rural,Telangana,Other Crimes,Cyber Crime,Female,31-45,4195,4171,24,4189,6
2010,Rural,Jharkhand,Other Crimes,Fraud,Female,0-12,8971,5010,3961,5539,3432
2005,Urban,Nagaland,Other Crimes,Corruption,Male,46-60,8150,6735,1415,7215,935
2001,Rural,Bihar,Crime Against Women,Domestic Violence,Male,60+,5333,3903,1430,5190,143
2006,Urban,Chhattisgarh,Crime Against Men,Extortion,Male,60+,6078,2059,4019,4848,1230
2005,Urban,Haryana,Other Crimes,Cyber Crime,Male,46-60,8064,3779,4285,6110,1954
2009,Urban,Karnataka,Other Crimes,Fraud,Female,46-60,3588,1103,2485,2800,788
2003,Urban,Himachal Pradesh,Crime Against Women,Dowry Deaths,Male,18-30,870,390,480,794,76
2007,Rural,Andhra Pradesh,Crime Against Children,Kidnapping,Female,46-60,7055,1678,5377,3124,3931
2003,Urban,Sikkim,Property Crime,Burglary,Male,60+,2974,305,2669,1329,1645
2005,Urban,Mizoram,Other Crimes,Drug Offense,Male,31-45,9896,6879,3017,8521,1375
2003,Urban,Uttar Pradesh,Crime Against Men,Assault,Male,0-12,3982,3204,778,3888,94
2010,Rural,Mizoram,Other Crimes,Drug Offense,Female,0-12,3082,675,2407,2539,543
2010,Urban,Kerala,Property Crime,Burglary,Female,18-30,5826,4455,1371,5391,435
2006,Urban,Gujarat,Crime Against Women,Rape,Male,60+,5336,1500,3836,4776,560
2010,Rural,Gujarat,Property Crime,Vandalism,Female,0-12,9552,8354,1198,8712,840
2008,Urban,Goa,Other Crimes,Drug Offense,Female,18-30,7286,296,6990,3367,3919
2004,Rural,Madhya Pradesh,Property Crime,Burglary,Female,0-12,262,31,231,36,226
2010,Rural,Madhya Pradesh,Crime Against Children,Kidnapping,Male,13-17,1836,1011,825,1420,416
2010,Urban,Assam,Crime Against Children,Child Labor,Male,0-12,98,58,40,61,37
2009,Urban,Madhya Pradesh,Crime Against Children,Child Abuse,Male,46-60,4636,1097,3539,1418,3218
2005,Urban,Jammu & Kashmir,Crime Against Children,Kidnapping,Male,0-12,1686,299,1387,531,1155
2005,Rural,Himachal Pradesh,Property Crime,Theft,Female,0-12,3342,2793,549,3105,237
2005,Urban,Chhattisgarh,Property Crime,Theft,Female,60+,6602,4679,1923,4747,1855
2001,Rural,Odisha,Crime Against Women,Dowry Deaths,Female,0-12,9923,8555,1368,8827,1096
2005,Rural,Mizoram,Other Crimes,Drug Offense,Male,18-30,5392,2289,3103,2333,3059
2007,Urban,Andhra Pradesh,Crime Against Women,Molestation,Male,13-17,7879,5656,2223,6473,1406
2001,Rural,Punjab,Crime Against Children,Child Abuse,Male,0-12,9750,1081,8669,3203,6547
2008,Rural,Goa,Other Crimes,Cyber Crime,Male,18-30,8132,1159,6973,6791,1341
2003,Rural,Kerala,Crime Against Men,Robbery,Male,31-45,2617,1213,1404,1287,1330
2005,Rural,Telangana,Crime Against Men,Extortion,Female,18-30,6607,1705,4902,2519,4088
2001,Rural,Telangana,Crime Against Men,Murder,Female,46-60,6640,4780,1860,5807,833
2001,Rural,Punjab,Crime Against Women,Rape,Female,60+,285,22,263,80,205
2009,Urban,Telangana,Other Crimes,Drug Offense,Male,46-60,72,25,47,37,35
2007,Urban,West Bengal,Crime Against Children,Kidnapping,Male,13-17,2893,789,2104,1580,1313
2008,Urban,Karnataka,Crime Against Men,Assault,Male,18-30,4294,3226,1068,4183,111
2001,Urban,Uttarakhand,Property Crime,Burglary,Male,18-30,983,788,195,877,106
2003,Rural,Bihar,Other Crimes,Fraud,Male,18-30,7553,3672,3881,7027,526
2004,Urban,Karnataka,Crime Against Children,Child Labor,Male,0-12,4602,4410,192,4447,155
2006,Rural,Chhattisgarh,Crime Against Men,Murder,Male,0-12,7484,532,6952,2310,5174
2003,Urban,Himachal Pradesh,Crime Against Men,Murder,Male,31-45,2266,1208,1058,1568,698
2007,Rural,Nagaland,Property Crime,Theft,Male,13-17,752,673,79,732,20
2008,Rural,Karnataka,Property Crime,Theft,Male,46-60,7736,7524,212,7680,56
2005,Rural,Madhya Pradesh,Crime Against Men,Robbery,Male,31-45,2203,371,1832,567,1636
2003,Urban,Punjab,Other Crimes,Corruption,Female,0-12,9897,4267,5630,6417,3480
2010,Rural,Nagaland,Crime Against Women,Rape,Female,13-17,4427,2695,1732,4159,268
2004,Rural,Goa,Crime Against Children,Child Abuse,Female,60+,2129,98,2031,412,1717
2007,Urban,Uttarakhand,Crime Against Children,Kidnapping,Female,31-45,549,155,394,514,35
2008,Urban,Arunachal Pradesh,Crime Against Men,Assault,Male,31-45,3826,542,3284,3501,325
2005,Urban,Sikkim,Crime Against Men,Assault,Male,60+,7164,2971,4193,7131,33
2009,Rural,Meghalaya,Crime Against Men,Extortion,Male,18-30,7768,2232,5536,7149,619
2003,Urban,Meghalaya,Crime Against Children,Trafficking,Female,60+,9737,2929,6808,8598,1139
2001,Urban,Tamil Nadu,Crime Against Men,Extortion,Male,13-17,4930,2172,2758,4585,345
2007,Rural,Punjab,Other Crimes,Cyber Crime,Male,60+,8132,963,7169,2075,6057
2001,Urban,Odisha,Property Crime,Arson,Female,46-60,7441,4215,3226,7402,39
2003,Rural,Sikkim,Crime Against Women,Dowry Deaths,Male,13-17,276,191,85,240,36
2003,Urban,Sikkim,Other Crimes,Drug Offense,Female,0-12,137,112,25,136,1
2003,Urban,Madhya Pradesh,Crime Against Men,Extortion,Female,13-17,2829,590,2239,662,2167
2007,Rural,Sikkim,Crime Against Men,Assault,Male,31-45,2864,1699,1165,2511,353
2004,Rural,Sikkim,Crime Against Women,Domestic Violence,Female,46-60,3889,3119,770,3225,664
2010,Rural,Telangana,Crime Against Women,Domestic Violence,Female,18-30,3682,111,3571,3503,179
2010,Rural,Bihar,Crime Against Women,Rape,Female,46-60,9432,4357,5075,4594,4838
2006,Rural,Nagaland,Crime Against Children,Child Labor,Male,0-12,7200,462,6738,4187,3013
2005,Urban,Kerala,Crime Against Men,Extortion,Female,13-17,6203,5209,994,5749,454
2005,Rural,Delhi,Property Crime,Theft,Male,60+,2199,1601,598,1646,553
2004,Rural,Punjab,Crime Against Men,Assault,Female,18-30,5926,622,5304,1244,4682
2007,Rural,Bihar,Other Crimes,Cyber Crime,Male,13-17,700,583,117,628,72
2006,Rural,Delhi,Crime Against Children,Child Labor,Male,13-17,3048,1112,1936,2637,411
2002,Urban,Mizoram,Property Crime,Burglary,Female,13-17,3117,1522,1595,2369,748
2007,Urban,Chhattisgarh,Crime Against Men,Robbery,Female,60+,9586,2749,6837,8900,686
2007,Urban,Assam,Crime Against Women,Molestation,Female,13-17,7477,3105,4372,5563,1914
2004,Urban,Goa,Other Crimes,Corruption,Male,18-30,443,108,335,217,226
2008,Rural,Haryana,Crime Against Women,Domestic Violence,Female,18-30,3179,2671,508,3060,119
2001,Rural,Himachal Pradesh,Other Crimes,Fraud,Male,13-17,1837,364,1473,470,1367
2001,Rural,Himachal Pradesh,Other Crimes,Corruption,Female,60+,1595,440,1155,712,883
2002,Rural,Odisha,Property Crime,Burglary,Female,0-12,3585,1376,2209,2970,615
2007,Rural,Jharkhand,Crime Against Women,Domestic Violence,Female,0-12,7508,6052,1456,7456,52
2005,Urban,Kerala,Other Crimes,Drug Offense,Male,0-12,3527,496,3031,770,2757
2006,Rural,Punjab,Crime Against Women,Molestation,Female,31-45,2363,157,2206,1239,1124
2008,Rural,Nagaland,Crime Against Men,Murder,Male,18-30,7290,3586,3704,4773,2517
2005,Urban,Tripura,Crime Against Women,Molestation,Male,18-30,2792,1713,1079,1866,926
2004,Rural,Rajasthan,Crime Against Children,Kidnapping,Female,0-12,7875,3018,4857,5268,2607
2002,Urban,Madhya Pradesh,Property Crime,Burglary,Female,46-60,5130,5125,5,5125,5
2001,Rural,Telangana,Crime Against Children,Kidnapping,Male,46-60,464,266,198,397,67
2006,Urban,Jammu & Kashmir,Crime Against Men,Murder,Male,0-12,238,110,128,156,82
2010,Rural,Jammu & Kashmir,Crime Against Men,Extortion,Male,46-60,3426,561,2865,924,2502
2006,Urban,Kerala,Crime Against Children,Child Abuse,Male,0-12,8789,8702,87,8746,43
2004,Urban,Madhya Pradesh,Crime Against Children,Trafficking,Male,18-30,6124,5511,613,6061,63
2010,Urban,Delhi,Crime Against Women,Molestation,Male,18-30,6615,2016,4599,2978,3637
2009,Urban,Meghalaya,Other Crimes,Fraud,Male,31-45,5185,5032,153,5129,56
2009,Urban,Rajasthan,Other Crimes,Corruption,Female,31-45,8874,1614,7260,3982,4892
2005,Urban,Tripura,Other Crimes,Fraud,Female,60+,566,192,374,316,250
2009,Urban,Mizoram,Crime Against Women,Domestic Violence,Male,31-45,4347,1324,3023,2965,1382
2009,Urban,Andhra Pradesh,Crime Against Women,Molestation,Male,31-45,3918,399,3519,1457,2461
2010,Urban,Gujarat,Other Crimes,Drug Offense,Male,31-45,7155,165,6990,5948,1207
2005,Urban,Karnataka,Crime Against Men,Murder,Male,18-30,8097,1157,6940,4212,3885
2001,Urban,Rajasthan,Property Crime,Arson,Female,0-12,4045,2297,1748,3251,794
2001,Urban,Jammu & Kashmir,Crime Against Children,Trafficking,Female,18-30,1927,881,1046,1519,408
2003,Urban,Madhya Pradesh,Property Crime,Arson,Male,46-60,416,108,308,110,306
2003,Rural,Himachal Pradesh,Crime Against Children,Kidnapping,Female,13-17,2242,2108,134,2143,99
2001,Urban,Meghalaya,Crime Against Children,Child Labor,Female,60+,725,688,37,706,19
2004,Rural,West Bengal,Crime Against Men,Assault,Male,18-30,2561,2513,48,2528,33
2006,Rural,Telangana,Other Crimes,Cyber Crime,Male,31-45,4037,3881,156,3983,54
2001,Rural,Karnataka,Other Crimes,Corruption,Male,0-12,3693,105,3588,399,3294
2007,Urban,Sikkim,Crime Against Men,Robbery,Male,31-45,4330,3032,1298,4141,189
2006,Rural,Kerala,Other Crimes,Cyber Crime,Male,31-45,2306,1026,1280,1173,1133
2003,Rural,Chhattisgarh,Property Crime,Theft,Female,0-12,6062,6009,53,6013,49
2002,Urban,Assam,Crime Against Children,Kidnapping,Male,46-60,4388,2058,2330,2093,2295
2005,Rural,Tamil Nadu,Crime Against Women,Rape,Female,0-12,1426,454,972,1174,252
2007,Urban,Tripura,Crime Against Men,Assault,Male,0-12,7758,5772,1986,5811,1947
2003,Urban,Jammu & Kashmir,Crime Against Men,Robbery,Female,0-12,6274,3524,2750,5092,1182
2008,Urban,Punjab,Other Crimes,Cyber Crime,Male,13-17,330,289,41,317,13
2001,Urban,West Bengal,Other Crimes,Corruption,Female,13-17,6064,5516,548,5777,287
2006,Urban,Uttar Pradesh,Crime Against Women,Domestic Violence,Male,13-17,8965,1097,7868,4216,4749
2008,Rural,Meghalaya,Crime Against Men,Murder,Male,13-17,3560,668,2892,3489,71
2008,Urban,Punjab,Crime Against Men,Robbery,Female,18-30,9299,1108,8191,5285,4014
2004,Rural,Andhra Pradesh,Crime Against Women,Rape,Female,31-45,5202,2055,3147,2572,2630
2010,Rural,Himachal Pradesh,Crime Against Men,Assault,Male,60+,4532,2990,1542,3402,1130
2009,Rural,Telangana,Other Crimes,Drug Offense,Female,31-45,5355,2655,2700,5034,321
2001,Urban,Jammu & Kashmir,Crime Against Men,Murder,Male,13-17,5349,2856,2493,3682,1667
2007,Urban,Jharkhand,Crime Against Women,Rape,Female,31-45,3879,2300,1579,2674,1205
2009,Urban,Himachal Pradesh,Property Crime,Arson,Female,46-60,6177,1844,4333,4917,1260
2007,Rural,Haryana,Crime Against Men,Extortion,Male,18-30,8040,3240,4800,6240,1800
2007,Rural,Delhi,Property Crime,Vandalism,Female,0-12,2161,1930,231,1972,189
2004,Urban,Bihar,Crime Against Children,Kidnapping,Female,60+,7659,3870,3789,6871,788
2002,Urban,Uttar Pradesh,Other Crimes,Drug Offense,Male,31-45,4486,530,3956,3116,1370
2002,Rural,Goa,Other Crimes,Drug Offense,Male,31-45,5378,4450,928,5162,216
2002,Urban,Telangana,Other Crimes,Fraud,Male,60+,86,64,22,84,2
2009,Urban,Andhra Pradesh,Crime Against Children,Trafficking,Male,0-12,55,33,22,44,11
2010,Urban,Mizoram,Property Crime,Arson,Female,18-30,7564,6128,1436,6336,1228
2001,Rural,Tamil Nadu,Crime Against Women,Dowry Deaths,Male,18-30,9845,1299,8546,4045,5800
2005,Rural,Jammu & Kashmir,Crime Against Children,Child Labor,Female,18-30,7695,1567,6128,4195,3500
2002,Urban,Jharkhand,Crime Against Men,Extortion,Female,18-30,51,35,16,41,10
2006,Urban,Manipur,Crime Against Men,Murder,Male,31-45,6665,757,5908,1335,5330
2004,Urban,Madhya Pradesh,Crime Against Men,Assault,Male,13-17,807,373,434,620,187
2003,Rural,Gujarat,Property Crime,Theft,Female,13-17,3559,1149,2410,3330,229
2010,Rural,Assam,Crime Against Children,Trafficking,Female,0-12,2532,650,1882,1358,1174
2007,Rural,Maharashtra,Crime Against Men,Robbery,Male,60+,2345,968,1377,1528,817
2010,Rural,Haryana,Other Crimes,Drug Offense,Male,60+,3750,1195,2555,3448,302
2003,Rural,Telangana,Crime Against Men,Assault,Female,60+,8746,1365,7381,8685,61
2009,Rural,Andhra Pradesh,Crime Against Children,Child Labor,Female,46-60,8591,6018,2573,6690,1901
2008,Rural,Andhra Pradesh,Property Crime,Arson,Female,18-30,6368,2608,3760,4497,1871
2001,Urban,Uttar Pradesh,Other Crimes,Corruption,Male,46-60,9086,4472,4614,8580,506
2006,Urban,Chhattisgarh,Property Crime,Theft,Female,46-60,5199,3850,1349,4224,975
2010,Rural,Delhi,Crime Against Women,Dowry Deaths,Female,18-30,9551,571,8980,771,8780
2001,Urban,Goa,Crime Against Women,Dowry Deaths,Female,18-30,6949,4683,2266,5657,1292
2005,Urban,Karnataka,Crime Against Men,Assault,Male,31-45,1381,747,634,983,398
2002,Rural,Chhattisgarh,Other Crimes,Cyber Crime,Female,60+,776,356,420,527,249
2001,Rural,Karnataka,Crime Against Men,Robbery,Male,18-30,5105,2605,2500,4457,648
2003,Urban,Meghalaya,Crime Against Men,Robbery,Male,13-17,7684,7377,307,7564,120
2003,Urban,Kerala,Other Crimes,Drug Offense,Female,0-12,489,481,8,485,4
2003,Rural,Karnataka,Crime Against Men,Murder,Female,18-30,6686,5320,1366,6271,415
2003,Urban,Kerala,Crime Against Children,Trafficking,Male,18-30,4711,461,4250,1402,3309
2009,Rural,West Bengal,Property Crime,Arson,Female,18-30,2729,1135,1594,2189,540
2003,Urban,Arunachal Pradesh,Crime Against Children,Child Abuse,Female,46-60,957,638,319,767,190
2004,Rural,Meghalaya,Other Crimes,Corruption,Female,60+,9914,2627,7287,7476,2438
2004,Urban,Tripura,Crime Against Men,Murder,Male,13-17,2472,1394,1078,2117,355
2007,Rural,Assam,Property Crime,Arson,Female,46-60,1819,804,1015,1293,526
2009,Rural,Tripura,Crime Against Men,Assault,Male,46-60,4988,3988,1000,4528,460
2006,Urban,Arunachal Pradesh,Crime Against Women,Rape,Female,18-30,9814,4168,5646,9707,107
2004,Rural,Sikkim,Property Crime,Arson,Female,60+,9648,4707,4941,9220,428
2007,Rural,Tripura,Other Crimes,Fraud,Male,60+,2431,2383,48,2397,34
2006,Rural,Tripura,Crime Against Men,Robbery,Male,31-45,4213,3413,800,3562,651
2009,Rural,Madhya Pradesh,Crime Against Men,Assault,Male,46-60,5957,1872,4085,4867,1090
2010,Rural,Uttarakhand,Crime Against Women,Molestation,Female,13-17,2282,1328,954,1581,701
2009,Urban,Assam,Crime Against Men,Robbery,Male,0-12,5351,344,5007,890,4461
2006,Urban,Madhya Pradesh,Crime Against Men,Robbery,Male,31-45,453,180,273,204,249
2008,Urban,Punjab,Property Crime,Burglary,Female,31-45,3904,886,3018,1445,2459
2002,Urban,Jharkhand,Other Crimes,Fraud,Male,18-30,1917,1094,823,1806,111
2009,Urban,Andhra Pradesh,Crime Against Children,Trafficking,Male,13-17,1112,511,601,834,278
2005,Urban,Jharkhand,Other Crimes,Cyber Crime,Male,31-45,784,379,405,437,347
2001,Rural,Telangana,Property Crime,Arson,Male,60+,8905,8652,253,8788,117
2002,Rural,Delhi,Crime Against Men,Assault,Male,18-30,2774,2073,701,2413,361
2004,Rural,Manipur,Crime Against Women,Rape,Male,31-45,6902,3946,2956,6474,428
2001,Rural,Arunachal Pradesh,Other Crimes,Drug Offense,Female,60+,7182,5710,1472,6516,666
2007,Rural,Punjab,Crime Against Women,Dowry Deaths,Male,31-45,3377,1230,2147,1728,1649
2007,Urban,Karnataka,Property Crime,Theft,Male,31-45,9971,9218,753,9860,111
2001,Rural,Nagaland,Crime Against Women,Domestic Violence,Male,18-30,7387,434,6953,4891,2496
2005,Rural,Himachal Pradesh,Other Crimes,Drug Offense,Male,13-17,1614,242,1372,1020,594
2001,Urban,Telangana,Other Crimes,Cyber Crime,Female,18-30,9302,3944,5358,7366,1936
2009,Rural,Odisha,Crime Against Children,Kidnapping,Female,46-60,4617,1470,3147,2188,2429
2005,Rural,Jharkhand,Crime Against Children,Child Abuse,Female,13-17,6112,6029,83,6075,37
2005,Urban,Tripura,Other Crimes,Drug Offense,Female,46-60,8909,3833,5076,8031,878
2006,Rural,Arunachal Pradesh,Other Crimes,Drug Offense,Female,0-12,7391,611,6780,6497,894
2005,Urban,West Bengal,Other Crimes,Corruption,Male,46-60,71,55,16,70,1
2003,Rural,Karnataka,Other Crimes,Cyber Crime,Female,18-30,736,669,67,683,53
2004,Urban,Bihar,Crime Against Women,Rape,Female,31-45,2567,1349,1218,2009,558
2004,Rural,Bihar,Crime Against Men,Robbery,Male,60+,6965,4124,2841,6313,652
2006,Rural,Arunachal Pradesh,Other Crimes,Drug Offense,Male,18-30,8669,6400,2269,6572,2097
2008,Rural,Maharashtra,Crime Against Men,Murder,Male,46-60,6696,6333,363,6539,157
2006,Urban,Bihar,Crime Against Men,Murder,Female,0-12,9321,4978,4343,6997,2324
2005,Urban,Meghalaya,Property Crime,Arson,Female,13-17,736,26,710,688,48
2006,Rural,West Bengal,Crime Against Women,Molestation,Male,0-12,1865,822,1043,1568,297
2004,Urban,Manipur,Property Crime,Vandalism,Female,13-17,2833,567,2266,2201,632
2007,Rural,Delhi,Crime Against Women,Dowry Deaths,Female,0-12,8448,2860,5588,3417,5031
2002,Urban,Madhya Pradesh,Property Crime,Arson,Female,13-17,7089,6192,897,6832,257
2003,Rural,Haryana,Crime Against Women,Rape,Male,46-60,1817,1283,534,1729,88
2005,Urban,Nagaland,Property Crime,Theft,Female,31-45,9798,4685,5113,6454,3344
2010,Rural,Mizoram,Other Crimes,Fraud,Male,31-45,6042,4354,1688,5952,90
2008,Rural,Bihar,Other Crimes,Drug Offense,Male,0-12,4986,2667,2319,4104,882
2003,Rural,Sikkim,Crime Against Children,Child Abuse,Male,18-30,8286,5651,2635,6631,1655
2010,Urban,Sikkim,Property Crime,Vandalism,Male,0-12,2546,1140,1406,1710,836
2001,Rural,West Bengal,Crime Against Children,Child Labor,Female,0-12,2409,676,1733,2139,270
2003,Urban,Uttar Pradesh,Other Crimes,Fraud,Female,0-12,364,346,18,346,18
2003,Urban,Maharashtra,Property Crime,Burglary,Male,0-12,227,125,102,174,53
2002,Urban,Tamil Nadu,Other Crimes,Fraud,Male,18-30,9448,1551,7897,5987,3461
2001,Rural,Goa,Property Crime,Burglary,Male,0-12,2147,736,1411,1770,377
2003,Rural,Himachal Pradesh,Crime Against Women,Molestation,Female,31-45,7510,2112,5398,7170,340
2010,Urban,Meghalaya,Crime Against Children,Kidnapping,Female,31-45,8180,1997,6183,8097,83
2003,Urban,Uttar Pradesh,Property Crime,Burglary,Female,18-30,8609,8005,604,8190,419
2005,Urban,Assam,Crime Against Men,Assault,Female,60+,8894,7134,1760,7387,1507
2009,Urban,Andhra Pradesh,Other Crimes,Cyber Crime,Male,0-12,4921,4614,307,4698,223
2003,Urban,Delhi,Crime Against Women,Domestic Violence,Female,13-17,3284,2324,960,2357,927
2004,Rural,Andhra Pradesh,Crime Against Children,Child Abuse,Female,60+,8967,3500,5467,7908,1059
2003,Urban,Jharkhand,Property Crime,Theft,Male,13-17,8305,3114,5191,7980,325
2004,Urban,Odisha,Other Crimes,Cyber Crime,Female,0-12,2997,356,2641,1328,1669
2005,Urban,Tamil Nadu,Property Crime,Vandalism,Female,0-12,4655,30,4625,2074,2581
2010,Rural,Punjab,Property Crime,Vandalism,Male,18-30,1214,257,957,508,706
2005,Urban,Nagaland,Crime Against Men,Extortion,Female,60+,8504,369,8135,7707,797
2003,Urban,Karnataka,Property Crime,Vandalism,Male,46-60,9445,3297,6148,7185,2260
2010,Rural,Gujarat,Crime Against Children,Kidnapping,Female,0-12,208,123,85,202,6
2003,Rural,Karnataka,Crime Against Women,Domestic Violence,Male,31-45,2347,87,2260,410,1937
2002,Rural,Chhattisgarh,Property Crime,Theft,Male,46-60,8332,4354,3978,4800,3532
2005,Rural,Assam,Crime Against Children,Child Labor,Female,13-17,2431,464,1967,2237,194
2010,Urban,Arunachal Pradesh,Crime Against Children,Trafficking,Female,18-30,2759,489,2270,1587,1172
2008,Urban,Uttar Pradesh,Other Crimes,Cyber Crime,Male,13-17,9918,8012,1906,8627,1291
2005,Urban,Karnataka,Crime Against Women,Domestic Violence,Male,60+,3309,1516,1793,2733,576
2008,Urban,Goa,Property Crime,Vandalism,Male,46-60,429,90,339,302,127
2008,Rural,Telangana,Crime Against Children,Child Abuse,Female,31-45,1682,1512,170,1544,138
2009,Urban,Tamil Nadu,Property Crime,Vandalism,Male,18-30,8905,3840,5065,4330,4575
2003,Rural,Rajasthan,Crime Against Men,Murder,Female,46-60,7238,6021,1217,6399,839
2008,Rural,Gujarat,Crime Against Children,Child Abuse,Female,60+,7916,5461,2455,6755,1161
2002,Rural,Telangana,Property Crime,Vandalism,Male,18-30,3856,1149,2707,2963,893
2003,Urban,Gujarat,Other Crimes,Cyber Crime,Female,60+,4283,2362,1921,2618,1665
2007,Rural,Gujarat,Other Crimes,Cyber Crime,Female,13-17,997,321,676,447,550
2007,Urban,Haryana,Crime Against Women,Dowry Deaths,Female,13-17,9937,8895,1042,9041,896
2004,Rural,Punjab,Crime Against Men,Extortion,Male,46-60,1895,1352,543,1895,0
2007,Urban,Assam,Crime Against Women,Domestic Violence,Male,13-17,9905,9402,503,9754,151
2001,Urban,Haryana,Other Crimes,Corruption,Male,18-30,1656,350,1306,812,844
2002,Rural,Himachal Pradesh,Crime Against Women,Molestation,Male,18-30,5845,3659,2186,5347,498
2008,Urban,Himachal Pradesh,Other Crimes,Fraud,Female,31-45,6061,1633,4428,3429,2632
2010,Urban,Himachal Pradesh,Other Crimes,Fraud,Female,46-60,9155,8656,499,8847,308
2010,Rural,Mizoram,Crime Against Women,Dowry Deaths,Female,31-45,4468,3118,1350,4132,336
2002,Rural,West Bengal,Property Crime,Burglary,Male,13-17,8763,3883,4880,5243,3520
2002,Rural,Haryana,Other Crimes,Drug Offense,Female,31-45,9293,5776,3517,8089,1204
2009,Urban,Uttar Pradesh,Property Crime,Vandalism,Male,13-17,1261,343,918,1239,22
2003,Rural,Meghalaya,Other Crimes,Cyber Crime,Male,13-17,8390,1453,6937,4657,3733
2001,Rural,Meghalaya,Crime Against Women,Molestation,Male,31-45,5007,4483,524,4764,243
2004,Urban,Tamil Nadu,Other Crimes,Corruption,Male,18-30,9871,3086,6785,3818,6053
2009,Rural,Uttarakhand,Crime Against Women,Molestation,Female,13-17,4344,1039,3305,2260,2084
2004,Urban,Manipur,Crime Against Women,Domestic Violence,Female,13-17,8411,4153,4258,8382,29
2001,Urban,Tamil Nadu,Crime Against Men,Assault,Male,13-17,2411,2178,233,2283,128
2005,Rural,Maharashtra,Property Crime,Burglary,Female,0-12,9453,5373,4080,6984,2469
2006,Rural,Haryana,Other Crimes,Fraud,Female,60+,3178,2744,434,3077,101
2003,Urban,West Bengal,Crime Against Men,Assault,Female,18-30,1194,1137,57,1189,5
2002,Urban,Sikkim,Property Crime,Theft,Female,18-30,5034,2339,2695,4961,73
2004,Rural,Punjab,Crime Against Men,Robbery,Male,13-17,140,61,79,69,71
2010,Rural,Bihar,Crime Against Children,Kidnapping,Female,13-17,5069,173,4896,5036,33
2002,Rural,Sikkim,Crime Against Children,Kidnapping,Female,0-12,8464,2434,6030,7130,1334
2006,Urban,Jammu & Kashmir,Crime Against Women,Rape,Female,60+,5621,1373,4248,1997,3624
2002,Rural,Jammu & Kashmir,Crime Against Children,Child Labor,Male,60+,8381,705,7676,3066,5315
2002,Urban,West Bengal,Other Crimes,Cyber Crime,Male,18-30,6365,1415,4950,4072,2293
2006,Urban,Manipur,Crime Against Men,Assault,Female,0-12,1518,1256,262,1481,37
2008,Rural,Odisha,Crime Against Children,Trafficking,Male,46-60,7806,7043,763,7225,581
2009,Urban,Arunachal Pradesh,Crime Against Men,Extortion,Female,60+,2840,2048,792,2057,783
2007,Rural,Odisha,Property Crime,Burglary,Male,31-45,2273,61,2212,401,1872
2008,Rural,Telangana,Crime Against Children,Trafficking,Male,0-12,3295,19,3276,601,2694
2004,Urban,West Bengal,Crime Against Children,Kidnapping,Female,31-45,8709,5919,2790,7239,1470
2003,Urban,Delhi,Crime Against Children,Kidnapping,Female,31-45,7673,305,7368,7497,176
2007,Rural,West Bengal,Crime Against Women,Molestation,Male,18-30,4298,537,3761,805,3493
2007,Rural,Assam,Crime Against Children,Trafficking,Male,18-30,4009,3192,817,3364,645
2006,Urban,Karnataka,Crime Against Women,Rape,Female,13-17,4960,1229,3731,3358,1602
2007,Urban,Bihar,Crime Against Women,Dowry Deaths,Male,31-45,2367,1384,983,1466,901
2002,Rural,Haryana,Crime Against Women,Dowry Deaths,Female,60+,7126,4727,2399,5002,2124
2002,Rural,Chhattisgarh,Crime Against Women,Molestation,Female,46-60,7507,5719,1788,5727,1780
2008,Rural,Tamil Nadu,Crime Against Men,Extortion,Male,0-12,5971,3048,2923,3126,2845
2001,Rural,Gujarat,Other Crimes,Drug Offense,Female,18-30,957,882,75,915,42
2005,Urban,Telangana,Property Crime,Arson,Male,13-17,2592,2089,503,2320,272
2005,Urban,Punjab,Crime Against Children,Trafficking,Male,0-12,9884,1762,8122,3690,6194
2008,Rural,Tamil Nadu,Crime Against Men,Murder,Male,46-60,4089,21,4068,543,3546
2004,Urban,Karnataka,Crime Against Women,Dowry Deaths,Male,0-12,9611,8929,682,9150,461
2006,Rural,Uttarakhand,Crime Against Men,Murder,Male,0-12,4827,2303,2524,4647,180
2003,Urban,Jammu & Kashmir,Other Crimes,Drug Offense,Female,46-60,6198,3566,2632,4437,1761
2006,Rural,Maharashtra,Crime Against Children,Child Labor,Male,31-45,3375,150,3225,161,3214
2009,Urban,Kerala,Crime Against Women,Domestic Violence,Female,0-12,3761,1605,2156,2354,1407
2002,Rural,West Bengal,Crime Against Women,Domestic Violence,Female,60+,4245,2212,2033,2306,1939
2009,Rural,Manipur,Crime Against Men,Assault,Male,0-12,9245,6538,2707,6599,2646
2002,Urban,Meghalaya,Crime Against Men,Assault,Female,31-45,3025,2918,107,3012,13
2009,Urban,Delhi,Crime Against Men,Assault,Female,60+,9884,2508,7376,9580,304
2007,Urban,Madhya Pradesh,Crime Against Women,Molestation,Male,60+,6490,1468,5022,3604,2886
2006,Urban,Uttarakhand,Crime Against Women,Domestic Violence,Male,31-45,6250,2481,3769,6206,44
2007,Urban,Jharkhand,Other Crimes,Drug Offense,Female,13-17,5316,3394,1922,3426,1890
2002,Rural,Tamil Nadu,Other Crimes,Cyber Crime,Female,46-60,6273,1393,4880,5663,610
2002,Urban,Himachal Pradesh,Other Crimes,Drug Offense,Male,46-60,5065,767,4298,3977,1088
2008,Rural,Manipur,Crime Against Men,Robbery,Male,31-45,2119,240,1879,1783,336
2009,Rural,Uttarakhand,Property Crime,Arson,Female,13-17,3188,1388,1800,2199,989
2005,Rural,Goa,Other Crimes,Fraud,Female,60+,1339,291,1048,1103,236
2008,Urban,West Bengal,Property Crime,Vandalism,Male,13-17,7861,5128,2733,7860,1
2004,Urban,Chhattisgarh,Other Crimes,Fraud,Female,60+,5350,1169,4181,2116,3234
2007,Urban,Goa,Property Crime,Vandalism,Female,13-17,2709,1899,810,1963,746
2007,Urban,Manipur,Property Crime,Theft,Male,31-45,6767,4825,1942,5448,1319
2001,Urban,Delhi,Crime Against Children,Child Abuse,Male,18-30,1833,676,1157,1287,546
2008,Rural,Madhya Pradesh,Property Crime,Arson,Male,13-17,8456,3568,4888,5740,2716
2005,Rural,Arunachal Pradesh,Crime Against Women,Domestic Violence,Female,46-60,9885,5015,4870,6335,3550
2008,Urban,Odisha,Crime Against Men,Extortion,Male,0-12,945,457,488,785,160
2002,Urban,Chhattisgarh,Crime Against Women,Rape,Male,13-17,5816,2471,3345,2576,3240
2006,Urban,Himachal Pradesh,Crime Against Men,Extortion,Female,31-45,2679,1555,1124,1571,1108
2002,Urban,Uttarakhand,Other Crimes,Drug Offense,Female,31-45,6106,4983,1123,5877,229
2003,Urban,Maharashtra,Property Crime,Arson,Female,31-45,4902,4088,814,4457,445
2010,Urban,Karnataka,Property Crime,Vandalism,Female,31-45,8553,5780,2773,8394,159
2007,Rural,Himachal Pradesh,Crime Against Children,Kidnapping,Male,0-12,4669,1547,3122,1937,2732
2009,Urban,Arunachal Pradesh,Other Crimes,Drug Offense,Female,0-12,7685,1282,6403,7492,193
2001,Rural,West Bengal,Other Crimes,Corruption,Female,60+,3631,2704,927,3630,1
2002,Rural,Gujarat,Property Crime,Burglary,Female,60+,4267,3630,637,4067,200
2010,Rural,Jammu & Kashmir,Crime Against Women,Dowry Deaths,Female,60+,1088,135,953,590,498
2009,Rural,Tamil Nadu,Crime Against Children,Kidnapping,Male,18-30,4780,3689,1091,3786,994
2008,Urban,Bihar,Other Crimes,Corruption,Male,13-17,9404,4440,4964,7552,1852
2001,Rural,Telangana,Property Crime,Arson,Female,60+,4951,2015,2936,2304,2647
2009,Rural,Nagaland,Crime Against Children,Child Labor,Female,60+,4465,2413,2052,3033,1432
2007,Urban,Arunachal Pradesh,Property Crime,Burglary,Male,46-60,2335,231,2104,1999,336
2003,Rural,Kerala,Other Crimes,Cyber Crime,Male,13-17,2559,2234,325,2303,256
2008,Urban,Karnataka,Crime Against Women,Rape,Female,31-45,343,312,31,329,14
2006,Urban,Mizoram,Other Crimes,Cyber Crime,Female,31-45,9127,6533,2594,7803,1324
2006,Urban,Karnataka,Crime Against Men,Extortion,Male,13-17,9861,264,9597,8263,1598
2004,Urban,West Bengal,Other Crimes,Corruption,Female,0-12,9984,3194,6790,4432,5552
2008,Urban,Meghalaya,Property Crime,Arson,Female,60+,7021,5063,1958,5258,1763
2003,Rural,Tamil Nadu,Other Crimes,Cyber Crime,Female,31-45,4316,47,4269,4065,251
2002,Urban,Mizoram,Property Crime,Vandalism,Female,60+,9946,628,9318,6098,3848
2006,Urban,Uttarakhand,Other Crimes,Drug Offense,Male,18-30,8722,1301,7421,5407,3315
2006,Rural,Rajasthan,Property Crime,Vandalism,Male,18-30,461,362,99,437,24
2001,Rural,Rajasthan,Other Crimes,Cyber Crime,Male,46-60,9655,8021,1634,8622,1033
2005,Rural,Goa,Property Crime,Burglary,Female,13-17,4594,3844,750,4448,146
2002,Rural,Haryana,Property Crime,Arson,Male,13-17,4569,412,4157,3281,1288
2002,Rural,Andhra Pradesh,Crime Against Children,Child Labor,Female,46-60,6894,954,5940,3675,3219
2005,Rural,Delhi,Crime Against Children,Child Abuse,Female,0-12,4113,3720,393,3856,257
2004,Urban,Arunachal Pradesh,Crime Against Children,Trafficking,Male,18-30,3766,889,2877,2366,1400
2009,Rural,Rajasthan,Property Crime,Arson,Male,18-30,1832,1737,95,1749,83
2010,Rural,Rajasthan,Other Crimes,Fraud,Female,18-30,8616,3565,5051,5298,3318
2007,Urban,Sikkim,Property Crime,Arson,Male,46-60,4196,3293,903,3949,247
2003,Rural,Tripura,Property Crime,Vandalism,Male,18-30,1762,617,1145,1182,580
2010,Urban,Meghalaya,Property Crime,Arson,Male,13-17,7609,2663,4946,4875,2734
2001,Rural,Nagaland,Crime Against Children,Trafficking,Male,31-45,5320,5152,168,5162,158
2010,Rural,Telangana,Crime Against Children,Kidnapping,Female,13-17,4736,3754,982,4641,95
2001,Urban,Rajasthan,Crime Against Children,Kidnapping,Female,31-45,6224,2849,3375,5099,1125
2001,Urban,Punjab,Crime Against Women,Dowry Deaths,Male,13-17,711,689,22,703,8
2004,Urban,Delhi,Crime Against Women,Molestation,Female,18-30,8998,6898,2100,7148,1850
2008,Urban,Rajasthan,Other Crimes,Corruption,Female,46-60,8704,891,7813,6575,2129
2003,Rural,Himachal Pradesh,Other Crimes,Drug Offense,Male,0-12,2971,821,2150,1793,1178
2006,Urban,Telangana,Crime Against Children,Kidnapping,Male,46-60,811,542,269,545,266
2008,Urban,Odisha,Other Crimes,Drug Offense,Male,13-17,7750,3852,3898,5784,1966
2005,Urban,Rajasthan,Crime Against Men,Murder,Female,0-12,1859,308,1551,1087,772
2004,Urban,Punjab,Property Crime,Burglary,Female,13-17,4463,2312,2151,3934,529
2010,Urban,Meghalaya,Property Crime,Arson,Female,46-60,1411,648,763,662,749
2008,Urban,Sikkim,Crime Against Children,Trafficking,Male,13-17,4622,1665,2957,2201,2421
2004,Rural,Meghalaya,Crime Against Women,Rape,Female,13-17,1270,621,649,899,371
2008,Urban,Uttar Pradesh,Other Crimes,Cyber Crime,Female,13-17,1524,551,973,1228,296
2007,Rural,Himachal Pradesh,Crime Against Children,Trafficking,Female,18-30,5920,3760,2160,5686,234
2002,Urban,West Bengal,Other Crimes,Cyber Crime,Female,31-45,3674,1334,2340,3627,47
2003,Rural,Punjab,Crime Against Children,Child Abuse,Female,13-17,4628,3416,1212,3660,968
2006,Urban,Punjab,Property Crime,Theft,Female,46-60,1849,45,1804,1186,663
2008,Rural,Jammu & Kashmir,Crime Against Men,Robbery,Female,60+,5973,2160,3813,3361,2612
2006,Urban,Himachal Pradesh,Crime Against Women,Molestation,Male,31-45,3897,3588,309,3660,237
2009,Urban,Bihar,Other Crimes,Corruption,Female,0-12,3746,663,3083,3322,424
2009,Urban,Rajasthan,Other Crimes,Fraud,Female,18-30,1828,1595,233,1659,169
2001,Rural,Telangana,Other Crimes,Corruption,Female,0-12,2261,14,2247,174,2087
2004,Urban,Jharkhand,Crime Against Children,Trafficking,Female,46-60,9079,5910,3169,6478,2601
2005,Rural,Gujarat,Crime Against Children,Child Abuse,Male,31-45,4510,2234,2276,2566,1944
2007,Rural,Andhra Pradesh,Other Crimes,Drug Offense,Male,60+,5555,4569,986,5325,230
2006,Rural,Arunachal Pradesh,Crime Against Children,Trafficking,Female,60+,6508,4678,1830,4719,1789
2004,Urban,Himachal Pradesh,Crime Against Women,Dowry Deaths,Male,60+,1908,468,1440,842,1066
2008,Rural,Maharashtra,Crime Against Men,Murder,Male,46-60,2331,1596,735,1683,648
2008,Urban,Chhattisgarh,Crime Against Men,Extortion,Male,31-45,4674,4008,666,4664,10
2010,Rural,Uttarakhand,Crime Against Women,Molestation,Male,46-60,2006,1516,490,1912,94
2009,Urban,Himachal Pradesh,Crime Against Women,Domestic Violence,Female,18-30,8295,4253,4042,7727,568
2007,Rural,Madhya Pradesh,Other Crimes,Corruption,Male,31-45,540,525,15,526,14
2005,Rural,Nagaland,Crime Against Women,Domestic Violence,Male,0-12,6282,5471,811,5986,296
2004,Rural,Himachal Pradesh,Other Crimes,Cyber Crime,Female,18-30,8707,8661,46,8663,44
2008,Rural,Karnataka,Other Crimes,Fraud,Male,0-12,1314,109,1205,166,1148
2002,Urban,Uttar Pradesh,Crime Against Women,Rape,Male,60+,2942,315,2627,393,2549
2010,Rural,Himachal Pradesh,Other Crimes,Fraud,Male,31-45,7691,5923,1768,6238,1453
2001,Urban,Mizoram,Crime Against Children,Child Labor,Male,31-45,7900,6716,1184,7482,418
2004,Urban,Chhattisgarh,Crime Against Children,Kidnapping,Male,60+,5942,1457,4485,2263,3679
2008,Rural,Meghalaya,Property Crime,Arson,Male,13-17,6669,365,6304,4076,2593
2007,Rural,Goa,Crime Against Children,Kidnapping,Female,18-30,2772,958,1814,1730,1042
2004,Urban,Haryana,Crime Against Children,Kidnapping,Female,13-17,3151,84,3067,1428,1723
2002,Rural,Arunachal Pradesh,Crime Against Women,Dowry Deaths,Female,60+,7262,1059,6203,1548,5714
2003,Rural,Himachal Pradesh,Crime Against Men,Extortion,Male,31-45,1276,38,1238,581,695
2004,Rural,Sikkim,Crime Against Women,Domestic Violence,Female,13-17,4705,2493,2212,3904,801
2007,Urban,Goa,Property Crime,Theft,Male,46-60,8392,2862,5530,6545,1847
2005,Rural,Himachal Pradesh,Crime Against Women,Dowry Deaths,Female,0-12,7306,3514,3792,4435,2871
2003,Urban,Punjab,Crime Against Men,Extortion,Female,31-45,5636,1805,3831,2967,2669
2004,Rural,Nagaland,Crime Against Men,Extortion,Male,60+,4707,2609,2098,4251,456
2008,Rural,Gujarat,Crime Against Children,Trafficking,Female,13-17,5365,4653,712,4665,700
2005,Urban,Meghalaya,Crime Against Men,Assault,Female,31-45,817,613,204,631,186
2002,Rural,Uttarakhand,Crime Against Women,Domestic Violence,Female,13-17,5389,5205,184,5245,144
2006,Urban,Uttarakhand,Crime Against Children,Child Labor,Female,18-30,5183,1427,3756,2547,2636
2010,Rural,Punjab,Crime Against Women,Molestation,Female,18-30,6374,1421,4953,2062,4312
2010,Urban,Jharkhand,Crime Against Women,Dowry Deaths,Female,46-60,7695,4891,2804,6973,722
2009,Urban,Maharashtra,Property Crime,Vandalism,Male,18-30,5041,2480,2561,3518,1523
2005,Urban,Mizoram,Crime Against Men,Murder,Female,0-12,4916,2921,1995,4303,613
2007,Urban,Madhya Pradesh,Property Crime,Theft,Male,0-12,7364,2307,5057,7147,217
2006,Urban,Manipur,Other Crimes,Drug Offense,Male,31-45,4743,3137,1606,3735,1008
2008,Rural,Manipur,Crime Against Men,Murder,Male,60+,5026,4656,370,4989,37
2008,Rural,Jharkhand,Crime Against Men,Murder,Female,31-45,3461,1432,2029,2178,1283
2004,Rural,Goa,Crime Against Men,Assault,Female,0-12,1773,533,1240,1559,214
2007,Rural,Delhi,Crime Against Women,Rape,Female,31-45,3177,2747,430,3033,144
2009,Rural,Delhi,Property Crime,Vandalism,Female,60+,4432,427,4005,3244,1188
2007,Urban,Uttarakhand,Crime Against Children,Kidnapping,Male,60+,5757,2943,2814,3908,1849
2005,Rural,Jammu & Kashmir,Other Crimes,Corruption,Male,13-17,6582,4637,1945,5537,1045
2009,Rural,Mizoram,Crime Against Women,Molestation,Male,31-45,8474,1831,6643,4583,3891
2002,Urban,Goa,Property Crime,Burglary,Female,13-17,2375,589,1786,1459,916
2010,Urban,Assam,Property Crime,Theft,Female,0-12,7401,5553,1848,6588,813
2004,Urban,Uttarakhand,Crime Against Women,Domestic Violence,Male,46-60,2899,1955,944,2728,171
2008,Rural,Andhra Pradesh,Crime Against Women,Dowry Deaths,Female,18-30,3076,1658,1418,1749,1327
2005,Urban,Goa,Crime Against Women,Domestic Violence,Female,0-12,6177,1399,4778,4608,1569
2003,Rural,Jammu & Kashmir,Crime Against Women,Dowry Deaths,Female,60+,7187,6488,699,6804,383
2005,Rural,Chhattisgarh,Crime Against Children,Child Abuse,Female,13-17,4908,2125,2783,2453,2455
2003,Rural,Himachal Pradesh,Crime Against Children,Trafficking,Female,31-45,6774,5631,1143,6755,19
2009,Rural,Rajasthan,Crime Against Women,Domestic Violence,Male,13-17,7876,4990,2886,5052,2824
2004,Rural,Nagaland,Property Crime,Arson,Female,46-60,9695,1670,8025,2916,6779
2001,Urban,Maharashtra,Crime Against Men,Extortion,Female,46-60,4572,2951,1621,3667,905
2003,Urban,Kerala,Other Crimes,Corruption,Female,46-60,6604,5016,1588,5204,1400
2005,Rural,Himachal Pradesh,Other Crimes,Cyber Crime,Female,60+,5846,3436,2410,5639,207
2006,Urban,Jharkhand,Crime Against Children,Child Abuse,Female,13-17,1727,927,800,1172,555
2003,Rural,Delhi,Crime Against Children,Kidnapping,Female,31-45,9140,4089,5051,7830,1310
2005,Rural,Mizoram,Crime Against Children,Kidnapping,Female,60+,2596,155,2441,371,2225
2005,Rural,Arunachal Pradesh,Crime Against Men,Assault,Male,0-12,7854,4311,3543,7067,787
2010,Urban,Tripura,Property Crime,Arson,Male,13-17,8796,6218,2578,6231,2565
2004,Rural,Rajasthan,Crime Against Women,Molestation,Female,13-17,6956,4941,2015,6271,685
2001,Rural,Rajasthan,Crime Against Men,Murder,Male,46-60,988,429,559,585,403
2008,Rural,Goa,Property Crime,Theft,Male,0-12,5304,4573,731,5177,127
2009,Rural,Nagaland,Other Crimes,Drug Offense,Female,18-30,9305,2152,7153,3054,6251
2006,Urban,Jammu & Kashmir,Crime Against Children,Child Labor,Female,46-60,2525,293,2232,1013,1512
2003,Urban,Haryana,Other Crimes,Corruption,Male,18-30,8058,8056,2,8057,1
2005,Rural,Madhya Pradesh,Crime Against Children,Child Labor,Male,46-60,1480,1097,383,1285,195
2005,Urban,Nagaland,Other Crimes,Fraud,Male,18-30,6962,4249,2713,6737,225
2008,Rural,Himachal Pradesh,Crime Against Men,Murder,Male,60+,6025,3629,2396,4695,1330
2006,Urban,Tripura,Other Crimes,Cyber Crime,Male,0-12,1575,1176,399,1556,19
2008,Rural,Gujarat,Property Crime,Arson,Female,31-45,7509,4584,2925,6042,1467
2008,Urban,Himachal Pradesh,Property Crime,Burglary,Male,60+,8502,8239,263,8350,152
2002,Urban,Jammu & Kashmir,Other Crimes,Cyber Crime,Female,0-12,9372,8520,852,9129,243
2009,Rural,Nagaland,Other Crimes,Corruption,Male,60+,3328,2726,602,3042,286
2002,Urban,Tamil Nadu,Property Crime,Vandalism,Female,60+,7787,7037,750,7424,363
2007,Rural,Nagaland,Property Crime,Arson,Female,46-60,4125,3265,860,3482,643
2001,Rural,Jammu & Kashmir,Property Crime,Vandalism,Female,18-30,7576,812,6764,827,6749
2010,Urban,Nagaland,Property Crime,Vandalism,Female,0-12,4728,4379,349,4616,112
2010,Urban,Jharkhand,Property Crime,Theft,Male,0-12,1552,950,602,1534,18
2005,Urban,Bihar,Crime Against Men,Murder,Male,18-30,4075,1599,2476,3823,252
2009,Rural,Maharashtra,Crime Against Children,Kidnapping,Male,13-17,8104,430,7674,4918,3186
2008,Rural,Andhra Pradesh,Crime Against Women,Domestic Violence,Male,18-30,9600,1864,7736,4542,5058
2005,Rural,Punjab,Other Crimes,Cyber Crime,Female,31-45,222,137,85,180,42
2009,Urban,Tripura,Crime Against Children,Child Abuse,Female,0-12,3023,639,2384,2070,953
2002,Urban,Punjab,Crime Against Men,Robbery,Female,60+,934,234,700,503,431
2007,Rural,Meghalaya,Other Crimes,Corruption,Female,13-17,3463,1399,2064,3189,274
2001,Rural,Odisha,Other Crimes,Fraud,Male,0-12,5339,2394,2945,4564,775
2004,Urban,Telangana,Other Crimes,Cyber Crime,Male,18-30,4051,2404,1647,3331,720
2005,Rural,Madhya Pradesh,Other Crimes,Drug Offense,Male,60+,4951,4496,455,4949,2
2005,Rural,West Bengal,Other Crimes,Corruption,Female,0-12,2823,1715,1108,1943,880
2006,Rural,Uttar Pradesh,Crime Against Children,Child Labor,Male,46-60,3205,647,2558,680,2525
2001,Urban,Andhra Pradesh,Other Crimes,Corruption,Female,31-45,9938,1846,8092,3861,6077
2003,Rural,Rajasthan,Other Crimes,Drug Offense,Female,46-60,5846,3657,2189,3911,1935
2003,Rural,Nagaland,Crime Against Women,Dowry Deaths,Male,18-30,8976,943,8033,1025,7951
2007,Urban,Odisha,Crime Against Men,Murder,Male,18-30,6823,6281,542,6417,406
2009,Rural,Odisha,Crime Against Men,Robbery,Female,13-17,552,387,165,432,120
2010,Urban,Punjab,Property Crime,Vandalism,Female,46-60,1458,789,669,930,528
2004,Rural,Mizoram,Other Crimes,Corruption,Male,46-60,9747,4576,5171,7494,2253
2010,Urban,Tamil Nadu,Other Crimes,Fraud,Male,60+,5438,5074,364,5411,27
2002,Urban,Himachal Pradesh,Other Crimes,Corruption,Female,46-60,9884,6072,3812,6983,2901
2010,Urban,Jammu & Kashmir,Crime Against Men,Assault,Female,0-12,5714,293,5421,4659,1055
2009,Urban,Nagaland,Crime Against Men,Extortion,Male,46-60,7935,1058,6877,1378,6557
2006,Rural,Gujarat,Other Crimes,Corruption,Female,46-60,9553,1373,8180,5005,4548
2003,Urban,Odisha,Crime Against Men,Assault,Female,18-30,4093,1601,2492,2865,1228
2001,Rural,Meghalaya,Property Crime,Arson,Male,31-45,5545,2548,2997,3405,2140
2006,Rural,Manipur,Other Crimes,Corruption,Female,31-45,3808,698,3110,2320,1488
2006,Rural,Goa,Crime Against Children,Child Labor,Female,31-45,2978,2418,560,2845,133
2001,Urban,Tripura,Property Crime,Burglary,Male,31-45,485,20,465,109,376
2005,Urban,Goa,Other Crimes,Cyber Crime,Male,60+,1931,362,1569,1658,273
2007,Rural,Odisha,Crime Against Men,Extortion,Male,13-17,9164,3599,5565,6403,2761
2004,Rural,Gujarat,Crime Against Men,Robbery,Female,60+,9444,2809,6635,4228,5216
2010,Rural,Karnataka,Crime Against Women,Molestation,Female,18-30,597,322,275,367,230
2006,Urban,Meghalaya,Other Crimes,Corruption,Male,60+,5521,5381,140,5488,33
2001,Rural,Maharashtra,Crime Against Children,Child Abuse,Female,46-60,9931,720,9211,3604,6327
2006,Rural,Himachal Pradesh,Crime Against Women,Rape,Male,18-30,4597,3700,897,4018,579
2006,Urban,Punjab,Crime Against Children,Kidnapping,Male,46-60,6772,4261,2511,6614,158
2003,Urban,Uttar Pradesh,Crime Against Children,Child Labor,Male,13-17,1094,211,883,470,624
2009,Urban,Madhya Pradesh,Crime Against Men,Extortion,Female,18-30,4194,2362,1832,2372,1822
2002,Urban,Arunachal Pradesh,Property Crime,Arson,Female,18-30,9374,191,9183,5206,4168
2001,Urban,Gujarat,Property Crime,Theft,Female,18-30,2996,394,2602,1390,1606
2002,Urban,Odisha,Crime Against Men,Murder,Male,0-12,1945,873,1072,1151,794
2009,Rural,Karnataka,Crime Against Men,Murder,Male,60+,415,114,301,180,235
2007,Rural,Odisha,Crime Against Men,Murder,Female,60+,8793,2702,6091,3395,5398
2010,Rural,Goa,Other Crimes,Drug Offense,Female,0-12,59,7,52,54,5
2005,Urban,Madhya Pradesh,Other Crimes,Cyber Crime,Male,46-60,9168,1055,8113,4999,4169
2002,Rural,Gujarat,Other Crimes,Corruption,Female,60+,3716,1665,2051,3127,589
2001,Urban,Punjab,Other Crimes,Cyber Crime,Male,0-12,3755,239,3516,2487,1268
2003,Urban,Madhya Pradesh,Crime Against Men,Extortion,Female,60+,8558,7293,1265,7790,768
2010,Rural,Sikkim,Other Crimes,Cyber Crime,Female,0-12,2886,1774,1112,2566,320
2008,Urban,Uttarakhand,Property Crime,Burglary,Female,0-12,4266,2665,1601,3623,643
2005,Rural,Maharashtra,Crime Against Children,Trafficking,Male,18-30,6583,358,6225,3642,2941
2004,Urban,Jammu & Kashmir,Other Crimes,Corruption,Female,46-60,3307,1434,1873,3050,257
2008,Urban,Tamil Nadu,Crime Against Women,Molestation,Female,0-12,359,10,349,242,117
2006,Urban,Himachal Pradesh,Crime Against Men,Robbery,Male,46-60,7931,4063,3868,4087,3844
2001,Rural,Arunachal Pradesh,Property Crime,Vandalism,Female,0-12,1093,243,850,801,292
2002,Urban,Madhya Pradesh,Other Crimes,Fraud,Female,0-12,4611,74,4537,346,4265
2005,Rural,Delhi,Property Crime,Vandalism,Female,46-60,2492,1708,784,2227,265
2004,Urban,Arunachal Pradesh,Property Crime,Vandalism,Male,13-17,7919,5045,2874,6736,1183
2001,Rural,Odisha,Crime Against Children,Child Labor,Female,60+,1943,1453,490,1926,17
2007,Rural,Nagaland,Crime Against Women,Domestic Violence,Female,46-60,6931,3311,3620,5019,1912
2007,Rural,Uttarakhand,Property Crime,Burglary,Male,31-45,4144,891,3253,3159,985
2002,Rural,Meghalaya,Crime Against Women,Dowry Deaths,Female,18-30,9537,2367,7170,4306,5231
2004,Urban,Tripura,Crime Against Children,Child Abuse,Female,60+,9813,8708,1105,9566,247
2005,Urban,West Bengal,Crime Against Men,Robbery,Male,60+,5107,3794,1313,4871,236
2010,Urban,Assam,Crime Against Children,Child Labor,Male,31-45,1786,426,1360,1199,587
2004,Urban,Rajasthan,Crime Against Women,Rape,Female,13-17,3929,2253,1676,3194,735
2002,Urban,Punjab,Crime Against Men,Murder,Female,13-17,7053,3363,3690,6421,632
2001,Urban,Tamil Nadu,Other Crimes,Fraud,Male,31-45,8048,4262,3786,5543,2505
2002,Rural,Jharkhand,Crime Against Men,Robbery,Male,0-12,5464,5100,364,5421,43
2004,Urban,Madhya Pradesh,Crime Against Men,Murder,Female,31-45,9764,3231,6533,3733,6031
2007,Urban,Andhra Pradesh,Crime Against Children,Trafficking,Female,13-17,8630,4965,3665,7536,1094
2002,Urban,Andhra Pradesh,Crime Against Men,Extortion,Female,13-17,5157,4239,918,4416,741
2008,Rural,Karnataka,Property Crime,Vandalism,Male,46-60,270,106,164,150,120
2003,Rural,Punjab,Crime Against Men,Robbery,Male,0-12,792,428,364,487,305
2005,Rural,Manipur,Crime Against Women,Rape,Male,60+,8912,819,8093,6053,2859
2002,Rural,Telangana,Crime Against Children,Trafficking,Female,13-17,9025,6030,2995,6780,2245
2009,Rural,Mizoram,Crime Against Children,Child Abuse,Female,60+,9915,6971,2944,9163,752
2006,Urban,Delhi,Crime Against Children,Kidnapping,Male,13-17,9188,5167,4021,7955,1233
2004,Urban,West Bengal,Crime Against Men,Extortion,Male,0-12,6103,2863,3240,4305,1798
2006,Urban,Maharashtra,Other Crimes,Corruption,Male,18-30,9319,6521,2798,8654,665
2006,Urban,Karnataka,Crime Against Children,Child Labor,Female,31-45,9505,794,8711,6448,3057
2005,Rural,Rajasthan,Other Crimes,Fraud,Female,13-17,5522,1262,4260,2135,3387
2010,Urban,Telangana,Crime Against Children,Child Labor,Male,31-45,7167,3863,3304,4662,2505
2002,Rural,Sikkim,Property Crime,Arson,Male,31-45,7637,5629,2008,7267,370
2009,Urban,Chhattisgarh,Other Crimes,Drug Offense,Male,46-60,2018,590,1428,909,1109
2005,Rural,Arunachal Pradesh,Property Crime,Arson,Male,0-12,8651,2474,6177,5126,3525
2001,Rural,West Bengal,Crime Against Women,Dowry Deaths,Male,31-45,1913,651,1262,1140,773
2008,Rural,Uttarakhand,Crime Against Men,Assault,Female,13-17,8859,2387,6472,7423,1436
2009,Urban,Uttarakhand,Crime Against Women,Molestation,Female,31-45,8840,7603,1237,8309,531
2009,Rural,Maharashtra,Property Crime,Arson,Male,18-30,5836,1198,4638,2632,3204
2003,Urban,Manipur,Property Crime,Arson,Male,31-45,7822,5983,1839,6565,1257
2003,Urban,Tamil Nadu,Crime Against Women,Dowry Deaths,Male,31-45,2513,1151,1362,1947,566
2003,Urban,Andhra Pradesh,Crime Against Children,Trafficking,Female,0-12,7424,7266,158,7371,53
2002,Urban,Rajasthan,Crime Against Men,Extortion,Female,31-45,609,170,439,413,196
2009,Rural,Himachal Pradesh,Crime Against Men,Robbery,Male,31-45,547,386,161,537,10
2004,Rural,Delhi,Crime Against Men,Murder,Female,31-45,9086,3565,5521,5236,3850
2005,Urban,Madhya Pradesh,Property Crime,Burglary,Female,18-30,6412,767,5645,5056,1356
2007,Rural,Kerala,Property Crime,Arson,Male,46-60,4866,1032,3834,3990,876
2003,Urban,West Bengal,Crime Against Children,Kidnapping,Female,18-30,9715,1144,8571,5524,4191
2001,Urban,Delhi,Crime Against Men,Extortion,Male,18-30,2967,336,2631,502,2465
2007,Rural,Sikkim,Crime Against Children,Trafficking,Female,0-12,4278,3017,1261,3679,599
2008,Rural,Mizoram,Crime Against Men,Murder,Male,60+,8344,6922,1422,7743,601
2008,Urban,Karnataka,Property Crime,Burglary,Male,46-60,3906,2933,973,3196,710
2010,Urban,Gujarat,Crime Against Women,Domestic Violence,Male,0-12,414,35,379,373,41
2010,Rural,Meghalaya,Crime Against Men,Assault,Male,46-60,7406,3125,4281,6244,1162
2005,Rural,Maharashtra,Property Crime,Vandalism,Male,0-12,256,173,83,180,76
2010,Urban,Delhi,Other Crimes,Cyber Crime,Male,18-30,2813,1888,925,2218,595
2001,Urban,Chhattisgarh,Property Crime,Burglary,Male,0-12,5557,3276,2281,3845,1712
2008,Rural,Bihar,Crime Against Children,Kidnapping,Male,46-60,1448,431,1017,670,778
2001,Urban,Tamil Nadu,Property Crime,Vandalism,Male,0-12,6072,2671,3401,6042,30
2004,Urban,Maharashtra,Crime Against Women,Dowry Deaths,Female,18-30,8518,3248,5270,8383,135
2006,Urban,Himachal Pradesh,Crime Against Men,Robbery,Male,18-30,3907,2996,911,3438,469
2009,Urban,Jammu & Kashmir,Property Crime,Burglary,Male,0-12,2812,1428,1384,2805,7
2009,Urban,Andhra Pradesh,Crime Against Men,Assault,Male,0-12,7445,3112,4333,4933,2512
2002,Rural,Telangana,Crime Against Women,Domestic Violence,Male,0-12,9999,6991,3008,7986,2013
2002,Urban,Maharashtra,Crime Against Children,Child Abuse,Female,60+,7615,5901,1714,7066,549
2010,Rural,Haryana,Other Crimes,Corruption,Female,18-30,5877,1280,4597,3146,2731
2009,Rural,Madhya Pradesh,Crime Against Children,Child Labor,Male,31-45,3771,487,3284,1822,1949
2001,Urban,Karnataka,Other Crimes,Cyber Crime,Female,0-12,6554,2884,3670,4579,1975
2010,Urban,Madhya Pradesh,Other Crimes,Corruption,Female,60+,2287,2095,192,2128,159
2007,Rural,Bihar,Other Crimes,Fraud,Male,60+,1734,1393,341,1732,2
2007,Rural,Nagaland,Crime Against Women,Rape,Male,18-30,8046,1455,6591,4315,3731
2007,Urban,Delhi,Crime Against Men,Assault,Male,18-30,4771,2626,2145,2741,2030
2004,Rural,Nagaland,Crime Against Women,Domestic Violence,Female,46-60,7522,7459,63,7472,50
2002,Urban,Bihar,Crime Against Women,Rape,Female,18-30,5259,5248,11,5254,5
2007,Urban,Assam,Property Crime,Burglary,Female,60+,2276,622,1654,682,1594
2005,Rural,Jammu & Kashmir,Crime Against Children,Trafficking,Male,46-60,7552,5376,2176,5698,1854
2007,Urban,Sikkim,Crime Against Men,Robbery,Female,46-60,7698,686,7012,2753,4945
2010,Rural,Haryana,Other Crimes,Corruption,Male,13-17,2488,1068,1420,2287,201
2007,Urban,Chhattisgarh,Property Crime,Arson,Female,13-17,7185,1669,5516,4783,2402
2002,Urban,Jharkhand,Crime Against Women,Rape,Female,60+,156,31,125,38,118
2002,Rural,Punjab,Other Crimes,Cyber Crime,Female,31-45,5565,4591,974,4822,743
2007,Urban,Jharkhand,Crime Against Children,Kidnapping,Female,31-45,9461,1393,8068,2113,7348
2006,Urban,Goa,Property Crime,Vandalism,Male,13-17,6691,5469,1222,6572,119
2001,Urban,Manipur,Crime Against Men,Murder,Male,31-45,2146,191,1955,480,1666
2001,Urban,Bihar,Other Crimes,Fraud,Male,60+,6432,5319,1113,6052,380
2010,Urban,Assam,Crime Against Children,Child Abuse,Male,0-12,2515,652,1863,1985,530
2009,Urban,Haryana,Crime Against Children,Child Abuse,Female,18-30,1742,1555,187,1728,14
2003,Urban,Tamil Nadu,Crime Against Men,Extortion,Female,13-17,108,97,11,98,10
2004,Urban,Sikkim,Crime Against Women,Domestic Violence,Female,18-30,2468,626,1842,1537,931
2001,Rural,Haryana,Crime Against Children,Child Labor,Male,31-45,108,74,34,89,19
2010,Urban,Bihar,Property Crime,Theft,Female,13-17,4040,460,3580,1537,2503
2005,Urban,Jharkhand,Crime Against Women,Dowry Deaths,Male,0-12,603,201,402,409,194
2001,Rural,Sikkim,Crime Against Men,Assault,Female,31-45,7428,257,7171,6144,1284
2003,Urban,Odisha,Other Crimes,Corruption,Female,0-12,2293,1431,862,1950,343
2007,Rural,Odisha,Other Crimes,Corruption,Female,31-45,4949,1227,3722,3640,1309
2007,Urban,Meghalaya,Crime Against Women,Rape,Male,46-60,1294,1138,156,1151,143
2008,Urban,Jammu & Kashmir,Crime Against Children,Child Abuse,Female,31-45,2283,1475,808,1698,585
2006,Rural,Uttar Pradesh,Property Crime,Vandalism,Female,46-60,6321,4522,1799,4721,1600
2007,Urban,Gujarat,Other Crimes,Fraud,Male,0-12,2600,1921,679,2100,500
2001,Rural,Arunachal Pradesh,Crime Against Children,Kidnapping,Male,60+,255,45,210,249,6
2007,Urban,Jharkhand,Crime Against Men,Robbery,Female,31-45,7198,4127,3071,7158,40
2008,Rural,Gujarat,Property Crime,Burglary,Male,13-17,3746,2238,1508,3661,85
2003,Urban,Himachal Pradesh,Crime Against Children,Trafficking,Male,18-30,75,63,12,67,8
2007,Rural,Arunachal Pradesh,Crime Against Children,Kidnapping,Male,46-60,8809,4838,3971,7100,1709
2003,Urban,Punjab,Other Crimes,Corruption,Female,46-60,7429,174,7255,6586,843
2001,Urban,Tamil Nadu,Crime Against Women,Rape,Female,31-45,1692,378,1314,783,909
2004,Urban,Odisha,Property Crime,Vandalism,Female,18-30,90,53,37,88,2
2003,Rural,Odisha,Crime Against Men,Murder,Male,13-17,6672,237,6435,300,6372
2003,Urban,Himachal Pradesh,Crime Against Children,Child Abuse,Female,46-60,8986,6112,2874,8415,571
2003,Rural,Punjab,Crime Against Men,Robbery,Female,46-60,2794,779,2015,1774,1020
2006,Urban,Chhattisgarh,Other Crimes,Cyber Crime,Female,31-45,6373,2640,3733,5353,1020
2010,Urban,Uttarakhand,Crime Against Women,Dowry Deaths,Female,0-12,5334,2286,3048,3119,2215
2003,Urban,Sikkim,Crime Against Children,Child Abuse,Female,60+,325,261,64,293,32
2007,Urban,Tamil Nadu,Crime Against Women,Rape,Female,18-30,5126,806,4320,4458,668
2002,Urban,Manipur,Crime Against Children,Kidnapping,Male,0-12,9374,9133,241,9291,83
2008,Rural,Meghalaya,Other Crimes,Fraud,Male,13-17,9621,2661,6960,6723,2898
2007,Urban,Meghalaya,Property Crime,Burglary,Female,0-12,6551,1439,5112,5211,1340
2003,Rural,Chhattisgarh,Crime Against Men,Extortion,Male,46-60,4068,3016,1052,3786,282
2004,Rural,Delhi,Property Crime,Theft,Female,0-12,9313,476,8837,2027,7286
2003,Urban,Maharashtra,Crime Against Women,Dowry Deaths,Male,31-45,1014,248,766,935,79
2008,Urban,Sikkim,Other Crimes,Drug Offense,Female,18-30,405,80,325,279,126
2003,Urban,Uttar Pradesh,Property Crime,Burglary,Female,46-60,4271,1177,3094,1590,2681
2005,Rural,Punjab,Crime Against Children,Child Abuse,Female,46-60,1544,776,768,1141,403
2002,Urban,Delhi,Crime Against Women,Domestic Violence,Female,31-45,4064,931,3133,3651,413
2010,Rural,Chhattisgarh,Crime Against Children,Trafficking,Male,60+,7647,385,7262,5519,2128
2007,Urban,Goa,Other Crimes,Cyber Crime,Female,18-30,7299,4253,3046,5791,1508
2006,Urban,Bihar,Crime Against Children,Child Labor,Male,18-30,5795,2616,3179,3614,2181
2005,Rural,Odisha,Crime Against Men,Extortion,Male,13-17,203,83,120,127,76
2005,Rural,Maharashtra,Property Crime,Theft,Male,0-12,879,4,875,843,36
2003,Rural,Tripura,Other Crimes,Cyber Crime,Male,60+,7697,7632,65,7641,56
2004,Urban,Punjab,Other Crimes,Fraud,Male,31-45,1176,148,1028,477,699
2010,Rural,Jammu & Kashmir,Crime Against Children,Child Labor,Female,18-30,5792,4622,1170,5073,719
2003,Rural,Odisha,Property Crime,Theft,Female,31-45,9335,7631,1704,8272,1063
2002,Rural,Bihar,Crime Against Children,Trafficking,Female,31-45,8125,5804,2321,7071,1054
2002,Urban,Rajasthan,Crime Against Men,Murder,Male,31-45,5370,3873,1497,4657,713
2008,Urban,Goa,Other Crimes,Drug Offense,Female,0-12,5718,744,4974,3303,2415
2001,Rural,Punjab,Crime Against Women,Rape,Female,0-12,5726,4387,1339,4925,801
2008,Urban,Himachal Pradesh,Crime Against Children,Child Labor,Female,0-12,7418,3661,3757,3795,3623
2009,Urban,Bihar,Crime Against Women,Dowry Deaths,Female,0-12,8998,8469,529,8870,128
2010,Rural,West Bengal,Crime Against Women,Molestation,Female,18-30,3115,2765,350,3019,96
2002,Urban,Chhattisgarh,Property Crime,Arson,Male,31-45,1479,1351,128,1449,30
2006,Urban,Telangana,Other Crimes,Fraud,Male,60+,439,301,138,420,19
2010,Rural,Tamil Nadu,Crime Against Children,Kidnapping,Female,60+,562,76,486,485,77
2007,Rural,Meghalaya,Property Crime,Vandalism,Female,0-12,5665,390,5275,4488,1177
2009,Urban,Karnataka,Crime Against Women,Rape,Male,18-30,1133,1123,10,1133,0
2005,Rural,Delhi,Crime Against Men,Robbery,Male,0-12,709,703,6,704,5
2002,Rural,Gujarat,Other Crimes,Drug Offense,Male,13-17,5340,345,4995,4890,450
2002,Urban,Punjab,Crime Against Children,Child Labor,Female,60+,638,319,319,451,187
2007,Rural,Uttar Pradesh,Crime Against Women,Domestic Violence,Male,31-45,8493,4123,4370,8116,377
2004,Rural,Assam,Crime Against Men,Extortion,Female,18-30,3873,986,2887,1901,1972
2008,Rural,West Bengal,Crime Against Women,Domestic Violence,Male,31-45,3368,2356,1012,3069,299
2003,Rural,Manipur,Other Crimes,Corruption,Female,46-60,6205,6121,84,6160,45
2005,Rural,Arunachal Pradesh,Crime Against Children,Child Abuse,Female,46-60,9252,6237,3015,6556,2696
2005,Rural,Tripura,Crime Against Women,Molestation,Male,46-60,1804,1201,603,1228,576
2003,Rural,Mizoram,Crime Against Men,Extortion,Female,13-17,7437,950,6487,2090,5347
2008,Rural,Assam,Other Crimes,Cyber Crime,Female,60+,2320,2018,302,2217,103
2010,Urban,Haryana,Crime Against Men,Assault,Female,60+,7385,1746,5639,4605,2780
2009,Rural,West Bengal,Crime Against Women,Dowry Deaths,Male,31-45,3182,1986,1196,2810,372
2005,Rural,Himachal Pradesh,Crime Against Women,Rape,Male,46-60,5062,2289,2773,2529,2533
2004,Urban,Meghalaya,Crime Against Children,Trafficking,Male,31-45,8008,3798,4210,4633,3375
2009,Urban,Kerala,Crime Against Women,Molestation,Male,18-30,9487,8214,1273,8526,961
2009,Urban,Jharkhand,Property Crime,Burglary,Female,13-17,8720,2264,6456,5680,3040
2002,Rural,Delhi,Other Crimes,Corruption,Male,13-17,1126,34,1092,361,765
2003,Urban,West Bengal,Crime Against Women,Molestation,Female,13-17,9805,5259,4546,6971,2834
2004,Rural,Maharashtra,Property Crime,Theft,Female,13-17,9182,4606,4576,6731,2451
2006,Urban,Tripura,Other Crimes,Drug Offense,Male,31-45,422,91,331,332,90
2009,Urban,Nagaland,Crime Against Children,Child Abuse,Female,18-30,9149,9112,37,9137,12
2002,Rural,Jammu & Kashmir,Crime Against Men,Murder,Male,13-17,7844,7256,588,7521,323
2001,Urban,Himachal Pradesh,Crime Against Children,Kidnapping,Female,18-30,3984,1955,2029,3883,101
2002,Rural,Delhi,Property Crime,Theft,Female,13-17,3592,1771,1821,2977,615
2008,Rural,Madhya Pradesh,Property Crime,Arson,Male,18-30,6421,5,6416,2200,4221
2008,Rural,Odisha,Crime Against Women,Domestic Violence,Male,13-17,6711,6114,597,6322,389
2005,Rural,Meghalaya,Crime Against Women,Molestation,Male,0-12,8525,7876,649,8301,224
2001,Rural,Karnataka,Crime Against Women,Molestation,Male,46-60,4833,567,4266,2920,1913
2001,Urban,Uttar Pradesh,Crime Against Women,Molestation,Male,0-12,3196,3011,185,3165,31
2007,Rural,Odisha,Property Crime,Arson,Male,18-30,8957,3478,5479,4579,4378
2002,Urban,Arunachal Pradesh,Other Crimes,Drug Offense,Male,31-45,2346,2148,198,2338,8
2005,Urban,Karnataka,Property Crime,Arson,Male,18-30,373,317,56,369,4
2001,Urban,Assam,Other Crimes,Fraud,Male,60+,3276,864,2412,971,2305
2007,Urban,Maharashtra,Property Crime,Arson,Female,31-45,1938,1355,583,1740,198
2003,Urban,Uttarakhand,Crime Against Women,Domestic Violence,Male,0-12,382,116,266,135,247
2006,Urban,Telangana,Property Crime,Theft,Female,46-60,5977,5554,423,5713,264
2005,Rural,Andhra Pradesh,Property Crime,Theft,Male,31-45,3708,3401,307,3417,291
2002,Rural,Himachal Pradesh,Property Crime,Burglary,Male,60+,6006,1870,4136,4024,1982
2009,Rural,Karnataka,Property Crime,Vandalism,Female,46-60,5575,1793,3782,3938,1637
2009,Urban,Tamil Nadu,Crime Against Women,Rape,Male,13-17,1732,999,733,1614,118
2009,Urban,Himachal Pradesh,Property Crime,Theft,Male,0-12,2806,283,2523,1116,1690
2004,Urban,Meghalaya,Crime Against Men,Extortion,Male,13-17,7304,610,6694,1751,5553
2001,Rural,Bihar,Crime Against Women,Molestation,Female,46-60,97,75,22,80,17
2007,Rural,Meghalaya,Crime Against Children,Kidnapping,Female,0-12,1799,1297,502,1752,47
2006,Urban,Uttar Pradesh,Crime Against Women,Rape,Female,18-30,9407,470,8937,6599,2808
2010,Rural,Jharkhand,Crime Against Women,Molestation,Female,0-12,955,802,153,899,56
2005,Urban,Uttarakhand,Crime Against Women,Domestic Violence,Female,0-12,9962,7572,2390,9093,869
2008,Urban,Telangana,Crime Against Children,Child Labor,Male,60+,2318,760,1558,2287,31
2008,Rural,Mizoram,Property Crime,Vandalism,Female,46-60,7978,5026,2952,6946,1032
2004,Rural,Delhi,Other Crimes,Drug Offense,Female,46-60,9112,8908,204,8913,199
2002,Urban,Maharashtra,Crime Against Women,Rape,Female,0-12,4845,1235,3610,1354,3491
2006,Rural,Tripura,Property Crime,Arson,Female,46-60,3945,3178,767,3790,155
2009,Urban,Rajasthan,Crime Against Women,Rape,Male,46-60,3501,694,2807,2675,826
2003,Rural,Tamil Nadu,Other Crimes,Cyber Crime,Female,60+,1844,1221,623,1541,303
2008,Rural,Jharkhand,Property Crime,Arson,Male,46-60,8791,4530,4261,8591,200
2010,Urban,Telangana,Crime Against Children,Child Abuse,Female,31-45,2947,1576,1371,2670,277
2005,Rural,Tripura,Crime Against Women,Molestation,Female,13-17,317,153,164,259,58
2008,Rural,Delhi,Crime Against Women,Domestic Violence,Male,60+,2465,2221,244,2320,145
2001,Urban,Madhya Pradesh,Other Crimes,Drug Offense,Female,31-45,3168,621,2547,3154,14
2009,Rural,Manipur,Crime Against Men,Robbery,Male,31-45,8543,6263,2280,7489,1054
2009,Rural,Punjab,Crime Against Children,Child Labor,Female,13-17,7573,5378,2195,7426,147
2003,Rural,Uttarakhand,Crime Against Children,Trafficking,Female,31-45,4115,644,3471,2389,1726
2009,Rural,Mizoram,Property Crime,Vandalism,Female,18-30,8314,363,7951,6493,1821
2001,Urban,Andhra Pradesh,Crime Against Children,Child Labor,Male,13-17,6933,1336,5597,3506,3427
2002,Urban,Uttarakhand,Crime Against Men,Extortion,Male,60+,5230,1282,3948,2740,2490
2003,Urban,Jammu & Kashmir,Crime Against Children,Trafficking,Male,13-17,881,105,776,830,51
2006,Rural,Telangana,Crime Against Women,Rape,Male,13-17,9672,7680,1992,9215,457
2005,Urban,Telangana,Property Crime,Theft,Female,60+,7329,1107,6222,2396,4933
2003,Urban,Sikkim,Crime Against Children,Kidnapping,Female,60+,3382,3308,74,3372,10
2008,Rural,West Bengal,Property Crime,Arson,Female,60+,6265,5933,332,5990,275
2002,Rural,West Bengal,Crime Against Children,Child Abuse,Male,31-45,9698,8973,725,9075,623
2002,Urban,Gujarat,Other Crimes,Drug Offense,Female,46-60,2224,2119,105,2163,61
2005,Rural,Maharashtra,Other Crimes,Drug Offense,Female,13-17,7475,5885,1590,6044,1431
2001,Urban,Odisha,Property Crime,Theft,Male,31-45,2593,298,2295,1808,785
2002,Rural,Uttar Pradesh,Crime Against Men,Robbery,Female,0-12,5520,3294,2226,4525,995
2009,Rural,Jammu & Kashmir,Crime Against Women,Domestic Violence,Male,46-60,2262,2178,84,2209,53
2001,Rural,Himachal Pradesh,Property Crime,Vandalism,Female,46-60,1086,65,1021,862,224
2010,Rural,Punjab,Crime Against Women,Rape,Male,18-30,212,26,186,189,23
2002,Rural,Jammu & Kashmir,Crime Against Men,Extortion,Male,0-12,113,112,1,112,1
2004,Urban,Punjab,Crime Against Children,Child Labor,Female,31-45,8499,7785,714,7797,702
2005,Rural,Bihar,Crime Against Children,Child Abuse,Male,31-45,1991,288,1703,1683,308
2002,Rural,Telangana,Crime Against Children,Trafficking,Female,60+,3263,2419,844,2901,362
2002,Rural,Manipur,Property Crime,Arson,Male,60+,6781,732,6049,5526,1255
2009,Urban,Chhattisgarh,Other Crimes,Corruption,Male,18-30,6528,5457,1071,5708,820
2010,Urban,Karnataka,Crime Against Men,Assault,Male,46-60,7454,1813,5641,2573,4881
2008,Urban,Karnataka,Crime Against Women,Rape,Male,0-12,409,383,26,408,1
2004,Rural,Madhya Pradesh,Crime Against Children,Kidnapping,Male,13-17,9411,3411,6000,6626,2785
2007,Urban,Rajasthan,Crime Against Children,Child Labor,Female,31-45,5382,4479,903,4761,621
2005,Urban,Arunachal Pradesh,Crime Against Women,Rape,Male,46-60,9348,4552,4796,4570,4778
2004,Rural,Jammu & Kashmir,Crime Against Men,Extortion,Male,13-17,1684,601,1083,881,803
2002,Urban,Himachal Pradesh,Crime Against Men,Assault,Female,46-60,8073,55,8018,7774,299
2005,Rural,Gujarat,Other Crimes,Cyber Crime,Female,0-12,2022,1964,58,1985,37
2001,Rural,Haryana,Crime Against Men,Assault,Male,31-45,2711,2464,247,2565,146
2002,Urban,Karnataka,Crime Against Children,Child Abuse,Female,31-45,6496,5490,1006,6070,426
2006,Urban,Bihar,Crime Against Children,Kidnapping,Male,46-60,7270,6395,875,7131,139
2010,Rural,Punjab,Crime Against Children,Child Abuse,Female,46-60,5176,1063,4113,4601,575
2001,Urban,Tamil Nadu,Crime Against Women,Rape,Male,31-45,2867,2636,231,2783,84
2008,Rural,Manipur,Crime Against Women,Rape,Male,13-17,8263,205,8058,6444,1819
2001,Urban,Telangana,Other Crimes,Corruption,Male,46-60,7534,6539,995,7026,508
2001,Rural,Nagaland,Crime Against Women,Rape,Male,46-60,8251,42,8209,3117,5134
2006,Urban,Tamil Nadu,Other Crimes,Cyber Crime,Female,46-60,3331,2552,779,3087,244
2009,Rural,Maharashtra,Crime Against Children,Child Abuse,Female,13-17,8974,2585,6389,4754,4220
2007,Rural,Arunachal Pradesh,Crime Against Men,Assault,Male,0-12,8377,1932,6445,5616,2761
2002,Urban,Manipur,Crime Against Men,Assault,Male,60+,9245,2274,6971,6644,2601
2010,Urban,Uttarakhand,Crime Against Children,Child Abuse,Male,31-45,4273,3167,1106,3724,549
2002,Rural,Sikkim,Crime Against Children,Child Abuse,Female,31-45,5084,3104,1980,5000,84
2003,Urban,West Bengal,Property Crime,Burglary,Female,0-12,4807,1017,3790,1782,3025
2003,Urban,Goa,Crime Against Children,Kidnapping,Male,13-17,5353,5030,323,5332,21
2006,Rural,Mizoram,Other Crimes,Cyber Crime,Female,60+,961,928,33,957,4
2005,Urban,Goa,Property Crime,Burglary,Male,13-17,3985,3522,463,3644,341
2002,Rural,Madhya Pradesh,Crime Against Men,Robbery,Female,18-30,6707,29,6678,642,6065
2007,Urban,Bihar,Other Crimes,Cyber Crime,Female,0-12,7738,3764,3974,6150,1588
2005,Urban,Kerala,Crime Against Women,Rape,Female,18-30,7308,1187,6121,5638,1670
2004,Urban,Delhi,Other Crimes,Corruption,Female,13-17,6650,1486,5164,6485,165
2008,Rural,Kerala,Other Crimes,Fraud,Female,13-17,2070,1821,249,1957,113
2008,Rural,Haryana,Property Crime,Arson,Female,13-17,6784,1868,4916,4209,2575
2007,Rural,Assam,Other Crimes,Cyber Crime,Male,0-12,9541,3071,6470,4481,5060
2004,Rural,Uttarakhand,Crime Against Children,Child Labor,Female,18-30,4556,2284,2272,3176,1380
2002,Rural,Jammu & Kashmir,Crime Against Men,Robbery,Female,0-12,5104,392,4712,848,4256
2003,Urban,Telangana,Property Crime,Vandalism,Female,18-30,3577,831,2746,1585,1992
2008,Rural,Maharashtra,Crime Against Men,Assault,Male,0-12,1997,416,1581,1815,182
2008,Rural,Meghalaya,Crime Against Women,Molestation,Male,18-30,7507,1126,6381,4283,3224
2006,Urban,Bihar,Crime Against Women,Rape,Male,13-17,149,118,31,118,31
2003,Urban,Telangana,Property Crime,Arson,Female,13-17,1414,1115,299,1165,249
2008,Rural,Rajasthan,Crime Against Men,Assault,Female,0-12,6353,3896,2457,4832,1521
2005,Urban,Chhattisgarh,Crime Against Children,Kidnapping,Male,13-17,8812,3526,5286,8026,786
2006,Rural,Goa,Crime Against Women,Rape,Male,0-12,5179,858,4321,3723,1456
2006,Rural,Madhya Pradesh,Crime Against Women,Rape,Female,60+,7189,4242,2947,6096,1093
2005,Urban,Delhi,Other Crimes,Fraud,Female,46-60,3437,2132,1305,2874,563
2010,Urban,Punjab,Crime Against Children,Kidnapping,Female,31-45,6934,1493,5441,4388,2546
2010,Rural,Chhattisgarh,Crime Against Women,Molestation,Male,18-30,5225,592,4633,2595,2630
2008,Rural,Delhi,Crime Against Women,Domestic Violence,Female,46-60,7737,2054,5683,3482,4255
2006,Urban,Karnataka,Crime Against Children,Child Labor,Female,0-12,422,139,283,406,16
2009,Urban,Sikkim,Other Crimes,Fraud,Male,0-12,8992,6594,2398,7448,1544
2007,Urban,Assam,Crime Against Women,Domestic Violence,Male,60+,3436,823,2613,2200,1236
2008,Urban,Arunachal Pradesh,Property Crime,Vandalism,Female,46-60,7028,6501,527,6836,192
2007,Rural,Himachal Pradesh,Crime Against Children,Child Labor,Female,18-30,4724,659,4065,3186,1538
2003,Rural,Mizoram,Other Crimes,Drug Offense,Male,31-45,3928,1595,2333,3639,289
2005,Urban,Meghalaya,Crime Against Men,Assault,Female,13-17,4925,3394,1531,4139,786
2004,Rural,Meghalaya,Crime Against Children,Trafficking,Male,31-45,4085,678,3407,2441,1644
2005,Urban,Madhya Pradesh,Crime Against Children,Child Abuse,Male,13-17,2314,357,1957,676,1638
2007,Urban,Mizoram,Property Crime,Arson,Female,46-60,9427,5863,3564,6168,3259
2006,Rural,Maharashtra,Crime Against Women,Domestic Violence,Male,0-12,9472,6410,3062,7428,2044
2002,Rural,Jharkhand,Crime Against Women,Rape,Male,13-17,4063,2188,1875,2832,1231
2008,Rural,Andhra Pradesh,Crime Against Men,Robbery,Male,31-45,909,425,484,895,14
2005,Rural,Tamil Nadu,Other Crimes,Corruption,Male,0-12,6545,6270,275,6274,271
2003,Rural,Kerala,Crime Against Men,Robbery,Female,60+,6321,1853,4468,5110,1211
2006,Rural,Punjab,Crime Against Children,Child Labor,Male,13-17,6170,5364,806,6052,118
2009,Rural,Jammu & Kashmir,Property Crime,Vandalism,Female,46-60,4393,3851,542,4282,111
2009,Rural,Assam,Crime Against Women,Molestation,Male,18-30,7115,3792,3323,4461,2654
2005,Urban,Punjab,Crime Against Women,Rape,Female,13-17,1633,779,854,786,847
2008,Rural,Jammu & Kashmir,Crime Against Women,Rape,Male,13-17,1348,525,823,1348,0
2007,Urban,Assam,Property Crime,Arson,Male,46-60,3981,1833,2148,1904,2077
2006,Urban,Mizoram,Property Crime,Burglary,Female,31-45,6528,4339,2189,4909,1619
2003,Urban,Meghalaya,Property Crime,Burglary,Female,0-12,9933,6974,2959,8897,1036
2004,Urban,Meghalaya,Crime Against Women,Molestation,Female,60+,9104,8012,1092,8241,863
2006,Urban,Tripura,Crime Against Women,Rape,Female,13-17,7229,6006,1223,6166,1063
2005,Rural,Himachal Pradesh,Property Crime,Theft,Female,0-12,4216,3163,1053,3317,899
2005,Rural,Telangana,Crime Against Children,Child Abuse,Female,60+,5769,5621,148,5635,134
2002,Rural,Tripura,Crime Against Men,Robbery,Male,31-45,2274,843,1431,863,1411
2004,Urban,Jharkhand,Crime Against Women,Dowry Deaths,Female,60+,9067,1473,7594,6668,2399
2004,Urban,Telangana,Crime Against Children,Trafficking,Male,0-12,4319,3492,827,3736,583
2009,Urban,Tamil Nadu,Other Crimes,Fraud,Female,31-45,9361,4226,5135,6854,2507
2009,Rural,Jharkhand,Property Crime,Vandalism,Female,46-60,8154,789,7365,7241,913
2003,Rural,Tripura,Crime Against Children,Child Abuse,Male,46-60,8863,19,8844,8410,453
2010,Rural,Madhya Pradesh,Other Crimes,Corruption,Female,46-60,5623,4042,1581,4753,870
2005,Rural,Punjab,Crime Against Men,Assault,Male,46-60,3587,534,3053,1590,1997
2009,Rural,Gujarat,Crime Against Women,Domestic Violence,Female,31-45,7105,6217,888,6791,314
2009,Urban,Goa,Crime Against Children,Kidnapping,Female,46-60,6874,562,6312,1048,5826
2004,Rural,Punjab,Crime Against Men,Robbery,Male,0-12,5891,4614,1277,4673,1218
2006,Urban,Arunachal Pradesh,Crime Against Children,Child Labor,Female,60+,8897,7337,1560,7559,1338
2005,Rural,Uttarakhand,Crime Against Men,Murder,Male,0-12,4246,3503,743,4023,223
2002,Rural,Nagaland,Other Crimes,Corruption,Female,46-60,2269,1666,603,1955,314
2008,Rural,Tamil Nadu,Property Crime,Vandalism,Female,13-17,2136,331,1805,593,1543
2001,Rural,Jammu & Kashmir,Crime Against Men,Extortion,Male,31-45,3969,571,3398,1933,2036
2003,Urban,Manipur,Crime Against Women,Rape,Male,13-17,2538,203,2335,1911,627
2007,Rural,Mizoram,Other Crimes,Fraud,Male,60+,8447,707,7740,1046,7401
2002,Urban,Telangana,Other Crimes,Fraud,Male,0-12,3151,1688,1463,1869,1282
2002,Urban,Telangana,Crime Against Children,Trafficking,Female,0-12,1716,1218,498,1526,190
2002,Rural,Punjab,Crime Against Children,Kidnapping,Female,13-17,6586,4168,2418,4378,2208
2007,Rural,Himachal Pradesh,Property Crime,Burglary,Male,31-45,3950,1545,2405,3555,395
2007,Urban,West Bengal,Crime Against Children,Child Abuse,Male,13-17,4082,2395,1687,3738,344
2005,Urban,Bihar,Crime Against Women,Domestic Violence,Female,13-17,4788,4767,21,4781,7
2010,Rural,Chhattisgarh,Other Crimes,Drug Offense,Male,31-45,1193,181,1012,1051,142
2005,Urban,Jammu & Kashmir,Crime Against Children,Kidnapping,Female,60+,2265,42,2223,824,1441
2002,Rural,Tamil Nadu,Crime Against Men,Extortion,Male,46-60,4193,3993,200,4149,44
2003,Rural,Madhya Pradesh,Property Crime,Burglary,Male,13-17,7427,5521,1906,6924,503
2006,Urban,Kerala,Crime Against Women,Molestation,Male,46-60,3214,72,3142,2042,1172
2001,Urban,West Bengal,Property Crime,Vandalism,Male,31-45,3196,3008,188,3171,25
2003,Rural,Arunachal Pradesh,Crime Against Women,Dowry Deaths,Male,0-12,6442,2713,3729,4663,1779
2004,Rural,Jammu & Kashmir,Crime Against Men,Assault,Male,60+,3180,36,3144,1715,1465
2003,Rural,Andhra Pradesh,Crime Against Children,Child Labor,Male,60+,7672,5943,1729,6207,1465
2009,Urban,Andhra Pradesh,Crime Against Men,Murder,Male,60+,4714,4651,63,4656,58
2006,Urban,Meghalaya,Other Crimes,Cyber Crime,Male,18-30,3619,1756,1863,2905,714
2001,Rural,Mizoram,Crime Against Women,Rape,Male,31-45,1270,773,497,1209,61
2006,Rural,West Bengal,Other Crimes,Cyber Crime,Female,13-17,3990,926,3064,3934,56
2004,Urban,Kerala,Crime Against Men,Murder,Male,31-45,2387,1657,730,1677,710
2010,Urban,Delhi,Crime Against Women,Dowry Deaths,Male,0-12,5749,4297,1452,4489,1260
2002,Rural,Mizoram,Property Crime,Arson,Female,31-45,7656,5249,2407,6385,1271
2003,Rural,Maharashtra,Crime Against Women,Molestation,Male,46-60,2536,1264,1272,1921,615
2004,Rural,Haryana,Property Crime,Vandalism,Male,18-30,3298,1170,2128,2740,558
2004,Urban,Tamil Nadu,Crime Against Men,Murder,Male,31-45,4213,806,3407,3726,487
2010,Urban,Jharkhand,Crime Against Men,Murder,Female,0-12,5032,1872,3160,4957,75
2006,Rural,Himachal Pradesh,Crime Against Children,Child Abuse,Male,60+,84,74,10,74,10
2004,Urban,Manipur,Property Crime,Vandalism,Female,13-17,6097,3543,2554,4778,1319
2001,Rural,Haryana,Other Crimes,Drug Offense,Female,60+,2745,1228,1517,1553,1192
2003,Rural,Andhra Pradesh,Crime Against Children,Child Labor,Male,0-12,7408,649,6759,3709,3699
2004,Rural,Mizoram,Crime Against Women,Molestation,Female,46-60,8763,1543,7220,2031,6732
2001,Urban,Maharashtra,Property Crime,Burglary,Male,18-30,7698,1480,6218,6163,1535
2010,Rural,Haryana,Property Crime,Vandalism,Male,46-60,6660,5479,1181,6247,413
2006,Urban,Himachal Pradesh,Crime Against Women,Rape,Female,18-30,4686,2398,2288,4466,220
2004,Rural,Tripura,Other Crimes,Drug Offense,Male,31-45,1909,508,1401,953,956
2001,Urban,Assam,Crime Against Children,Child Abuse,Male,60+,4416,2279,2137,2802,1614
2007,Rural,Chhattisgarh,Crime Against Women,Molestation,Male,13-17,3705,1930,1775,3575,130
2009,Rural,Kerala,Crime Against Women,Dowry Deaths,Male,60+,3236,2129,1107,2563,673
2003,Urban,Karnataka,Property Crime,Burglary,Female,0-12,7814,5264,2550,7592,222
2010,Rural,West Bengal,Crime Against Women,Molestation,Female,46-60,3048,2737,311,3017,31
2004,Rural,Haryana,Crime Against Women,Dowry Deaths,Female,0-12,4381,1209,3172,3230,1151
2005,Rural,Mizoram,Other Crimes,Corruption,Female,60+,3395,1339,2056,2728,667
2006,Urban,Meghalaya,Crime Against Men,Extortion,Female,0-12,7850,6147,1703,6967,883
2006,Urban,Himachal Pradesh,Crime Against Women,Molestation,Female,60+,5012,2264,2748,3477,1535
2009,Rural,Goa,Crime Against Children,Trafficking,Female,0-12,2619,997,1622,2066,553
2005,Rural,Punjab,Crime Against Men,Extortion,Female,60+,4010,595,3415,945,3065
2009,Urban,Kerala,Other Crimes,Drug Offense,Male,0-12,7904,4081,3823,4954,2950
2010,Rural,Nagaland,Crime Against Women,Rape,Male,0-12,871,33,838,57,814
2010,Rural,Kerala,Other Crimes,Fraud,Male,60+,3613,1191,2422,1539,2074
2004,Urban,Gujarat,Crime Against Men,Robbery,Male,31-45,5218,1826,3392,3521,1697
2009,Urban,Gujarat,Property Crime,Arson,Male,13-17,5612,2772,2840,4344,1268
2004,Rural,Delhi,Crime Against Women,Dowry Deaths,Male,18-30,994,626,368,824,170
2001,Rural,Jharkhand,Property Crime,Burglary,Female,60+,6872,2838,4034,5556,1316
2002,Urban,Himachal Pradesh,Crime Against Women,Domestic Violence,Male,18-30,4299,278,4021,1202,3097
2002,Urban,Maharashtra,Crime Against Men,Assault,Female,0-12,5170,796,4374,4902,268
2001,Rural,Punjab,Property Crime,Burglary,Male,13-17,9642,9615,27,9640,2
2001,Rural,Jammu & Kashmir,Property Crime,Vandalism,Female,31-45,2917,16,2901,2114,803
2006,Rural,Uttar Pradesh,Crime Against Men,Extortion,Male,60+,6769,6341,428,6591,178
2002,Urban,Karnataka,Crime Against Children,Child Abuse,Male,18-30,8044,6638,1406,7588,456
2006,Urban,Assam,Crime Against Children,Child Labor,Male,13-17,5162,1721,3441,3726,1436
2009,Urban,Arunachal Pradesh,Property Crime,Arson,Female,0-12,4798,864,3934,4556,242
2009,Urban,Rajasthan,Crime Against Women,Dowry Deaths,Female,31-45,674,60,614,587,87
2004,Rural,Delhi,Crime Against Men,Extortion,Female,31-45,4143,1840,2303,3189,954
2002,Rural,Telangana,Crime Against Men,Murder,Female,46-60,6885,1483,5402,4408,2477
2009,Urban,Meghalaya,Other Crimes,Fraud,Male,31-45,5371,819,4552,4883,488
2001,Rural,Meghalaya,Crime Against Children,Kidnapping,Male,18-30,354,71,283,213,141
2006,Urban,Mizoram,Crime Against Men,Extortion,Male,18-30,1187,83,1104,297,890
2004,Urban,Assam,Crime Against Children,Child Abuse,Female,18-30,5306,2403,2903,4525,781
2002,Urban,Gujarat,Crime Against Women,Rape,Female,31-45,4770,4746,24,4763,7
2006,Urban,Chhattisgarh,Crime Against Men,Assault,Female,31-45,9017,2652,6365,8819,198
2007,Rural,Gujarat,Crime Against Men,Extortion,Male,0-12,5529,4785,744,4840,689
2001,Urban,Chhattisgarh,Crime Against Women,Rape,Female,46-60,920,763,157,772,148
2010,Rural,Andhra Pradesh,Crime Against Women,Rape,Male,0-12,2686,309,2377,2213,473
2004,Rural,Tripura,Crime Against Children,Trafficking,Male,0-12,2160,9,2151,213,1947
2007,Rural,Uttarakhand,Property Crime,Burglary,Female,18-30,8406,8384,22,8389,17
2005,Rural,Tamil Nadu,Property Crime,Vandalism,Female,60+,2705,87,2618,1285,1420
2003,Rural,Punjab,Crime Against Women,Molestation,Female,13-17,5365,4947,418,5086,279
2005,Urban,Arunachal Pradesh,Other Crimes,Drug Offense,Male,31-45,7888,800,7088,3818,4070
2002,Urban,Tamil Nadu,Crime Against Children,Child Labor,Female,0-12,2694,732,1962,999,1695
2005,Urban,Odisha,Crime Against Women,Rape,Female,31-45,3582,550,3032,949,2633
2009,Rural,Uttarakhand,Crime Against Men,Assault,Female,18-30,6602,3358,3244,3501,3101
2001,Urban,Sikkim,Crime Against Men,Extortion,Female,46-60,9356,129,9227,8550,806
2007,Urban,Goa,Crime Against Women,Rape,Female,46-60,2335,1959,376,2120,215
2004,Urban,Maharashtra,Property Crime,Burglary,Female,13-17,7810,801,7009,2950,4860
2005,Urban,Chhattisgarh,Crime Against Children,Child Labor,Female,18-30,167,60,107,118,49
2005,Rural,Karnataka,Crime Against Children,Child Labor,Male,31-45,8332,3185,5147,6747,1585
2003,Urban,Rajasthan,Crime Against Women,Molestation,Male,46-60,5429,4209,1220,4953,476
2001,Urban,Maharashtra,Property Crime,Vandalism,Female,60+,6868,1994,4874,5921,947
2003,Rural,Jammu & Kashmir,Crime Against Men,Extortion,Female,18-30,8284,7371,913,7460,824
2001,Rural,Uttarakhand,Crime Against Children,Trafficking,Female,31-45,1172,880,292,930,242
2001,Rural,Meghalaya,Crime Against Women,Rape,Female,60+,4167,4052,115,4089,78
2002,Rural,Uttar Pradesh,Crime Against Men,Extortion,Female,0-12,83,32,51,66,17
2005,Urban,Jharkhand,Crime Against Children,Child Labor,Female,13-17,3796,419,3377,1721,2075
2006,Urban,Himachal Pradesh,Crime Against Women,Domestic Violence,Male,60+,3431,3255,176,3431,0
2002,Rural,Tamil Nadu,Crime Against Men,Assault,Male,18-30,8619,6085,2534,8244,375
2009,Urban,Chhattisgarh,Crime Against Women,Dowry Deaths,Male,0-12,2308,329,1979,2010,298
2003,Urban,Goa,Property Crime,Vandalism,Male,0-12,2925,433,2492,773,2152
2005,Urban,Telangana,Crime Against Men,Extortion,Female,13-17,9827,9713,114,9762,65
2001,Urban,Andhra Pradesh,Crime Against Men,Robbery,Male,60+,1919,1443,476,1529,390
2003,Rural,Andhra Pradesh,Crime Against Men,Extortion,Male,31-45,893,220,673,533,360
2010,Rural,Delhi,Property Crime,Arson,Female,46-60,3556,2305,1251,2633,923
2001,Rural,Tripura,Crime Against Men,Murder,Female,13-17,5299,2279,3020,2678,2621
2008,Urban,Kerala,Crime Against Men,Robbery,Male,0-12,3211,1993,1218,2144,1067
2009,Urban,Sikkim,Property Crime,Burglary,Male,46-60,7314,3939,3375,5724,1590
2008,Rural,Maharashtra,Property Crime,Theft,Female,60+,1600,454,1146,969,631
2010,Urban,Maharashtra,Crime Against Women,Dowry Deaths,Female,31-45,3572,1309,2263,3111,461
2010,Rural,Tripura,Crime Against Children,Child Abuse,Female,18-30,9737,256,9481,6523,3214
2006,Urban,Arunachal Pradesh,Crime Against Children,Kidnapping,Male,0-12,2774,993,1781,1147,1627
2008,Rural,Odisha,Crime Against Women,Domestic Violence,Male,13-17,4129,3001,1128,3986,143
2006,Rural,Sikkim,Other Crimes,Drug Offense,Male,46-60,7256,5389,1867,7243,13
2004,Urban,Uttar Pradesh,Other Crimes,Fraud,Female,46-60,4664,3414,1250,4287,377
2002,Rural,Jharkhand,Crime Against Women,Rape,Male,13-17,1510,992,518,1072,438
2004,Urban,Arunachal Pradesh,Property Crime,Vandalism,Male,60+,3374,968,2406,2491,883
2009,Urban,Meghalaya,Crime Against Children,Trafficking,Male,31-45,8599,8548,51,8569,30
2009,Urban,Andhra Pradesh,Crime Against Men,Extortion,Female,18-30,5608,4234,1374,4578,1030
2001,Rural,Karnataka,Property Crime,Arson,Female,60+,9961,324,9637,1314,8647
2009,Rural,Delhi,Property Crime,Theft,Male,0-12,753,331,422,675,78
2004,Rural,Haryana,Crime Against Women,Dowry Deaths,Male,31-45,5572,2772,2800,2913,2659
2005,Urban,Bihar,Other Crimes,Fraud,Male,18-30,8166,4303,3863,5300,2866
2010,Urban,Uttarakhand,Crime Against Children,Trafficking,Male,60+,5038,4018,1020,4278,760
2010,Urban,Punjab,Crime Against Women,Domestic Violence,Female,31-45,3739,3114,625,3530,209
2008,Rural,Mizoram,Crime Against Children,Child Abuse,Male,46-60,73,16,57,31,42
2010,Urban,Manipur,Property Crime,Theft,Male,60+,4933,1137,3796,4468,465
2010,Urban,Rajasthan,Crime Against Women,Domestic Violence,Male,46-60,2412,131,2281,528,1884
2005,Urban,Meghalaya,Crime Against Men,Assault,Female,13-17,9797,5922,3875,6060,3737
2003,Rural,Andhra Pradesh,Crime Against Men,Murder,Female,46-60,2392,960,1432,1406,986
2007,Rural,Maharashtra,Other Crimes,Drug Offense,Male,31-45,2857,1972,885,2470,387
2005,Rural,Tripura,Other Crimes,Cyber Crime,Female,0-12,9394,8235,1159,8239,1155
2003,Rural,Assam,Property Crime,Vandalism,Male,18-30,5577,3579,1998,4169,1408
2002,Urban,Andhra Pradesh,Crime Against Women,Rape,Male,0-12,680,112,568,635,45
2005,Rural,West Bengal,Crime Against Children,Trafficking,Female,31-45,1537,1073,464,1089,448
2009,Rural,Meghalaya,Crime Against Men,Murder,Male,31-45,224,13,211,117,107
2007,Rural,Jharkhand,Other Crimes,Drug Offense,Female,18-30,9344,1291,8053,4522,4822
2006,Urban,Andhra Pradesh,Property Crime,Burglary,Female,46-60,4566,4530,36,4555,11
2008,Rural,Uttarakhand,Crime Against Children,Kidnapping,Male,18-30,5795,5115,680,5766,29
2010,Rural,West Bengal,Other Crimes,Fraud,Male,18-30,7946,7509,437,7749,197
2005,Rural,Odisha,Crime Against Men,Assault,Female,31-45,7524,4736,2788,5404,2120
2004,Rural,Odisha,Crime Against Children,Child Labor,Male,46-60,2628,646,1982,817,1811
2006,Urban,Jharkhand,Crime Against Children,Child Labor,Female,13-17,7520,5795,1725,6844,676
2003,Urban,Mizoram,Crime Against Women,Dowry Deaths,Male,31-45,780,328,452,570,210
2008,Urban,Meghalaya,Property Crime,Vandalism,Female,31-45,9559,2418,7141,9310,249
2004,Urban,Tamil Nadu,Other Crimes,Fraud,Female,60+,6253,1397,4856,3999,2254
2007,Rural,Rajasthan,Other Crimes,Fraud,Female,18-30,7021,4353,2668,5673,1348
2010,Urban,Haryana,Other Crimes,Cyber Crime,Male,18-30,6765,1858,4907,4211,2554
2005,Rural,Nagaland,Other Crimes,Cyber Crime,Female,60+,5210,3946,1264,4972,238
2001,Urban,Telangana,Crime Against Women,Molestation,Male,0-12,5994,5943,51,5968,26
2002,Rural,Maharashtra,Other Crimes,Drug Offense,Female,18-30,1910,1258,652,1691,219
2009,Urban,Meghalaya,Other Crimes,Cyber Crime,Male,46-60,2953,2563,390,2819,134
2006,Urban,Chhattisgarh,Property Crime,Arson,Female,0-12,8486,7370,1116,7729,757
2010,Rural,Kerala,Crime Against Women,Molestation,Female,60+,3299,1146,2153,1718,1581
2010,Rural,Sikkim,Crime Against Women,Rape,Male,0-12,8394,6981,1413,8287,107
2004,Urban,Gujarat,Crime Against Children,Kidnapping,Female,0-12,8160,4886,3274,8021,139
2009,Rural,Jharkhand,Crime Against Men,Extortion,Female,46-60,2279,1438,841,1637,642
2003,Urban,West Bengal,Crime Against Children,Child Abuse,Male,31-45,4168,1765,2403,3991,177
2006,Urban,Meghalaya,Property Crime,Burglary,Male,31-45,442,6,436,405,37
2001,Urban,Jammu & Kashmir,Crime Against Men,Robbery,Male,13-17,8429,2315,6114,2446,5983
2010,Rural,Gujarat,Crime Against Children,Kidnapping,Male,46-60,2318,2147,171,2262,56
2001,Rural,Punjab,Crime Against Children,Kidnapping,Female,31-45,5785,4700,1085,5171,614
2004,Urban,Jharkhand,Crime Against Children,Child Abuse,Female,0-12,9793,2997,6796,5364,4429
2001,Rural,Himachal Pradesh,Crime Against Women,Dowry Deaths,Female,0-12,3716,3165,551,3554,162
2007,Urban,Uttar Pradesh,Crime Against Women,Molestation,Male,0-12,9711,8075,1636,9086,625
2007,Urban,Uttar Pradesh,Crime Against Women,Domestic Violence,Female,60+,333,271,62,299,34
2005,Urban,Sikkim,Crime Against Children,Child Abuse,Male,18-30,8619,3963,4656,4904,3715
2008,Urban,Himachal Pradesh,Crime Against Women,Domestic Violence,Male,0-12,9619,3565,6054,4860,4759
2005,Urban,Gujarat,Crime Against Men,Assault,Male,0-12,5420,2432,2988,3877,1543
2006,Urban,Delhi,Property Crime,Theft,Female,13-17,8593,7886,707,8580,13
2005,Rural,Odisha,Crime Against Women,Rape,Male,13-17,391,106,285,179,212
2004,Rural,Arunachal Pradesh,Property Crime,Vandalism,Male,0-12,2020,1550,470,1635,385
2009,Rural,Sikkim,Property Crime,Vandalism,Female,18-30,1079,997,82,1041,38
2002,Urban,Tripura,Crime Against Children,Trafficking,Female,0-12,6291,2976,3315,3931,2360
2010,Urban,Gujarat,Crime Against Children,Child Abuse,Male,13-17,1342,604,738,816,526
2002,Urban,Chhattisgarh,Property Crime,Burglary,Male,60+,9498,3277,6221,6916,2582
2008,Urban,Madhya Pradesh,Crime Against Women,Domestic Violence,Male,31-45,6889,1965,4924,5353,1536
2006,Rural,Delhi,Property Crime,Arson,Male,31-45,1244,770,474,1005,239
2010,Urban,Andhra Pradesh,Crime Against Children,Child Abuse,Female,18-30,535,91,444,393,142
2005,Urban,Tripura,Other Crimes,Drug Offense,Male,13-17,4145,4130,15,4131,14
2001,Urban,Andhra Pradesh,Property Crime,Vandalism,Female,60+,6199,4824,1375,4863,1336
2003,Rural,Meghalaya,Property Crime,Theft,Female,60+,161,13,148,23,138
2009,Rural,Tamil Nadu,Other Crimes,Fraud,Male,31-45,1022,488,534,930,92
2004,Urban,Bihar,Other Crimes,Fraud,Female,13-17,267,124,143,140,127
2009,Rural,Sikkim,Crime Against Men,Murder,Female,60+,3096,2824,272,3013,83
2004,Urban,Rajasthan,Crime Against Women,Rape,Female,60+,6795,4039,2756,5313,1482
2002,Urban,Punjab,Other Crimes,Corruption,Female,31-45,5172,1314,3858,1873,3299
2006,Urban,Himachal Pradesh,Crime Against Children,Child Abuse,Male,13-17,3364,515,2849,3248,116
2001,Rural,Madhya Pradesh,Crime Against Men,Murder,Male,46-60,5290,4721,569,4882,408
2001,Rural,West Bengal,Property Crime,Theft,Male,0-12,6902,1179,5723,3283,3619
2005,Rural,Tamil Nadu,Property Crime,Burglary,Female,60+,3773,796,2977,1732,2041
2004,Urban,Goa,Crime Against Women,Domestic Violence,Male,0-12,2826,1492,1334,2122,704
2008,Urban,Karnataka,Crime Against Women,Molestation,Male,18-30,7838,7174,664,7678,160
2004,Rural,Rajasthan,Crime Against Men,Assault,Male,13-17,2495,1678,817,2035,460
2009,Urban,West Bengal,Crime Against Men,Murder,Male,31-45,3546,1249,2297,3045,501
2003,Rural,Kerala,Property Crime,Burglary,Female,0-12,3144,735,2409,755,2389
2006,Urban,Uttarakhand,Crime Against Children,Kidnapping,Male,13-17,3806,1863,1943,2870,936
2008,Rural,Nagaland,Crime Against Children,Trafficking,Female,46-60,3057,1833,1224,2751,306
2010,Rural,Karnataka,Crime Against Children,Child Abuse,Female,0-12,1787,294,1493,1402,385
2003,Urban,Tripura,Crime Against Men,Murder,Female,13-17,7428,763,6665,1480,5948
2007,Urban,Sikkim,Crime Against Children,Trafficking,Male,0-12,2293,1515,778,1657,636
2001,Rural,Bihar,Crime Against Women,Molestation,Female,31-45,118,65,53,70,48
2007,Rural,Himachal Pradesh,Property Crime,Vandalism,Female,60+,6022,2005,4017,5490,532
2005,Rural,Gujarat,Crime Against Men,Assault,Male,60+,8155,2273,5882,2715,5440
2003,Rural,Manipur,Crime Against Children,Child Labor,Male,60+,62,11,51,14,48
2009,Urban,Haryana,Crime Against Women,Rape,Female,13-17,3549,771,2778,2871,678
2007,Rural,Goa,Other Crimes,Corruption,Female,18-30,6942,61,6881,462,6480
2010,Urban,Odisha,Crime Against Children,Child Abuse,Male,60+,294,224,70,279,15
2005,Urban,Sikkim,Crime Against Women,Dowry Deaths,Male,60+,6949,6857,92,6895,54
2004,Urban,Uttarakhand,Crime Against Children,Child Abuse,Female,13-17,2372,1359,1013,2164,208
2008,Urban,West Bengal,Other Crimes,Cyber Crime,Male,0-12,6752,2808,3944,5827,925
2005,Urban,Telangana,Property Crime,Vandalism,Female,18-30,2996,1610,1386,1892,1104
2009,Urban,Jharkhand,Crime Against Women,Dowry Deaths,Male,31-45,5422,2936,2486,4211,1211
2001,Urban,Maharashtra,Crime Against Children,Child Abuse,Female,13-17,8720,1185,7535,2841,5879
2003,Urban,Jammu & Kashmir,Crime Against Women,Molestation,Female,46-60,7862,5144,2718,6726,1136
2008,Urban,Uttar Pradesh,Crime Against Children,Trafficking,Male,46-60,6497,4524,1973,5360,1137
2009,Urban,Assam,Crime Against Women,Rape,Male,31-45,4577,3271,1306,3770,807
2010,Rural,Assam,Other Crimes,Fraud,Female,0-12,8878,8337,541,8788,90
2006,Rural,Punjab,Property Crime,Burglary,Female,60+,6363,1710,4653,3128,3235
2004,Urban,Chhattisgarh,Crime Against Women,Molestation,Female,46-60,7482,888,6594,6667,815
2006,Urban,Nagaland,Crime Against Children,Trafficking,Female,13-17,5071,2879,2192,4776,295
2006,Urban,Tamil Nadu,Other Crimes,Drug Offense,Male,60+,9509,6510,2999,9058,451
2008,Urban,Rajasthan,Property Crime,Burglary,Male,31-45,9030,2142,6888,4208,4822
2010,Urban,Tamil Nadu,Other Crimes,Fraud,Female,31-45,8284,5560,2724,8035,249
2007,Rural,Assam,Crime Against Children,Child Labor,Female,31-45,7345,6087,1258,6197,1148
2005,Rural,Mizoram,Crime Against Women,Domestic Violence,Female,18-30,1443,290,1153,1150,293
2007,Rural,Manipur,Other Crimes,Cyber Crime,Male,31-45,1280,952,328,1189,91
2004,Urban,Meghalaya,Crime Against Men,Murder,Female,0-12,834,6,828,677,157
2009,Urban,Arunachal Pradesh,Other Crimes,Corruption,Male,60+,2213,1299,914,1402,811
2006,Urban,Delhi,Crime Against Women,Molestation,Male,18-30,4753,1376,3377,3932,821
2001,Urban,Punjab,Crime Against Women,Dowry Deaths,Male,18-30,9223,7567,1656,8608,615
2003,Rural,Rajasthan,Property Crime,Theft,Male,13-17,298,95,203,99,199
2001,Rural,Rajasthan,Other Crimes,Fraud,Female,13-17,253,221,32,234,19
2010,Rural,Jharkhand,Property Crime,Arson,Male,18-30,4657,3404,1253,4021,636
2004,Urban,Telangana,Crime Against Children,Trafficking,Female,46-60,2036,510,1526,1458,578
2007,Rural,Arunachal Pradesh,Crime Against Men,Robbery,Female,0-12,8302,2276,6026,4075,4227
2006,Urban,Uttar Pradesh,Property Crime,Arson,Female,18-30,6052,3130,2922,5484,568
2008,Rural,Mizoram,Crime Against Women,Domestic Violence,Male,31-45,4087,725,3362,2822,1265
2003,Urban,Punjab,Other Crimes,Cyber Crime,Male,31-45,5284,1929,3355,2371,2913
2008,Rural,Chhattisgarh,Property Crime,Arson,Male,31-45,8036,2013,6023,4755,3281
2010,Rural,Haryana,Crime Against Children,Child Labor,Male,18-30,3240,1493,1747,3031,209
2010,Urban,Uttar Pradesh,Crime Against Women,Molestation,Female,13-17,3655,3369,286,3420,235
2009,Rural,Goa,Crime Against Men,Extortion,Female,13-17,3727,1218,2509,2425,1302
2008,Urban,Uttar Pradesh,Crime Against Children,Kidnapping,Female,13-17,1567,175,1392,850,717
2009,Rural,Nagaland,Property Crime,Arson,Male,60+,5666,5183,483,5587,79
2003,Urban,Bihar,Crime Against Children,Child Labor,Female,13-17,4343,1307,3036,2998,1345
2003,Rural,Sikkim,Property Crime,Burglary,Male,18-30,7918,7478,440,7668,250
2008,Rural,Maharashtra,Crime Against Children,Child Labor,Male,18-30,5791,1238,4553,2145,3646
2010,Rural,Bihar,Property Crime,Burglary,Female,31-45,8775,4966,3809,7864,911
2003,Rural,Tripura,Other Crimes,Fraud,Female,31-45,2553,890,1663,941,1612
2010,Urban,Delhi,Crime Against Children,Child Abuse,Male,13-17,6906,3479,3427,3652,3254
2009,Urban,Jharkhand,Crime Against Men,Extortion,Female,46-60,3781,3043,738,3591,190
2006,Urban,Telangana,Other Crimes,Cyber Crime,Male,13-17,3815,3805,10,3813,2
2007,Rural,Gujarat,Crime Against Women,Rape,Male,18-30,5430,2425,3005,2501,2929
2009,Rural,Jammu & Kashmir,Property Crime,Theft,Female,60+,2414,1690,724,1966,448
2008,Urban,Assam,Other Crimes,Drug Offense,Female,31-45,7226,7171,55,7196,30
2007,Rural,Mizoram,Property Crime,Vandalism,Male,46-60,7921,5599,2322,6462,1459
2008,Urban,Tripura,Other Crimes,Drug Offense,Male,46-60,1453,648,805,1243,210
2002,Rural,Uttar Pradesh,Other Crimes,Cyber Crime,Female,18-30,9452,6684,2768,7345,2107
2010,Urban,Sikkim,Other Crimes,Fraud,Female,18-30,4868,3197,1671,3458,1410
2003,Rural,Bihar,Crime Against Women,Dowry Deaths,Female,31-45,519,305,214,454,65
2006,Rural,Andhra Pradesh,Crime Against Women,Dowry Deaths,Female,60+,4412,3056,1356,4255,157
2004,Rural,Gujarat,Property Crime,Burglary,Female,31-45,8583,8287,296,8353,230
2008,Rural,Meghalaya,Crime Against Women,Molestation,Female,0-12,8093,5791,2302,8087,6
2002,Rural,Assam,Crime Against Women,Molestation,Male,18-30,1547,1233,314,1415,132
2002,Rural,Himachal Pradesh,Property Crime,Arson,Female,31-45,934,631,303,809,125
2010,Urban,Goa,Crime Against Men,Murder,Male,13-17,4437,3512,925,3849,588
2010,Rural,Bihar,Crime Against Children,Child Abuse,Male,31-45,9471,913,8558,4372,5099
2007,Urban,Maharashtra,Crime Against Children,Trafficking,Male,31-45,4392,754,3638,4032,360
2008,Urban,Assam,Crime Against Women,Rape,Male,0-12,7371,3965,3406,4653,2718
2003,Urban,Uttar Pradesh,Crime Against Men,Robbery,Male,18-30,7000,3831,3169,4719,2281
2010,Rural,Odisha,Property Crime,Burglary,Female,31-45,1238,588,650,963,275
2004,Rural,Bihar,Crime Against Children,Child Abuse,Male,13-17,8081,5313,2768,6550,1531
2010,Rural,Telangana,Crime Against Men,Robbery,Female,60+,3506,3148,358,3230,276
2001,Rural,Jammu & Kashmir,Crime Against Women,Dowry Deaths,Male,18-30,7769,6019,1750,6917,852
2010,Rural,Maharashtra,Other Crimes,Cyber Crime,Male,31-45,3878,2571,1307,2826,1052
2005,Urban,Jharkhand,Crime Against Women,Rape,Female,46-60,4639,1503,3136,2276,2363
2009,Rural,Rajasthan,Crime Against Women,Dowry Deaths,Female,31-45,2009,83,1926,550,1459
2006,Urban,Goa,Other Crimes,Drug Offense,Male,0-12,5769,5217,552,5380,389
2004,Urban,Jharkhand,Crime Against Children,Child Labor,Male,18-30,5997,1859,4138,2807,3190
2003,Urban,Sikkim,Crime Against Men,Extortion,Female,60+,2786,2546,240,2777,9
2001,Rural,Jharkhand,Property Crime,Burglary,Female,0-12,1406,1036,370,1200,206
2005,Rural,Karnataka,Crime Against Men,Extortion,Male,46-60,2433,865,1568,1633,800
2008,Rural,Odisha,Other Crimes,Cyber Crime,Male,18-30,3622,2983,639,3508,114
2004,Rural,Karnataka,Other Crimes,Drug Offense,Male,31-45,5625,5093,532,5507,118
2002,Urban,Maharashtra,Crime Against Children,Child Labor,Female,46-60,3601,706,2895,3218,383
2007,Urban,Telangana,Crime Against Women,Rape,Male,60+,602,346,256,477,125
2005,Urban,Haryana,Property Crime,Vandalism,Female,31-45,6648,4162,2486,5248,1400
2010,Urban,Madhya Pradesh,Other Crimes,Drug Offense,Female,46-60,3785,3555,230,3707,78
2003,Rural,Punjab,Other Crimes,Cyber Crime,Male,0-12,3270,2778,492,2937,333
2008,Rural,Bihar,Other Crimes,Fraud,Male,46-60,9043,8575,468,8710,333
2010,Urban,West Bengal,Property Crime,Vandalism,Male,18-30,2095,607,1488,1566,529
2009,Urban,Haryana,Crime Against Children,Child Labor,Male,60+,1895,774,1121,1382,513
2001,Urban,Uttarakhand,Other Crimes,Corruption,Female,46-60,1961,1082,879,1382,579
2001,Urban,Telangana,Other Crimes,Fraud,Male,46-60,2271,762,1509,1617,654
2004,Rural,Mizoram,Property Crime,Burglary,Female,0-12,399,45,354,170,229
2005,Rural,Jharkhand,Crime Against Women,Rape,Male,31-45,6047,4174,1873,5958,89
2006,Rural,Tripura,Property Crime,Vandalism,Female,46-60,8822,3600,5222,6609,2213
2008,Urban,Jharkhand,Crime Against Men,Extortion,Female,46-60,699,356,343,557,142
2009,Rural,Tamil Nadu,Crime Against Children,Kidnapping,Female,13-17,4662,1270,3392,1855,2807
2002,Rural,Punjab,Crime Against Men,Extortion,Male,0-12,9113,8445,668,8899,214
2002,Rural,Maharashtra,Crime Against Women,Dowry Deaths,Male,0-12,9421,2150,7271,6993,2428
2002,Urban,Nagaland,Crime Against Children,Kidnapping,Female,18-30,3769,2838,931,3387,382
2003,Urban,Odisha,Crime Against Children,Child Labor,Male,31-45,4595,1856,2739,2079,2516
2009,Rural,Himachal Pradesh,Crime Against Children,Child Abuse,Male,31-45,1750,713,1037,1562,188
2002,Rural,Sikkim,Crime Against Men,Robbery,Female,18-30,4236,3757,479,3979,257
2004,Rural,Gujarat,Crime Against Children,Trafficking,Male,46-60,3964,3875,89,3935,29
2008,Urban,West Bengal,Other Crimes,Cyber Crime,Female,31-45,9355,8383,972,9288,67
2001,Urban,Tamil Nadu,Crime Against Women,Rape,Male,60+,8212,2840,5372,3921,4291
2007,Urban,Manipur,Crime Against Women,Dowry Deaths,Female,31-45,9890,936,8954,8120,1770
2002,Rural,Punjab,Crime Against Children,Kidnapping,Male,18-30,5092,363,4729,4072,1020
2005,Urban,Nagaland,Crime Against Children,Child Abuse,Male,60+,696,48,648,497,199
2010,Rural,Odisha,Other Crimes,Corruption,Female,13-17,3123,2334,789,2983,140
2008,Rural,Rajasthan,Crime Against Children,Child Abuse,Male,18-30,5359,4366,993,4488,871
2005,Urban,Maharashtra,Property Crime,Vandalism,Male,46-60,1643,875,768,1025,618
2002,Urban,Maharashtra,Crime Against Men,Assault,Male,18-30,7079,6366,713,7003,76
2010,Rural,Delhi,Crime Against Children,Kidnapping,Male,60+,3930,3229,701,3801,129
2009,Rural,Andhra Pradesh,Property Crime,Arson,Female,31-45,3775,327,3448,3174,601
2006,Rural,Gujarat,Crime Against Women,Molestation,Female,60+,8740,7651,1089,7883,857
2010,Rural,Meghalaya,Property Crime,Theft,Male,13-17,6356,1606,4750,3654,2702
2002,Urban,Himachal Pradesh,Crime Against Children,Child Abuse,Male,13-17,7801,384,7417,7532,269
2007,Rural,Maharashtra,Other Crimes,Drug Offense,Male,13-17,689,332,357,435,254
2008,Rural,Karnataka,Crime Against Children,Kidnapping,Male,46-60,9781,8481,1300,8856,925
2010,Urban,Delhi,Crime Against Women,Domestic Violence,Female,0-12,471,78,393,284,187
2010,Rural,Uttar Pradesh,Crime Against Women,Rape,Male,18-30,6783,5723,1060,6481,302
2002,Rural,Delhi,Property Crime,Arson,Female,46-60,5817,5615,202,5670,147
2007,Rural,Telangana,Other Crimes,Fraud,Female,0-12,919,581,338,658,261
2003,Urban,Himachal Pradesh,Crime Against Men,Extortion,Female,13-17,4189,3449,740,3679,510
2009,Rural,Bihar,Crime Against Children,Child Abuse,Female,60+,9570,7365,2205,8517,1053
2001,Rural,Bihar,Crime Against Men,Extortion,Male,46-60,5287,1144,4143,4806,481
2002,Rural,Delhi,Crime Against Women,Rape,Female,18-30,9680,1013,8667,8650,1030
2001,Rural,Karnataka,Crime Against Children,Kidnapping,Female,31-45,7228,1450,5778,3232,3996
2010,Urban,Bihar,Property Crime,Arson,Male,0-12,4186,2606,1580,3155,1031
2004,Rural,Maharashtra,Crime Against Men,Murder,Male,18-30,2589,2104,485,2286,303
2002,Urban,Punjab,Other Crimes,Corruption,Male,60+,9982,6878,3104,8388,1594
2006,Rural,Andhra Pradesh,Crime Against Men,Extortion,Male,13-17,9338,6493,2845,8729,609
2006,Rural,Gujarat,Crime Against Children,Child Abuse,Male,31-45,9946,2772,7174,9856,90
2006,Urban,Haryana,Crime Against Children,Kidnapping,Female,18-30,4253,1132,3121,4144,109
2008,Rural,Nagaland,Crime Against Women,Domestic Violence,Male,46-60,2926,499,2427,1478,1448
2005,Rural,Sikkim,Crime Against Men,Assault,Male,46-60,2912,1950,962,2886,26
2001,Urban,Punjab,Crime Against Men,Murder,Male,0-12,4245,3173,1072,3200,1045
2001,Urban,Gujarat,Crime Against Men,Robbery,Male,13-17,4035,2896,1139,3577,458
2001,Rural,Haryana,Crime Against Children,Trafficking,Female,31-45,5649,1887,3762,4721,928
2002,Rural,Gujarat,Crime Against Children,Child Abuse,Male,18-30,72,22,50,46,26
2008,Urban,Jammu & Kashmir,Crime Against Women,Domestic Violence,Female,60+,4062,942,3120,2140,1922
2003,Rural,West Bengal,Crime Against Men,Robbery,Male,60+,2347,1328,1019,1441,906
2004,Urban,Nagaland,Other Crimes,Corruption,Male,13-17,7834,5854,1980,7802,32
2004,Urban,Manipur,Other Crimes,Drug Offense,Female,13-17,9174,1091,8083,3063,6111
2010,Rural,Uttarakhand,Property Crime,Theft,Male,46-60,4695,3105,1590,3948,747
2002,Rural,Odisha,Crime Against Women,Dowry Deaths,Male,0-12,1820,1450,370,1814,6
2004,Urban,Tripura,Crime Against Children,Child Labor,Female,46-60,7590,695,6895,1464,6126
2003,Rural,Telangana,Other Crimes,Drug Offense,Female,13-17,8032,2791,5241,7585,447
2007,Rural,Manipur,Crime Against Children,Child Labor,Male,46-60,9578,1935,7643,4010,5568
2010,Urban,Jammu & Kashmir,Property Crime,Arson,Male,31-45,2394,588,1806,2024,370
2003,Rural,Gujarat,Crime Against Children,Kidnapping,Female,31-45,3798,3646,152,3729,69
2002,Urban,Haryana,Other Crimes,Cyber Crime,Female,0-12,3959,157,3802,886,3073
2003,Rural,Telangana,Crime Against Women,Molestation,Male,0-12,6680,1754,4926,5302,1378
2010,Rural,Mizoram,Other Crimes,Corruption,Female,0-12,2640,1756,884,1868,772
2010,Urban,Delhi,Crime Against Women,Molestation,Female,31-45,1610,1371,239,1446,164
2008,Urban,Kerala,Crime Against Men,Murder,Male,60+,6789,1840,4949,5731,1058
2007,Urban,Bihar,Property Crime,Vandalism,Male,13-17,5484,354,5130,2667,2817
2003,Rural,Odisha,Other Crimes,Drug Offense,Male,46-60,9451,3715,5736,8277,1174
2002,Rural,Nagaland,Other Crimes,Fraud,Female,0-12,2176,1234,942,1860,316
2010,Urban,Haryana,Crime Against Women,Dowry Deaths,Male,13-17,8519,5442,3077,6520,1999
2001,Rural,Maharashtra,Other Crimes,Cyber Crime,Female,60+,9567,3906,5661,6572,2995
2005,Urban,Uttarakhand,Crime Against Women,Molestation,Female,0-12,3675,881,2794,2311,1364
2009,Urban,Meghalaya,Property Crime,Arson,Male,18-30,6204,3377,2827,5363,841
2008,Urban,Mizoram,Crime Against Men,Robbery,Male,13-17,327,116,211,268,59
2006,Urban,Gujarat,Crime Against Men,Robbery,Female,60+,6170,4257,1913,5010,1160
2007,Urban,Haryana,Other Crimes,Drug Offense,Female,18-30,6608,2251,4357,6379,229
2009,Rural,Bihar,Crime Against Men,Murder,Male,60+,4070,2834,1236,3798,272
2009,Rural,Bihar,Other Crimes,Fraud,Female,46-60,6272,2286,3986,4713,1559
2004,Urban,Odisha,Crime Against Men,Extortion,Male,60+,1481,706,775,1216,265
2002,Urban,Kerala,Crime Against Women,Domestic Violence,Male,0-12,3024,1431,1593,2953,71
2001,Rural,Delhi,Crime Against Children,Child Labor,Male,0-12,8679,6934,1745,8450,229
2008,Rural,Manipur,Property Crime,Arson,Male,46-60,9492,3036,6456,4384,5108
2003,Rural,Karnataka,Crime Against Men,Robbery,Female,13-17,8796,5729,3067,8476,320
2008,Rural,Chhattisgarh,Other Crimes,Drug Offense,Female,0-12,6900,2743,4157,5325,1575
2002,Urban,Mizoram,Crime Against Children,Child Labor,Female,46-60,640,108,532,387,253
2009,Rural,Telangana,Other Crimes,Cyber Crime,Female,0-12,4248,4101,147,4141,107
2003,Urban,Jammu & Kashmir,Property Crime,Arson,Male,0-12,5526,2580,2946,3067,2459
2007,Urban,Odisha,Property Crime,Arson,Male,46-60,1836,1093,743,1419,417
2003,Urban,Uttar Pradesh,Other Crimes,Cyber Crime,Female,31-45,2104,787,1317,1567,537
2007,Rural,Uttarakhand,Property Crime,Vandalism,Female,46-60,3717,121,3596,1079,2638
2007,Rural,Chhattisgarh,Other Crimes,Drug Offense,Female,13-17,5395,3755,1640,4916,479
2006,Urban,Karnataka,Property Crime,Burglary,Male,0-12,9552,2647,6905,6429,3123
2002,Urban,Punjab,Property Crime,Theft,Male,46-60,6552,1735,4817,2201,4351
2001,Rural,West Bengal,Crime Against Women,Domestic Violence,Male,18-30,1710,337,1373,538,1172
2002,Urban,Sikkim,Crime Against Women,Domestic Violence,Male,13-17,8742,5871,2871,7977,765
2008,Urban,Haryana,Crime Against Children,Kidnapping,Male,31-45,3199,2301,898,3190,9
2007,Urban,Meghalaya,Other Crimes,Cyber Crime,Female,60+,4685,615,4070,3581,1104
2003,Rural,Haryana,Crime Against Men,Robbery,Female,13-17,8742,2095,6647,6967,1775
2009,Urban,Delhi,Crime Against Women,Dowry Deaths,Male,31-45,3171,291,2880,2081,1090
2009,Rural,Rajasthan,Other Crimes,Drug Offense,Male,0-12,3029,1904,1125,2056,973
2005,Urban,Jammu & Kashmir,Crime Against Men,Robbery,Female,46-60,5353,3277,2076,4636,717
2010,Rural,Manipur,Crime Against Men,Murder,Female,31-45,9091,4148,4943,6704,2387
2006,Rural,Sikkim,Other Crimes,Cyber Crime,Female,31-45,2850,80,2770,870,1980
2005,Rural,Uttarakhand,Other Crimes,Drug Offense,Female,0-12,8986,3977,5009,7105,1881
2009,Urban,Karnataka,Property Crime,Arson,Female,46-60,2342,2197,145,2262,80
2001,Rural,Chhattisgarh,Property Crime,Arson,Female,0-12,4649,346,4303,2605,2044
2006,Rural,Uttar Pradesh,Other Crimes,Cyber Crime,Female,18-30,6720,3150,3570,4237,2483
2006,Urban,Bihar,Other Crimes,Cyber Crime,Female,13-17,8991,5984,3007,7731,1260
2007,Rural,Andhra Pradesh,Crime Against Women,Dowry Deaths,Male,46-60,5107,1547,3560,4682,425
2001,Rural,Jharkhand,Crime Against Women,Molestation,Female,31-45,8036,592,7444,5396,2640
2009,Rural,Delhi,Property Crime,Arson,Male,46-60,9881,8190,1691,8359,1522
2008,Rural,Punjab,Crime Against Men,Murder,Male,13-17,948,758,190,868,80
2008,Rural,Goa,Crime Against Children,Kidnapping,Female,18-30,593,489,104,540,53
2008,Urban,Tamil Nadu,Crime Against Children,Child Labor,Female,0-12,6472,1452,5020,6373,99
2010,Urban,Haryana,Crime Against Men,Robbery,Male,0-12,4338,95,4243,2192,2146
2010,Rural,Tamil Nadu,Crime Against Men,Robbery,Female,18-30,1432,1242,190,1274,158
2008,Urban,Manipur,Crime Against Children,Trafficking,Male,46-60,8079,1513,6566,1738,6341
2006,Rural,Tamil Nadu,Crime Against Men,Robbery,Male,0-12,9254,2846,6408,4938,4316
2008,Rural,Punjab,Crime Against Women,Domestic Violence,Female,31-45,3828,2879,949,2934,894
2008,Rural,Gujarat,Crime Against Children,Kidnapping,Female,60+,9419,3193,6226,6920,2499
2005,Rural,Uttar Pradesh,Other Crimes,Cyber Crime,Male,31-45,7910,6835,1075,7619,291
2004,Urban,Tamil Nadu,Crime Against Men,Murder,Male,18-30,4005,2508,1497,3794,211
2008,Rural,West Bengal,Property Crime,Arson,Female,13-17,7436,6862,574,7423,13
2008,Rural,Madhya Pradesh,Property Crime,Vandalism,Male,60+,7525,3884,3641,6817,708
2005,Urban,Madhya Pradesh,Crime Against Women,Dowry Deaths,Male,13-17,4286,3097,1189,3435,851
2004,Urban,Punjab,Crime Against Men,Assault,Female,13-17,6292,3094,3198,3479,2813
2001,Rural,Delhi,Crime Against Men,Murder,Female,13-17,5637,3104,2533,5443,194
2003,Rural,Arunachal Pradesh,Crime Against Children,Child Abuse,Female,18-30,8746,6849,1897,8311,435
2008,Urban,Odisha,Other Crimes,Corruption,Female,0-12,3127,2329,798,2395,732
2006,Urban,Arunachal Pradesh,Crime Against Men,Assault,Female,18-30,2793,810,1983,1802,991
2007,Rural,Madhya Pradesh,Crime Against Men,Extortion,Female,31-45,7125,3696,3429,6279,846
2002,Rural,Karnataka,Crime Against Women,Dowry Deaths,Male,13-17,3730,2600,1130,3534,196
2001,Urban,Tamil Nadu,Crime Against Men,Assault,Male,60+,9655,6083,3572,8844,811
2009,Rural,Himachal Pradesh,Crime Against Children,Trafficking,Female,31-45,4502,235,4267,593,3909
2004,Rural,Uttarakhand,Crime Against Women,Rape,Male,18-30,6249,2501,3748,3981,2268
2004,Urban,Mizoram,Crime Against Children,Trafficking,Male,46-60,4278,3168,1110,4082,196
2004,Urban,Uttar Pradesh,Crime Against Women,Dowry Deaths,Male,31-45,8304,7208,1096,7894,410
2010,Rural,Mizoram,Property Crime,Arson,Male,0-12,4393,694,3699,707,3686
2001,Rural,Tamil Nadu,Crime Against Men,Extortion,Male,13-17,9759,7763,1996,9219,540
2003,Urban,Andhra Pradesh,Other Crimes,Corruption,Female,13-17,4512,3901,611,4438,74
2010,Urban,Gujarat,Crime Against Women,Molestation,Female,60+,2356,661,1695,886,1470
2002,Rural,Andhra Pradesh,Crime Against Men,Robbery,Female,18-30,4019,3776,243,3933,86
2007,Urban,Delhi,Property Crime,Arson,Male,18-30,8448,2917,5531,7926,522
2008,Rural,Madhya Pradesh,Crime Against Women,Molestation,Female,18-30,2755,193,2562,2327,428
2002,Urban,Delhi,Crime Against Men,Murder,Female,18-30,4699,476,4223,1986,2713
2002,Rural,Odisha,Property Crime,Arson,Male,0-12,8639,575,8064,4032,4607
2007,Urban,Tamil Nadu,Other Crimes,Corruption,Male,0-12,1228,835,393,956,272
2006,Urban,Himachal Pradesh,Crime Against Men,Murder,Male,18-30,3533,133,3400,259,3274
2006,Rural,Gujarat,Crime Against Women,Domestic Violence,Female,46-60,5526,1292,4234,4051,1475
2007,Rural,Odisha,Property Crime,Arson,Female,13-17,5226,4325,901,5139,87
2003,Urban,Meghalaya,Other Crimes,Fraud,Female,13-17,4305,2663,1642,2775,1530
2004,Rural,Punjab,Crime Against Women,Rape,Male,0-12,9423,3116,6307,9413,10
2007,Urban,Mizoram,Crime Against Children,Child Abuse,Male,46-60,9367,6882,2485,8754,613
2004,Rural,Uttar Pradesh,Property Crime,Theft,Male,18-30,9328,1192,8136,9065,263
2007,Rural,Jammu & Kashmir,Property Crime,Arson,Female,46-60,7655,3585,4070,4038,3617
2010,Urban,Arunachal Pradesh,Other Crimes,Cyber Crime,Female,18-30,406,191,215,306,100
2009,Rural,Maharashtra,Crime Against Women,Rape,Male,18-30,4748,4628,120,4690,58
2008,Rural,Telangana,Crime Against Women,Molestation,Female,13-17,613,513,100,608,5
2008,Urban,Arunachal Pradesh,Crime Against Children,Trafficking,Male,18-30,6827,5123,1704,6316,511
2003,Urban,Andhra Pradesh,Crime Against Children,Child Labor,Female,31-45,3202,728,2474,1228,1974
2003,Rural,Delhi,Crime Against Women,Domestic Violence,Male,0-12,996,229,767,664,332
2002,Rural,Himachal Pradesh,Crime Against Children,Kidnapping,Female,0-12,6740,1241,5499,2801,3939
2001,Urban,Chhattisgarh,Crime Against Women,Molestation,Male,31-45,283,187,96,273,10
2008,Rural,Maharashtra,Crime Against Children,Trafficking,Female,31-45,7495,3820,3675,5153,2342
2004,Urban,Jammu & Kashmir,Crime Against Women,Dowry Deaths,Male,31-45,6144,1273,4871,1888,4256
2009,Rural,Goa,Crime Against Children,Child Labor,Male,13-17,5675,5203,472,5343,332
2010,Urban,Gujarat,Property Crime,Theft,Female,0-12,5940,4188,1752,5335,605
2003,Urban,Manipur,Crime Against Women,Molestation,Female,18-30,1849,1341,508,1541,308
2004,Urban,Kerala,Crime Against Women,Rape,Female,18-30,723,634,89,642,81
2010,Urban,Jharkhand,Crime Against Men,Assault,Female,18-30,7396,4539,2857,5669,1727
2005,Urban,Manipur,Crime Against Men,Extortion,Female,18-30,9101,7173,1928,8604,497
2007,Rural,West Bengal,Property Crime,Vandalism,Female,0-12,5270,2671,2599,3482,1788
2010,Urban,Maharashtra,Other Crimes,Fraud,Male,60+,2754,1084,1670,2714,40
2004,Urban,Bihar,Crime Against Men,Robbery,Male,46-60,7893,2980,4913,3103,4790
2002,Urban,Sikkim,Crime Against Men,Extortion,Male,0-12,5444,3522,1922,4652,792
2004,Urban,Assam,Property Crime,Theft,Male,46-60,3397,2722,675,3007,390
2004,Urban,Odisha,Crime Against Women,Rape,Male,0-12,2165,117,2048,1906,259
2009,Rural,West Bengal,Property Crime,Theft,Female,60+,627,126,501,254,373
2002,Rural,Mizoram,Crime Against Women,Rape,Female,46-60,4595,952,3643,1169,3426
2002,Urban,Mizoram,Crime Against Children,Trafficking,Female,46-60,4017,1005,3012,3063,954
2006,Rural,Nagaland,Other Crimes,Fraud,Male,0-12,7935,608,7327,4713,3222
2010,Rural,Nagaland,Crime Against Women,Domestic Violence,Female,0-12,6879,699,6180,6559,320
2006,Rural,Madhya Pradesh,Crime Against Children,Child Abuse,Male,0-12,8882,5601,3281,6872,2010
2001,Urban,Goa,Property Crime,Theft,Female,18-30,8173,4734,3439,5174,2999
2007,Urban,Karnataka,Crime Against Women,Rape,Male,46-60,2585,96,2489,2547,38
2002,Urban,Tamil Nadu,Crime Against Men,Robbery,Female,13-17,7135,742,6393,1685,5450
2008,Urban,Arunachal Pradesh,Property Crime,Burglary,Female,60+,2405,859,1546,1397,1008
2003,Urban,Manipur,Crime Against Children,Trafficking,Female,60+,2981,2715,266,2808,173
2009,Urban,West Bengal,Property Crime,Burglary,Male,31-45,3638,3613,25,3613,25
2008,Urban,Nagaland,Crime Against Men,Assault,Female,0-12,4401,2863,1538,3224,1177
2007,Rural,Punjab,Crime Against Women,Dowry Deaths,Female,0-12,7011,5559,1452,6201,810
2008,Urban,Uttarakhand,Crime Against Children,Kidnapping,Male,13-17,8044,5223,2821,5787,2257
2007,Rural,Assam,Crime Against Children,Trafficking,Male,0-12,8190,1571,6619,3665,4525
2002,Rural,Mizoram,Other Crimes,Drug Offense,Female,31-45,3451,1981,1470,3095,356
2004,Urban,Karnataka,Property Crime,Arson,Female,13-17,8644,3607,5037,3862,4782
2008,Rural,Telangana,Property Crime,Theft,Male,46-60,9616,6652,2964,7037,2579
2001,Urban,Nagaland,Other Crimes,Fraud,Male,46-60,9834,7454,2380,8828,1006
2009,Rural,Sikkim,Crime Against Children,Child Labor,Male,13-17,9008,4338,4670,6304,2704
2007,Rural,Sikkim,Other Crimes,Drug Offense,Female,0-12,4816,912,3904,4017,799
2009,Urban,Assam,Other Crimes,Drug Offense,Male,0-12,1271,100,1171,158,1113
2007,Urban,Gujarat,Property Crime,Theft,Male,31-45,470,316,154,367,103
2001,Rural,Bihar,Property Crime,Theft,Male,60+,5351,4746,605,5155,196
2008,Rural,West Bengal,Crime Against Women,Rape,Female,0-12,6457,1779,4678,2483,3974
2008,Urban,West Bengal,Crime Against Men,Murder,Male,46-60,7322,963,6359,6040,1282
2001,Rural,Punjab,Crime Against Men,Assault,Female,18-30,8185,5978,2207,7107,1078
2001,Urban,Goa,Property Crime,Vandalism,Male,13-17,988,474,514,714,274
2005,Rural,Meghalaya,Other Crimes,Fraud,Male,31-45,3411,1826,1585,2438,973
2006,Urban,Kerala,Property Crime,Arson,Male,13-17,7450,1303,6147,4271,3179
2006,Urban,Kerala,Crime Against Women,Domestic Violence,Female,13-17,5702,3266,2436,3772,1930
2010,Rural,Haryana,Crime Against Men,Extortion,Female,46-60,1306,1116,190,1287,19
2001,Rural,Tamil Nadu,Other Crimes,Cyber Crime,Female,13-17,5446,4767,679,5342,104
2001,Urban,Uttar Pradesh,Crime Against Children,Child Abuse,Female,0-12,9527,2665,6862,5822,3705
2006,Urban,Andhra Pradesh,Other Crimes,Fraud,Male,46-60,5719,3261,2458,4599,1120
2002,Urban,Jharkhand,Property Crime,Burglary,Male,31-45,620,118,502,477,143
2008,Rural,Maharashtra,Crime Against Women,Domestic Violence,Male,0-12,1501,404,1097,649,852
2009,Rural,Punjab,Crime Against Children,Child Abuse,Female,18-30,5985,3239,2746,4005,1980
2007,Urban,West Bengal,Crime Against Women,Dowry Deaths,Male,13-17,5640,3917,1723,4479,1161
2006,Rural,Uttarakhand,Crime Against Children,Child Abuse,Male,31-45,8111,576,7535,6360,1751
2003,Rural,Bihar,Crime Against Children,Child Abuse,Male,0-12,4598,2783,1815,3584,1014
2009,Urban,Gujarat,Other Crimes,Fraud,Female,46-60,3908,3623,285,3687,221
2010,Urban,Karnataka,Property Crime,Burglary,Female,46-60,2393,1416,977,2114,279
2003,Rural,Chhattisgarh,Property Crime,Theft,Male,13-17,4547,9,4538,3178,1369
2003,Urban,Tripura,Other Crimes,Corruption,Female,46-60,8550,236,8314,6838,1712
2001,Urban,Tamil Nadu,Crime Against Women,Molestation,Male,60+,7945,7322,623,7578,367
2001,Urban,Chhattisgarh,Crime Against Children,Trafficking,Male,13-17,6434,5408,1026,6403,31
2007,Urban,Nagaland,Crime Against Women,Dowry Deaths,Male,46-60,9562,3827,5735,4983,4579
2009,Rural,Tripura,Other Crimes,Fraud,Male,60+,9084,1198,7886,1402,7682
2002,Urban,Manipur,Crime Against Children,Trafficking,Female,31-45,2343,1890,453,2004,339
2009,Rural,Gujarat,Other Crimes,Corruption,Male,0-12,7259,2321,4938,6811,448
2008,Urban,Jammu & Kashmir,Crime Against Men,Robbery,Female,0-12,1084,21,1063,1047,37
2003,Urban,Punjab,Other Crimes,Cyber Crime,Male,31-45,6677,1497,5180,2206,4471
2007,Rural,Himachal Pradesh,Crime Against Children,Child Labor,Male,46-60,9331,3905,5426,7768,1563
2005,Urban,Goa,Other Crimes,Corruption,Male,46-60,178,116,62,139,39
2002,Rural,Meghalaya,Other Crimes,Corruption,Male,13-17,3366,1308,2058,2509,857
2007,Rural,Sikkim,Crime Against Women,Domestic Violence,Male,0-12,5644,2916,2728,4299,1345
2007,Urban,Jharkhand,Crime Against Women,Domestic Violence,Male,31-45,6963,2377,4586,6936,27
2010,Rural,Chhattisgarh,Other Crimes,Fraud,Male,0-12,1318,349,969,1201,117
2002,Urban,Uttar Pradesh,Property Crime,Vandalism,Male,46-60,8640,3634,5006,6617,2023
2004,Urban,Telangana,Crime Against Women,Dowry Deaths,Male,31-45,5653,2648,3005,2669,2984
2007,Rural,Himachal Pradesh,Crime Against Women,Molestation,Female,18-30,5455,3298,2157,3730,1725
2002,Rural,Chhattisgarh,Crime Against Children,Child Abuse,Female,60+,3876,1801,2075,3758,118
2005,Urban,Andhra Pradesh,Crime Against Women,Rape,Female,46-60,9792,6690,3102,7291,2501
2003,Urban,Andhra Pradesh,Property Crime,Arson,Female,13-17,3385,2912,473,3018,367
2005,Rural,Assam,Other Crimes,Drug Offense,Male,60+,1418,1264,154,1306,112
2005,Urban,Himachal Pradesh,Other Crimes,Drug Offense,Male,13-17,4598,2786,1812,3561,1037
2002,Rural,Manipur,Crime Against Men,Robbery,Male,60+,6461,2276,4185,6208,253
2002,Rural,Rajasthan,Crime Against Children,Kidnapping,Female,13-17,5896,3470,2426,5837,59
2009,Urban,Meghalaya,Crime Against Women,Domestic Violence,Female,18-30,6377,2986,3391,3958,2419
2006,Urban,Tripura,Other Crimes,Cyber Crime,Female,60+,2525,2259,266,2454,71
2005,Urban,Rajasthan,Property Crime,Theft,Female,60+,2967,954,2013,2620,347
2004,Rural,Jharkhand,Property Crime,Theft,Male,0-12,2191,686,1505,1237,954
2008,Rural,Haryana,Crime Against Men,Extortion,Male,0-12,9542,7005,2537,7225,2317
2007,Urban,Andhra Pradesh,Crime Against Children,Trafficking,Male,60+,2753,337,2416,2443,310
2006,Urban,Madhya Pradesh,Property Crime,Vandalism,Male,60+,9073,8918,155,8965,108
2002,Rural,Andhra Pradesh,Crime Against Children,Child Labor,Male,60+,6464,3927,2537,6078,386
2004,Urban,Assam,Crime Against Men,Murder,Female,46-60,1808,1226,582,1362,446
2002,Rural,Tripura,Property Crime,Arson,Female,0-12,7067,6388,679,6996,71
2006,Urban,Uttar Pradesh,Other Crimes,Corruption,Female,13-17,1411,814,597,987,424
2007,Urban,Himachal Pradesh,Crime Against Women,Dowry Deaths,Male,13-17,2312,146,2166,388,1924
2006,Urban,Haryana,Crime Against Men,Assault,Female,46-60,3750,1773,1977,2180,1570
2010,Rural,Uttar Pradesh,Crime Against Women,Molestation,Female,13-17,5041,207,4834,4201,840
2007,Rural,Odisha,Crime Against Children,Kidnapping,Female,31-45,3608,2607,1001,3600,8
2010,Urban,Odisha,Crime Against Children,Trafficking,Male,31-45,9529,13,9516,3390,6139
2001,Rural,Maharashtra,Crime Against Children,Child Labor,Female,31-45,1732,632,1100,930,802
2007,Urban,Uttar Pradesh,Other Crimes,Corruption,Male,18-30,5868,1068,4800,3407,2461
2010,Rural,Punjab,Crime Against Children,Child Abuse,Male,46-60,4098,2396,1702,3425,673
2003,Urban,Sikkim,Property Crime,Theft,Female,46-60,3317,401,2916,1172,2145
2009,Urban,Delhi,Crime Against Women,Dowry Deaths,Male,18-30,6402,5601,801,6000,402
2005,Urban,Jammu & Kashmir,Crime Against Children,Child Abuse,Female,60+,5353,714,4639,2652,2701
2009,Urban,Himachal Pradesh,Crime Against Women,Domestic Violence,Female,18-30,4488,3076,1412,3302,1186
2001,Rural,Tripura,Crime Against Women,Rape,Male,18-30,6483,4568,1915,6234,249
2010,Urban,Goa,Property Crime,Burglary,Female,0-12,3495,3163,332,3248,247
2004,Rural,Punjab,Other Crimes,Corruption,Male,18-30,4215,3057,1158,3723,492
2009,Rural,Telangana,Crime Against Women,Dowry Deaths,Female,31-45,1541,1004,537,1362,179
2007,Urban,Arunachal Pradesh,Crime Against Children,Trafficking,Female,18-30,7025,1634,5391,4330,2695
2008,Urban,Uttar Pradesh,Crime Against Children,Child Labor,Male,0-12,2663,754,1909,791,1872
2002,Urban,Goa,Crime Against Women,Domestic Violence,Male,46-60,5639,4889,750,5309,330
2001,Urban,Meghalaya,Property Crime,Burglary,Female,31-45,9749,8189,1560,8236,1513
2009,Rural,Punjab,Crime Against Children,Child Labor,Female,13-17,1209,781,428,1118,91
2002,Urban,Gujarat,Crime Against Men,Murder,Male,46-60,9677,8304,1373,8364,1313
2009,Urban,Telangana,Crime Against Men,Robbery,Female,46-60,4268,3430,838,4146,122
2010,Rural,Gujarat,Property Crime,Theft,Female,31-45,9670,898,8772,978,8692
2005,Urban,Madhya Pradesh,Property Crime,Arson,Female,0-12,84,43,41,43,41
2009,Rural,Goa,Crime Against Men,Extortion,Female,46-60,2636,2251,385,2262,374
2001,Rural,Jharkhand,Crime Against Women,Molestation,Female,46-60,8244,7777,467,8192,52
2010,Urban,Odisha,Property Crime,Vandalism,Female,60+,7215,771,6444,3874,3341
2004,Urban,Arunachal Pradesh,Property Crime,Burglary,Male,46-60,2719,2320,399,2680,39
2010,Rural,Telangana,Crime Against Men,Extortion,Male,0-12,498,88,410,308,190
2009,Urban,Himachal Pradesh,Crime Against Men,Robbery,Male,60+,8113,3310,4803,6236,1877
2006,Urban,Telangana,Crime Against Men,Robbery,Male,46-60,4892,1615,3277,4861,31
2006,Rural,Sikkim,Crime Against Women,Molestation,Male,31-45,7710,1705,6005,5364,2346
2006,Rural,Jharkhand,Crime Against Children,Trafficking,Male,13-17,877,236,641,683,194
2007,Rural,Maharashtra,Other Crimes,Drug Offense,Male,31-45,2494,1231,1263,1491,1003
2009,Rural,Jammu & Kashmir,Property Crime,Vandalism,Female,18-30,3074,103,2971,1130,1944
2008,Rural,Mizoram,Crime Against Children,Child Abuse,Female,0-12,5323,526,4797,1814,3509
2010,Urban,Jammu & Kashmir,Crime Against Children,Kidnapping,Male,31-45,4215,1880,2335,3123,1092
2005,Urban,West Bengal,Property Crime,Theft,Male,60+,3457,2808,649,3377,80
2009,Urban,Kerala,Crime Against Men,Extortion,Male,18-30,9342,3159,6183,8578,764
2007,Rural,Manipur,Crime Against Women,Molestation,Female,18-30,1707,633,1074,1227,480
2001,Urban,Rajasthan,Crime Against Men,Assault,Male,13-17,1836,642,1194,750,1086
2003,Rural,Telangana,Crime Against Men,Assault,Male,46-60,938,436,502,574,364
2007,Urban,Delhi,Crime Against Children,Child Abuse,Male,46-60,5150,1079,4071,4400,750
2006,Urban,Jammu & Kashmir,Crime Against Women,Rape,Female,46-60,8567,1290,7277,3623,4944
2009,Rural,Manipur,Crime Against Children,Trafficking,Female,46-60,9310,3738,5572,4099,5211
2003,Rural,Mizoram,Crime Against Children,Child Abuse,Male,13-17,2143,1794,349,2053,90
2008,Urban,Bihar,Other Crimes,Drug Offense,Male,46-60,9092,3768,5324,6033,3059
2002,Rural,Uttar Pradesh,Crime Against Children,Trafficking,Female,60+,9626,290,9336,931,8695
2004,Rural,Mizoram,Crime Against Men,Extortion,Female,46-60,8004,390,7614,3685,4319
2005,Rural,Tamil Nadu,Crime Against Men,Assault,Female,13-17,4603,3129,1474,3150,1453
2010,Urban,Gujarat,Crime Against Children,Trafficking,Female,60+,6105,3617,2488,5323,782
2010,Urban,Mizoram,Property Crime,Vandalism,Female,60+,5531,245,5286,2408,3123
2003,Rural,Delhi,Other Crimes,Corruption,Male,31-45,6603,5443,1160,6454,149
2003,Rural,Nagaland,Crime Against Men,Murder,Male,18-30,8259,1423,6836,3742,4517
2010,Rural,Uttar Pradesh,Crime Against Women,Domestic Violence,Male,18-30,5813,22,5791,4948,865
2004,Urban,Kerala,Property Crime,Burglary,Female,13-17,4546,3430,1116,4369,177
2004,Rural,Odisha,Crime Against Men,Murder,Male,31-45,6359,3846,2513,4799,1560
2010,Rural,Jharkhand,Property Crime,Vandalism,Female,0-12,4026,1131,2895,3200,826
2001,Urban,Punjab,Property Crime,Burglary,Male,0-12,8249,3694,4555,5653,2596
2004,Urban,Goa,Property Crime,Vandalism,Female,13-17,9159,1218,7941,4976,4183
2010,Rural,Maharashtra,Crime Against Children,Child Labor,Female,18-30,4362,2415,1947,3418,944
2006,Urban,Madhya Pradesh,Crime Against Children,Child Labor,Male,31-45,5735,680,5055,3982,1753
2007,Rural,Andhra Pradesh,Crime Against Children,Child Abuse,Male,46-60,4607,3898,709,4312,295
2001,Rural,Sikkim,Property Crime,Theft,Female,31-45,8359,5758,2601,7459,900
2006,Rural,Madhya Pradesh,Property Crime,Arson,Male,18-30,4765,2067,2698,3274,1491
2002,Rural,Chhattisgarh,Crime Against Women,Dowry Deaths,Male,60+,5959,1869,4090,3053,2906
2006,Urban,Himachal Pradesh,Crime Against Children,Trafficking,Female,60+,4520,3826,694,4349,171
2010,Rural,Assam,Property Crime,Burglary,Female,46-60,8225,7425,800,8098,127
2002,Urban,Gujarat,Crime Against Women,Molestation,Female,13-17,1341,212,1129,531,810
2006,Urban,Andhra Pradesh,Property Crime,Theft,Male,0-12,3907,163,3744,1263,2644
2002,Urban,Kerala,Property Crime,Arson,Female,31-45,5657,66,5591,5134,523
2001,Rural,Goa,Crime Against Men,Extortion,Male,18-30,3033,1939,1094,2954,79
2006,Urban,Assam,Other Crimes,Cyber Crime,Male,13-17,1394,236,1158,1124,270
2004,Rural,Chhattisgarh,Crime Against Children,Kidnapping,Female,13-17,3415,1471,1944,2409,1006
2006,Urban,Punjab,Property Crime,Burglary,Male,46-60,6600,5841,759,6025,575
2003,Urban,Bihar,Other Crimes,Fraud,Female,46-60,5310,169,5141,2619,2691
2002,Urban,Andhra Pradesh,Other Crimes,Corruption,Male,31-45,5415,2041,3374,2708,2707
2003,Urban,Nagaland,Crime Against Women,Domestic Violence,Male,60+,1214,1146,68,1181,33
2010,Rural,Punjab,Crime Against Women,Rape,Female,13-17,962,349,613,900,62
2006,Rural,Himachal Pradesh,Property Crime,Theft,Female,18-30,8810,6133,2677,6150,2660
2001,Urban,Jharkhand,Crime Against Women,Dowry Deaths,Female,18-30,1323,340,983,454,869
2010,Rural,Delhi,Other Crimes,Drug Offense,Female,13-17,2472,2238,234,2341,131
2002,Rural,West Bengal,Property Crime,Theft,Male,60+,9436,3911,5525,7135,2301
2009,Rural,Kerala,Crime Against Children,Kidnapping,Male,31-45,740,339,401,344,396
2002,Rural,West Bengal,Property Crime,Theft,Female,18-30,3725,1331,2394,1519,2206
2004,Urban,Kerala,Other Crimes,Fraud,Male,60+,9110,6495,2615,7196,1914
2008,Urban,Himachal Pradesh,Crime Against Children,Kidnapping,Female,0-12,1582,1033,549,1304,278
2001,Rural,Bihar,Crime Against Men,Robbery,Female,13-17,3588,3386,202,3477,111
2006,Urban,Mizoram,Property Crime,Burglary,Female,13-17,3811,1792,2019,3509,302
2006,Urban,Jammu & Kashmir,Property Crime,Burglary,Female,60+,4956,903,4053,1762,3194
2001,Rural,Punjab,Property Crime,Arson,Male,46-60,800,476,324,716,84
2010,Urban,Andhra Pradesh,Crime Against Women,Rape,Female,18-30,1890,1608,282,1739,151
2007,Urban,Chhattisgarh,Crime Against Children,Kidnapping,Female,13-17,2564,1363,1201,2562,2
2007,Rural,Bihar,Property Crime,Theft,Female,60+,5567,2358,3209,3065,2502
2005,Rural,Meghalaya,Crime Against Children,Child Labor,Male,18-30,8200,7123,1077,8166,34
2009,Urban,Uttar Pradesh,Property Crime,Burglary,Male,31-45,8722,2768,5954,7778,944
2001,Rural,Bihar,Property Crime,Arson,Male,46-60,5006,2049,2957,2274,2732
2003,Rural,Andhra Pradesh,Crime Against Men,Robbery,Female,31-45,5339,3536,1803,5191,148
2001,Urban,Goa,Property Crime,Burglary,Female,18-30,387,54,333,107,280
2003,Rural,Chhattisgarh,Other Crimes,Corruption,Male,60+,3992,404,3588,564,3428
2006,Urban,Odisha,Crime Against Men,Robbery,Male,18-30,396,120,276,357,39
2002,Rural,Uttar Pradesh,Property Crime,Arson,Female,60+,7658,6714,944,6913,745
2001,Rural,Odisha,Crime Against Men,Extortion,Female,0-12,7260,4978,2282,6411,849
2001,Urban,Gujarat,Other Crimes,Drug Offense,Female,0-12,572,192,380,358,214
2004,Rural,Himachal Pradesh,Crime Against Children,Child Labor,Male,0-12,5660,4565,1095,5263,397
2002,Rural,Delhi,Crime Against Men,Murder,Female,0-12,3538,884,2654,2314,1224
2010,Rural,Chhattisgarh,Property Crime,Theft,Male,46-60,8178,649,7529,1247,6931
2005,Urban,Chhattisgarh,Property Crime,Theft,Male,13-17,5222,378,4844,2602,2620
2010,Rural,Punjab,Crime Against Children,Kidnapping,Male,46-60,548,298,250,367,181
2002,Rural,Uttarakhand,Crime Against Women,Rape,Female,0-12,5888,4622,1266,4685,1203
2003,Urban,Mizoram,Property Crime,Theft,Male,31-45,5194,3860,1334,5128,66
2009,Rural,Bihar,Crime Against Men,Robbery,Male,31-45,2975,1418,1557,2814,161
2007,Rural,Rajasthan,Crime Against Men,Murder,Female,31-45,3226,3018,208,3102,124
2004,Urban,Tamil Nadu,Property Crime,Vandalism,Female,0-12,9376,4433,4943,4492,4884
2007,Rural,Sikkim,Crime Against Men,Robbery,Female,31-45,5938,4756,1182,5071,867
2001,Rural,Arunachal Pradesh,Property Crime,Theft,Female,46-60,3824,1257,2567,2158,1666
2010,Rural,Madhya Pradesh,Other Crimes,Corruption,Male,0-12,8668,5330,3338,7510,1158
2007,Rural,Uttarakhand,Property Crime,Vandalism,Female,13-17,3114,1890,1224,2127,987
2005,Rural,Haryana,Property Crime,Theft,Female,13-17,6363,5047,1316,6026,337
2003,Rural,Uttar Pradesh,Crime Against Women,Rape,Male,13-17,5448,5283,165,5406,42
2003,Rural,Manipur,Other Crimes,Corruption,Male,13-17,2469,1319,1150,1375,1094
2007,Urban,Sikkim,Crime Against Women,Rape,Male,13-17,1922,308,1614,909,1013
2006,Urban,Punjab,Crime Against Women,Molestation,Male,18-30,8808,1042,7766,8342,466
2005,Urban,Gujarat,Crime Against Children,Child Labor,Female,46-60,5971,110,5861,1177,4794
2005,Urban,Arunachal Pradesh,Other Crimes,Fraud,Male,46-60,3894,2529,1365,2679,1215
2006,Urban,Rajasthan,Other Crimes,Fraud,Male,60+,2004,1745,259,1858,146
2010,Urban,Tamil Nadu,Crime Against Children,Kidnapping,Female,60+,3810,3145,665,3776,34
2006,Urban,Haryana,Other Crimes,Corruption,Male,0-12,4839,1852,2987,3444,1395
2007,Rural,Odisha,Crime Against Men,Robbery,Female,46-60,591,486,105,536,55
2004,Urban,Karnataka,Crime Against Men,Murder,Male,60+,3766,351,3415,810,2956
2002,Rural,Tamil Nadu,Crime Against Men,Assault,Male,18-30,1602,638,964,844,758
2010,Rural,Manipur,Crime Against Men,Extortion,Male,60+,1763,1550,213,1575,188
2010,Rural,Haryana,Crime Against Children,Kidnapping,Female,31-45,5657,4603,1054,5248,409
2008,Urban,Manipur,Crime Against Women,Domestic Violence,Female,13-17,9655,7838,1817,9233,422
2006,Rural,Madhya Pradesh,Crime Against Men,Extortion,Male,31-45,5474,877,4597,3667,1807
2010,Rural,Karnataka,Crime Against Women,Molestation,Male,46-60,2408,1819,589,1979,429
2003,Urban,Jammu & Kashmir,Crime Against Women,Molestation,Male,0-12,6733,659,6074,1964,4769
2005,Rural,Jammu & Kashmir,Other Crimes,Drug Offense,Female,18-30,5856,768,5088,2762,3094
2008,Rural,Bihar,Crime Against Men,Assault,Female,60+,1259,1249,10,1256,3
2010,Rural,Meghalaya,Crime Against Women,Domestic Violence,Female,18-30,4545,3104,1441,3798,747
2006,Urban,Arunachal Pradesh,Other Crimes,Corruption,Female,46-60,6460,3027,3433,4167,2293
2009,Rural,Telangana,Property Crime,Vandalism,Female,60+,4866,2439,2427,3925,941
2001,Rural,Sikkim,Other Crimes,Corruption,Female,18-30,9581,5976,3605,6328,3253
2007,Urban,Assam,Crime Against Women,Dowry Deaths,Male,13-17,8533,7819,714,8426,107
2008,Rural,Tripura,Crime Against Men,Robbery,Male,46-60,458,430,28,446,12
2008,Urban,Karnataka,Crime Against Women,Dowry Deaths,Female,31-45,9811,6966,2845,7578,2233
2002,Rural,Karnataka,Crime Against Men,Murder,Male,0-12,1048,677,371,987,61
2006,Urban,Himachal Pradesh,Other Crimes,Drug Offense,Female,46-60,2524,559,1965,1854,670
2009,Urban,Uttarakhand,Crime Against Children,Child Labor,Female,0-12,8300,3823,4477,6486,1814
2004,Rural,Punjab,Crime Against Children,Child Labor,Male,13-17,4923,1636,3287,2941,1982
2009,Rural,Nagaland,Other Crimes,Drug Offense,Female,46-60,8991,6223,2768,8457,534
2005,Rural,Mizoram,Crime Against Women,Domestic Violence,Male,0-12,6944,5687,1257,6330,614
2006,Rural,Uttarakhand,Other Crimes,Fraud,Male,13-17,8566,5304,3262,7578,988
2001,Rural,Andhra Pradesh,Crime Against Women,Dowry Deaths,Female,13-17,2726,383,2343,1412,1314
2003,Rural,Assam,Other Crimes,Corruption,Male,46-60,1998,517,1481,1049,949
2003,Urban,Himachal Pradesh,Crime Against Men,Extortion,Male,13-17,1190,726,464,1081,109
2003,Urban,Goa,Crime Against Men,Assault,Female,18-30,2290,1451,839,2264,26
2010,Rural,Haryana,Property Crime,Theft,Male,18-30,8145,303,7842,5681,2464
2001,Rural,Haryana,Crime Against Women,Dowry Deaths,Female,46-60,1816,808,1008,1450,366
2009,Urban,Arunachal Pradesh,Crime Against Women,Rape,Female,0-12,1884,320,1564,1761,123
2006,Rural,Manipur,Crime Against Children,Child Abuse,Male,18-30,3474,770,2704,1996,1478
2003,Urban,Arunachal Pradesh,Property Crime,Theft,Female,60+,6838,218,6620,6735,103
2002,Urban,Sikkim,Property Crime,Burglary,Male,31-45,1423,1411,12,1422,1
2004,Urban,Rajasthan,Crime Against Men,Extortion,Male,13-17,4994,1181,3813,3538,1456
2002,Urban,Gujarat,Crime Against Children,Child Abuse,Male,46-60,5555,1330,4225,3157,2398
2006,Rural,Gujarat,Property Crime,Theft,Male,18-30,1411,707,704,1159,252
2003,Urban,Nagaland,Crime Against Women,Dowry Deaths,Female,13-17,1633,889,744,1009,624
2005,Urban,Kerala,Crime Against Children,Kidnapping,Male,46-60,7465,2139,5326,4084,3381
2003,Urban,Karnataka,Property Crime,Arson,Female,31-45,6103,2436,3667,3128,2975
2007,Urban,Maharashtra,Crime Against Women,Domestic Violence,Male,13-17,490,479,11,490,0
2007,Rural,Andhra Pradesh,Other Crimes,Fraud,Male,46-60,3520,31,3489,281,3239
2009,Urban,Odisha,Other Crimes,Cyber Crime,Male,46-60,6393,3406,2987,5091,1302
2002,Urban,Meghalaya,Property Crime,Arson,Female,0-12,8590,6711,1879,8240,350
2008,Urban,Meghalaya,Property Crime,Burglary,Male,46-60,9234,249,8985,6653,2581
2002,Urban,Kerala,Crime Against Women,Rape,Female,46-60,6853,6701,152,6822,31
2001,Urban,Rajasthan,Crime Against Women,Rape,Male,18-30,9032,6838,2194,7866,1166
2004,Rural,Odisha,Crime Against Children,Trafficking,Male,31-45,1939,1775,164,1803,136
2010,Urban,Andhra Pradesh,Property Crime,Vandalism,Female,31-45,9869,4965,4904,7184,2685
2005,Urban,Uttar Pradesh,Crime Against Women,Domestic Violence,Female,31-45,4203,2381,1822,3968,235
2004,Rural,Delhi,Crime Against Women,Rape,Male,60+,3717,291,3426,2749,968
2010,Urban,Arunachal Pradesh,Crime Against Children,Trafficking,Female,13-17,8829,3495,5334,6361,2468
2009,Rural,Kerala,Other Crimes,Fraud,Female,46-60,2555,13,2542,2147,408
2008,Rural,Karnataka,Crime Against Women,Domestic Violence,Female,46-60,1701,571,1130,878,823
2002,Rural,Maharashtra,Crime Against Women,Dowry Deaths,Male,31-45,2073,1514,559,1689,384
2002,Urban,Maharashtra,Crime Against Women,Rape,Male,0-12,2276,869,1407,1439,837
2008,Rural,Sikkim,Property Crime,Theft,Male,18-30,2418,481,1937,1210,1208
2002,Rural,Nagaland,Crime Against Women,Dowry Deaths,Female,13-17,3626,2767,859,3118,508
2003,Rural,Goa,Crime Against Children,Kidnapping,Female,31-45,246,23,223,121,125
2004,Urban,Uttarakhand,Crime Against Men,Assault,Male,18-30,5224,4891,333,5108,116
2003,Rural,Assam,Crime Against Children,Child Abuse,Male,60+,9490,1613,7877,5419,4071
2002,Urban,Chhattisgarh,Crime Against Men,Extortion,Female,31-45,2105,1072,1033,1377,728
2002,Rural,Meghalaya,Crime Against Men,Robbery,Female,18-30,608,490,118,492,116
2008,Rural,Maharashtra,Crime Against Children,Trafficking,Male,18-30,1291,723,568,805,486
2004,Urban,Karnataka,Crime Against Women,Rape,Female,60+,2447,199,2248,2094,353
2010,Urban,Andhra Pradesh,Other Crimes,Fraud,Female,0-12,2575,1670,905,2200,375
2003,Rural,Gujarat,Crime Against Men,Assault,Male,60+,5562,2304,3258,4548,1014
2005,Urban,Bihar,Crime Against Women,Dowry Deaths,Male,13-17,3398,1141,2257,2060,1338
2006,Rural,Himachal Pradesh,Crime Against Children,Trafficking,Male,46-60,9117,3337,5780,5397,3720
2010,Rural,Delhi,Crime Against Children,Kidnapping,Male,31-45,2908,1964,944,2848,60
2006,Rural,Arunachal Pradesh,Crime Against Women,Domestic Violence,Male,0-12,6966,3093,3873,5020,1946
2003,Urban,Haryana,Property Crime,Theft,Male,13-17,7105,3581,3524,6112,993
2002,Urban,Uttarakhand,Crime Against Men,Murder,Female,46-60,5929,3395,2534,3945,1984
2004,Urban,Telangana,Property Crime,Vandalism,Female,13-17,477,457,20,469,8
2006,Rural,Rajasthan,Other Crimes,Fraud,Female,31-45,74,1,73,29,45
2006,Rural,Nagaland,Crime Against Men,Robbery,Male,31-45,8596,7654,942,8544,52
2005,Rural,Uttarakhand,Crime Against Men,Extortion,Male,31-45,4642,2465,2177,3806,836
2009,Urban,Rajasthan,Crime Against Women,Domestic Violence,Male,0-12,1588,691,897,1363,225
2008,Urban,Jammu & Kashmir,Crime Against Men,Murder,Male,31-45,1898,97,1801,719,1179
2005,Urban,Madhya Pradesh,Other Crimes,Fraud,Female,13-17,619,384,235,449,170
2008,Urban,Himachal Pradesh,Property Crime,Burglary,Female,18-30,5712,3350,2362,4028,1684
2005,Urban,Maharashtra,Crime Against Men,Murder,Female,13-17,6724,3782,2942,4538,2186
2003,Urban,Nagaland,Other Crimes,Cyber Crime,Male,46-60,6149,1817,4332,4176,1973
2003,Rural,Meghalaya,Crime Against Men,Assault,Male,31-45,4329,1072,3257,1838,2491
2001,Rural,Andhra Pradesh,Property Crime,Arson,Female,18-30,9328,5303,4025,6429,2899
2005,Rural,Haryana,Crime Against Women,Molestation,Male,0-12,103,59,44,72,31
2008,Rural,Meghalaya,Other Crimes,Cyber Crime,Female,31-45,979,503,476,505,474
2001,Urban,Manipur,Property Crime,Arson,Female,31-45,3650,3280,370,3584,66
2005,Urban,Jammu & Kashmir,Crime Against Men,Murder,Male,46-60,9411,4711,4700,5295,4116
2009,Rural,Tripura,Crime Against Women,Dowry Deaths,Male,13-17,7449,1200,6249,5559,1890
2004,Rural,Assam,Property Crime,Burglary,Female,60+,9576,5968,3608,6541,3035
2005,Urban,Uttar Pradesh,Crime Against Women,Rape,Female,46-60,7470,6607,863,7155,315
2001,Rural,Uttar Pradesh,Other Crimes,Drug Offense,Female,46-60,476,464,12,472,4
2007,Rural,West Bengal,Other Crimes,Cyber Crime,Male,13-17,1526,193,1333,579,947
2004,Rural,Uttarakhand,Crime Against Children,Kidnapping,Female,0-12,4348,3766,582,3995,353
2008,Rural,Sikkim,Crime Against Men,Assault,Female,46-60,2144,911,1233,1156,988
2010,Urban,Goa,Property Crime,Burglary,Female,0-12,2438,449,1989,1898,540
2007,Rural,Telangana,Other Crimes,Cyber Crime,Female,0-12,3955,643,3312,1852,2103
2007,Urban,Maharashtra,Crime Against Children,Kidnapping,Male,31-45,9990,6400,3590,7915,2075
2009,Urban,Mizoram,Other Crimes,Fraud,Male,60+,768,200,568,359,409
2003,Urban,Assam,Crime Against Children,Child Labor,Male,0-12,2285,2025,260,2152,133
2010,Urban,Sikkim,Other Crimes,Cyber Crime,Male,13-17,3879,1564,2315,1674,2205
2009,Urban,Himachal Pradesh,Crime Against Women,Molestation,Male,18-30,114,103,11,105,9
2009,Rural,West Bengal,Crime Against Children,Child Labor,Female,31-45,6496,4448,2048,6082,414
2001,Urban,Tamil Nadu,Other Crimes,Fraud,Male,0-12,2381,302,2079,1795,586
2010,Rural,Assam,Property Crime,Arson,Male,46-60,1706,1546,160,1650,56
2009,Rural,Bihar,Property Crime,Theft,Male,13-17,2652,1260,1392,1990,662
2005,Rural,Telangana,Other Crimes,Corruption,Female,13-17,3018,2691,327,2756,262
2008,Rural,Tamil Nadu,Property Crime,Theft,Female,13-17,2961,2491,470,2608,353
2003,Rural,Tripura,Crime Against Children,Child Labor,Male,0-12,3612,989,2623,3106,506
2008,Urban,Jharkhand,Other Crimes,Corruption,Male,13-17,5455,1009,4446,3316,2139
2002,Rural,West Bengal,Property Crime,Burglary,Female,0-12,7148,5825,1323,7139,9
2009,Urban,Madhya Pradesh,Crime Against Children,Kidnapping,Male,18-30,6101,1498,4603,3103,2998
2006,Rural,West Bengal,Crime Against Men,Murder,Male,31-45,6948,1455,5493,2491,4457
2007,Rural,Sikkim,Crime Against Children,Child Abuse,Male,46-60,9854,9491,363,9529,325
2006,Urban,Nagaland,Crime Against Children,Trafficking,Female,18-30,8575,257,8318,3515,5060
2008,Rural,Manipur,Crime Against Children,Child Labor,Male,13-17,353,51,302,223,130
2002,Urban,Sikkim,Crime Against Men,Robbery,Male,18-30,1949,1465,484,1946,3
2010,Urban,Meghalaya,Crime Against Men,Robbery,Female,13-17,6900,4000,2900,6714,186
2005,Urban,Sikkim,Crime Against Children,Kidnapping,Female,0-12,8946,1343,7603,8286,660
2008,Urban,Rajasthan,Crime Against Men,Extortion,Female,13-17,1858,877,981,1483,375
2005,Rural,Chhattisgarh,Crime Against Children,Child Abuse,Female,18-30,9016,5878,3138,8453,563
2010,Rural,Jharkhand,Other Crimes,Drug Offense,Female,31-45,5760,4944,816,5261,499
2004,Urban,Himachal Pradesh,Other Crimes,Cyber Crime,Female,60+,8759,336,8423,5275,3484
2006,Rural,Meghalaya,Other Crimes,Fraud,Female,18-30,2684,933,1751,2445,239
2010,Rural,Madhya Pradesh,Crime Against Women,Rape,Female,46-60,3879,420,3459,2606,1273
2002,Rural,Sikkim,Property Crime,Theft,Male,18-30,8111,6348,1763,7804,307
2004,Urban,Nagaland,Crime Against Men,Extortion,Female,0-12,8518,1984,6534,7719,799
2005,Rural,Himachal Pradesh,Property Crime,Theft,Male,60+,4148,858,3290,1979,2169
2010,Urban,Kerala,Other Crimes,Fraud,Male,46-60,502,141,361,442,60
2008,Urban,Tripura,Other Crimes,Drug Offense,Female,60+,8356,2963,5393,4244,4112
2007,Urban,Madhya Pradesh,Crime Against Women,Rape,Female,0-12,4400,2094,2306,3799,601
2007,Rural,Chhattisgarh,Crime Against Men,Assault,Male,46-60,1890,153,1737,1856,34
2008,Rural,Jammu & Kashmir,Property Crime,Theft,Female,31-45,7507,111,7396,4395,3112
2008,Urban,Manipur,Crime Against Women,Dowry Deaths,Male,18-30,2346,316,2030,1918,428
2010,Urban,Kerala,Crime Against Children,Trafficking,Male,13-17,5609,5062,547,5271,338
2010,Rural,Maharashtra,Other Crimes,Drug Offense,Female,13-17,5675,4054,1621,5663,12
2007,Urban,Meghalaya,Crime Against Women,Domestic Violence,Female,31-45,9182,9034,148,9129,53
2006,Urban,Uttarakhand,Crime Against Children,Child Abuse,Female,13-17,9893,7655,2238,9418,475
2005,Rural,Madhya Pradesh,Other Crimes,Drug Offense,Male,13-17,2679,2460,219,2621,58
2003,Urban,Karnataka,Property Crime,Burglary,Female,31-45,4762,1780,2982,2293,2469
2010,Rural,Goa,Crime Against Men,Assault,Male,18-30,1081,995,86,1005,76
2010,Rural,Rajasthan,Crime Against Women,Domestic Violence,Male,13-17,5220,2226,2994,2667,2553
2009,Urban,Meghalaya,Crime Against Men,Assault,Male,31-45,375,299,76,353,22
2009,Rural,Gujarat,Crime Against Children,Child Abuse,Female,46-60,2977,523,2454,1138,1839
2003,Urban,Bihar,Crime Against Men,Robbery,Female,13-17,7117,1236,5881,4899,2218
2010,Rural,Assam,Crime Against Women,Rape,Female,46-60,532,378,154,515,17
2010,Rural,Jharkhand,Crime Against Men,Robbery,Female,0-12,1794,1150,644,1387,407
2001,Rural,Rajasthan,Crime Against Women,Rape,Male,31-45,4459,2674,1785,3136,1323
2004,Urban,Rajasthan,Crime Against Men,Assault,Male,31-45,4494,3754,740,4343,151
2001,Urban,Tripura,Other Crimes,Drug Offense,Male,13-17,5214,3964,1250,4728,486
2008,Rural,Nagaland,Crime Against Children,Kidnapping,Female,46-60,3945,3057,888,3142,803
2009,Rural,Jharkhand,Property Crime,Vandalism,Female,18-30,2055,2021,34,2033,22
2005,Urban,Maharashtra,Crime Against Children,Trafficking,Female,13-17,5287,4219,1068,4830,457
2010,Rural,Jharkhand,Crime Against Men,Extortion,Female,31-45,2709,475,2234,2194,515
2001,Rural,Chhattisgarh,Crime Against Children,Child Abuse,Female,13-17,3431,291,3140,1154,2277
2006,Rural,Nagaland,Other Crimes,Corruption,Female,0-12,6819,870,5949,4772,2047
2004,Urban,Bihar,Crime Against Children,Child Labor,Male,46-60,5035,4836,199,4919,116
2001,Rural,Jharkhand,Crime Against Children,Child Abuse,Female,31-45,4759,1385,3374,3300,1459
2009,Urban,Assam,Property Crime,Vandalism,Male,60+,8503,6580,1923,8165,338
2006,Urban,Mizoram,Crime Against Women,Domestic Violence,Male,0-12,4933,809,4124,2295,2638
2003,Urban,Arunachal Pradesh,Other Crimes,Fraud,Female,0-12,8145,3170,4975,6772,1373
2010,Rural,Meghalaya,Crime Against Women,Rape,Female,46-60,1381,413,968,1365,16
2004,Rural,Himachal Pradesh,Property Crime,Burglary,Male,13-17,732,605,127,668,64
2004,Urban,Jharkhand,Crime Against Children,Trafficking,Male,31-45,4182,425,3757,2962,1220
2009,Urban,Tamil Nadu,Crime Against Children,Child Labor,Male,13-17,3240,2904,336,3187,53
2004,Rural,West Bengal,Crime Against Women,Molestation,Male,31-45,379,208,171,328,51
2002,Urban,Tripura,Crime Against Men,Extortion,Male,0-12,2017,1391,626,1699,318
2008,Urban,Uttar Pradesh,Other Crimes,Cyber Crime,Female,18-30,7699,7593,106,7646,53
2008,Urban,Tripura,Property Crime,Burglary,Male,31-45,3617,1535,2082,1769,1848
2001,Rural,Nagaland,Other Crimes,Fraud,Male,31-45,2603,142,2461,857,1746
2001,Rural,West Bengal,Crime Against Men,Robbery,Male,31-45,8393,5276,3117,5796,2597
2006,Urban,Punjab,Crime Against Children,Kidnapping,Male,0-12,5697,2117,3580,5697,0
2008,Urban,Goa,Crime Against Children,Child Abuse,Male,18-30,9496,2998,6498,8759,737
2003,Urban,Goa,Other Crimes,Fraud,Female,31-45,9011,1924,7087,7768,1243
2008,Rural,Chhattisgarh,Crime Against Men,Robbery,Male,0-12,3520,2963,557,3454,66
2010,Urban,Chhattisgarh,Crime Against Children,Kidnapping,Male,46-60,1313,896,417,1288,25
2003,Rural,Chhattisgarh,Other Crimes,Fraud,Female,13-17,7756,2880,4876,3293,4463
2005,Urban,Odisha,Other Crimes,Corruption,Male,31-45,9316,5240,4076,7795,1521
2006,Rural,Tripura,Property Crime,Vandalism,Male,60+,5897,4095,1802,5884,13
2005,Rural,Assam,Crime Against Children,Trafficking,Male,0-12,1742,952,790,1068,674
2004,Rural,Chhattisgarh,Other Crimes,Fraud,Female,31-45,3384,1499,1885,3020,364
2006,Urban,Bihar,Crime Against Children,Child Labor,Female,60+,4530,2618,1912,3344,1186
2010,Urban,Tamil Nadu,Property Crime,Theft,Female,46-60,352,178,174,211,141
2004,Urban,Uttar Pradesh,Crime Against Children,Kidnapping,Female,0-12,5687,4604,1083,5229,458
2003,Rural,Telangana,Crime Against Children,Child Abuse,Female,13-17,4977,2471,2506,3403,1574
2008,Rural,Meghalaya,Crime Against Men,Assault,Male,31-45,2292,944,1348,2271,21
2004,Urban,Mizoram,Crime Against Men,Murder,Male,18-30,7961,1949,6012,3491,4470
2008,Urban,Andhra Pradesh,Crime Against Children,Child Labor,Female,60+,2435,842,1593,1746,689
2004,Rural,West Bengal,Property Crime,Theft,Female,0-12,3212,167,3045,2300,912
2009,Urban,Uttarakhand,Crime Against Men,Murder,Male,60+,6817,75,6742,5258,1559
2002,Urban,Mizoram,Crime Against Men,Extortion,Male,46-60,5562,2202,3360,5462,100
2010,Urban,Tripura,Crime Against Children,Child Abuse,Female,13-17,5520,1369,4151,1417,4103
2003,Rural,Chhattisgarh,Crime Against Children,Kidnapping,Female,31-45,6743,1073,5670,6347,396
2004,Urban,Telangana,Other Crimes,Fraud,Male,13-17,5867,2486,3381,4828,1039
2005,Urban,Kerala,Crime Against Children,Kidnapping,Male,18-30,3764,2691,1073,2904,860
2010,Urban,Chhattisgarh,Other Crimes,Fraud,Male,13-17,4793,363,4430,4318,475
2007,Urban,Himachal Pradesh,Other Crimes,Fraud,Female,60+,3775,846,2929,3640,135
2007,Urban,Haryana,Crime Against Men,Assault,Male,60+,8648,3637,5011,4109,4539
2009,Rural,Madhya Pradesh,Crime Against Women,Rape,Female,18-30,2156,487,1669,646,1510
2004,Rural,Andhra Pradesh,Property Crime,Arson,Female,13-17,730,684,46,690,40
2002,Rural,Madhya Pradesh,Crime Against Women,Dowry Deaths,Male,46-60,916,610,306,795,121
2003,Rural,Odisha,Crime Against Men,Assault,Female,46-60,2764,2741,23,2742,22
2006,Rural,Himachal Pradesh,Other Crimes,Corruption,Female,46-60,1295,454,841,1250,45
2001,Urban,Delhi,Crime Against Men,Assault,Male,46-60,121,36,85,57,64
2007,Urban,Odisha,Property Crime,Vandalism,Male,60+,4861,826,4035,1007,3854
2001,Rural,Tamil Nadu,Property Crime,Arson,Female,60+,4871,569,4302,1026,3845
2009,Rural,West Bengal,Property Crime,Arson,Male,60+,9605,2609,6996,5222,4383
2002,Urban,Madhya Pradesh,Crime Against Men,Assault,Male,46-60,9151,3279,5872,7233,1918
2002,Urban,Karnataka,Crime Against Women,Molestation,Male,18-30,9402,8413,989,9226,176
2004,Urban,Haryana,Other Crimes,Drug Offense,Female,31-45,4449,426,4023,3799,650
2005,Rural,Karnataka,Crime Against Men,Assault,Male,0-12,9416,9129,287,9209,207
2003,Rural,Haryana,Other Crimes,Drug Offense,Female,46-60,6844,3277,3567,6281,563
2006,Urban,Gujarat,Other Crimes,Fraud,Female,60+,2915,1336,1579,1400,1515
2008,Rural,Telangana,Other Crimes,Fraud,Female,46-60,3514,3358,156,3497,17
2006,Urban,Sikkim,Other Crimes,Corruption,Male,13-17,315,178,137,223,92
2001,Urban,Mizoram,Property Crime,Vandalism,Female,31-45,1089,235,854,965,124
2006,Urban,Haryana,Other Crimes,Fraud,Female,31-45,1569,705,864,1122,447
2003,Rural,Kerala,Crime Against Men,Extortion,Male,0-12,3402,1964,1438,2010,1392
2006,Rural,Delhi,Crime Against Women,Dowry Deaths,Female,0-12,4751,2520,2231,4478,273
2009,Rural,Odisha,Crime Against Children,Child Labor,Male,46-60,9304,2407,6897,6424,2880
2001,Rural,Madhya Pradesh,Property Crime,Arson,Male,18-30,806,96,710,153,653
2004,Urban,Andhra Pradesh,Crime Against Children,Trafficking,Male,0-12,9731,7063,2668,9178,553
2003,Urban,Sikkim,Property Crime,Vandalism,Female,13-17,1423,98,1325,226,1197
2008,Urban,Haryana,Crime Against Children,Child Labor,Female,31-45,4191,4001,190,4051,140
2004,Rural,Manipur,Crime Against Children,Trafficking,Male,18-30,1450,810,640,1049,401
2003,Urban,Jammu & Kashmir,Crime Against Men,Murder,Male,0-12,1078,1008,70,1016,62
2005,Urban,Bihar,Crime Against Women,Molestation,Female,46-60,8923,1720,7203,5400,3523
2006,Urban,Punjab,Crime Against Men,Murder,Male,31-45,5986,2924,3062,4079,1907
2010,Urban,Sikkim,Property Crime,Arson,Female,60+,9159,3994,5165,4238,4921
2003,Rural,Manipur,Crime Against Women,Dowry Deaths,Male,31-45,818,782,36,783,35
2009,Rural,Maharashtra,Crime Against Women,Rape,Female,13-17,1583,1397,186,1509,74
2001,Rural,Assam,Property Crime,Arson,Male,31-45,783,444,339,477,306
2004,Rural,Meghalaya,Crime Against Children,Child Abuse,Female,46-60,4386,3284,1102,3619,767
2008,Urban,Tamil Nadu,Other Crimes,Corruption,Male,31-45,6913,5607,1306,5878,1035
2008,Urban,Arunachal Pradesh,Property Crime,Arson,Male,13-17,6791,5729,1062,5895,896
2010,Urban,Tamil Nadu,Crime Against Women,Molestation,Female,46-60,9389,4684,4705,5632,3757
2010,Urban,Arunachal Pradesh,Property Crime,Arson,Male,31-45,6942,3227,3715,6576,366
2008,Urban,Assam,Other Crimes,Drug Offense,Male,18-30,4415,4160,255,4338,77
2005,Urban,Telangana,Property Crime,Arson,Male,13-17,304,130,174,228,76
2004,Rural,Rajasthan,Crime Against Men,Assault,Female,46-60,111,102,9,108,3
2001,Rural,Chhattisgarh,Crime Against Children,Trafficking,Female,13-17,4297,3348,949,3945,352
2006,Urban,West Bengal,Crime Against Women,Domestic Violence,Male,13-17,6391,5874,517,6246,145
2007,Urban,Uttar Pradesh,Crime Against Women,Rape,Female,13-17,5051,1803,3248,3261,1790
2002,Urban,Uttarakhand,Crime Against Children,Kidnapping,Female,18-30,8402,328,8074,776,7626
2009,Urban,Telangana,Crime Against Children,Trafficking,Female,13-17,5967,5894,73,5965,2
2010,Urban,Mizoram,Crime Against Women,Molestation,Male,18-30,7189,6366,823,6987,202
2004,Rural,Jammu & Kashmir,Crime Against Women,Dowry Deaths,Male,46-60,1286,214,1072,913,373
2007,Urban,Meghalaya,Property Crime,Burglary,Female,31-45,7160,813,6347,4041,3119
2003,Urban,Telangana,Property Crime,Vandalism,Male,46-60,172,87,85,93,79
2001,Rural,Haryana,Other Crimes,Drug Offense,Male,18-30,9227,5200,4027,5954,3273
2005,Urban,Jammu & Kashmir,Other Crimes,Cyber Crime,Female,46-60,4728,1692,3036,2030,2698
2008,Rural,Rajasthan,Property Crime,Burglary,Female,60+,9640,2472,7168,3386,6254
2005,Rural,Karnataka,Crime Against Children,Child Abuse,Female,13-17,4145,185,3960,3949,196
2004,Rural,Haryana,Other Crimes,Drug Offense,Female,46-60,1566,320,1246,963,603
2008,Rural,West Bengal,Crime Against Men,Murder,Female,60+,317,297,20,300,17
2004,Urban,Uttar Pradesh,Crime Against Women,Rape,Female,46-60,9536,2627,6909,6120,3416
2009,Rural,Telangana,Crime Against Women,Domestic Violence,Female,0-12,432,42,390,273,159
2006,Rural,Haryana,Other Crimes,Corruption,Male,0-12,2927,2145,782,2893,34
2001,Rural,Mizoram,Other Crimes,Drug Offense,Male,46-60,9787,7278,2509,8095,1692
2006,Urban,Madhya Pradesh,Property Crime,Vandalism,Male,31-45,6797,1495,5302,5446,1351
2003,Urban,Meghalaya,Crime Against Children,Kidnapping,Male,0-12,7353,7049,304,7353,0
2010,Urban,Mizoram,Crime Against Children,Trafficking,Male,0-12,3086,864,2222,1244,1842
2010,Urban,Jharkhand,Other Crimes,Corruption,Female,60+,9229,2153,7076,2761,6468
2006,Urban,Andhra Pradesh,Crime Against Men,Robbery,Male,13-17,1995,1296,699,1935,60
2005,Urban,Tripura,Crime Against Men,Robbery,Female,60+,9212,1351,7861,4793,4419
2005,Urban,Mizoram,Other Crimes,Corruption,Female,60+,2791,260,2531,1608,1183
2002,Urban,Odisha,Crime Against Children,Kidnapping,Male,31-45,1936,120,1816,682,1254
2002,Urban,Punjab,Crime Against Women,Domestic Violence,Male,0-12,4937,3628,1309,4039,898
2004,Rural,Nagaland,Property Crime,Vandalism,Male,13-17,3198,1269,1929,1750,1448
2007,Rural,Uttarakhand,Crime Against Men,Extortion,Male,18-30,4784,1764,3020,3989,795
2007,Urban,Madhya Pradesh,Crime Against Children,Trafficking,Male,60+,6854,1765,5089,4792,2062
2006,Urban,Odisha,Property Crime,Vandalism,Female,46-60,125,42,83,43,82
2007,Rural,Jharkhand,Other Crimes,Cyber Crime,Male,18-30,2998,326,2672,2597,401
2004,Rural,Madhya Pradesh,Crime Against Men,Robbery,Female,31-45,4519,733,3786,2642,1877
2007,Urban,Nagaland,Crime Against Children,Kidnapping,Female,0-12,7925,4184,3741,6138,1787
2003,Urban,Uttar Pradesh,Other Crimes,Cyber Crime,Female,13-17,7872,5349,2523,6982,890
2005,Urban,Uttarakhand,Other Crimes,Fraud,Male,31-45,2549,1408,1141,1783,766
2002,Rural,Assam,Other Crimes,Drug Offense,Female,46-60,3891,3717,174,3773,118
2001,Urban,Telangana,Crime Against Women,Dowry Deaths,Male,31-45,4207,923,3284,1997,2210
2002,Urban,Madhya Pradesh,Crime Against Women,Dowry Deaths,Female,60+,4857,4651,206,4741,116
2006,Rural,Manipur,Crime Against Children,Child Abuse,Male,0-12,9917,6571,3346,8278,1639
2009,Rural,Tamil Nadu,Other Crimes,Fraud,Female,13-17,6099,4850,1249,5056,1043
2009,Urban,Himachal Pradesh,Crime Against Children,Child Abuse,Female,31-45,213,73,140,182,31
2010,Urban,Odisha,Property Crime,Arson,Male,46-60,853,24,829,837,16
2009,Urban,Mizoram,Crime Against Children,Child Labor,Male,31-45,6400,421,5979,553,5847
2003,Rural,Delhi,Crime Against Children,Trafficking,Male,46-60,9864,5730,4134,6893,2971
2003,Urban,Assam,Crime Against Men,Robbery,Female,46-60,1215,23,1192,521,694
2005,Rural,Sikkim,Other Crimes,Cyber Crime,Female,31-45,5147,2781,2366,3806,1341
2001,Rural,Uttarakhand,Crime Against Women,Domestic Violence,Male,18-30,7103,5579,1524,6780,323
2001,Rural,Tamil Nadu,Crime Against Men,Murder,Female,31-45,2017,1670,347,1958,59
2008,Urban,Kerala,Crime Against Men,Extortion,Male,31-45,7805,814,6991,6669,1136
2003,Rural,Gujarat,Other Crimes,Drug Offense,Male,46-60,8162,4967,3195,6810,1352
2003,Urban,Manipur,Property Crime,Arson,Male,0-12,4062,134,3928,1129,2933
2001,Rural,Tripura,Crime Against Children,Kidnapping,Male,46-60,2815,2171,644,2436,379
2001,Urban,Jammu & Kashmir,Crime Against Men,Extortion,Female,31-45,4847,2630,2217,2778,2069
2003,Urban,Himachal Pradesh,Crime Against Women,Molestation,Male,18-30,7193,6271,922,6660,533
2009,Urban,Rajasthan,Crime Against Women,Domestic Violence,Male,46-60,8598,5597,3001,5970,2628
2003,Rural,Goa,Property Crime,Burglary,Male,13-17,2397,1938,459,2288,109
2001,Rural,Tamil Nadu,Crime Against Women,Domestic Violence,Male,60+,2604,671,1933,1424,1180
2004,Urban,Himachal Pradesh,Property Crime,Arson,Female,18-30,8714,8418,296,8692,22
2006,Urban,Assam,Crime Against Women,Rape,Male,60+,6786,471,6315,2564,4222
2001,Rural,Haryana,Crime Against Men,Murder,Male,18-30,423,407,16,408,15
2010,Urban,Goa,Property Crime,Burglary,Female,13-17,8036,5075,2961,6429,1607
2002,Urban,Arunachal Pradesh,Other Crimes,Fraud,Female,60+,7183,2196,4987,5417,1766
2003,Urban,Telangana,Crime Against Men,Extortion,Male,31-45,9553,3682,5871,9094,459
2009,Rural,Punjab,Other Crimes,Cyber Crime,Female,18-30,7163,2401,4762,2809,4354
2009,Rural,Chhattisgarh,Other Crimes,Cyber Crime,Female,60+,1340,913,427,1135,205
2004,Urban,West Bengal,Crime Against Women,Rape,Female,0-12,7388,2239,5149,4084,3304
2005,Rural,Manipur,Crime Against Women,Rape,Male,60+,3073,2430,643,2451,622
2010,Urban,Manipur,Property Crime,Vandalism,Male,13-17,1131,262,869,860,271
2007,Urban,Maharashtra,Property Crime,Arson,Female,46-60,2329,639,1690,1841,488
2002,Rural,Nagaland,Crime Against Women,Domestic Violence,Male,60+,876,494,382,719,157
2006,Urban,Telangana,Property Crime,Burglary,Female,0-12,6164,4826,1338,5024,1140
2008,Urban,Telangana,Other Crimes,Corruption,Male,0-12,7251,5618,1633,6449,802
2005,Urban,Punjab,Other Crimes,Fraud,Male,0-12,5494,4362,1132,4749,745
2005,Urban,Manipur,Crime Against Women,Rape,Female,60+,848,312,536,343,505
2006,Urban,Uttarakhand,Other Crimes,Cyber Crime,Male,0-12,8445,7156,1289,8201,244
2008,Urban,Gujarat,Crime Against Children,Child Labor,Male,46-60,5433,3374,2059,3887,1546
2009,Rural,Tripura,Other Crimes,Cyber Crime,Female,18-30,270,246,24,247,23
2006,Urban,Telangana,Property Crime,Arson,Male,60+,6935,2357,4578,4476,2459
2006,Rural,Uttarakhand,Crime Against Women,Rape,Female,60+,4426,3103,1323,3760,666
2005,Rural,Tripura,Crime Against Women,Domestic Violence,Male,18-30,1664,523,1141,1586,78
2002,Rural,Bihar,Crime Against Children,Kidnapping,Male,46-60,4209,197,4012,3057,1152
2008,Urban,Gujarat,Crime Against Women,Molestation,Male,13-17,2707,730,1977,1811,896
2008,Urban,Uttarakhand,Crime Against Women,Molestation,Female,18-30,8109,2071,6038,3999,4110
2008,Rural,Maharashtra,Crime Against Children,Child Labor,Male,60+,8075,5251,2824,7735,340
2005,Rural,Telangana,Other Crimes,Drug Offense,Female,18-30,7131,6099,1032,6786,345
2008,Rural,Maharashtra,Crime Against Men,Robbery,Male,0-12,4675,1518,3157,3755,920
2001,Urban,Punjab,Crime Against Women,Molestation,Male,31-45,9075,578,8497,7514,1561
2003,Urban,Gujarat,Other Crimes,Fraud,Male,18-30,3572,764,2808,1940,1632
2008,Urban,Nagaland,Other Crimes,Drug Offense,Female,18-30,8643,3322,5321,4170,4473
2010,Urban,Meghalaya,Crime Against Women,Rape,Female,60+,2303,2267,36,2267,36
2006,Rural,Arunachal Pradesh,Property Crime,Burglary,Female,18-30,5639,3934,1705,4096,1543
2004,Rural,Andhra Pradesh,Crime Against Women,Domestic Violence,Male,31-45,8661,840,7821,1448,7213
2003,Urban,Tamil Nadu,Crime Against Women,Dowry Deaths,Female,0-12,9221,4851,4370,5966,3255
2001,Urban,Jammu & Kashmir,Property Crime,Theft,Female,31-45,6337,5812,525,5977,360
2001,Urban,Andhra Pradesh,Crime Against Men,Murder,Female,46-60,1896,727,1169,764,1132
2009,Urban,Karnataka,Crime Against Women,Dowry Deaths,Male,60+,8954,1514,7440,2281,6673
2004,Urban,Sikkim,Crime Against Women,Dowry Deaths,Male,0-12,5261,2949,2312,3445,1816
2004,Rural,Madhya Pradesh,Crime Against Women,Molestation,Male,60+,407,406,1,406,1
2008,Urban,Delhi,Property Crime,Arson,Female,13-17,579,57,522,269,310
2002,Rural,Bihar,Crime Against Women,Rape,Female,13-17,3176,1100,2076,1190,1986
2006,Urban,Punjab,Crime Against Women,Molestation,Female,18-30,4640,4073,567,4083,557
2007,Rural,Arunachal Pradesh,Crime Against Men,Assault,Female,13-17,7816,2932,4884,4790,3026
2004,Rural,Kerala,Crime Against Children,Kidnapping,Male,31-45,8275,3400,4875,7335,940
2010,Rural,Meghalaya,Property Crime,Theft,Female,60+,2260,2039,221,2045,215
2003,Rural,Arunachal Pradesh,Property Crime,Vandalism,Female,0-12,8278,3439,4839,3714,4564
2006,Rural,Assam,Crime Against Men,Assault,Female,0-12,8942,7565,1377,7947,995
2002,Rural,Kerala,Crime Against Women,Rape,Male,60+,8301,4821,3480,7862,439
2006,Rural,Telangana,Crime Against Children,Trafficking,Female,18-30,7402,4219,3183,5471,1931
2003,Rural,Tripura,Crime Against Women,Rape,Female,31-45,1889,1718,171,1875,14
2008,Urban,Telangana,Property Crime,Vandalism,Male,0-12,308,220,88,262,46
2004,Rural,Andhra Pradesh,Crime Against Women,Dowry Deaths,Female,18-30,4225,1014,3211,4087,138
2004,Rural,Haryana,Crime Against Children,Child Abuse,Female,60+,2357,1296,1061,2023,334
2002,Urban,Arunachal Pradesh,Property Crime,Theft,Female,60+,6081,1323,4758,1361,4720
2008,Rural,Punjab,Crime Against Children,Trafficking,Female,0-12,6070,5333,737,5341,729
2009,Rural,Delhi,Other Crimes,Drug Offense,Male,46-60,1856,813,1043,1736,120
2004,Urban,Maharashtra,Crime Against Men,Extortion,Male,13-17,9602,7057,2545,8106,1496
2004,Urban,Jammu & Kashmir,Other Crimes,Drug Offense,Male,31-45,1675,403,1272,465,1210
2004,Urban,Uttarakhand,Crime Against Children,Trafficking,Female,13-17,5656,3041,2615,3885,1771
2006,Urban,Delhi,Crime Against Children,Child Labor,Female,46-60,603,144,459,185,418
2002,Rural,Andhra Pradesh,Other Crimes,Cyber Crime,Male,13-17,3792,2416,1376,3452,340
2004,Rural,Uttar Pradesh,Property Crime,Burglary,Male,60+,6089,615,5474,3764,2325
2003,Rural,Bihar,Crime Against Women,Molestation,Female,0-12,3579,530,3049,1063,2516
2004,Rural,Meghalaya,Crime Against Women,Rape,Male,46-60,8504,4309,4195,6959,1545
2006,Urban,Tamil Nadu,Property Crime,Burglary,Male,13-17,1180,9,1171,241,939
2002,Urban,Himachal Pradesh,Property Crime,Vandalism,Female,18-30,8206,102,8104,1278,6928
2008,Urban,Madhya Pradesh,Crime Against Women,Domestic Violence,Male,0-12,2900,2124,776,2157,743
2010,Rural,Himachal Pradesh,Property Crime,Theft,Female,46-60,6926,2093,4833,2289,4637
2006,Rural,Gujarat,Property Crime,Theft,Male,18-30,4991,2788,2203,3661,1330
2007,Urban,Sikkim,Crime Against Children,Kidnapping,Female,13-17,4840,4820,20,4834,6
2002,Urban,Jammu & Kashmir,Other Crimes,Cyber Crime,Male,13-17,6030,2041,3989,2671,3359
2004,Urban,Meghalaya,Crime Against Men,Robbery,Male,13-17,3957,649,3308,3089,868
2010,Rural,Arunachal Pradesh,Crime Against Women,Dowry Deaths,Male,60+,7020,4133,2887,4338,2682
2010,Urban,Mizoram,Crime Against Children,Child Labor,Male,13-17,9810,9552,258,9721,89
2001,Urban,Bihar,Crime Against Men,Robbery,Female,60+,6472,249,6223,4435,2037
2009,Rural,Odisha,Crime Against Women,Dowry Deaths,Male,13-17,7459,7423,36,7450,9
2004,Urban,Rajasthan,Other Crimes,Fraud,Female,0-12,5591,4326,1265,4939,652
2008,Urban,Sikkim,Crime Against Women,Dowry Deaths,Female,13-17,9857,5923,3934,9692,165
2007,Rural,West Bengal,Other Crimes,Cyber Crime,Male,31-45,9119,2291,6828,3760,5359
2008,Urban,Bihar,Crime Against Men,Assault,Female,31-45,8074,7551,523,8015,59
2005,Urban,Mizoram,Crime Against Children,Trafficking,Female,13-17,655,88,567,196,459
2009,Urban,Jharkhand,Crime Against Men,Extortion,Female,13-17,8299,8190,109,8197,102
2005,Rural,Punjab,Property Crime,Vandalism,Male,0-12,4195,661,3534,3441,754
2009,Urban,Sikkim,Property Crime,Arson,Female,18-30,7512,2260,5252,5172,2340
2010,Urban,Nagaland,Property Crime,Vandalism,Female,31-45,9465,3422,6043,9356,109
2002,Urban,Karnataka,Property Crime,Burglary,Female,46-60,6459,2869,3590,6402,57
2002,Urban,Jharkhand,Crime Against Men,Assault,Male,0-12,7403,3422,3981,5045,2358
2010,Urban,Odisha,Crime Against Children,Child Abuse,Female,60+,7817,2986,4831,7415,402
2004,Rural,Telangana,Crime Against Children,Kidnapping,Male,0-12,3370,1423,1947,3237,133
2005,Urban,Nagaland,Crime Against Children,Trafficking,Male,31-45,5997,1099,4898,3285,2712
2001,Urban,Haryana,Other Crimes,Fraud,Female,18-30,6139,4788,1351,5166,973
2006,Rural,Kerala,Other Crimes,Cyber Crime,Female,46-60,2435,1041,1394,1750,685
2009,Rural,Chhattisgarh,Crime Against Children,Child Abuse,Male,0-12,7955,4285,3670,4620,3335
2004,Urban,Gujarat,Other Crimes,Drug Offense,Female,13-17,1324,1093,231,1323,1
2010,Urban,West Bengal,Property Crime,Burglary,Male,0-12,7172,4075,3097,6352,820
2001,Rural,Tripura,Crime Against Men,Murder,Female,13-17,2891,2333,558,2743,148
2008,Urban,Nagaland,Crime Against Men,Assault,Female,18-30,2113,1612,501,1842,271
2007,Urban,Tamil Nadu,Other Crimes,Corruption,Female,18-30,9162,4532,4630,5587,3575
2002,Urban,Jharkhand,Property Crime,Vandalism,Male,13-17,3866,2402,1464,2885,981
2001,Rural,Telangana,Crime Against Children,Trafficking,Female,13-17,7370,7123,247,7336,34
2010,Rural,Karnataka,Crime Against Children,Kidnapping,Female,60+,3681,2984,697,3071,610
2006,Rural,Manipur,Crime Against Women,Molestation,Male,13-17,9787,4834,4953,8522,1265
2010,Rural,Assam,Other Crimes,Cyber Crime,Female,31-45,1514,613,901,1027,487
2003,Urban,Tamil Nadu,Property Crime,Theft,Male,46-60,334,262,72,318,16
2003,Rural,Goa,Crime Against Children,Trafficking,Female,0-12,8535,5808,2727,8238,297
2008,Rural,West Bengal,Other Crimes,Corruption,Male,31-45,7113,5805,1308,6337,776
2006,Urban,Jharkhand,Crime Against Children,Kidnapping,Male,13-17,2400,99,2301,1453,947
2010,Urban,Rajasthan,Property Crime,Burglary,Female,60+,5076,3942,1134,4786,290
2004,Rural,Tripura,Crime Against Women,Dowry Deaths,Male,60+,2242,242,2000,974,1268
2003,Urban,Maharashtra,Crime Against Women,Domestic Violence,Female,60+,7855,2955,4900,5188,2667
2004,Rural,Maharashtra,Crime Against Women,Dowry Deaths,Male,46-60,597,79,518,236,361
2007,Rural,Manipur,Property Crime,Burglary,Female,46-60,8146,2245,5901,4489,3657
2010,Urban,Jharkhand,Crime Against Women,Molestation,Female,46-60,5594,3279,2315,4290,1304
2001,Rural,Sikkim,Crime Against Women,Rape,Female,18-30,7003,5041,1962,6989,14
2001,Urban,Manipur,Property Crime,Arson,Female,46-60,1249,501,748,520,729
2006,Urban,Maharashtra,Crime Against Men,Robbery,Female,31-45,1205,414,791,667,538
2001,Rural,Maharashtra,Crime Against Women,Domestic Violence,Male,60+,7607,5633,1974,7273,334
2010,Urban,Mizoram,Crime Against Women,Dowry Deaths,Male,13-17,5678,3968,1710,4644,1034
2008,Urban,Himachal Pradesh,Crime Against Men,Robbery,Female,31-45,2983,1656,1327,2046,937
2001,Rural,Punjab,Crime Against Women,Rape,Male,13-17,5509,1889,3620,4657,852
2006,Rural,Sikkim,Crime Against Men,Assault,Male,18-30,4515,3026,1489,3088,1427
2010,Rural,Madhya Pradesh,Other Crimes,Cyber Crime,Female,18-30,2359,1455,904,1511,848
2003,Rural,Uttarakhand,Crime Against Children,Kidnapping,Female,18-30,7309,5663,1646,6600,709
2006,Rural,Tamil Nadu,Crime Against Children,Child Abuse,Female,13-17,8164,3093,5071,3206,4958
2003,Rural,Goa,Crime Against Women,Rape,Female,13-17,8403,6083,2320,6402,2001
2003,Rural,West Bengal,Crime Against Men,Robbery,Female,60+,6305,717,5588,4857,1448
2005,Rural,Maharashtra,Property Crime,Burglary,Female,0-12,9431,1275,8156,7811,1620
2004,Rural,Manipur,Property Crime,Arson,Male,31-45,813,139,674,786,27
2001,Rural,Sikkim,Property Crime,Burglary,Female,31-45,9236,3858,5378,8370,866
2009,Rural,Goa,Other Crimes,Drug Offense,Male,60+,3753,2121,1632,3672,81
2004,Urban,Jammu & Kashmir,Crime Against Men,Assault,Male,46-60,8706,6221,2485,6737,1969
2010,Urban,Tamil Nadu,Crime Against Children,Trafficking,Female,46-60,5277,1621,3656,5152,125
2006,Rural,Telangana,Other Crimes,Fraud,Male,60+,102,45,57,85,17
2008,Urban,Jammu & Kashmir,Crime Against Women,Domestic Violence,Male,0-12,6415,234,6181,4258,2157
2004,Urban,Manipur,Property Crime,Burglary,Female,18-30,6557,4719,1838,5293,1264
2008,Urban,Gujarat,Other Crimes,Fraud,Female,13-17,160,47,113,98,62
2008,Urban,West Bengal,Crime Against Children,Child Labor,Male,13-17,4618,210,4408,1516,3102
2007,Urban,Himachal Pradesh,Property Crime,Burglary,Female,13-17,5525,2651,2874,3733,1792
2003,Urban,Telangana,Crime Against Men,Extortion,Female,31-45,7729,3534,4195,5253,2476
2001,Rural,Kerala,Property Crime,Arson,Female,18-30,6225,6025,200,6141,84
2009,Urban,Uttarakhand,Property Crime,Vandalism,Female,18-30,9396,5786,3610,6446,2950
2004,Urban,Uttar Pradesh,Other Crimes,Drug Offense,Female,60+,7999,353,7646,3728,4271
2001,Rural,Gujarat,Crime Against Women,Domestic Violence,Male,46-60,8259,665,7594,7172,1087
2003,Urban,Madhya Pradesh,Crime Against Men,Robbery,Male,0-12,6713,752,5961,5114,1599
2007,Urban,Punjab,Crime Against Men,Robbery,Female,13-17,7275,6266,1009,6445,830
2002,Rural,Tamil Nadu,Other Crimes,Cyber Crime,Male,46-60,1841,557,1284,1091,750
2010,Rural,Punjab,Crime Against Women,Molestation,Male,60+,9259,3894,5365,5014,4245
2009,Urban,Arunachal Pradesh,Crime Against Women,Rape,Female,13-17,3090,997,2093,1263,1827
2007,Rural,Uttar Pradesh,Other Crimes,Fraud,Female,0-12,569,31,538,200,369
2010,Rural,Himachal Pradesh,Crime Against Children,Trafficking,Female,60+,3937,1875,2062,2232,1705
2006,Urban,Gujarat,Other Crimes,Corruption,Male,46-60,1549,1077,472,1479,70
2005,Rural,Telangana,Property Crime,Theft,Male,0-12,1918,872,1046,1619,299
2007,Urban,Telangana,Crime Against Men,Assault,Male,18-30,8166,4366,3800,7943,223
2010,Urban,Tamil Nadu,Property Crime,Arson,Female,60+,9103,4611,4492,6744,2359
2002,Urban,Haryana,Crime Against Children,Child Labor,Male,0-12,600,69,531,547,53
2002,Rural,West Bengal,Property Crime,Theft,Male,31-45,6672,134,6538,5030,1642
2003,Urban,Manipur,Crime Against Men,Extortion,Male,60+,4000,1534,2466,1831,2169
2008,Rural,Himachal Pradesh,Crime Against Men,Extortion,Female,13-17,4590,1456,3134,4195,395
2005,Urban,Karnataka,Crime Against Children,Kidnapping,Female,0-12,6073,1829,4244,2085,3988
2005,Urban,Madhya Pradesh,Crime Against Children,Child Abuse,Female,60+,1139,1040,99,1102,37
2010,Rural,Uttarakhand,Crime Against Children,Trafficking,Female,60+,9948,3757,6191,6873,3075
2003,Rural,Punjab,Property Crime,Arson,Male,31-45,5096,4481,615,5095,1
2009,Rural,Nagaland,Crime Against Children,Trafficking,Male,0-12,7111,518,6593,2115,4996
2005,Urban,West Bengal,Crime Against Men,Robbery,Male,13-17,7891,630,7261,4193,3698
2005,Urban,Uttar Pradesh,Crime Against Children,Trafficking,Male,0-12,7786,1047,6739,2320,5466
2004,Urban,Jharkhand,Property Crime,Vandalism,Female,46-60,5930,4049,1881,4268,1662
2009,Urban,Assam,Crime Against Women,Domestic Violence,Male,31-45,8814,5436,3378,7388,1426
2006,Urban,Goa,Crime Against Women,Dowry Deaths,Male,31-45,9685,6238,3447,7482,2203
2001,Urban,Mizoram,Crime Against Women,Domestic Violence,Male,60+,2811,2389,422,2763,48
2002,Urban,Maharashtra,Crime Against Children,Trafficking,Male,31-45,2058,345,1713,1996,62
2003,Rural,Bihar,Property Crime,Arson,Female,46-60,9176,5052,4124,5599,3577
2002,Rural,Telangana,Crime Against Women,Domestic Violence,Female,18-30,2533,1001,1532,1335,1198
2005,Urban,West Bengal,Property Crime,Arson,Male,13-17,82,79,3,80,2
2007,Rural,Goa,Crime Against Children,Kidnapping,Female,18-30,2233,1973,260,2071,162
2007,Urban,Telangana,Crime Against Women,Domestic Violence,Female,0-12,2473,1492,981,1839,634
2008,Rural,Kerala,Crime Against Children,Child Labor,Male,18-30,1320,1200,120,1257,63
2009,Urban,Madhya Pradesh,Crime Against Children,Kidnapping,Male,46-60,8513,1149,7364,1988,6525
2002,Rural,Bihar,Crime Against Men,Extortion,Male,60+,4012,3819,193,4006,6
2010,Urban,Chhattisgarh,Property Crime,Arson,Female,60+,1472,477,995,1264,208
2003,Rural,Nagaland,Other Crimes,Corruption,Male,0-12,150,19,131,48,102
2005,Urban,Maharashtra,Property Crime,Vandalism,Male,0-12,8851,8391,460,8488,363
2001,Urban,Uttar Pradesh,Other Crimes,Drug Offense,Female,46-60,456,314,142,388,68
2001,Urban,Telangana,Property Crime,Vandalism,Male,0-12,6631,3548,3083,5361,1270
2007,Urban,Madhya Pradesh,Property Crime,Arson,Female,18-30,1387,419,968,954,433
2005,Urban,Uttarakhand,Property Crime,Vandalism,Female,0-12,3170,1358,1812,2989,181
2003,Urban,Kerala,Crime Against Men,Robbery,Male,18-30,5344,173,5171,4180,1164
2005,Urban,Telangana,Crime Against Children,Trafficking,Female,18-30,463,35,428,440,23
2003,Rural,Jharkhand,Crime Against Men,Assault,Male,46-60,7181,1645,5536,4376,2805
2007,Rural,Himachal Pradesh,Property Crime,Burglary,Female,31-45,4340,1154,3186,4066,274
2006,Urban,Odisha,Other Crimes,Cyber Crime,Female,0-12,9412,8980,432,9294,118
2002,Urban,Manipur,Crime Against Children,Child Labor,Female,13-17,5241,3462,1779,3545,1696
2004,Urban,Bihar,Crime Against Children,Trafficking,Male,60+,2173,273,1900,1767,406
2005,Rural,Karnataka,Crime Against Children,Child Labor,Female,13-17,6171,2568,3603,4127,2044
2002,Urban,Manipur,Other Crimes,Corruption,Female,46-60,6595,4827,1768,6000,595
2007,Rural,Rajasthan,Other Crimes,Fraud,Female,13-17,7353,4642,2711,5963,1390
2008,Rural,Goa,Crime Against Children,Child Abuse,Female,13-17,9829,1132,8697,9789,40
2003,Rural,Karnataka,Other Crimes,Corruption,Female,46-60,2573,243,2330,1466,1107
2005,Rural,Bihar,Other Crimes,Fraud,Male,60+,3011,1918,1093,2036,975
2006,Rural,Maharashtra,Crime Against Children,Child Abuse,Male,46-60,504,244,260,446,58
2009,Urban,Madhya Pradesh,Crime Against Women,Rape,Male,46-60,4397,831,3566,3602,795
2004,Rural,Mizoram,Crime Against Men,Extortion,Female,0-12,1546,632,914,1073,473
2005,Urban,Odisha,Crime Against Women,Domestic Violence,Male,31-45,2994,2166,828,2962,32
2007,Urban,West Bengal,Crime Against Men,Murder,Male,13-17,2645,2229,416,2588,57
2002,Urban,Telangana,Crime Against Women,Molestation,Female,60+,675,518,157,551,124
2004,Rural,Mizoram,Crime Against Women,Dowry Deaths,Female,18-30,6461,3759,2702,5340,1121
2010,Rural,Andhra Pradesh,Crime Against Men,Murder,Female,46-60,7324,472,6852,7194,130
2005,Rural,Arunachal Pradesh,Property Crime,Burglary,Female,0-12,7974,6299,1675,7875,99
2005,Urban,Punjab,Crime Against Men,Robbery,Female,13-17,1714,234,1480,669,1045
2001,Rural,Delhi,Crime Against Children,Trafficking,Male,46-60,2312,805,1507,1103,1209
2007,Urban,Uttar Pradesh,Crime Against Women,Dowry Deaths,Male,0-12,9633,6825,2808,9612,21
2003,Rural,Kerala,Crime Against Women,Domestic Violence,Female,31-45,2113,1754,359,2094,19
2002,Urban,Andhra Pradesh,Crime Against Men,Robbery,Female,13-17,2913,2220,693,2492,421
2004,Rural,Himachal Pradesh,Property Crime,Vandalism,Female,18-30,1208,535,673,729,479
2010,Rural,Tamil Nadu,Property Crime,Vandalism,Male,13-17,8519,6781,1738,7710,809
2004,Rural,Gujarat,Crime Against Children,Kidnapping,Male,18-30,6926,6276,650,6891,35
2005,Rural,Assam,Crime Against Men,Extortion,Female,13-17,247,31,216,118,129
2008,Urban,Chhattisgarh,Other Crimes,Drug Offense,Female,60+,9937,9519,418,9835,102
2002,Rural,Bihar,Crime Against Children,Kidnapping,Male,18-30,6142,3663,2479,4876,1266
2010,Rural,Sikkim,Crime Against Women,Domestic Violence,Female,60+,3501,704,2797,2304,1197
2008,Rural,Karnataka,Crime Against Men,Assault,Female,31-45,7554,4431,3123,5588,1966
2009,Rural,Mizoram,Property Crime,Vandalism,Female,46-60,327,229,98,260,67
2003,Rural,Haryana,Crime Against Women,Rape,Male,13-17,6651,2496,4155,6405,246
2009,Rural,Gujarat,Crime Against Men,Assault,Female,31-45,3309,1999,1310,3100,209
2002,Rural,Delhi,Other Crimes,Drug Offense,Male,18-30,2716,697,2019,1953,763
2006,Urban,Jharkhand,Crime Against Women,Rape,Male,60+,7147,6371,776,6911,236
2004,Urban,Chhattisgarh,Crime Against Children,Trafficking,Male,31-45,4817,2986,1831,3772,1045
2009,Rural,Haryana,Other Crimes,Corruption,Female,31-45,3947,1054,2893,1172,2775
2010,Urban,Madhya Pradesh,Crime Against Women,Dowry Deaths,Female,46-60,7119,6794,325,6989,130
2008,Rural,Nagaland,Crime Against Children,Trafficking,Female,13-17,3772,2326,1446,2767,1005
2010,Rural,Uttar Pradesh,Crime Against Children,Child Abuse,Female,13-17,388,90,298,138,250
2006,Urban,Arunachal Pradesh,Crime Against Children,Trafficking,Male,46-60,2694,1100,1594,1412,1282
2009,Urban,Maharashtra,Crime Against Women,Molestation,Male,18-30,7120,3851,3269,6127,993
2005,Rural,Bihar,Other Crimes,Drug Offense,Female,13-17,9309,1273,8036,2489,6820
2003,Urban,Andhra Pradesh,Other Crimes,Corruption,Female,31-45,5264,4677,587,5067,197
2010,Urban,Maharashtra,Other Crimes,Fraud,Female,13-17,4444,4333,111,4429,15
2004,Rural,Uttar Pradesh,Crime Against Men,Murder,Male,18-30,6415,3053,3362,3554,2861
2002,Urban,Punjab,Crime Against Men,Extortion,Female,31-45,7164,568,6596,1723,5441
2008,Rural,Sikkim,Crime Against Children,Trafficking,Female,18-30,5136,2669,2467,4632,504
2010,Urban,Andhra Pradesh,Crime Against Women,Domestic Violence,Female,13-17,2808,186,2622,1674,1134
2002,Rural,Rajasthan,Property Crime,Theft,Female,60+,811,129,682,722,89
2001,Rural,Maharashtra,Crime Against Women,Molestation,Female,60+,7941,3042,4899,3308,4633
2005,Urban,Andhra Pradesh,Property Crime,Arson,Female,31-45,5729,1380,4349,2152,3577
2009,Urban,Sikkim,Crime Against Women,Rape,Female,46-60,7835,1744,6091,5671,2164
2003,Urban,West Bengal,Crime Against Children,Trafficking,Female,31-45,9966,9924,42,9934,32
2003,Urban,Telangana,Other Crimes,Cyber Crime,Female,18-30,2081,1687,394,1693,388
2002,Rural,Odisha,Crime Against Children,Child Labor,Female,46-60,6340,4448,1892,6137,203
2010,Rural,Odisha,Crime Against Men,Extortion,Female,46-60,4329,2635,1694,3300,1029
2001,Rural,Uttarakhand,Property Crime,Arson,Male,31-45,7933,2658,5275,6168,1765
2009,Urban,Telangana,Property Crime,Theft,Female,0-12,6498,1683,4815,5112,1386
2010,Urban,West Bengal,Crime Against Men,Assault,Female,46-60,1951,936,1015,1454,497
2002,Urban,Goa,Crime Against Women,Molestation,Male,13-17,924,157,767,419,505
2001,Rural,Sikkim,Property Crime,Burglary,Male,31-45,1940,167,1773,863,1077
2001,Rural,Kerala,Other Crimes,Corruption,Female,13-17,794,18,776,180,614
2004,Urban,Punjab,Property Crime,Theft,Female,0-12,8185,3790,4395,4174,4011
2005,Rural,Tripura,Crime Against Women,Domestic Violence,Male,60+,2690,2533,157,2598,92
2009,Rural,Kerala,Crime Against Men,Assault,Male,31-45,8368,783,7585,5116,3252
2004,Urban,Sikkim,Crime Against Men,Murder,Male,31-45,9911,7533,2378,8313,1598
2009,Rural,Manipur,Crime Against Men,Extortion,Male,31-45,7216,4129,3087,5685,1531
2004,Urban,Madhya Pradesh,Property Crime,Burglary,Male,31-45,7263,1206,6057,4707,2556
2002,Rural,Sikkim,Other Crimes,Drug Offense,Male,18-30,2370,610,1760,1876,494
2007,Rural,Rajasthan,Crime Against Men,Extortion,Female,60+,7311,5697,1614,6614,697
2002,Urban,Bihar,Other Crimes,Fraud,Male,18-30,7133,4034,3099,5177,1956
2001,Rural,Kerala,Property Crime,Theft,Male,0-12,7836,7,7829,6805,1031
2003,Urban,Manipur,Crime Against Women,Rape,Female,60+,4047,3068,979,4002,45
2010,Urban,Tripura,Crime Against Children,Trafficking,Female,60+,7641,2639,5002,5409,2232
2007,Urban,Manipur,Crime Against Women,Domestic Violence,Male,60+,307,184,123,220,87
2007,Rural,Rajasthan,Crime Against Women,Rape,Female,31-45,5922,3438,2484,4481,1441
2005,Rural,Delhi,Property Crime,Burglary,Female,0-12,9391,7053,2338,7582,1809
2007,Urban,Sikkim,Crime Against Men,Robbery,Female,0-12,5423,2290,3133,4841,582
2003,Rural,Uttar Pradesh,Crime Against Children,Child Abuse,Female,13-17,8085,4211,3874,7337,748
2004,Rural,Rajasthan,Other Crimes,Drug Offense,Male,13-17,5893,3132,2761,5625,268
2010,Urban,Tripura,Other Crimes,Corruption,Male,31-45,153,140,13,146,7
2009,Rural,Arunachal Pradesh,Other Crimes,Corruption,Female,13-17,53,30,23,38,15
2002,Urban,Jammu & Kashmir,Crime Against Women,Molestation,Female,46-60,5242,3401,1841,3499,1743
2009,Urban,Sikkim,Crime Against Women,Molestation,Female,60+,2922,1076,1846,2012,910
2001,Urban,Manipur,Property Crime,Arson,Female,18-30,2677,2627,50,2633,44
2010,Rural,Odisha,Crime Against Men,Robbery,Male,18-30,2242,377,1865,2099,143
2006,Urban,Andhra Pradesh,Property Crime,Burglary,Male,46-60,2493,255,2238,2376,117
2010,Rural,Odisha,Crime Against Children,Child Abuse,Female,18-30,3937,1912,2025,2615,1322
2010,Urban,Uttar Pradesh,Property Crime,Arson,Female,18-30,220,215,5,215,5
2006,Rural,Telangana,Crime Against Children,Trafficking,Male,0-12,7436,3475,3961,6681,755
2010,Urban,Telangana,Property Crime,Arson,Male,46-60,2750,2117,633,2737,13
2007,Rural,Madhya Pradesh,Property Crime,Vandalism,Female,0-12,1733,1504,229,1577,156
2009,Rural,Jharkhand,Other Crimes,Cyber Crime,Female,46-60,4799,3956,843,4398,401
2007,Urban,Andhra Pradesh,Crime Against Children,Kidnapping,Female,46-60,1656,322,1334,956,700
2005,Rural,Chhattisgarh,Crime Against Women,Domestic Violence,Female,31-45,8339,4256,4083,4284,4055
2003,Rural,Andhra Pradesh,Property Crime,Theft,Female,46-60,341,190,151,234,107
2004,Rural,Uttarakhand,Crime Against Children,Trafficking,Female,0-12,9409,8192,1217,8851,558
2005,Rural,Gujarat,Crime Against Men,Extortion,Female,60+,4419,4317,102,4328,91
2010,Rural,Mizoram,Crime Against Children,Trafficking,Female,13-17,1518,1178,340,1471,47
2001,Rural,Uttarakhand,Other Crimes,Corruption,Male,31-45,4642,1163,3479,1782,2860
2008,Rural,Assam,Property Crime,Theft,Female,13-17,726,702,24,719,7
2006,Urban,Maharashtra,Crime Against Children,Trafficking,Female,13-17,533,395,138,484,49
2004,Urban,Jammu & Kashmir,Other Crimes,Cyber Crime,Female,18-30,3024,2664,360,2801,223
2007,Rural,Chhattisgarh,Crime Against Men,Murder,Female,18-30,8699,5610,3089,5908,2791
2007,Urban,Karnataka,Crime Against Children,Trafficking,Male,18-30,1334,1137,197,1199,135
2003,Urban,Uttarakhand,Crime Against Women,Rape,Male,18-30,4327,3021,1306,4150,177
2007,Rural,Tripura,Property Crime,Burglary,Male,31-45,3070,1914,1156,2334,736
2003,Urban,Andhra Pradesh,Property Crime,Theft,Male,60+,6878,6199,679,6378,500
2003,Urban,Kerala,Other Crimes,Cyber Crime,Male,46-60,5635,2851,2784,4402,1233
2002,Urban,Assam,Property Crime,Theft,Female,18-30,6538,1600,4938,1804,4734
2001,Rural,Uttar Pradesh,Property Crime,Burglary,Male,0-12,6334,2239,4095,4752,1582
2009,Rural,Meghalaya,Other Crimes,Fraud,Female,0-12,5776,424,5352,1720,4056
2008,Urban,Arunachal Pradesh,Property Crime,Arson,Male,60+,2172,216,1956,1847,325
2005,Rural,Jammu & Kashmir,Property Crime,Theft,Male,0-12,1146,465,681,683,463
2003,Rural,Madhya Pradesh,Crime Against Children,Child Labor,Male,13-17,5836,2493,3343,3361,2475
2004,Rural,Himachal Pradesh,Crime Against Women,Molestation,Male,0-12,8565,2823,5742,4396,4169
2008,Rural,Gujarat,Crime Against Children,Child Abuse,Female,31-45,6686,4838,1848,6559,127
2002,Rural,Karnataka,Crime Against Women,Dowry Deaths,Female,18-30,70,46,24,51,19
2003,Urban,Odisha,Crime Against Children,Child Labor,Male,31-45,2912,1274,1638,2143,769
2007,Urban,Haryana,Other Crimes,Drug Offense,Female,46-60,8728,2833,5895,5586,3142
2007,Rural,Tripura,Other Crimes,Cyber Crime,Male,18-30,198,64,134,104,94
2003,Rural,Andhra Pradesh,Other Crimes,Drug Offense,Female,60+,4539,3127,1412,3896,643
2003,Urban,Tripura,Crime Against Men,Robbery,Male,31-45,8448,447,8001,8361,87
2002,Rural,Tripura,Crime Against Women,Dowry Deaths,Male,13-17,58,4,54,11,47
2005,Urban,Tamil Nadu,Crime Against Men,Murder,Female,31-45,6368,1843,4525,2171,4197
2010,Urban,Telangana,Crime Against Men,Assault,Female,60+,3418,1399,2019,1566,1852
2005,Rural,Uttar Pradesh,Crime Against Women,Domestic Violence,Male,60+,7431,2559,4872,3680,3751
2009,Urban,Arunachal Pradesh,Crime Against Men,Robbery,Male,31-45,4577,409,4168,1983,2594
2006,Urban,Himachal Pradesh,Crime Against Children,Kidnapping,Male,60+,9599,7555,2044,9031,568
2005,Urban,Jharkhand,Crime Against Children,Child Labor,Male,18-30,6128,3737,2391,5025,1103
2006,Urban,Mizoram,Crime Against Women,Rape,Male,0-12,9644,8695,949,9548,96
2010,Rural,Delhi,Other Crimes,Fraud,Male,46-60,8173,911,7262,1357,6816
2005,Urban,Karnataka,Crime Against Children,Kidnapping,Female,13-17,9292,787,8505,1098,8194
2006,Rural,Nagaland,Crime Against Men,Murder,Male,0-12,1894,1735,159,1871,23
2003,Rural,Sikkim,Other Crimes,Fraud,Male,0-12,136,2,134,76,60
2007,Urban,Karnataka,Other Crimes,Cyber Crime,Female,60+,1659,1342,317,1342,317
2006,Rural,Sikkim,Property Crime,Theft,Male,0-12,8372,1185,7187,6068,2304
2009,Urban,Uttar Pradesh,Other Crimes,Drug Offense,Male,31-45,4633,3665,968,4026,607
2001,Urban,Sikkim,Crime Against Women,Domestic Violence,Male,31-45,6962,964,5998,4720,2242
2008,Rural,Assam,Property Crime,Burglary,Male,0-12,8256,762,7494,3023,5233
2008,Rural,Delhi,Property Crime,Burglary,Male,18-30,2952,1123,1829,2575,377
2008,Rural,Delhi,Crime Against Children,Kidnapping,Male,60+,3594,314,3280,2854,740
2002,Urban,Nagaland,Property Crime,Burglary,Male,0-12,8297,4307,3990,7042,1255
2006,Urban,Tamil Nadu,Crime Against Men,Extortion,Male,46-60,2048,56,1992,2046,2
2001,Urban,Uttarakhand,Property Crime,Burglary,Female,13-17,5313,5099,214,5176,137
2009,Urban,Manipur,Crime Against Children,Child Abuse,Female,46-60,790,217,573,336,454
2006,Rural,Goa,Crime Against Men,Extortion,Female,0-12,2807,2252,555,2582,225
2002,Urban,Jharkhand,Crime Against Men,Extortion,Female,13-17,1156,413,743,906,250
2008,Urban,Punjab,Crime Against Women,Molestation,Male,46-60,9091,1226,7865,2339,6752
2005,Rural,Uttar Pradesh,Crime Against Men,Murder,Female,31-45,3135,1445,1690,1638,1497
2007,Rural,Rajasthan,Other Crimes,Cyber Crime,Female,46-60,4793,3559,1234,3629,1164
2002,Rural,Madhya Pradesh,Crime Against Children,Kidnapping,Male,18-30,5717,2740,2977,3827,1890
2004,Urban,Maharashtra,Other Crimes,Fraud,Male,31-45,1786,1517,269,1522,264
2005,Urban,Tripura,Crime Against Children,Child Labor,Male,60+,8906,5595,3311,8150,756
2003,Urban,Gujarat,Crime Against Men,Robbery,Female,0-12,1657,1137,520,1284,373
2003,Rural,Himachal Pradesh,Property Crime,Theft,Male,0-12,3963,1374,2589,2160,1803
2006,Urban,Andhra Pradesh,Other Crimes,Cyber Crime,Female,0-12,738,509,229,549,189
2008,Rural,Assam,Property Crime,Arson,Male,60+,766,598,168,717,49
2005,Urban,Gujarat,Property Crime,Theft,Male,60+,4448,2663,1785,3001,1447
2010,Rural,Tripura,Property Crime,Theft,Female,60+,6639,3505,3134,5893,746
2008,Rural,Maharashtra,Crime Against Women,Rape,Male,60+,1734,184,1550,674,1060
2009,Rural,Mizoram,Crime Against Children,Child Labor,Male,18-30,109,16,93,65,44
2007,Rural,Karnataka,Crime Against Children,Child Abuse,Male,13-17,5297,853,4444,1064,4233
2008,Urban,Haryana,Other Crimes,Corruption,Male,60+,4668,2239,2429,2929,1739
2002,Urban,Himachal Pradesh,Crime Against Children,Child Abuse,Male,0-12,6683,3935,2748,6221,462
2006,Urban,Meghalaya,Other Crimes,Fraud,Male,18-30,9538,5584,3954,5884,3654
2005,Rural,Chhattisgarh,Crime Against Women,Rape,Female,31-45,9879,4759,5120,5355,4524
2010,Rural,Gujarat,Crime Against Women,Rape,Female,31-45,301,2,299,289,12
2008,Rural,Goa,Property Crime,Arson,Male,31-45,8078,7860,218,7977,101
2002,Urban,Bihar,Crime Against Children,Kidnapping,Male,60+,5420,1349,4071,4623,797
2007,Urban,Punjab,Crime Against Men,Robbery,Female,31-45,5584,3607,1977,3836,1748
2009,Rural,Tamil Nadu,Other Crimes,Drug Offense,Female,0-12,123,42,81,122,1
2007,Urban,Chhattisgarh,Crime Against Men,Murder,Male,0-12,2086,1640,446,1942,144
2010,Rural,Uttarakhand,Property Crime,Arson,Female,0-12,3062,50,3012,1162,1900
2010,Rural,Haryana,Crime Against Children,Kidnapping,Female,0-12,7282,6595,687,6724,558
2004,Rural,Sikkim,Property Crime,Arson,Female,0-12,6354,3835,2519,6148,206
2009,Rural,Maharashtra,Crime Against Women,Domestic Violence,Male,46-60,1372,672,700,939,433
2004,Rural,Assam,Crime Against Children,Child Abuse,Male,31-45,9142,6658,2484,7949,1193
2001,Urban,Punjab,Property Crime,Burglary,Male,31-45,6459,4880,1579,5645,814
2006,Urban,West Bengal,Crime Against Women,Dowry Deaths,Male,18-30,228,189,39,218,10
2005,Urban,Haryana,Crime Against Men,Murder,Male,46-60,8480,6566,1914,8062,418
2001,Urban,Nagaland,Crime Against Children,Trafficking,Male,0-12,979,227,752,615,364
2004,Rural,Karnataka,Property Crime,Arson,Male,13-17,6831,5985,846,6287,544
2007,Rural,Meghalaya,Crime Against Children,Child Labor,Male,0-12,5110,4546,564,4889,221
2007,Urban,Meghalaya,Other Crimes,Drug Offense,Female,31-45,450,44,406,353,97
2009,Urban,West Bengal,Property Crime,Theft,Female,31-45,4039,2099,1940,2521,1518
2003,Urban,Manipur,Other Crimes,Fraud,Female,46-60,5207,438,4769,4914,293
2009,Rural,Meghalaya,Crime Against Men,Extortion,Female,46-60,6255,1591,4664,5048,1207
2006,Rural,Jharkhand,Crime Against Women,Molestation,Female,60+,1656,721,935,1356,300
2002,Rural,Assam,Crime Against Women,Domestic Violence,Female,46-60,4068,1496,2572,3182,886
2010,Rural,Rajasthan,Crime Against Children,Trafficking,Female,13-17,1557,1392,165,1544,13
2008,Urban,Chhattisgarh,Property Crime,Theft,Male,0-12,4585,4011,574,4380,205
2003,Urban,Nagaland,Crime Against Children,Trafficking,Female,60+,8443,1744,6699,3287,5156
2008,Rural,Sikkim,Crime Against Women,Domestic Violence,Female,31-45,8402,6178,2224,6618,1784
2006,Urban,Tripura,Crime Against Men,Robbery,Female,31-45,3127,348,2779,2951,176
2006,Urban,Odisha,Property Crime,Vandalism,Female,0-12,7888,4885,3003,5245,2643
2009,Urban,Andhra Pradesh,Property Crime,Burglary,Male,60+,1833,957,876,1528,305
2009,Urban,Uttar Pradesh,Property Crime,Arson,Female,46-60,1651,1166,485,1437,214
2009,Urban,Madhya Pradesh,Crime Against Women,Domestic Violence,Male,46-60,2781,858,1923,1943,838
2008,Rural,Mizoram,Crime Against Women,Rape,Female,46-60,51,21,30,23,28
2004,Rural,Chhattisgarh,Other Crimes,Drug Offense,Female,31-45,98,44,54,73,25
2005,Urban,Jammu & Kashmir,Crime Against Women,Rape,Female,18-30,5634,2155,3479,2986,2648
2002,Rural,Meghalaya,Other Crimes,Cyber Crime,Female,13-17,256,32,224,256,0
2003,Rural,Nagaland,Crime Against Men,Robbery,Female,46-60,3476,491,2985,1209,2267
2009,Rural,Arunachal Pradesh,Crime Against Men,Assault,Female,18-30,5838,1068,4770,3403,2435
2004,Rural,Gujarat,Crime Against Women,Rape,Male,31-45,5882,1691,4191,2249,3633
2003,Urban,Jammu & Kashmir,Property Crime,Arson,Female,13-17,7142,2059,5083,3511,3631
2002,Urban,Assam,Crime Against Children,Child Labor,Female,0-12,2151,988,1163,1395,756
2001,Rural,Goa,Crime Against Women,Molestation,Male,31-45,6949,5231,1718,6935,14
2006,Rural,Delhi,Crime Against Men,Extortion,Female,18-30,8407,5934,2473,6864,1543
2005,Rural,Assam,Crime Against Men,Assault,Male,60+,9790,2164,7626,5346,4444
2005,Urban,Delhi,Crime Against Men,Extortion,Female,18-30,7793,3126,4667,5718,2075
2003,Rural,Jammu & Kashmir,Property Crime,Vandalism,Male,31-45,8493,7504,989,8186,307
2007,Urban,Gujarat,Crime Against Women,Rape,Female,31-45,6303,2479,3824,3047,3256
2001,Urban,West Bengal,Crime Against Children,Trafficking,Female,46-60,4029,549,3480,2582,1447
2003,Urban,Rajasthan,Property Crime,Theft,Female,31-45,9671,786,8885,7811,1860
2004,Urban,Telangana,Other Crimes,Drug Offense,Male,60+,4236,3974,262,4112,124
2001,Urban,Meghalaya,Crime Against Men,Assault,Female,31-45,5785,1864,3921,2742,3043
2009,Urban,Haryana,Other Crimes,Corruption,Male,60+,8621,761,7860,6226,2395
2007,Urban,Tamil Nadu,Crime Against Men,Robbery,Male,60+,3909,3413,496,3891,18
2009,Rural,West Bengal,Other Crimes,Drug Offense,Female,46-60,588,539,49,543,45
2001,Urban,Uttarakhand,Crime Against Children,Kidnapping,Female,46-60,3862,2208,1654,3766,96
2003,Urban,Tamil Nadu,Property Crime,Arson,Female,13-17,3812,2829,983,3393,419
2001,Urban,Maharashtra,Other Crimes,Fraud,Female,13-17,2206,921,1285,1247,959
2007,Rural,Tripura,Crime Against Children,Kidnapping,Female,0-12,601,146,455,358,243
2002,Rural,Nagaland,Crime Against Women,Domestic Violence,Male,46-60,834,557,277,672,162
2008,Urban,Uttarakhand,Other Crimes,Drug Offense,Female,60+,9715,2916,6799,8760,955
2002,Rural,Kerala,Crime Against Men,Extortion,Male,18-30,323,3,320,74,249
2003,Urban,Uttar Pradesh,Property Crime,Arson,Male,46-60,6145,4738,1407,4749,1396
2009,Rural,Nagaland,Crime Against Women,Molestation,Male,31-45,2252,505,1747,1934,318
2002,Urban,Andhra Pradesh,Property Crime,Vandalism,Male,31-45,5986,4381,1605,4971,1015
2009,Rural,Chhattisgarh,Crime Against Women,Domestic Violence,Female,46-60,6827,753,6074,5286,1541
2006,Rural,Assam,Crime Against Women,Rape,Female,60+,2570,1448,1122,2221,349
2001,Rural,Uttarakhand,Crime Against Men,Assault,Male,46-60,9114,5161,3953,5402,3712
2007,Urban,Uttar Pradesh,Crime Against Women,Dowry Deaths,Male,46-60,5286,2524,2762,5237,49
2008,Urban,Goa,Crime Against Women,Molestation,Male,13-17,2462,2084,378,2269,193
2010,Rural,Rajasthan,Crime Against Children,Kidnapping,Female,60+,8078,2330,5748,3967,4111
2008,Urban,Karnataka,Crime Against Women,Dowry Deaths,Male,13-17,5982,531,5451,4579,1403
2010,Rural,Karnataka,Crime Against Children,Child Labor,Female,46-60,7051,1681,5370,4168,2883
2004,Urban,Madhya Pradesh,Crime Against Children,Child Abuse,Male,13-17,460,113,347,437,23
2010,Rural,Haryana,Crime Against Women,Molestation,Female,60+,2183,2168,15,2181,2
2004,Rural,Tamil Nadu,Crime Against Men,Robbery,Male,31-45,8244,4311,3933,7319,925
2001,Rural,Andhra Pradesh,Property Crime,Burglary,Female,31-45,5368,1034,4334,1911,3457
2005,Urban,Chhattisgarh,Property Crime,Vandalism,Female,31-45,2420,1446,974,1869,551
2007,Rural,Telangana,Property Crime,Theft,Male,18-30,2021,1266,755,1473,548
2003,Rural,Telangana,Property Crime,Arson,Male,13-17,2066,1245,821,1303,763
2009,Urban,Kerala,Crime Against Women,Dowry Deaths,Female,31-45,6283,5424,859,5437,846
2007,Rural,Meghalaya,Crime Against Men,Assault,Male,46-60,1622,863,759,1404,218
2001,Urban,Manipur,Crime Against Women,Rape,Male,31-45,6264,1746,4518,5159,1105
2006,Rural,Uttar Pradesh,Crime Against Women,Dowry Deaths,Male,18-30,1914,947,967,1766,148
2003,Rural,Manipur,Crime Against Children,Child Labor,Female,60+,2291,2111,180,2210,81
2007,Rural,Tamil Nadu,Crime Against Children,Trafficking,Male,0-12,3453,187,3266,1501,1952
2007,Urban,Tamil Nadu,Property Crime,Vandalism,Male,13-17,5968,2228,3740,5897,71
2005,Urban,Andhra Pradesh,Other Crimes,Cyber Crime,Male,60+,7164,6137,1027,6900,264
2007,Rural,Kerala,Crime Against Men,Murder,Female,13-17,7840,289,7551,3889,3951
2009,Urban,Sikkim,Crime Against Men,Robbery,Male,0-12,8799,3037,5762,3211,5588
2002,Rural,Goa,Crime Against Men,Extortion,Female,18-30,3955,1234,2721,2783,1172
2003,Rural,Himachal Pradesh,Crime Against Children,Kidnapping,Female,18-30,6496,3714,2782,5523,973
2009,Urban,Manipur,Crime Against Women,Rape,Female,60+,8043,1163,6880,4982,3061
2001,Urban,Manipur,Crime Against Children,Child Labor,Female,13-17,2828,1100,1728,2676,152
2001,Urban,Manipur,Crime Against Men,Murder,Female,46-60,9788,6848,2940,7812,1976
2007,Rural,Nagaland,Crime Against Children,Kidnapping,Female,18-30,1863,1300,563,1685,178
2003,Rural,Jharkhand,Crime Against Men,Assault,Female,46-60,1021,231,790,730,291
2001,Rural,Manipur,Other Crimes,Drug Offense,Female,13-17,7380,5735,1645,6318,1062
2003,Rural,Meghalaya,Other Crimes,Corruption,Female,31-45,6824,836,5988,1878,4946
2003,Rural,Punjab,Crime Against Children,Child Labor,Female,0-12,5897,3973,1924,4850,1047
2009,Rural,Himachal Pradesh,Crime Against Women,Molestation,Male,13-17,7598,2998,4600,3325,4273
2005,Rural,Tamil Nadu,Crime Against Women,Rape,Male,60+,1923,1496,427,1627,296
2004,Rural,Maharashtra,Property Crime,Burglary,Female,13-17,7404,200,7204,6930,474
2005,Urban,Haryana,Other Crimes,Corruption,Female,13-17,4077,3676,401,4040,37
2002,Rural,Meghalaya,Crime Against Children,Trafficking,Male,60+,4239,3612,627,3788,451
2005,Urban,Uttar Pradesh,Crime Against Children,Trafficking,Female,60+,8743,6316,2427,7078,1665
2006,Urban,Gujarat,Other Crimes,Corruption,Male,0-12,561,300,261,471,90
2006,Rural,Kerala,Property Crime,Vandalism,Male,13-17,3505,2962,543,3142,363
2008,Urban,Maharashtra,Crime Against Children,Child Abuse,Male,0-12,7247,5043,2204,5451,1796
2005,Urban,Mizoram,Property Crime,Arson,Female,46-60,955,380,575,730,225
2007,Urban,Arunachal Pradesh,Crime Against Women,Dowry Deaths,Female,0-12,8219,4268,3951,7640,579
2010,Rural,West Bengal,Crime Against Children,Trafficking,Female,60+,7488,37,7451,7098,390
2008,Rural,Rajasthan,Property Crime,Arson,Female,60+,8563,7924,639,8184,379
2004,Urban,Manipur,Crime Against Men,Extortion,Female,13-17,4159,3822,337,3898,261
2004,Rural,Madhya Pradesh,Crime Against Children,Trafficking,Female,60+,8830,5833,2997,8461,369
2009,Rural,Madhya Pradesh,Crime Against Men,Murder,Male,0-12,342,205,137,300,42
2006,Urban,Goa,Other Crimes,Fraud,Female,18-30,9250,952,8298,7235,2015
2006,Rural,Chhattisgarh,Crime Against Men,Murder,Female,13-17,8179,1623,6556,7337,842
2002,Urban,Manipur,Property Crime,Theft,Female,31-45,1365,334,1031,749,616
2007,Urban,Uttarakhand,Property Crime,Burglary,Female,13-17,6556,5026,1530,5080,1476
2009,Rural,Haryana,Property Crime,Arson,Female,46-60,7386,6783,603,7278,108
2006,Rural,Sikkim,Crime Against Men,Murder,Male,18-30,1913,328,1585,586,1327
2003,Urban,Mizoram,Other Crimes,Cyber Crime,Female,60+,8996,1552,7444,3729,5267
2007,Urban,Tamil Nadu,Crime Against Children,Child Abuse,Female,18-30,3334,799,2535,2772,562
2007,Rural,Telangana,Other Crimes,Fraud,Female,60+,6965,5521,1444,6193,772
2006,Rural,Jammu & Kashmir,Property Crime,Vandalism,Male,18-30,5704,842,4862,2077,3627
2002,Rural,Maharashtra,Property Crime,Vandalism,Male,0-12,1350,1323,27,1335,15
2003,Rural,Manipur,Crime Against Men,Murder,Male,31-45,7951,2630,5321,4796,3155
2008,Rural,Arunachal Pradesh,Other Crimes,Corruption,Male,0-12,3187,2355,832,3075,112
2003,Rural,Telangana,Crime Against Men,Extortion,Male,0-12,3850,2588,1262,2861,989
2002,Rural,Tamil Nadu,Crime Against Women,Domestic Violence,Male,46-60,3238,21,3217,607,2631
2003,Rural,Delhi,Crime Against Children,Trafficking,Female,46-60,5142,2289,2853,5062,80
2005,Urban,Manipur,Other Crimes,Corruption,Male,46-60,6650,5400,1250,5449,1201
2008,Urban,Nagaland,Property Crime,Vandalism,Male,0-12,5408,4543,865,4830,578
2003,Urban,Maharashtra,Crime Against Children,Trafficking,Male,18-30,3294,526,2768,2918,376
2003,Urban,Tamil Nadu,Crime Against Children,Kidnapping,Male,18-30,5510,569,4941,3998,1512
2003,Rural,Sikkim,Other Crimes,Corruption,Male,13-17,6251,446,5805,4912,1339
2002,Rural,Tripura,Crime Against Children,Trafficking,Male,46-60,4661,747,3914,2837,1824
2008,Rural,Manipur,Other Crimes,Drug Offense,Male,18-30,8051,2001,6050,4462,3589
2007,Urban,Assam,Crime Against Men,Robbery,Female,13-17,1386,1307,79,1321,65
2001,Urban,Karnataka,Crime Against Men,Murder,Male,46-60,8642,5601,3041,6120,2522
2009,Rural,Maharashtra,Crime Against Children,Trafficking,Female,13-17,6167,4875,1292,5998,169
2002,Urban,Tripura,Crime Against Men,Assault,Male,13-17,1433,122,1311,519,914
2010,Rural,Madhya Pradesh,Crime Against Men,Assault,Female,18-30,9522,2797,6725,2931,6591
2001,Rural,Odisha,Crime Against Children,Child Abuse,Female,18-30,8879,5713,3166,8084,795
2004,Rural,Nagaland,Property Crime,Arson,Female,0-12,246,140,106,166,80
2010,Urban,Bihar,Crime Against Men,Robbery,Female,0-12,5423,1132,4291,1858,3565
2002,Urban,Goa,Other Crimes,Drug Offense,Male,13-17,6378,4600,1778,4797,1581
2002,Rural,Chhattisgarh,Crime Against Women,Dowry Deaths,Female,31-45,136,75,61,124,12
2001,Rural,Uttarakhand,Crime Against Men,Extortion,Male,0-12,4116,2533,1583,3573,543
2010,Rural,Delhi,Other Crimes,Fraud,Male,13-17,6707,4018,2689,4026,2681
2009,Urban,Arunachal Pradesh,Property Crime,Theft,Female,31-45,1400,391,1009,1394,6
2008,Rural,Jammu & Kashmir,Crime Against Men,Assault,Male,46-60,2193,779,1414,1373,820
2004,Rural,Mizoram,Property Crime,Arson,Female,18-30,7486,3725,3761,4548,2938
2007,Urban,Delhi,Crime Against Women,Rape,Female,18-30,513,334,179,463,50
2010,Rural,Haryana,Crime Against Men,Extortion,Male,0-12,6228,301,5927,4573,1655
2006,Rural,Mizoram,Crime Against Women,Rape,Female,46-60,9340,5519,3821,8788,552
2005,Rural,Meghalaya,Other Crimes,Fraud,Male,0-12,6238,3616,2622,6150,88
2003,Urban,Manipur,Other Crimes,Fraud,Female,18-30,4454,327,4127,986,3468
2004,Urban,Assam,Crime Against Men,Assault,Female,31-45,8822,2354,6468,3038,5784
2007,Rural,Haryana,Other Crimes,Corruption,Female,31-45,3958,1479,2479,2283,1675
2004,Urban,Jammu & Kashmir,Property Crime,Burglary,Male,46-60,5260,2923,2337,3330,1930
2001,Urban,Odisha,Property Crime,Theft,Male,46-60,7542,6676,866,6865,677
2006,Rural,Punjab,Property Crime,Arson,Female,0-12,1459,193,1266,893,566
2003,Urban,Rajasthan,Property Crime,Vandalism,Female,18-30,8896,6394,2502,7073,1823
2001,Rural,Gujarat,Crime Against Women,Rape,Female,18-30,3895,465,3430,794,3101
2001,Urban,West Bengal,Crime Against Children,Kidnapping,Female,46-60,9630,5489,4141,7949,1681
2009,Urban,Karnataka,Property Crime,Theft,Male,18-30,2744,301,2443,1236,1508
2006,Urban,Himachal Pradesh,Crime Against Men,Murder,Female,31-45,7093,3017,4076,5215,1878
2006,Urban,Tamil Nadu,Crime Against Children,Kidnapping,Male,18-30,7993,7886,107,7947,46
2009,Rural,Mizoram,Crime Against Women,Dowry Deaths,Female,18-30,3363,1398,1965,2938,425
2005,Urban,Goa,Crime Against Children,Trafficking,Female,46-60,1029,631,398,823,206
2007,Urban,Chhattisgarh,Crime Against Women,Rape,Male,0-12,4358,4205,153,4290,68
2010,Rural,Jammu & Kashmir,Crime Against Children,Trafficking,Female,18-30,1008,816,192,988,20
2002,Rural,Mizoram,Crime Against Men,Murder,Female,13-17,123,99,24,117,6
2003,Urban,Jammu & Kashmir,Property Crime,Vandalism,Male,0-12,2347,580,1767,979,1368
2001,Urban,Assam,Property Crime,Vandalism,Female,46-60,3210,1745,1465,2278,932
2001,Urban,Telangana,Other Crimes,Cyber Crime,Female,46-60,8811,3867,4944,6805,2006
2004,Urban,Himachal Pradesh,Crime Against Women,Molestation,Female,31-45,3366,326,3040,1385,1981
2001,Rural,Mizoram,Property Crime,Theft,Female,0-12,2475,2463,12,2465,10
2004,Urban,Assam,Crime Against Men,Extortion,Female,13-17,2211,1199,1012,1862,349
2008,Rural,Jharkhand,Other Crimes,Drug Offense,Female,13-17,7410,3645,3765,6813,597
2010,Urban,Sikkim,Crime Against Children,Trafficking,Male,60+,5002,50,4952,1416,3586
2009,Urban,Uttar Pradesh,Property Crime,Theft,Male,18-30,581,53,528,160,421
2004,Urban,Jammu & Kashmir,Crime Against Men,Assault,Female,18-30,7301,6937,364,7017,284
2009,Rural,Uttarakhand,Property Crime,Vandalism,Female,0-12,5159,648,4511,4807,352
2008,Rural,Mizoram,Property Crime,Burglary,Female,13-17,679,156,523,418,261
2006,Rural,Andhra Pradesh,Other Crimes,Drug Offense,Male,18-30,113,54,59,76,37
2006,Urban,Mizoram,Crime Against Women,Dowry Deaths,Female,0-12,9851,3074,6777,7432,2419
2006,Urban,Haryana,Crime Against Children,Kidnapping,Female,31-45,4746,775,3971,1667,3079
2004,Rural,Kerala,Other Crimes,Fraud,Male,18-30,1464,830,634,1081,383
2003,Rural,West Bengal,Other Crimes,Fraud,Male,18-30,1387,840,547,1058,329
2010,Urban,Chhattisgarh,Crime Against Children,Kidnapping,Female,13-17,1011,818,193,947,64
2002,Rural,Chhattisgarh,Crime Against Men,Murder,Male,60+,8248,5462,2786,6275,1973
2010,Rural,Delhi,Crime Against Women,Rape,Female,60+,1533,225,1308,1391,142
2007,Rural,Meghalaya,Property Crime,Arson,Male,31-45,9813,8135,1678,8350,1463
2004,Urban,Delhi,Other Crimes,Fraud,Female,0-12,3110,1122,1988,1495,1615
2007,Urban,Nagaland,Crime Against Children,Child Abuse,Male,60+,6926,605,6321,3629,3297
2008,Urban,Goa,Other Crimes,Corruption,Male,0-12,5527,2714,2813,3188,2339
2006,Rural,Arunachal Pradesh,Crime Against Women,Molestation,Male,31-45,3016,1941,1075,2748,268
2010,Urban,Andhra Pradesh,Crime Against Women,Molestation,Male,46-60,797,464,333,660,137
2008,Rural,Uttar Pradesh,Crime Against Men,Murder,Male,13-17,3552,2672,880,2867,685
2009,Urban,Jharkhand,Crime Against Men,Murder,Female,0-12,1809,1529,280,1675,134
2009,Rural,Uttar Pradesh,Other Crimes,Corruption,Male,46-60,238,65,173,65,173
2008,Urban,Tamil Nadu,Crime Against Children,Kidnapping,Male,46-60,3503,2932,571,3425,78
2002,Rural,Gujarat,Other Crimes,Corruption,Male,60+,6975,4420,2555,6095,880
2002,Rural,Jammu & Kashmir,Crime Against Children,Kidnapping,Male,0-12,9015,2212,6803,5569,3446
2007,Rural,Nagaland,Property Crime,Arson,Female,0-12,4388,1272,3116,2122,2266
2006,Urban,Punjab,Other Crimes,Corruption,Male,60+,4709,3972,737,4430,279
2001,Urban,West Bengal,Crime Against Women,Domestic Violence,Male,13-17,3155,1075,2080,1790,1365
2001,Rural,Jharkhand,Other Crimes,Drug Offense,Male,13-17,1793,951,842,1707,86
2003,Rural,Manipur,Property Crime,Vandalism,Male,31-45,5865,4162,1703,5121,744
2006,Rural,Nagaland,Other Crimes,Cyber Crime,Female,0-12,786,776,10,777,9
2003,Rural,Uttar Pradesh,Property Crime,Burglary,Male,0-12,2699,337,2362,1995,704
2009,Rural,Gujarat,Crime Against Men,Murder,Male,31-45,5775,5629,146,5714,61
2009,Rural,Sikkim,Crime Against Children,Child Abuse,Female,13-17,997,23,974,75,922
2007,Urban,Andhra Pradesh,Crime Against Men,Murder,Female,31-45,743,432,311,580,163
2002,Rural,Arunachal Pradesh,Property Crime,Burglary,Male,60+,6934,5945,989,6725,209
2010,Rural,Madhya Pradesh,Crime Against Men,Assault,Female,60+,6193,4501,1692,4947,1246
2003,Urban,Uttar Pradesh,Property Crime,Burglary,Male,13-17,4065,3772,293,4035,30
2004,Rural,Odisha,Property Crime,Arson,Male,13-17,290,10,280,79,211
2004,Urban,Jharkhand,Crime Against Women,Molestation,Male,60+,2562,655,1907,1566,996
2005,Urban,Jharkhand,Crime Against Men,Robbery,Female,0-12,3315,11,3304,1320,1995
2009,Urban,Jharkhand,Crime Against Men,Murder,Male,18-30,1377,620,757,1214,163
2005,Urban,Delhi,Crime Against Women,Dowry Deaths,Male,46-60,9956,545,9411,5944,4012
2007,Rural,Karnataka,Crime Against Men,Robbery,Female,31-45,2552,464,2088,1837,715
2008,Urban,Gujarat,Crime Against Men,Murder,Male,18-30,6317,560,5757,4156,2161
2009,Urban,Bihar,Other Crimes,Corruption,Female,60+,4162,2808,1354,4137,25
2010,Urban,Meghalaya,Crime Against Women,Molestation,Female,13-17,1771,1534,237,1626,145
2008,Urban,Tripura,Property Crime,Arson,Male,13-17,1076,521,555,816,260
2008,Urban,Himachal Pradesh,Crime Against Children,Child Labor,Female,18-30,5569,1612,3957,5188,381
2003,Rural,Jharkhand,Crime Against Men,Murder,Female,60+,5336,3922,1414,3968,1368
2003,Urban,Chhattisgarh,Crime Against Women,Molestation,Female,60+,425,38,387,173,252
2003,Urban,Bihar,Crime Against Women,Domestic Violence,Male,0-12,1591,806,785,1444,147
2005,Rural,Sikkim,Property Crime,Theft,Male,46-60,368,317,51,366,2
2010,Rural,Gujarat,Crime Against Women,Dowry Deaths,Male,46-60,2076,1359,717,1500,576
2009,Urban,Delhi,Property Crime,Vandalism,Male,46-60,1808,1488,320,1791,17
2009,Urban,Odisha,Property Crime,Vandalism,Female,60+,2222,1928,294,1995,227
2008,Urban,Goa,Property Crime,Theft,Male,13-17,1352,549,803,807,545
2007,Rural,West Bengal,Crime Against Women,Domestic Violence,Male,0-12,2977,1257,1720,2166,811
2005,Urban,Haryana,Other Crimes,Corruption,Male,18-30,8818,257,8561,8108,710
2008,Urban,Haryana,Crime Against Women,Dowry Deaths,Male,46-60,3901,3712,189,3739,162
2007,Rural,Manipur,Crime Against Women,Domestic Violence,Female,60+,4796,3491,1305,3833,963
2010,Rural,Kerala,Crime Against Children,Child Abuse,Female,18-30,7512,1269,6243,1339,6173
2002,Rural,Goa,Property Crime,Arson,Female,46-60,9742,8286,1456,9463,279
2003,Rural,Uttar Pradesh,Crime Against Women,Dowry Deaths,Female,18-30,933,851,82,857,76
2006,Rural,Jammu & Kashmir,Crime Against Men,Assault,Male,0-12,1380,310,1070,1027,353
2005,Rural,Mizoram,Other Crimes,Drug Offense,Female,18-30,1527,695,832,1269,258
2002,Urban,Gujarat,Crime Against Children,Trafficking,Male,46-60,6036,359,5677,4735,1301
2002,Rural,Uttarakhand,Property Crime,Burglary,Male,60+,9028,3696,5332,4016,5012
2005,Rural,Chhattisgarh,Property Crime,Theft,Female,31-45,3361,235,3126,405,2956
2006,Urban,Andhra Pradesh,Property Crime,Arson,Male,60+,4479,368,4111,2012,2467
2002,Rural,Arunachal Pradesh,Other Crimes,Drug Offense,Female,13-17,4774,4296,478,4300,474
2006,Urban,Gujarat,Crime Against Children,Trafficking,Male,46-60,6346,105,6241,4441,1905
2007,Rural,Telangana,Crime Against Men,Assault,Female,46-60,7605,3538,4067,4383,3222
2004,Rural,Delhi,Property Crime,Theft,Female,31-45,3164,2507,657,2534,630
2004,Urban,Odisha,Crime Against Children,Trafficking,Female,46-60,1439,963,476,1016,423
2006,Rural,Madhya Pradesh,Property Crime,Vandalism,Male,13-17,6548,6253,295,6530,18
2009,Rural,Punjab,Other Crimes,Drug Offense,Female,13-17,8380,4160,4220,5387,2993
2006,Urban,Tamil Nadu,Crime Against Women,Domestic Violence,Female,13-17,1334,1038,296,1292,42
2001,Urban,Tripura,Crime Against Men,Assault,Male,13-17,8887,5071,3816,8518,369
2010,Urban,Maharashtra,Crime Against Men,Murder,Female,13-17,2624,1677,947,2581,43
2003,Rural,Punjab,Crime Against Women,Molestation,Female,46-60,4436,3942,494,4296,140
2007,Urban,Delhi,Other Crimes,Drug Offense,Male,46-60,5360,145,5215,5030,330
2006,Urban,Andhra Pradesh,Crime Against Children,Child Abuse,Male,60+,8740,904,7836,3490,5250
2010,Urban,Kerala,Property Crime,Theft,Male,60+,5632,3582,2050,5603,29
2010,Urban,Tamil Nadu,Crime Against Women,Dowry Deaths,Male,18-30,7075,4949,2126,6985,90
2007,Rural,Haryana,Property Crime,Theft,Male,0-12,2335,1120,1215,1596,739
2008,Rural,Arunachal Pradesh,Crime Against Men,Robbery,Male,0-12,5779,2867,2912,3776,2003
2002,Rural,Gujarat,Other Crimes,Corruption,Female,0-12,8399,6714,1685,8207,192
2007,Rural,Madhya Pradesh,Crime Against Women,Molestation,Male,0-12,7848,4898,2950,7729,119
2003,Rural,Jharkhand,Other Crimes,Fraud,Female,46-60,7909,3920,3989,5665,2244
2005,Urban,Tamil Nadu,Other Crimes,Cyber Crime,Female,0-12,5500,3930,1570,5397,103
2007,Rural,Tripura,Crime Against Children,Kidnapping,Male,13-17,6279,4675,1604,6209,70
2008,Urban,Chhattisgarh,Crime Against Men,Robbery,Male,46-60,3879,1527,2352,3863,16
2008,Urban,Haryana,Crime Against Men,Assault,Female,60+,7126,2515,4611,4274,2852
2010,Rural,Andhra Pradesh,Other Crimes,Corruption,Female,0-12,4914,1065,3849,3445,1469
2001,Urban,Sikkim,Crime Against Women,Rape,Female,0-12,9367,1502,7865,2223,7144
2007,Urban,Arunachal Pradesh,Property Crime,Arson,Male,31-45,4733,3066,1667,3843,890
2004,Urban,Andhra Pradesh,Crime Against Women,Dowry Deaths,Male,31-45,58,22,36,55,3
2006,Urban,Goa,Crime Against Men,Robbery,Female,0-12,1424,755,669,1065,359
2010,Urban,Punjab,Crime Against Children,Trafficking,Female,46-60,3050,2987,63,3026,24
2001,Rural,Chhattisgarh,Other Crimes,Corruption,Female,18-30,3368,3215,153,3291,77
2003,Urban,Kerala,Crime Against Women,Molestation,Female,18-30,6983,6542,441,6681,302
2001,Urban,Uttar Pradesh,Other Crimes,Drug Offense,Male,18-30,2590,1571,1019,2312,278
2009,Rural,Gujarat,Crime Against Children,Child Labor,Female,60+,7721,4255,3466,6502,1219
2009,Rural,Uttarakhand,Property Crime,Burglary,Female,13-17,7987,1137,6850,7083,904
2009,Rural,Tripura,Property Crime,Arson,Female,13-17,1246,476,770,477,769
2009,Urban,Jharkhand,Crime Against Men,Robbery,Male,13-17,1798,1390,408,1687,111
2006,Rural,Uttarakhand,Crime Against Children,Child Abuse,Male,31-45,7592,7127,465,7523,69
2004,Urban,Mizoram,Crime Against Men,Murder,Female,0-12,9246,5850,3396,7341,1905
2006,Urban,Kerala,Crime Against Women,Molestation,Female,60+,3173,2853,320,3124,49
2009,Urban,Odisha,Crime Against Men,Extortion,Female,0-12,1436,1336,100,1374,62
2002,Rural,Tripura,Crime Against Children,Trafficking,Female,60+,3454,1188,2266,1495,1959
2010,Rural,Bihar,Crime Against Men,Assault,Female,13-17,3478,2188,1290,2453,1025
2003,Urban,Odisha,Other Crimes,Corruption,Female,60+,2624,1404,1220,2208,416
2004,Rural,Gujarat,Crime Against Men,Robbery,Female,18-30,593,305,288,397,196
2007,Rural,Karnataka,Crime Against Men,Extortion,Male,46-60,203,122,81,167,36
2007,Rural,Jharkhand,Other Crimes,Fraud,Male,60+,4608,4549,59,4600,8
2009,Urban,Chhattisgarh,Property Crime,Arson,Female,13-17,601,371,230,499,102
2003,Urban,Rajasthan,Crime Against Men,Murder,Female,46-60,8595,1345,7250,5853,2742
2005,Urban,Assam,Crime Against Women,Molestation,Male,31-45,889,737,152,829,60
2007,Urban,Meghalaya,Property Crime,Vandalism,Female,60+,3032,281,2751,2108,924
2005,Rural,Manipur,Property Crime,Vandalism,Female,13-17,4276,2754,1522,2790,1486
2006,Urban,Haryana,Crime Against Men,Robbery,Female,18-30,9175,8462,713,9175,0
2006,Urban,Uttar Pradesh,Crime Against Women,Rape,Male,0-12,2322,1427,895,1654,668
2007,Urban,Punjab,Crime Against Men,Murder,Male,60+,7996,132,7864,1255,6741
2007,Urban,Punjab,Crime Against Women,Molestation,Female,31-45,7727,4167,3560,5262,2465
2005,Rural,Goa,Crime Against Children,Trafficking,Female,46-60,5352,4154,1198,4979,373
2004,Rural,Telangana,Property Crime,Theft,Male,31-45,9191,162,9029,7819,1372
2003,Rural,Kerala,Crime Against Men,Assault,Female,13-17,2178,251,1927,1295,883
2010,Rural,Madhya Pradesh,Crime Against Women,Molestation,Female,13-17,8090,5356,2734,5842,2248
2001,Urban,Jharkhand,Property Crime,Theft,Female,13-17,3087,2034,1053,2340,747
2005,Urban,Punjab,Crime Against Women,Domestic Violence,Male,13-17,859,232,627,732,127
2007,Urban,Mizoram,Other Crimes,Drug Offense,Female,60+,9559,8136,1423,8488,1071
2008,Urban,Punjab,Crime Against Children,Kidnapping,Male,13-17,5689,4893,796,4979,710
2004,Rural,Nagaland,Crime Against Children,Child Abuse,Male,46-60,4079,2792,1287,3667,412
2006,Urban,Arunachal Pradesh,Property Crime,Arson,Female,46-60,1405,1062,343,1161,244
2009,Urban,Bihar,Crime Against Men,Murder,Female,46-60,6309,1620,4689,1689,4620
2002,Rural,West Bengal,Crime Against Children,Child Abuse,Female,46-60,6246,1936,4310,2012,4234
2002,Rural,Assam,Crime Against Men,Assault,Male,0-12,7577,6952,625,7468,109
2006,Urban,Maharashtra,Crime Against Children,Child Labor,Male,18-30,8249,4443,3806,4893,3356
2003,Rural,Delhi,Crime Against Children,Trafficking,Female,60+,8279,2830,5449,3594,4685
2007,Rural,West Bengal,Property Crime,Theft,Male,0-12,7321,1247,6074,3123,4198
2005,Rural,Telangana,Property Crime,Burglary,Male,13-17,9574,2984,6590,9379,195
2009,Urban,Tamil Nadu,Crime Against Women,Rape,Female,18-30,1952,710,1242,1821,131
2005,Rural,Meghalaya,Crime Against Children,Kidnapping,Female,18-30,4808,720,4088,1029,3779
2007,Rural,Delhi,Property Crime,Vandalism,Female,60+,3405,3116,289,3192,213
2001,Rural,Tamil Nadu,Crime Against Children,Kidnapping,Male,60+,4215,4114,101,4135,80
2006,Rural,Goa,Crime Against Children,Kidnapping,Male,18-30,4488,942,3546,3997,491
2008,Urban,Haryana,Crime Against Women,Dowry Deaths,Male,13-17,9518,5670,3848,8740,778
2006,Rural,West Bengal,Property Crime,Vandalism,Female,13-17,2956,2000,956,2622,334
2009,Urban,Assam,Crime Against Children,Trafficking,Female,18-30,1069,688,381,739,330
2002,Rural,Meghalaya,Property Crime,Vandalism,Male,13-17,1962,855,1107,1641,321
2002,Urban,Tamil Nadu,Property Crime,Burglary,Male,31-45,4853,642,4211,4416,437
2001,Urban,Chhattisgarh,Other Crimes,Cyber Crime,Male,13-17,9351,493,8858,2733,6618
2009,Urban,Manipur,Property Crime,Theft,Male,46-60,811,171,640,766,45
2001,Rural,Jammu & Kashmir,Crime Against Children,Trafficking,Female,46-60,6468,3778,2690,4783,1685
2008,Urban,Uttar Pradesh,Crime Against Women,Rape,Male,60+,8998,6351,2647,7221,1777
2002,Urban,Arunachal Pradesh,Crime Against Men,Assault,Male,46-60,1262,61,1201,556,706
2005,Urban,Punjab,Property Crime,Theft,Female,18-30,305,295,10,301,4
2007,Rural,Karnataka,Crime Against Women,Dowry Deaths,Female,13-17,4616,4264,352,4586,30
2001,Rural,Assam,Crime Against Women,Dowry Deaths,Female,31-45,9435,7099,2336,7602,1833
2010,Urban,Kerala,Crime Against Men,Extortion,Female,0-12,6047,5193,854,6036,11
2007,Rural,Delhi,Other Crimes,Cyber Crime,Female,0-12,510,215,295,477,33
2010,Rural,Maharashtra,Crime Against Children,Child Labor,Female,13-17,3792,1030,2762,3739,53
2005,Urban,Gujarat,Property Crime,Arson,Female,46-60,3560,29,3531,746,2814
2002,Rural,Tripura,Crime Against Children,Child Abuse,Female,13-17,8066,481,7585,6793,1273
2003,Urban,Nagaland,Crime Against Women,Rape,Male,13-17,6789,1876,4913,4764,2025
2002,Urban,Maharashtra,Crime Against Children,Child Labor,Female,0-12,8969,3360,5609,5702,3267
2010,Rural,Madhya Pradesh,Property Crime,Burglary,Female,18-30,302,131,171,226,76
2007,Rural,Goa,Crime Against Children,Child Labor,Female,31-45,9329,2890,6439,3243,6086
2007,Urban,Andhra Pradesh,Other Crimes,Corruption,Male,46-60,5043,3735,1308,4627,416
2010,Urban,West Bengal,Crime Against Men,Assault,Male,46-60,5686,2044,3642,5042,644
2008,Rural,Himachal Pradesh,Crime Against Men,Assault,Female,46-60,481,382,99,389,92
2006,Rural,Madhya Pradesh,Crime Against Children,Kidnapping,Male,0-12,7659,5125,2534,6498,1161
2009,Urban,Gujarat,Property Crime,Vandalism,Male,13-17,1494,958,536,1453,41
2009,Urban,Jharkhand,Crime Against Men,Assault,Female,46-60,3610,3422,188,3447,163
2005,Rural,Telangana,Crime Against Women,Domestic Violence,Female,46-60,3795,3184,611,3480,315
2001,Rural,Nagaland,Crime Against Men,Extortion,Female,46-60,298,15,283,62,236
2005,Rural,Punjab,Crime Against Women,Molestation,Male,0-12,1798,109,1689,1769,29
2009,Urban,Manipur,Crime Against Children,Trafficking,Male,46-60,6818,1096,5722,4826,1992
2004,Urban,Tripura,Crime Against Women,Rape,Male,0-12,8451,2962,5489,5792,2659
2008,Urban,Nagaland,Property Crime,Burglary,Female,31-45,7791,105,7686,3859,3932
2003,Rural,Rajasthan,Crime Against Children,Kidnapping,Female,13-17,9342,9188,154,9327,15
2007,Rural,West Bengal,Crime Against Men,Robbery,Female,46-60,2360,364,1996,1586,774
2003,Urban,Tripura,Property Crime,Arson,Male,13-17,1945,1054,891,1427,518
2010,Rural,Bihar,Crime Against Children,Child Labor,Female,31-45,8367,4054,4313,8280,87
2009,Urban,Himachal Pradesh,Crime Against Children,Kidnapping,Female,13-17,2350,1665,685,2041,309
2009,Rural,Punjab,Crime Against Men,Assault,Male,46-60,1220,918,302,1177,43
2008,Urban,Arunachal Pradesh,Other Crimes,Cyber Crime,Female,31-45,3995,236,3759,1334,2661
2006,Rural,Chhattisgarh,Crime Against Women,Dowry Deaths,Male,18-30,5322,1934,3388,3516,1806
2009,Urban,Karnataka,Crime Against Men,Murder,Female,31-45,7473,5055,2418,7003,470
2007,Rural,Jharkhand,Property Crime,Vandalism,Male,0-12,3625,2170,1455,3487,138
2004,Urban,Goa,Property Crime,Burglary,Male,18-30,8383,6513,1870,6630,1753
2004,Urban,Madhya Pradesh,Crime Against Children,Kidnapping,Male,0-12,3190,933,2257,2340,850
2008,Urban,Tripura,Crime Against Men,Robbery,Male,46-60,5557,1863,3694,2744,2813
2002,Rural,Bihar,Property Crime,Burglary,Male,13-17,1678,1475,203,1483,195
2001,Urban,Tripura,Property Crime,Vandalism,Male,31-45,7256,3031,4225,4830,2426
2005,Rural,Chhattisgarh,Crime Against Men,Robbery,Male,31-45,5697,5200,497,5213,484
2003,Rural,Sikkim,Crime Against Men,Assault,Female,18-30,5984,162,5822,5125,859
2010,Urban,Madhya Pradesh,Crime Against Children,Child Labor,Female,13-17,3077,1646,1431,2844,233
2003,Rural,Madhya Pradesh,Crime Against Men,Murder,Male,13-17,1898,1895,3,1897,1
2005,Rural,Haryana,Crime Against Men,Extortion,Male,13-17,6980,6262,718,6611,369
2008,Rural,West Bengal,Property Crime,Vandalism,Male,18-30,8810,1824,6986,3843,4967
2003,Urban,Haryana,Crime Against Men,Murder,Female,31-45,7897,2702,5195,3008,4889
2001,Urban,Kerala,Property Crime,Vandalism,Male,46-60,4959,3092,1867,3985,974
2003,Urban,Goa,Other Crimes,Cyber Crime,Male,46-60,8448,6399,2049,7992,456
2002,Rural,Goa,Crime Against Men,Extortion,Male,0-12,7757,2408,5349,3184,4573
2010,Urban,Tamil Nadu,Property Crime,Arson,Male,46-60,3047,2950,97,3014,33
2002,Urban,Meghalaya,Crime Against Women,Molestation,Male,13-17,9567,904,8663,7771,1796
2003,Rural,Goa,Crime Against Men,Robbery,Female,31-45,4950,540,4410,1219,3731
2010,Rural,Maharashtra,Crime Against Children,Child Labor,Female,31-45,9687,2791,6896,5514,4173
2002,Urban,Kerala,Crime Against Men,Assault,Female,31-45,930,358,572,513,417
2003,Rural,Odisha,Crime Against Men,Robbery,Male,46-60,226,31,195,78,148
2008,Urban,Haryana,Crime Against Men,Extortion,Female,13-17,2072,406,1666,769,1303
2008,Rural,Meghalaya,Crime Against Children,Trafficking,Male,0-12,2920,1012,1908,1422,1498
2002,Urban,Gujarat,Crime Against Children,Trafficking,Male,13-17,2995,132,2863,2247,748
2002,Urban,Mizoram,Other Crimes,Drug Offense,Female,13-17,8156,7242,914,8108,48
2001,Urban,Maharashtra,Crime Against Men,Murder,Male,31-45,9934,4099,5835,8000,1934
2002,Urban,Uttarakhand,Property Crime,Arson,Male,0-12,3365,1168,2197,2540,825
2001,Urban,Delhi,Property Crime,Theft,Female,46-60,1461,191,1270,632,829
2005,Urban,Delhi,Other Crimes,Corruption,Female,13-17,9825,2163,7662,9584,241
2002,Urban,Telangana,Crime Against Women,Molestation,Female,31-45,5967,1099,4868,1352,4615
2005,Rural,Nagaland,Crime Against Children,Child Labor,Male,18-30,8109,570,7539,4786,3323
2006,Rural,Nagaland,Other Crimes,Fraud,Female,18-30,9792,74,9718,9392,400
2009,Urban,Manipur,Property Crime,Theft,Female,18-30,8151,1282,6869,1506,6645
2005,Rural,Meghalaya,Other Crimes,Corruption,Female,0-12,8547,3310,5237,4681,3866
2004,Rural,Mizoram,Crime Against Women,Molestation,Female,46-60,3764,2320,1444,2486,1278
2002,Urban,Madhya Pradesh,Crime Against Children,Child Abuse,Male,60+,9471,73,9398,3334,6137
2010,Rural,Kerala,Crime Against Men,Extortion,Male,60+,319,240,79,252,67
2005,Rural,Chhattisgarh,Crime Against Women,Dowry Deaths,Female,0-12,4065,3068,997,3463,602
2001,Rural,Maharashtra,Crime Against Women,Domestic Violence,Female,0-12,2133,1226,907,2131,2
2001,Urban,Sikkim,Crime Against Men,Assault,Female,0-12,2071,1813,258,1998,73
2002,Rural,Jammu & Kashmir,Crime Against Women,Molestation,Male,0-12,6510,2164,4346,3729,2781
2001,Rural,Telangana,Crime Against Women,Molestation,Male,46-60,1041,121,920,431,610
2008,Urban,Andhra Pradesh,Crime Against Children,Trafficking,Male,60+,6279,1266,5013,3331,2948
2008,Rural,Rajasthan,Property Crime,Theft,Female,46-60,4235,714,3521,851,3384
2005,Rural,Karnataka,Property Crime,Arson,Female,18-30,1166,944,222,990,176
2005,Urban,Goa,Crime Against Women,Dowry Deaths,Male,13-17,8474,3606,4868,4157,4317
2005,Urban,Rajasthan,Crime Against Children,Kidnapping,Female,13-17,3747,3075,672,3281,466
2010,Rural,Mizoram,Property Crime,Arson,Male,31-45,363,1,362,300,63
2002,Rural,Telangana,Crime Against Women,Rape,Female,31-45,7280,6124,1156,6633,647
2006,Rural,Sikkim,Crime Against Children,Child Labor,Female,60+,9933,5121,4812,6209,3724
2002,Rural,Uttarakhand,Other Crimes,Fraud,Female,60+,4379,1453,2926,3009,1370
2006,Urban,Nagaland,Crime Against Women,Dowry Deaths,Male,60+,4788,2500,2288,3451,1337
2008,Urban,Uttarakhand,Crime Against Children,Kidnapping,Female,0-12,81,71,10,77,4
2008,Urban,Chhattisgarh,Property Crime,Vandalism,Female,18-30,1249,570,679,1102,147
2001,Urban,Rajasthan,Crime Against Women,Dowry Deaths,Male,60+,4807,2358,2449,3304,1503
2003,Rural,Tamil Nadu,Property Crime,Burglary,Female,18-30,2572,2549,23,2553,19
2003,Urban,Nagaland,Property Crime,Burglary,Female,13-17,4631,91,4540,4444,187
2001,Rural,Bihar,Other Crimes,Drug Offense,Male,18-30,6816,2746,4070,4671,2145
2008,Urban,Rajasthan,Crime Against Children,Kidnapping,Male,46-60,4344,2340,2004,2706,1638
2009,Rural,Chhattisgarh,Crime Against Women,Molestation,Female,13-17,3117,941,2176,2451,666
2010,Urban,Delhi,Property Crime,Arson,Male,13-17,1074,931,143,1068,6
2001,Urban,Andhra Pradesh,Crime Against Women,Molestation,Female,0-12,6276,2837,3439,6036,240
2001,Rural,Jharkhand,Property Crime,Burglary,Female,46-60,4998,3596,1402,4662,336
2002,Rural,Nagaland,Property Crime,Arson,Male,60+,4117,1032,3085,1983,2134
2004,Urban,Jharkhand,Property Crime,Theft,Female,18-30,5921,3089,2832,5915,6
2008,Urban,Mizoram,Other Crimes,Drug Offense,Male,13-17,9279,8092,1187,8391,888
2003,Urban,Jammu & Kashmir,Crime Against Men,Robbery,Female,46-60,7948,4016,3932,4733,3215
2001,Rural,Mizoram,Crime Against Men,Murder,Male,0-12,9145,2164,6981,2922,6223
2002,Urban,Manipur,Crime Against Children,Child Labor,Male,46-60,1141,612,529,691,450
2001,Rural,Maharashtra,Property Crime,Theft,Male,46-60,7516,973,6543,7108,408
2008,Rural,Meghalaya,Other Crimes,Corruption,Male,46-60,8806,799,8007,5455,3351
2009,Rural,Madhya Pradesh,Crime Against Men,Murder,Female,0-12,9663,6251,3412,7994,1669
2006,Urban,Jharkhand,Property Crime,Vandalism,Male,60+,4521,589,3932,3929,592
2009,Urban,Tripura,Other Crimes,Drug Offense,Female,46-60,8133,1786,6347,4277,3856
2002,Urban,Kerala,Other Crimes,Drug Offense,Female,18-30,7688,1600,6088,2825,4863
2006,Rural,Rajasthan,Crime Against Women,Dowry Deaths,Female,31-45,6152,1969,4183,4716,1436
2002,Rural,Telangana,Crime Against Women,Domestic Violence,Male,60+,3572,2343,1229,3074,498
2005,Urban,Manipur,Property Crime,Vandalism,Female,60+,7894,7293,601,7434,460
2009,Urban,Punjab,Crime Against Children,Child Labor,Female,18-30,1874,1113,761,1411,463
2008,Urban,Goa,Crime Against Women,Molestation,Male,46-60,5588,1637,3951,1704,3884
2008,Urban,Maharashtra,Property Crime,Arson,Male,31-45,724,320,404,686,38
2002,Urban,Kerala,Property Crime,Vandalism,Female,18-30,5277,1754,3523,1889,3388
2010,Urban,Tamil Nadu,Crime Against Women,Molestation,Female,60+,8502,2372,6130,7107,1395
2009,Rural,Nagaland,Property Crime,Vandalism,Male,18-30,1508,1121,387,1475,33
2008,Urban,Jammu & Kashmir,Property Crime,Burglary,Male,31-45,3163,1636,1527,2507,656
2006,Urban,Telangana,Property Crime,Burglary,Male,18-30,4976,4368,608,4564,412
2010,Urban,Nagaland,Crime Against Children,Kidnapping,Male,60+,1323,499,824,910,413
2005,Rural,Goa,Crime Against Children,Kidnapping,Female,60+,7319,2973,4346,4513,2806
2007,Urban,Nagaland,Property Crime,Burglary,Female,18-30,9697,6468,3229,8014,1683
2006,Urban,Andhra Pradesh,Crime Against Women,Domestic Violence,Female,18-30,3306,1199,2107,1865,1441
2006,Urban,Bihar,Property Crime,Arson,Female,0-12,7258,582,6676,2566,4692
2010,Urban,Maharashtra,Other Crimes,Corruption,Female,60+,5574,4134,1440,5138,436
2004,Urban,West Bengal,Other Crimes,Drug Offense,Male,0-12,4098,2991,1107,3053,1045
2007,Rural,Kerala,Crime Against Children,Child Abuse,Female,60+,4605,1528,3077,3582,1023
2007,Urban,Tripura,Property Crime,Burglary,Male,13-17,8229,6179,2050,8141,88
2004,Urban,Delhi,Crime Against Children,Child Abuse,Female,46-60,7110,1082,6028,5135,1975
2006,Rural,Mizoram,Crime Against Women,Molestation,Male,46-60,7052,5189,1863,5203,1849
2004,Urban,Manipur,Property Crime,Vandalism,Female,0-12,5990,1054,4936,4270,1720
2002,Rural,Odisha,Crime Against Women,Domestic Violence,Female,60+,3215,3028,187,3061,154
2009,Rural,Telangana,Crime Against Women,Molestation,Male,31-45,9704,1028,8676,3237,6467
2001,Rural,Maharashtra,Crime Against Women,Rape,Male,18-30,7318,5334,1984,7049,269
2004,Rural,Gujarat,Crime Against Women,Dowry Deaths,Male,13-17,8364,7393,971,7693,671
2009,Rural,Bihar,Other Crimes,Fraud,Female,31-45,5933,884,5049,5032,901
2004,Rural,Gujarat,Other Crimes,Corruption,Female,13-17,6563,6522,41,6522,41
2004,Urban,Gujarat,Other Crimes,Corruption,Male,46-60,488,195,293,473,15
2005,Urban,Kerala,Property Crime,Arson,Female,60+,6225,5670,555,6052,173
2006,Rural,Tamil Nadu,Other Crimes,Fraud,Female,0-12,307,221,86,227,80
2006,Urban,Bihar,Crime Against Men,Murder,Male,60+,6800,336,6464,4491,2309
2007,Urban,Sikkim,Crime Against Children,Child Abuse,Female,0-12,885,623,262,665,220
2010,Urban,Rajasthan,Other Crimes,Corruption,Male,46-60,5825,4447,1378,5128,697
2008,Rural,Tripura,Other Crimes,Drug Offense,Female,31-45,5475,5147,328,5468,7
2010,Urban,Bihar,Property Crime,Arson,Female,0-12,4850,483,4367,767,4083
2004,Rural,Kerala,Crime Against Men,Murder,Male,60+,3927,547,3380,1368,2559
2003,Rural,Tripura,Crime Against Children,Kidnapping,Male,60+,1808,960,848,1042,766
2001,Urban,Karnataka,Other Crimes,Drug Offense,Female,31-45,5422,3568,1854,5160,262
2009,Rural,Meghalaya,Crime Against Children,Child Labor,Male,31-45,6804,2069,4735,3702,3102
2007,Rural,Goa,Crime Against Women,Molestation,Female,60+,360,234,126,278,82
2003,Urban,Haryana,Crime Against Children,Child Abuse,Female,46-60,4217,3965,252,3986,231
2006,Urban,Maharashtra,Crime Against Men,Murder,Female,18-30,8568,3987,4581,7102,1466
2010,Urban,Arunachal Pradesh,Other Crimes,Cyber Crime,Male,31-45,3009,1875,1134,2270,739
2007,Urban,Himachal Pradesh,Crime Against Men,Robbery,Female,31-45,3177,2661,516,2715,462
2006,Rural,Goa,Other Crimes,Fraud,Male,31-45,6253,1414,4839,4436,1817
2008,Urban,Madhya Pradesh,Crime Against Children,Trafficking,Male,18-30,1547,174,1373,741,806
2006,Rural,West Bengal,Crime Against Men,Extortion,Female,18-30,7789,6757,1032,7268,521
2002,Urban,Karnataka,Property Crime,Theft,Male,13-17,4880,4532,348,4812,68
2002,Rural,Punjab,Crime Against Children,Child Labor,Male,18-30,6561,1617,4944,2489,4072
2006,Urban,Maharashtra,Crime Against Men,Extortion,Female,13-17,1222,661,561,698,524
2003,Rural,Sikkim,Other Crimes,Corruption,Male,60+,4558,3571,987,4519,39
2006,Urban,Meghalaya,Crime Against Children,Child Labor,Male,18-30,1667,1108,559,1261,406
2003,Urban,Jammu & Kashmir,Property Crime,Theft,Male,18-30,2700,1133,1567,2430,270
2010,Rural,Himachal Pradesh,Property Crime,Vandalism,Male,13-17,7335,1366,5969,4077,3258
2007,Rural,Arunachal Pradesh,Crime Against Children,Trafficking,Female,13-17,9743,1981,7762,4332,5411
2009,Rural,Mizoram,Property Crime,Vandalism,Female,13-17,2942,368,2574,746,2196
2002,Rural,Mizoram,Crime Against Children,Trafficking,Male,60+,1443,1313,130,1421,22
2004,Urban,Sikkim,Other Crimes,Corruption,Female,0-12,726,486,240,572,154
2008,Urban,Jammu & Kashmir,Crime Against Women,Domestic Violence,Female,0-12,9149,8996,153,9040,109
2003,Urban,Telangana,Other Crimes,Corruption,Female,31-45,1443,253,1190,1350,93
2010,Rural,Tripura,Crime Against Women,Domestic Violence,Male,31-45,3967,3513,454,3832,135
2009,Urban,Gujarat,Other Crimes,Drug Offense,Female,18-30,5151,450,4701,2261,2890
2002,Urban,Odisha,Crime Against Children,Kidnapping,Female,31-45,6300,4915,1385,5230,1070
2002,Rural,Haryana,Property Crime,Arson,Female,0-12,6945,4123,2822,5514,1431
2005,Rural,Mizoram,Other Crimes,Corruption,Female,31-45,9970,7614,2356,8516,1454
2003,Rural,Himachal Pradesh,Other Crimes,Fraud,Female,46-60,8509,6633,1876,7146,1363
2001,Urban,Rajasthan,Crime Against Men,Robbery,Male,46-60,3654,35,3619,623,3031
2001,Rural,Andhra Pradesh,Crime Against Women,Molestation,Male,31-45,882,181,701,718,164
2008,Rural,Goa,Other Crimes,Cyber Crime,Male,13-17,5355,3574,1781,4060,1295
2007,Urban,Bihar,Other Crimes,Drug Offense,Male,46-60,5408,3869,1539,5248,160
2002,Urban,Rajasthan,Other Crimes,Fraud,Male,46-60,1791,209,1582,365,1426
2009,Rural,Himachal Pradesh,Crime Against Women,Dowry Deaths,Female,18-30,226,159,67,212,14
2005,Urban,West Bengal,Property Crime,Vandalism,Female,18-30,4055,2400,1655,3809,246
2003,Rural,Uttarakhand,Other Crimes,Corruption,Male,0-12,5968,2071,3897,3478,2490
2001,Rural,Chhattisgarh,Other Crimes,Drug Offense,Female,18-30,7168,2855,4313,5886,1282
2003,Rural,Madhya Pradesh,Other Crimes,Cyber Crime,Male,13-17,983,565,418,631,352
2001,Rural,Haryana,Crime Against Children,Trafficking,Male,0-12,1043,289,754,875,168
2008,Urban,Nagaland,Crime Against Children,Child Labor,Male,46-60,498,176,322,210,288
2006,Rural,Telangana,Crime Against Men,Robbery,Female,46-60,2894,1257,1637,2737,157
2001,Rural,Tripura,Other Crimes,Cyber Crime,Female,31-45,8476,1227,7249,5690,2786
2008,Rural,Himachal Pradesh,Crime Against Children,Trafficking,Female,46-60,2331,231,2100,1574,757
2004,Urban,Uttarakhand,Property Crime,Burglary,Male,13-17,4405,837,3568,1920,2485
2002,Urban,Telangana,Property Crime,Theft,Male,60+,6098,106,5992,311,5787
2010,Urban,Tripura,Crime Against Children,Trafficking,Female,46-60,5235,2229,3006,3657,1578
2001,Rural,West Bengal,Crime Against Men,Murder,Female,18-30,4397,127,4270,3172,1225
2002,Rural,Nagaland,Property Crime,Theft,Male,0-12,2256,924,1332,1023,1233
2009,Rural,Kerala,Crime Against Children,Kidnapping,Female,60+,4685,2650,2035,3724,961
2001,Rural,Andhra Pradesh,Other Crimes,Cyber Crime,Female,31-45,775,381,394,391,384
2002,Urban,Assam,Crime Against Women,Domestic Violence,Female,46-60,2506,1291,1215,1829,677
2002,Rural,Maharashtra,Property Crime,Theft,Female,60+,7526,4890,2636,5245,2281
2003,Rural,Telangana,Crime Against Women,Molestation,Male,18-30,5012,4621,391,4681,331
2001,Urban,Rajasthan,Other Crimes,Fraud,Male,0-12,3496,96,3400,1799,1697
2001,Rural,Jharkhand,Crime Against Men,Assault,Male,0-12,7572,4699,2873,5981,1591
2007,Urban,Gujarat,Other Crimes,Cyber Crime,Male,31-45,6081,1407,4674,2114,3967
2009,Urban,Odisha,Crime Against Children,Child Labor,Male,0-12,2589,540,2049,1384,1205
2003,Urban,Andhra Pradesh,Crime Against Women,Molestation,Female,0-12,8199,301,7898,3293,4906
2009,Urban,Sikkim,Other Crimes,Drug Offense,Female,46-60,548,440,108,497,51
2001,Urban,Uttarakhand,Other Crimes,Drug Offense,Male,0-12,5398,726,4672,1163,4235
2001,Urban,Uttar Pradesh,Crime Against Men,Robbery,Female,0-12,2977,1247,1730,2572,405
2001,Urban,Andhra Pradesh,Crime Against Women,Rape,Male,60+,8599,1111,7488,3223,5376
2010,Urban,Assam,Crime Against Children,Child Abuse,Male,18-30,418,30,388,373,45
2010,Rural,Goa,Crime Against Children,Trafficking,Male,46-60,9814,8270,1544,8929,885
2009,Urban,Jammu & Kashmir,Other Crimes,Cyber Crime,Male,31-45,6144,5863,281,5900,244
2008,Urban,Uttar Pradesh,Other Crimes,Cyber Crime,Male,60+,7676,5628,2048,7335,341
2007,Rural,Telangana,Other Crimes,Cyber Crime,Male,13-17,8012,4544,3468,6882,1130
2007,Rural,Odisha,Crime Against Men,Extortion,Male,0-12,427,95,332,164,263
2007,Rural,West Bengal,Crime Against Children,Kidnapping,Female,18-30,4797,3173,1624,4606,191
2010,Rural,Chhattisgarh,Property Crime,Theft,Female,60+,5693,2827,2866,4865,828
2009,Rural,Nagaland,Crime Against Children,Kidnapping,Female,0-12,9745,880,8865,4815,4930
2005,Rural,Uttarakhand,Property Crime,Arson,Female,31-45,7883,2958,4925,5350,2533
2007,Urban,Odisha,Other Crimes,Cyber Crime,Female,13-17,8753,8045,708,8155,598
2008,Rural,Jharkhand,Crime Against Men,Murder,Female,13-17,4720,1761,2959,3842,878
2007,Urban,Manipur,Crime Against Children,Trafficking,Female,13-17,6002,2164,3838,3510,2492
2005,Urban,Mizoram,Other Crimes,Drug Offense,Male,31-45,7335,2452,4883,6255,1080
2005,Rural,Gujarat,Crime Against Children,Child Labor,Male,60+,4942,4169,773,4252,690
2010,Rural,Kerala,Crime Against Women,Dowry Deaths,Female,18-30,6516,6186,330,6413,103
2007,Urban,Arunachal Pradesh,Other Crimes,Drug Offense,Male,31-45,168,121,47,145,23
2006,Rural,Jammu & Kashmir,Crime Against Women,Molestation,Female,0-12,582,99,483,317,265
2007,Rural,Goa,Other Crimes,Corruption,Male,46-60,6566,6164,402,6271,295
2007,Rural,Karnataka,Crime Against Men,Robbery,Male,46-60,1909,548,1361,1786,123
2003,Rural,Sikkim,Crime Against Women,Dowry Deaths,Female,31-45,3267,441,2826,1543,1724
2009,Rural,Madhya Pradesh,Property Crime,Vandalism,Male,0-12,5021,29,4992,2637,2384
2005,Rural,Punjab,Other Crimes,Drug Offense,Female,60+,8944,2867,6077,6914,2030
2003,Urban,Mizoram,Crime Against Men,Assault,Male,13-17,3189,1893,1296,2828,361
2010,Rural,Manipur,Crime Against Men,Robbery,Female,60+,3422,301,3121,3076,346
2006,Rural,Rajasthan,Other Crimes,Corruption,Female,18-30,8681,2945,5736,3939,4742
2002,Rural,Arunachal Pradesh,Crime Against Women,Rape,Male,0-12,9704,7472,2232,9320,384
2003,Urban,Bihar,Crime Against Women,Rape,Female,31-45,9010,1211,7799,5642,3368
2004,Rural,Sikkim,Crime Against Men,Assault,Female,13-17,9673,4175,5498,6300,3373
2010,Rural,Arunachal Pradesh,Crime Against Children,Kidnapping,Male,0-12,2252,859,1393,1239,1013
2010,Urban,Telangana,Property Crime,Burglary,Male,60+,3280,399,2881,1519,1761
2009,Urban,Manipur,Crime Against Men,Extortion,Male,31-45,625,183,442,607,18
2007,Urban,Nagaland,Crime Against Men,Extortion,Female,46-60,2557,82,2475,1237,1320
2010,Urban,Assam,Crime Against Men,Assault,Female,13-17,3877,1632,2245,2433,1444
2009,Urban,Jharkhand,Other Crimes,Drug Offense,Male,31-45,6449,4285,2164,5522,927
2009,Urban,Mizoram,Other Crimes,Drug Offense,Female,46-60,7033,6179,854,6778,255
2009,Rural,Odisha,Crime Against Children,Trafficking,Male,0-12,5299,195,5104,2802,2497
2001,Rural,Odisha,Crime Against Women,Molestation,Female,46-60,5019,3346,1673,4389,630
2007,Rural,Rajasthan,Property Crime,Vandalism,Female,60+,8504,3779,4725,7042,1462
2007,Urban,Sikkim,Crime Against Men,Murder,Male,46-60,5735,2638,3097,3292,2443
2001,Urban,Bihar,Crime Against Children,Child Abuse,Male,60+,6361,6321,40,6342,19
2005,Urban,Meghalaya,Crime Against Children,Child Abuse,Male,0-12,8811,3977,4834,8668,143
2010,Rural,Uttarakhand,Other Crimes,Fraud,Male,18-30,3485,1428,2057,2618,867
2009,Urban,Arunachal Pradesh,Crime Against Children,Child Labor,Male,18-30,5987,2988,2999,4408,1579
2001,Rural,Nagaland,Property Crime,Burglary,Female,60+,1589,1084,505,1356,233
2006,Urban,West Bengal,Crime Against Women,Molestation,Female,18-30,5814,132,5682,3443,2371
2010,Urban,Uttar Pradesh,Property Crime,Burglary,Male,31-45,7594,4130,3464,7109,485
2003,Urban,Tamil Nadu,Crime Against Children,Trafficking,Male,31-45,7061,2541,4520,6127,934
2008,Rural,Meghalaya,Crime Against Children,Kidnapping,Female,18-30,8398,5519,2879,6334,2064
2003,Urban,West Bengal,Other Crimes,Cyber Crime,Female,46-60,598,342,256,482,116
2008,Rural,Maharashtra,Crime Against Men,Assault,Female,60+,1128,14,1114,59,1069
2007,Urban,West Bengal,Other Crimes,Corruption,Female,46-60,8435,1031,7404,5757,2678
2005,Rural,Telangana,Crime Against Women,Domestic Violence,Female,0-12,9441,8965,476,9201,240
2006,Rural,Rajasthan,Crime Against Women,Rape,Male,60+,1161,787,374,857,304
2009,Rural,Tripura,Crime Against Children,Child Labor,Male,60+,7545,1788,5757,4650,2895
2003,Rural,Tripura,Crime Against Children,Trafficking,Male,46-60,4439,828,3611,3359,1080
2004,Rural,Telangana,Other Crimes,Drug Offense,Female,18-30,6694,2045,4649,5571,1123
2010,Rural,Uttar Pradesh,Other Crimes,Cyber Crime,Female,31-45,9494,4857,4637,5903,3591
2004,Rural,Madhya Pradesh,Other Crimes,Fraud,Male,13-17,8912,2634,6278,6738,2174
2006,Rural,Uttar Pradesh,Other Crimes,Drug Offense,Male,46-60,1791,1395,396,1661,130
2009,Urban,Mizoram,Crime Against Children,Kidnapping,Female,46-60,7509,710,6799,1759,5750
2002,Urban,Manipur,Crime Against Children,Trafficking,Male,46-60,8173,2705,5468,6741,1432
2010,Rural,Telangana,Crime Against Men,Murder,Male,18-30,9647,1992,7655,6395,3252
2001,Urban,Gujarat,Crime Against Children,Child Labor,Male,60+,2090,110,1980,1799,291
2006,Urban,Rajasthan,Property Crime,Arson,Male,13-17,9534,8489,1045,8527,1007
2009,Urban,Manipur,Other Crimes,Fraud,Male,13-17,7064,2354,4710,2764,4300
2009,Urban,Tamil Nadu,Crime Against Children,Child Abuse,Male,13-17,2676,1101,1575,1230,1446
2009,Urban,Mizoram,Crime Against Women,Dowry Deaths,Female,13-17,3228,1164,2064,2924,304
2006,Urban,Mizoram,Crime Against Children,Trafficking,Female,13-17,9978,1923,8055,6139,3839
2001,Rural,Tripura,Property Crime,Theft,Male,13-17,1061,474,587,545,516
2009,Urban,Bihar,Crime Against Women,Molestation,Male,46-60,2865,275,2590,1149,1716
2005,Urban,Uttarakhand,Crime Against Children,Child Abuse,Male,0-12,1576,1037,539,1369,207
2002,Urban,Odisha,Other Crimes,Corruption,Female,31-45,796,746,50,779,17
2001,Rural,Bihar,Other Crimes,Drug Offense,Male,60+,2260,352,1908,1316,944
2003,Urban,Kerala,Crime Against Women,Molestation,Female,46-60,5463,746,4717,4232,1231
2008,Urban,Meghalaya,Other Crimes,Cyber Crime,Female,60+,1209,527,682,825,384
2008,Urban,West Bengal,Property Crime,Theft,Male,31-45,9042,7399,1643,8919,123
2007,Urban,Rajasthan,Crime Against Children,Kidnapping,Male,13-17,5229,2148,3081,3854,1375
2008,Urban,Jharkhand,Crime Against Men,Murder,Female,18-30,7414,5484,1930,5813,1601
2009,Urban,Assam,Crime Against Men,Murder,Female,18-30,7851,3030,4821,5944,1907
2005,Rural,Himachal Pradesh,Crime Against Women,Molestation,Male,13-17,5955,5538,417,5791,164
2008,Urban,Gujarat,Crime Against Women,Dowry Deaths,Male,0-12,728,172,556,289,439
2006,Rural,Tamil Nadu,Property Crime,Burglary,Male,46-60,7224,3713,3511,4619,2605
2006,Urban,West Bengal,Other Crimes,Drug Offense,Male,0-12,8885,1743,7142,3645,5240
2009,Rural,Manipur,Property Crime,Arson,Male,0-12,5475,480,4995,2759,2716
2009,Rural,Mizoram,Crime Against Women,Dowry Deaths,Male,60+,1600,278,1322,837,763
2010,Rural,West Bengal,Property Crime,Arson,Female,31-45,8508,342,8166,2661,5847
2003,Urban,Madhya Pradesh,Crime Against Children,Kidnapping,Male,60+,1556,841,715,1496,60
2010,Urban,Goa,Property Crime,Burglary,Female,13-17,4863,140,4723,2517,2346
2010,Rural,Kerala,Crime Against Women,Dowry Deaths,Female,0-12,9718,2885,6833,8844,874
2007,Urban,Nagaland,Crime Against Men,Assault,Female,46-60,215,192,23,206,9
2010,Urban,Haryana,Crime Against Women,Rape,Female,46-60,2786,949,1837,1059,1727
2001,Urban,Punjab,Property Crime,Arson,Male,46-60,8516,4075,4441,4448,4068
2005,Rural,Uttarakhand,Crime Against Men,Murder,Female,13-17,403,81,322,386,17
2010,Rural,Uttarakhand,Crime Against Women,Domestic Violence,Female,18-30,5062,2133,2929,4498,564
2009,Urban,Bihar,Crime Against Children,Child Labor,Female,31-45,7789,7383,406,7648,141
2002,Urban,Bihar,Property Crime,Vandalism,Male,18-30,7521,4134,3387,5024,2497
2009,Urban,Meghalaya,Other Crimes,Fraud,Male,13-17,7647,2887,4760,3252,4395
2010,Urban,Punjab,Other Crimes,Corruption,Male,18-30,4820,233,4587,2912,1908
2009,Urban,Mizoram,Crime Against Women,Dowry Deaths,Male,60+,5159,2897,2262,3562,1597
2002,Rural,Meghalaya,Crime Against Children,Kidnapping,Male,46-60,9328,4078,5250,6186,3142
2008,Urban,Chhattisgarh,Crime Against Men,Assault,Female,18-30,7974,4109,3865,4863,3111
2003,Rural,Rajasthan,Crime Against Men,Assault,Female,18-30,9848,3225,6623,9710,138
2007,Urban,Uttar Pradesh,Crime Against Men,Extortion,Male,60+,6171,4140,2031,5678,493
2008,Urban,Maharashtra,Other Crimes,Corruption,Male,18-30,1098,804,294,957,141
2001,Rural,Jharkhand,Other Crimes,Corruption,Male,46-60,1108,632,476,658,450
2009,Rural,Sikkim,Property Crime,Burglary,Female,46-60,5974,5938,36,5951,23
2001,Urban,Rajasthan,Crime Against Women,Domestic Violence,Male,18-30,5077,2087,2990,2299,2778
2010,Urban,Uttar Pradesh,Crime Against Children,Trafficking,Male,46-60,9140,2196,6944,5260,3880
2003,Rural,Maharashtra,Crime Against Women,Dowry Deaths,Male,31-45,7358,540,6818,2813,4545
2007,Urban,Jharkhand,Property Crime,Arson,Male,18-30,7050,3214,3836,4878,2172
2010,Rural,Himachal Pradesh,Other Crimes,Fraud,Male,0-12,247,171,76,244,3
2007,Rural,Tripura,Crime Against Women,Molestation,Male,13-17,3767,705,3062,2725,1042
2010,Urban,Karnataka,Crime Against Women,Domestic Violence,Female,18-30,1919,1746,173,1777,142
2007,Urban,Assam,Crime Against Women,Dowry Deaths,Male,18-30,4316,1594,2722,3554,762
2010,Urban,Odisha,Crime Against Men,Assault,Male,31-45,8613,6515,2098,8454,159
2006,Rural,Jharkhand,Crime Against Women,Rape,Male,31-45,9113,4442,4671,8398,715
2006,Rural,Mizoram,Property Crime,Arson,Male,18-30,2062,442,1620,1989,73
2006,Rural,Bihar,Property Crime,Arson,Female,18-30,9392,4396,4996,8132,1260
2005,Rural,Punjab,Crime Against Women,Domestic Violence,Male,31-45,9198,1006,8192,9141,57
2010,Urban,Odisha,Crime Against Men,Assault,Female,31-45,8909,3687,5222,7356,1553
2007,Urban,Uttarakhand,Property Crime,Vandalism,Female,0-12,1632,91,1541,284,1348
2003,Rural,Andhra Pradesh,Crime Against Children,Child Abuse,Female,60+,1153,449,704,764,389
2007,Rural,Bihar,Crime Against Children,Child Abuse,Female,0-12,4395,1592,2803,2712,1683
2008,Rural,Karnataka,Other Crimes,Cyber Crime,Female,13-17,1305,1036,269,1274,31
2001,Rural,Arunachal Pradesh,Crime Against Women,Rape,Female,31-45,324,240,84,252,72
2007,Rural,Telangana,Other Crimes,Fraud,Male,46-60,5825,750,5075,2980,2845
2005,Rural,Odisha,Crime Against Men,Robbery,Female,60+,1996,1668,328,1741,255
2009,Rural,Goa,Crime Against Children,Kidnapping,Male,60+,9938,9856,82,9856,82
2008,Rural,Telangana,Property Crime,Theft,Male,18-30,4112,1319,2793,3799,313
2009,Rural,West Bengal,Property Crime,Theft,Male,46-60,1308,1036,272,1067,241
2005,Rural,Meghalaya,Crime Against Children,Child Labor,Male,31-45,859,165,694,749,110
2004,Urban,Mizoram,Crime Against Women,Domestic Violence,Female,31-45,6669,5660,1009,6659,10
2006,Rural,Uttar Pradesh,Other Crimes,Drug Offense,Male,0-12,5129,1865,3264,2510,2619
2004,Urban,Himachal Pradesh,Other Crimes,Cyber Crime,Male,60+,9503,734,8769,5099,4404
2009,Rural,Maharashtra,Property Crime,Theft,Male,0-12,3602,2539,1063,2698,904
2002,Rural,Jammu & Kashmir,Property Crime,Arson,Female,0-12,2488,1632,856,2009,479
2007,Urban,Andhra Pradesh,Property Crime,Arson,Male,46-60,3886,3685,201,3722,164
2003,Rural,Tamil Nadu,Other Crimes,Cyber Crime,Female,0-12,3168,2787,381,3089,79
2009,Rural,Haryana,Property Crime,Theft,Male,18-30,734,662,72,712,22
2007,Rural,Assam,Crime Against Children,Trafficking,Female,0-12,6213,1260,4953,5045,1168
2003,Rural,Andhra Pradesh,Crime Against Women,Domestic Violence,Female,0-12,628,292,336,428,200
2009,Urban,Odisha,Crime Against Women,Molestation,Male,0-12,6291,5115,1176,5862,429
2003,Rural,Himachal Pradesh,Crime Against Women,Domestic Violence,Female,0-12,5671,2414,3257,5587,84
2008,Rural,Goa,Crime Against Men,Extortion,Male,13-17,7959,1314,6645,7006,953
2008,Rural,Andhra Pradesh,Property Crime,Theft,Female,31-45,7958,4447,3511,5475,2483
2006,Rural,Karnataka,Crime Against Children,Trafficking,Female,13-17,5351,4607,744,5022,329
2004,Urban,Tamil Nadu,Crime Against Women,Molestation,Male,0-12,7341,3993,3348,6392,949
2003,Urban,Tamil Nadu,Property Crime,Arson,Male,46-60,133,57,76,76,57
2005,Urban,Rajasthan,Crime Against Women,Molestation,Female,46-60,7115,5768,1347,6024,1091
2010,Rural,Arunachal Pradesh,Other Crimes,Drug Offense,Male,31-45,9347,9330,17,9336,11
2001,Urban,Meghalaya,Property Crime,Arson,Female,18-30,7045,5510,1535,6286,759
2003,Rural,Assam,Crime Against Women,Rape,Male,31-45,2198,623,1575,1403,795
2008,Rural,Uttar Pradesh,Other Crimes,Drug Offense,Male,0-12,5956,2588,3368,4508,1448
2003,Urban,Sikkim,Crime Against Children,Kidnapping,Male,13-17,3499,2828,671,3002,497
2004,Urban,Sikkim,Property Crime,Theft,Male,0-12,5477,1045,4432,1537,3940
2001,Urban,Madhya Pradesh,Crime Against Children,Child Abuse,Female,13-17,2506,1503,1003,2098,408
2010,Rural,West Bengal,Crime Against Women,Rape,Male,13-17,194,68,126,182,12
2007,Rural,Telangana,Crime Against Women,Molestation,Male,0-12,5564,1255,4309,4421,1143
2007,Rural,Sikkim,Crime Against Children,Kidnapping,Male,60+,2421,1216,1205,2018,403
2010,Urban,Arunachal Pradesh,Crime Against Men,Murder,Female,31-45,5491,4703,788,4732,759
2005,Rural,Himachal Pradesh,Other Crimes,Corruption,Male,13-17,9470,9211,259,9270,200
2005,Urban,Tripura,Property Crime,Arson,Male,60+,9945,9415,530,9501,444
2008,Rural,Telangana,Crime Against Women,Dowry Deaths,Female,18-30,2854,2479,375,2652,202
2006,Rural,Punjab,Crime Against Women,Molestation,Female,0-12,7376,6166,1210,6331,1045
2007,Urban,Bihar,Crime Against Children,Child Abuse,Female,31-45,4930,365,4565,1385,3545
2009,Rural,Himachal Pradesh,Crime Against Children,Trafficking,Male,60+,7010,4382,2628,4901,2109
2007,Urban,Sikkim,Other Crimes,Corruption,Female,13-17,5204,4324,880,4649,555
2007,Rural,Meghalaya,Crime Against Children,Kidnapping,Female,13-17,2584,570,2014,996,1588
2003,Urban,Jammu & Kashmir,Property Crime,Arson,Female,31-45,3993,1511,2482,2944,1049
2001,Urban,Odisha,Crime Against Women,Dowry Deaths,Female,46-60,5648,3117,2531,4984,664
2008,Rural,Uttarakhand,Crime Against Children,Kidnapping,Male,46-60,2859,779,2080,2373,486
2003,Rural,Odisha,Crime Against Women,Dowry Deaths,Male,13-17,7514,3922,3592,5019,2495
2005,Urban,Karnataka,Crime Against Children,Child Abuse,Female,0-12,523,522,1,522,1
2001,Rural,Maharashtra,Crime Against Women,Molestation,Female,31-45,6388,4640,1748,4944,1444
2010,Urban,Meghalaya,Crime Against Men,Extortion,Male,46-60,3284,554,2730,1930,1354
2008,Urban,Sikkim,Crime Against Men,Robbery,Female,60+,9795,3628,6167,8532,1263
2003,Rural,Uttar Pradesh,Crime Against Women,Domestic Violence,Male,46-60,4006,2038,1968,2986,1020
2006,Rural,Manipur,Crime Against Women,Dowry Deaths,Male,0-12,1892,1750,142,1803,89
2007,Rural,Himachal Pradesh,Crime Against Men,Extortion,Female,0-12,2468,520,1948,1573,895
2001,Rural,Jammu & Kashmir,Property Crime,Vandalism,Male,60+,9002,1707,7295,3930,5072
2003,Rural,Assam,Crime Against Women,Rape,Male,0-12,7061,920,6141,1270,5791
2003,Urban,Delhi,Property Crime,Arson,Male,18-30,9688,6252,3436,7361,2327
2010,Urban,West Bengal,Other Crimes,Fraud,Male,31-45,426,208,218,243,183
2002,Urban,Nagaland,Crime Against Men,Robbery,Male,0-12,5419,2656,2763,4906,513
2001,Rural,Meghalaya,Other Crimes,Drug Offense,Female,0-12,8492,2272,6220,6970,1522
2003,Urban,Tamil Nadu,Other Crimes,Corruption,Male,60+,7694,4036,3658,5301,2393
2006,Rural,Andhra Pradesh,Crime Against Women,Rape,Female,18-30,894,211,683,515,379
2002,Urban,Haryana,Crime Against Men,Murder,Female,46-60,6981,4052,2929,6493,488
2006,Urban,Manipur,Crime Against Women,Domestic Violence,Female,13-17,6258,3512,2746,6101,157
2002,Rural,Punjab,Other Crimes,Drug Offense,Female,60+,1398,813,585,1026,372
2005,Rural,Manipur,Crime Against Women,Molestation,Male,60+,4123,3564,559,3894,229
2001,Urban,Arunachal Pradesh,Property Crime,Burglary,Male,13-17,2269,814,1455,1756,513
2009,Urban,Kerala,Crime Against Men,Extortion,Female,31-45,718,699,19,713,5
2001,Urban,Gujarat,Crime Against Children,Kidnapping,Male,13-17,5983,5011,972,5979,4
2005,Urban,Gujarat,Crime Against Women,Molestation,Female,60+,6839,1590,5249,6084,755
2001,Rural,Manipur,Other Crimes,Drug Offense,Female,18-30,4864,2202,2662,2639,2225
2007,Rural,Sikkim,Crime Against Children,Child Labor,Female,31-45,9415,34,9381,6580,2835
2008,Urban,Telangana,Crime Against Men,Extortion,Female,13-17,1602,1281,321,1495,107
2001,Rural,Andhra Pradesh,Crime Against Men,Extortion,Female,31-45,5408,4162,1246,4185,1223
2002,Urban,Sikkim,Crime Against Children,Child Abuse,Female,18-30,9564,1343,8221,2529,7035
2004,Urban,Uttarakhand,Crime Against Men,Assault,Male,13-17,1008,280,728,324,684
2006,Rural,Punjab,Crime Against Men,Extortion,Female,13-17,5497,3794,1703,4906,591
2003,Rural,Madhya Pradesh,Crime Against Men,Extortion,Female,0-12,746,53,693,680,66
2001,Urban,Maharashtra,Crime Against Men,Murder,Male,18-30,8929,7295,1634,8570,359
2002,Urban,Karnataka,Crime Against Men,Extortion,Female,60+,1336,642,694,959,377
2010,Urban,Uttarakhand,Crime Against Children,Trafficking,Female,13-17,4613,3361,1252,4328,285
2008,Rural,Kerala,Crime Against Children,Child Abuse,Female,0-12,6766,4194,2572,6186,580
2006,Urban,Punjab,Crime Against Men,Murder,Female,46-60,2940,1204,1736,1296,1644
2010,Rural,Punjab,Other Crimes,Fraud,Male,18-30,3039,3026,13,3037,2
2002,Urban,Mizoram,Crime Against Children,Kidnapping,Female,31-45,5792,4003,1789,5045,747
2007,Rural,Chhattisgarh,Property Crime,Burglary,Female,31-45,6285,22,6263,1692,4593
2004,Urban,Meghalaya,Crime Against Men,Extortion,Male,46-60,2130,985,1145,1981,149
2008,Rural,Assam,Property Crime,Vandalism,Female,31-45,2049,1116,933,1970,79
2005,Rural,Andhra Pradesh,Crime Against Women,Rape,Female,18-30,9447,1428,8019,2691,6756
2001,Rural,West Bengal,Property Crime,Arson,Male,0-12,6107,1002,5105,4584,1523
2004,Rural,Telangana,Other Crimes,Drug Offense,Male,0-12,2909,178,2731,2516,393
2003,Rural,Uttarakhand,Crime Against Men,Extortion,Female,60+,7482,3277,4205,3305,4177
2006,Rural,Sikkim,Crime Against Women,Domestic Violence,Female,13-17,8545,7612,933,7986,559
2002,Urban,Maharashtra,Crime Against Men,Assault,Female,31-45,4280,890,3390,2019,2261
2009,Urban,Andhra Pradesh,Crime Against Children,Kidnapping,Female,46-60,7105,4725,2380,5915,1190
2001,Rural,Jammu & Kashmir,Crime Against Women,Rape,Male,60+,4090,3197,893,3794,296
2004,Urban,Manipur,Crime Against Men,Murder,Female,46-60,297,26,271,206,91
2004,Urban,Arunachal Pradesh,Property Crime,Burglary,Female,0-12,9417,4773,4644,8866,551
2008,Rural,Kerala,Crime Against Children,Child Labor,Female,31-45,6122,3388,2734,3804,2318
2004,Rural,Jammu & Kashmir,Crime Against Men,Extortion,Female,46-60,8410,2907,5503,7640,770
2006,Rural,Manipur,Other Crimes,Fraud,Female,18-30,7553,1303,6250,5513,2040
2008,Rural,Madhya Pradesh,Crime Against Men,Extortion,Male,60+,1657,580,1077,1121,536
2002,Rural,Tripura,Crime Against Men,Murder,Female,60+,9223,6710,2513,7326,1897
2004,Rural,Nagaland,Other Crimes,Fraud,Male,46-60,2131,536,1595,779,1352
2010,Urban,Tripura,Crime Against Men,Robbery,Male,46-60,3825,3645,180,3804,21
2010,Rural,Tamil Nadu,Crime Against Children,Kidnapping,Male,0-12,9407,6826,2581,6889,2518
2006,Rural,Rajasthan,Other Crimes,Fraud,Female,0-12,9210,216,8994,824,8386
2007,Rural,Chhattisgarh,Other Crimes,Cyber Crime,Male,60+,8551,6440,2111,8391,160
2010,Rural,Uttarakhand,Crime Against Men,Extortion,Male,18-30,1549,229,1320,662,887
2004,Rural,Uttar Pradesh,Other Crimes,Cyber Crime,Male,31-45,2147,493,1654,1432,715
2004,Rural,Andhra Pradesh,Other Crimes,Cyber Crime,Female,13-17,4212,4169,43,4174,38
2004,Rural,Punjab,Crime Against Men,Extortion,Female,46-60,3458,2209,1249,2651,807
2010,Rural,Odisha,Crime Against Women,Molestation,Female,60+,8132,1537,6595,4672,3460
2003,Urban,Jharkhand,Crime Against Men,Extortion,Male,18-30,3602,2826,776,3328,274
2004,Urban,Uttarakhand,Other Crimes,Drug Offense,Female,0-12,2676,1115,1561,1400,1276
2003,Urban,Jharkhand,Crime Against Women,Molestation,Male,60+,6147,2338,3809,3529,2618
2001,Rural,Tamil Nadu,Crime Against Women,Molestation,Female,31-45,6068,4373,1695,5871,197
2006,Urban,Jammu & Kashmir,Other Crimes,Cyber Crime,Female,46-60,7679,7548,131,7597,82
2001,Rural,Himachal Pradesh,Property Crime,Vandalism,Female,18-30,2797,1517,1280,2300,497
2001,Rural,Madhya Pradesh,Crime Against Women,Domestic Violence,Male,13-17,5749,756,4993,2979,2770
2004,Rural,Manipur,Property Crime,Burglary,Female,31-45,4982,4832,150,4931,51
2007,Urban,Tamil Nadu,Crime Against Children,Kidnapping,Male,60+,3980,1703,2277,2833,1147
2008,Urban,Uttar Pradesh,Crime Against Children,Kidnapping,Female,0-12,2978,2157,821,2794,184
2008,Urban,West Bengal,Other Crimes,Corruption,Female,31-45,2300,1349,951,1771,529
2005,Rural,Bihar,Property Crime,Theft,Female,13-17,1097,792,305,792,305
2009,Rural,Odisha,Crime Against Children,Kidnapping,Male,31-45,4161,2878,1283,3712,449
2005,Rural,Arunachal Pradesh,Crime Against Men,Extortion,Male,46-60,8849,6492,2357,8233,616
2001,Rural,Odisha,Property Crime,Theft,Male,13-17,6982,2257,4725,2990,3992
2010,Rural,Bihar,Other Crimes,Corruption,Female,31-45,3708,148,3560,2677,1031
2006,Urban,Goa,Crime Against Women,Domestic Violence,Female,18-30,6408,3211,3197,5512,896
2008,Urban,Sikkim,Crime Against Children,Kidnapping,Female,31-45,432,155,277,418,14
2010,Urban,Kerala,Crime Against Women,Dowry Deaths,Female,60+,3270,1298,1972,2903,367
2001,Urban,Sikkim,Crime Against Men,Extortion,Male,31-45,8457,5359,3098,5451,3006
2007,Urban,Andhra Pradesh,Crime Against Women,Dowry Deaths,Female,46-60,2378,1129,1249,2072,306
2009,Rural,Haryana,Crime Against Women,Molestation,Male,18-30,4689,486,4203,1378,3311
2004,Urban,Andhra Pradesh,Crime Against Women,Dowry Deaths,Female,13-17,6842,2315,4527,4710,2132
2010,Urban,West Bengal,Crime Against Children,Kidnapping,Female,60+,7998,2271,5727,6519,1479
2009,Urban,Rajasthan,Crime Against Men,Extortion,Male,0-12,6268,5519,749,5894,374
2009,Rural,Tripura,Property Crime,Vandalism,Male,18-30,5962,2679,3283,5850,112
2002,Urban,Himachal Pradesh,Crime Against Women,Domestic Violence,Female,0-12,1809,148,1661,824,985
2010,Rural,Uttar Pradesh,Crime Against Men,Murder,Male,13-17,865,342,523,844,21
2003,Rural,Himachal Pradesh,Property Crime,Theft,Male,46-60,2464,1961,503,2021,443
2010,Rural,Chhattisgarh,Other Crimes,Drug Offense,Male,31-45,6207,1803,4404,2289,3918
2008,Rural,West Bengal,Other Crimes,Cyber Crime,Male,46-60,8784,5087,3697,6388,2396
2009,Urban,Jharkhand,Other Crimes,Cyber Crime,Male,0-12,3451,143,3308,3275,176
2010,Rural,Karnataka,Property Crime,Burglary,Male,13-17,6519,4967,1552,5811,708
2008,Urban,West Bengal,Other Crimes,Cyber Crime,Male,0-12,2139,2064,75,2126,13
2010,Urban,Meghalaya,Other Crimes,Cyber Crime,Male,13-17,9176,2700,6476,5602,3574
2004,Rural,Manipur,Crime Against Children,Kidnapping,Male,0-12,1416,828,588,1222,194
2001,Urban,Assam,Crime Against Men,Robbery,Female,13-17,8118,6020,2098,7193,925
2010,Rural,Delhi,Crime Against Men,Murder,Female,60+,8073,467,7606,4415,3658
2002,Rural,West Bengal,Crime Against Men,Murder,Female,46-60,9301,4974,4327,7846,1455
2003,Urban,Haryana,Other Crimes,Corruption,Female,60+,4769,1950,2819,2993,1776
2007,Rural,Jammu & Kashmir,Other Crimes,Corruption,Male,31-45,4090,3135,955,3736,354
2002,Rural,Nagaland,Other Crimes,Corruption,Male,18-30,6671,6191,480,6276,395
2007,Rural,Arunachal Pradesh,Crime Against Women,Dowry Deaths,Female,0-12,5496,366,5130,3853,1643
2005,Rural,Chhattisgarh,Property Crime,Burglary,Female,13-17,448,144,304,444,4
2005,Urban,Tripura,Property Crime,Arson,Female,31-45,6344,3925,2419,6318,26
2006,Rural,Andhra Pradesh,Other Crimes,Fraud,Male,0-12,4403,1250,3153,1579,2824
2008,Urban,Tamil Nadu,Property Crime,Burglary,Male,0-12,7437,6,7431,3834,3603
2010,Rural,Gujarat,Crime Against Men,Assault,Male,31-45,1728,398,1330,1338,390
2005,Urban,Punjab,Property Crime,Burglary,Female,0-12,5648,1836,3812,3203,2445
2005,Urban,Meghalaya,Crime Against Children,Child Labor,Female,18-30,6847,1389,5458,3294,3553
2008,Urban,Punjab,Other Crimes,Fraud,Female,18-30,2788,1592,1196,2746,42
2009,Urban,Nagaland,Crime Against Women,Domestic Violence,Male,60+,3223,2,3221,2327,896
2003,Urban,Jharkhand,Crime Against Children,Kidnapping,Male,46-60,5143,2897,2246,3172,1971
2003,Urban,Andhra Pradesh,Other Crimes,Corruption,Male,13-17,5898,436,5462,3399,2499
2010,Urban,Andhra Pradesh,Crime Against Men,Robbery,Female,0-12,2275,637,1638,1627,648
2006,Urban,Chhattisgarh,Crime Against Men,Robbery,Female,18-30,2426,965,1461,1906,520
2006,Urban,Uttar Pradesh,Property Crime,Burglary,Male,18-30,9271,1520,7751,1709,7562
2004,Rural,Karnataka,Crime Against Men,Assault,Female,46-60,2262,1735,527,2006,256
2002,Urban,Gujarat,Crime Against Children,Kidnapping,Male,46-60,4905,3812,1093,4545,360
2009,Rural,Arunachal Pradesh,Crime Against Children,Child Abuse,Female,13-17,1192,923,269,1110,82
2001,Urban,Andhra Pradesh,Crime Against Children,Child Abuse,Female,60+,5045,3773,1272,4369,676
2001,Rural,Uttar Pradesh,Property Crime,Theft,Female,0-12,6096,4837,1259,5298,798
2006,Urban,Arunachal Pradesh,Other Crimes,Corruption,Male,31-45,8008,1637,6371,2648,5360
2003,Urban,Arunachal Pradesh,Property Crime,Theft,Male,60+,1297,109,1188,898,399
2003,Urban,Sikkim,Property Crime,Burglary,Female,31-45,7867,2453,5414,7444,423
2009,Urban,Manipur,Crime Against Men,Robbery,Female,60+,999,887,112,961,38
2006,Urban,Jharkhand,Crime Against Children,Kidnapping,Female,0-12,3614,1045,2569,1191,2423
2009,Rural,Andhra Pradesh,Property Crime,Arson,Male,13-17,67,57,10,65,2
2004,Rural,Nagaland,Crime Against Men,Robbery,Female,46-60,3490,2826,664,2882,608
2004,Rural,Uttar Pradesh,Property Crime,Burglary,Female,46-60,7148,4489,2659,6735,413
2004,Rural,Jammu & Kashmir,Crime Against Men,Assault,Male,60+,3961,238,3723,1083,2878
2010,Urban,Arunachal Pradesh,Crime Against Women,Molestation,Male,46-60,4198,4105,93,4143,55
2007,Rural,Assam,Crime Against Children,Child Abuse,Male,0-12,6691,4222,2469,4312,2379
2009,Rural,Delhi,Crime Against Men,Murder,Female,60+,9370,5336,4034,6695,2675
2005,Urban,Nagaland,Crime Against Men,Extortion,Male,31-45,219,84,135,100,119
2001,Urban,Jharkhand,Other Crimes,Drug Offense,Male,31-45,7742,814,6928,3353,4389
2004,Urban,Manipur,Crime Against Men,Murder,Male,13-17,1899,1828,71,1875,24
2005,Rural,Goa,Crime Against Women,Dowry Deaths,Female,13-17,8626,1707,6919,6147,2479
2006,Rural,Punjab,Other Crimes,Drug Offense,Female,60+,8963,7117,1846,7355,1608
2007,Urban,Telangana,Crime Against Men,Robbery,Female,0-12,4819,331,4488,988,3831
2004,Rural,Haryana,Other Crimes,Corruption,Female,60+,422,61,361,338,84
2008,Rural,Punjab,Crime Against Children,Child Abuse,Male,0-12,8389,2736,5653,6505,1884
2001,Urban,Arunachal Pradesh,Property Crime,Arson,Female,60+,7899,2501,5398,2784,5115
2007,Urban,Jammu & Kashmir,Crime Against Men,Assault,Male,46-60,9581,5025,4556,8012,1569
2006,Rural,Manipur,Property Crime,Theft,Male,18-30,3626,2187,1439,3415,211
2005,Rural,Telangana,Crime Against Children,Child Abuse,Male,13-17,9900,2809,7091,5143,4757
2005,Urban,Andhra Pradesh,Crime Against Men,Murder,Female,46-60,5284,3036,2248,5123,161
2003,Rural,West Bengal,Property Crime,Burglary,Male,0-12,3617,747,2870,3466,151
2004,Rural,Jharkhand,Crime Against Children,Kidnapping,Male,13-17,7951,4950,3001,6328,1623
2009,Rural,Goa,Crime Against Women,Dowry Deaths,Male,60+,2974,1319,1655,1742,1232
2008,Rural,Rajasthan,Crime Against Children,Child Labor,Female,18-30,6275,5444,831,5627,648
2004,Urban,Himachal Pradesh,Other Crimes,Fraud,Female,0-12,1630,511,1119,941,689
2008,Rural,Mizoram,Crime Against Men,Murder,Female,31-45,3959,1384,2575,3525,434
2006,Rural,Assam,Property Crime,Vandalism,Male,13-17,8089,5674,2415,6191,1898
2006,Rural,Mizoram,Crime Against Women,Domestic Violence,Male,46-60,8516,7660,856,8450,66
2009,Rural,Uttar Pradesh,Crime Against Children,Child Abuse,Male,60+,1826,943,883,1463,363
2007,Urban,Nagaland,Crime Against Men,Extortion,Female,60+,4431,1970,2461,1980,2451
2007,Rural,Odisha,Property Crime,Vandalism,Female,18-30,2772,2206,566,2398,374
2005,Rural,Uttarakhand,Property Crime,Theft,Male,0-12,6166,3818,2348,4010,2156
2010,Rural,Karnataka,Crime Against Men,Murder,Male,31-45,5679,1616,4063,3693,1986
2003,Rural,Assam,Other Crimes,Fraud,Male,0-12,8833,3657,5176,6000,2833
2007,Urban,Nagaland,Crime Against Children,Child Abuse,Female,0-12,6492,3116,3376,6436,56
2003,Rural,Telangana,Crime Against Women,Rape,Female,31-45,5693,1654,4039,4868,825
2004,Urban,Punjab,Crime Against Children,Child Abuse,Female,0-12,306,112,194,134,172
2003,Urban,Sikkim,Crime Against Men,Robbery,Female,0-12,4491,57,4434,4198,293
2010,Urban,Uttar Pradesh,Crime Against Women,Rape,Male,0-12,2409,840,1569,1414,995
2007,Rural,Chhattisgarh,Crime Against Children,Kidnapping,Male,0-12,7406,3954,3452,6863,543
2007,Urban,Tamil Nadu,Property Crime,Vandalism,Male,60+,7469,7175,294,7425,44
2007,Rural,Karnataka,Property Crime,Burglary,Male,46-60,9505,7443,2062,7878,1627
2008,Urban,Odisha,Property Crime,Vandalism,Male,13-17,1272,458,814,657,615
2006,Rural,Kerala,Other Crimes,Corruption,Female,31-45,5341,2753,2588,4966,375
2010,Rural,Uttar Pradesh,Crime Against Men,Extortion,Female,18-30,3298,1605,1693,2005,1293
2004,Rural,Tripura,Other Crimes,Drug Offense,Male,13-17,1174,869,305,1057,117
2002,Rural,Haryana,Crime Against Women,Molestation,Male,18-30,6823,3212,3611,4814,2009
2008,Rural,Punjab,Crime Against Children,Child Labor,Male,31-45,9496,6755,2741,7841,1655
2005,Rural,Jharkhand,Crime Against Women,Molestation,Female,13-17,4900,439,4461,1555,3345
2004,Rural,Tripura,Other Crimes,Fraud,Male,60+,7251,6047,1204,6271,980
2008,Rural,Arunachal Pradesh,Other Crimes,Drug Offense,Male,18-30,2164,1139,1025,1894,270
2007,Urban,Telangana,Crime Against Women,Dowry Deaths,Female,13-17,6213,2481,3732,5573,640
2002,Urban,Haryana,Other Crimes,Drug Offense,Male,18-30,1968,1147,821,1739,229
2002,Rural,Nagaland,Crime Against Children,Kidnapping,Female,60+,7050,6348,702,6465,585
2006,Urban,Manipur,Crime Against Children,Trafficking,Female,18-30,3194,888,2306,2271,923
2004,Rural,Madhya Pradesh,Crime Against Women,Rape,Male,18-30,7319,3838,3481,6862,457
2007,Rural,Tripura,Property Crime,Arson,Male,13-17,9938,3198,6740,5208,4730
2001,Rural,Andhra Pradesh,Crime Against Men,Murder,Male,0-12,3471,3041,430,3106,365
2003,Rural,Telangana,Crime Against Men,Assault,Male,13-17,3919,801,3118,1930,1989
2010,Rural,Nagaland,Property Crime,Theft,Male,18-30,2270,1418,852,1917,353
2002,Rural,Gujarat,Property Crime,Arson,Male,46-60,9258,2465,6793,6173,3085
2004,Urban,Meghalaya,Crime Against Children,Kidnapping,Male,60+,1120,113,1007,947,173
2007,Rural,Mizoram,Crime Against Men,Extortion,Male,46-60,1866,1353,513,1802,64
2003,Urban,Delhi,Crime Against Women,Domestic Violence,Female,13-17,9269,1656,7613,7138,2131
2001,Rural,Assam,Property Crime,Theft,Female,46-60,8478,1477,7001,1926,6552
2006,Rural,Himachal Pradesh,Property Crime,Arson,Male,46-60,8177,5924,2253,6053,2124
2007,Urban,West Bengal,Crime Against Women,Rape,Female,13-17,9666,395,9271,3771,5895
2004,Urban,Meghalaya,Crime Against Men,Extortion,Male,31-45,8652,35,8617,5171,3481
2009,Rural,Jammu & Kashmir,Crime Against Men,Extortion,Female,31-45,9717,4509,5208,7016,2701
2009,Rural,Kerala,Property Crime,Vandalism,Female,13-17,6308,901,5407,3028,3280
2003,Urban,Manipur,Crime Against Children,Trafficking,Female,31-45,3137,912,2225,2224,913
2005,Rural,Tamil Nadu,Crime Against Women,Rape,Female,46-60,2876,1358,1518,1573,1303
2009,Rural,Telangana,Other Crimes,Drug Offense,Female,31-45,7983,365,7618,3869,4114
2004,Urban,Karnataka,Other Crimes,Drug Offense,Female,0-12,9110,6576,2534,8762,348
2006,Rural,Himachal Pradesh,Crime Against Women,Dowry Deaths,Female,46-60,1221,1104,117,1186,35
2006,Rural,Telangana,Property Crime,Theft,Male,60+,7914,2385,5529,3494,4420
2010,Urban,Andhra Pradesh,Crime Against Women,Domestic Violence,Male,18-30,9205,4062,5143,7496,1709
2003,Rural,Tamil Nadu,Crime Against Men,Extortion,Male,31-45,2730,2012,718,2470,260
2010,Urban,Karnataka,Crime Against Women,Rape,Female,0-12,9127,2798,6329,5793,3334
2010,Rural,Kerala,Crime Against Men,Assault,Male,60+,2190,2040,150,2161,29
2005,Urban,Chhattisgarh,Other Crimes,Corruption,Female,13-17,8121,6890,1231,7175,946
2003,Rural,Madhya Pradesh,Crime Against Children,Child Abuse,Female,46-60,8163,7887,276,8155,8
2001,Rural,Bihar,Crime Against Women,Dowry Deaths,Male,46-60,5132,266,4866,1621,3511
2001,Urban,Kerala,Crime Against Children,Child Labor,Male,31-45,4442,3554,888,4138,304
2006,Urban,Rajasthan,Property Crime,Theft,Female,0-12,4976,219,4757,1478,3498
2001,Rural,Madhya Pradesh,Crime Against Women,Rape,Male,0-12,5865,1145,4720,3782,2083
2010,Rural,Chhattisgarh,Crime Against Children,Trafficking,Female,46-60,354,151,203,322,32
2004,Urban,Telangana,Property Crime,Arson,Male,46-60,3499,2709,790,3293,206
2009,Urban,Manipur,Crime Against Children,Kidnapping,Male,18-30,9856,7124,2732,9526,330
2003,Urban,Mizoram,Crime Against Men,Robbery,Male,13-17,2894,2036,858,2491,403
2009,Rural,Arunachal Pradesh,Other Crimes,Cyber Crime,Male,0-12,9585,1270,8315,6075,3510
2010,Rural,Punjab,Crime Against Men,Murder,Female,0-12,450,375,75,391,59
2007,Rural,Rajasthan,Crime Against Children,Child Abuse,Female,60+,1899,198,1701,861,1038
2008,Rural,Sikkim,Crime Against Men,Murder,Male,13-17,7456,62,7394,607,6849
2005,Urban,Andhra Pradesh,Crime Against Children,Child Labor,Female,46-60,9301,1895,7406,7305,1996
2001,Urban,Nagaland,Crime Against Women,Dowry Deaths,Female,13-17,2792,452,2340,682,2110
2007,Urban,Assam,Other Crimes,Drug Offense,Male,31-45,7350,5505,1845,6191,1159
2005,Urban,Rajasthan,Property Crime,Vandalism,Female,18-30,953,674,279,872,81
2007,Rural,Tripura,Other Crimes,Drug Offense,Male,0-12,9557,8033,1524,8906,651
2010,Urban,Andhra Pradesh,Property Crime,Burglary,Male,60+,3616,2128,1488,3543,73
2007,Rural,Uttar Pradesh,Crime Against Women,Molestation,Male,46-60,9481,1575,7906,5858,3623
2008,Rural,Tamil Nadu,Other Crimes,Corruption,Female,60+,8121,5169,2952,5901,2220
2008,Urban,Odisha,Crime Against Children,Child Labor,Male,31-45,221,75,146,88,133
2004,Rural,Tamil Nadu,Crime Against Women,Dowry Deaths,Female,18-30,7837,7018,819,7738,99
2002,Rural,Punjab,Crime Against Children,Trafficking,Female,60+,9053,1169,7884,8364,689
2006,Rural,Kerala,Property Crime,Arson,Male,46-60,4384,775,3609,3984,400
2005,Urban,Gujarat,Crime Against Women,Molestation,Male,18-30,5510,2535,2975,5488,22
2001,Urban,Manipur,Crime Against Children,Trafficking,Female,18-30,5862,1464,4398,3730,2132
2006,Urban,Uttar Pradesh,Crime Against Children,Kidnapping,Male,13-17,6659,3304,3355,5374,1285
2007,Urban,Delhi,Crime Against Men,Extortion,Female,13-17,2450,596,1854,666,1784
2007,Urban,Bihar,Crime Against Men,Robbery,Male,13-17,678,26,652,440,238
2004,Rural,Madhya Pradesh,Crime Against Children,Trafficking,Male,18-30,2871,1257,1614,2417,454
2008,Rural,West Bengal,Crime Against Women,Dowry Deaths,Male,18-30,2130,2026,104,2118,12
2006,Rural,Odisha,Crime Against Women,Dowry Deaths,Male,18-30,7883,4597,3286,6663,1220
2001,Urban,Manipur,Other Crimes,Drug Offense,Female,60+,5943,2119,3824,2685,3258
2002,Rural,West Bengal,Crime Against Women,Domestic Violence,Male,60+,570,10,560,251,319
2001,Urban,Himachal Pradesh,Other Crimes,Corruption,Male,31-45,8233,5399,2834,6676,1557
2005,Rural,Arunachal Pradesh,Other Crimes,Cyber Crime,Female,0-12,7614,4045,3569,7390,224
2006,Urban,Arunachal Pradesh,Crime Against Children,Kidnapping,Male,46-60,6454,3183,3271,6169,285
2003,Rural,Telangana,Crime Against Men,Murder,Male,31-45,1092,589,503,799,293
2007,Urban,Andhra Pradesh,Crime Against Men,Robbery,Female,13-17,6729,578,6151,3619,3110
2001,Urban,Maharashtra,Crime Against Men,Robbery,Female,13-17,3230,2426,804,3045,185
2001,Rural,Kerala,Crime Against Children,Trafficking,Male,31-45,5945,3192,2753,5214,731
2004,Rural,Karnataka,Property Crime,Theft,Male,46-60,6765,6281,484,6568,197
2006,Urban,Gujarat,Crime Against Children,Trafficking,Female,60+,9632,2573,7059,2927,6705
2004,Urban,Nagaland,Crime Against Children,Kidnapping,Male,18-30,4414,1829,2585,2584,1830
2006,Rural,Andhra Pradesh,Crime Against Men,Murder,Male,0-12,3126,2737,389,3083,43
2006,Rural,West Bengal,Crime Against Children,Kidnapping,Male,60+,205,26,179,188,17
2001,Urban,Sikkim,Crime Against Men,Assault,Male,31-45,1872,136,1736,938,934
2008,Rural,Rajasthan,Crime Against Men,Assault,Male,31-45,5924,780,5144,5427,497
2008,Rural,Mizoram,Crime Against Men,Assault,Female,31-45,2987,2966,21,2970,17
2006,Urban,Tripura,Other Crimes,Corruption,Female,31-45,5848,4827,1021,5073,775
2002,Urban,Tamil Nadu,Other Crimes,Drug Offense,Female,13-17,1849,210,1639,1121,728
2007,Rural,West Bengal,Property Crime,Burglary,Male,60+,1678,361,1317,1168,510
2009,Rural,Odisha,Other Crimes,Corruption,Male,18-30,6342,4569,1773,4720,1622
2001,Urban,Goa,Other Crimes,Fraud,Male,0-12,2796,92,2704,2548,248
2003,Rural,Arunachal Pradesh,Crime Against Children,Child Abuse,Female,46-60,1224,273,951,571,653
2005,Rural,Uttarakhand,Crime Against Women,Domestic Violence,Female,60+,7294,6817,477,7212,82
2002,Rural,Madhya Pradesh,Crime Against Men,Assault,Female,31-45,9834,1461,8373,3354,6480
2010,Urban,Tamil Nadu,Crime Against Women,Molestation,Female,46-60,4164,264,3900,2294,1870
2008,Urban,Maharashtra,Property Crime,Arson,Female,31-45,4885,936,3949,3534,1351
2009,Rural,Odisha,Crime Against Men,Robbery,Male,60+,7531,5811,1720,5828,1703
2004,Urban,Goa,Crime Against Children,Child Labor,Male,46-60,7638,2251,5387,7315,323
2001,Urban,Uttar Pradesh,Crime Against Children,Kidnapping,Female,60+,9331,5196,4135,6538,2793
2001,Urban,Arunachal Pradesh,Other Crimes,Fraud,Female,60+,8896,5124,3772,5595,3301
2009,Urban,Uttarakhand,Crime Against Children,Kidnapping,Male,13-17,8919,164,8755,5307,3612
2010,Urban,Maharashtra,Property Crime,Burglary,Female,18-30,1412,1300,112,1382,30
2005,Urban,Gujarat,Property Crime,Burglary,Male,31-45,8333,7686,647,7993,340
2009,Rural,Chhattisgarh,Property Crime,Vandalism,Male,60+,6371,1564,4807,4701,1670
2005,Urban,Kerala,Other Crimes,Corruption,Male,31-45,1972,932,1040,1080,892
2001,Rural,Haryana,Property Crime,Arson,Male,46-60,3242,1620,1622,2089,1153
2005,Urban,Sikkim,Other Crimes,Corruption,Male,46-60,7717,2267,5450,4866,2851
2003,Rural,Maharashtra,Property Crime,Burglary,Female,18-30,7176,2813,4363,4863,2313
2008,Rural,Jharkhand,Crime Against Children,Child Labor,Male,60+,8531,6505,2026,8385,146
2006,Rural,Uttarakhand,Property Crime,Arson,Female,60+,7123,5084,2039,6132,991
2007,Urban,Arunachal Pradesh,Other Crimes,Drug Offense,Male,0-12,2109,866,1243,1857,252
2010,Rural,Himachal Pradesh,Property Crime,Burglary,Male,31-45,612,461,151,594,18
2002,Rural,Madhya Pradesh,Crime Against Women,Rape,Female,13-17,630,188,442,215,415
2009,Rural,Telangana,Property Crime,Vandalism,Male,31-45,710,584,126,589,121
2002,Rural,Odisha,Other Crimes,Corruption,Female,46-60,4894,2034,2860,2154,2740
2007,Urban,Andhra Pradesh,Crime Against Men,Robbery,Male,60+,2742,1659,1083,1852,890
2001,Rural,Manipur,Crime Against Children,Child Labor,Male,31-45,9703,7506,2197,7523,2180
2003,Rural,Bihar,Crime Against Men,Robbery,Male,60+,3628,88,3540,3510,118
2007,Urban,Kerala,Crime Against Women,Dowry Deaths,Female,0-12,6217,1114,5103,2498,3719
2010,Rural,Goa,Crime Against Women,Molestation,Female,31-45,6791,5750,1041,6285,506
2007,Rural,Sikkim,Crime Against Women,Rape,Female,60+,9450,458,8992,8172,1278
2002,Urban,West Bengal,Crime Against Women,Molestation,Female,13-17,1128,966,162,1034,94
2009,Rural,Manipur,Other Crimes,Fraud,Female,60+,353,132,221,212,141
2005,Rural,Rajasthan,Crime Against Men,Assault,Female,60+,2184,1296,888,1377,807
2001,Urban,Madhya Pradesh,Crime Against Men,Murder,Male,13-17,2110,1890,220,2015,95
2004,Urban,Andhra Pradesh,Other Crimes,Fraud,Male,18-30,3980,935,3045,3260,720
2007,Urban,Goa,Crime Against Women,Molestation,Male,31-45,8396,2146,6250,7003,1393
2006,Urban,Rajasthan,Crime Against Children,Kidnapping,Male,31-45,9967,4448,5519,8011,1956
2007,Urban,Goa,Other Crimes,Corruption,Female,46-60,2910,484,2426,859,2051
2007,Rural,Telangana,Property Crime,Burglary,Female,18-30,2061,1612,449,1965,96
2004,Urban,Uttarakhand,Property Crime,Arson,Male,18-30,9565,7628,1937,7669,1896
2005,Urban,Mizoram,Crime Against Women,Domestic Violence,Male,60+,164,160,4,160,4
2003,Rural,Jammu & Kashmir,Crime Against Children,Trafficking,Female,31-45,4079,3259,820,3978,101
2006,Rural,Nagaland,Crime Against Children,Child Labor,Male,60+,1848,277,1571,445,1403
2003,Rural,Nagaland,Property Crime,Vandalism,Female,46-60,9324,8429,895,8741,583
2006,Rural,Rajasthan,Property Crime,Theft,Female,46-60,8830,5263,3567,6218,2612
2001,Urban,Bihar,Crime Against Children,Kidnapping,Female,60+,7852,2049,5803,5475,2377
2003,Urban,Uttar Pradesh,Crime Against Children,Child Abuse,Female,13-17,4763,2711,2052,4326,437
2003,Rural,Sikkim,Crime Against Women,Molestation,Male,0-12,8471,6182,2289,6562,1909
2008,Rural,Assam,Other Crimes,Drug Offense,Female,46-60,6468,3423,3045,5052,1416
2004,Urban,Haryana,Crime Against Men,Assault,Female,18-30,9618,9253,365,9261,357
2007,Urban,Himachal Pradesh,Property Crime,Theft,Male,31-45,6282,1841,4441,4861,1421
2002,Urban,Andhra Pradesh,Crime Against Women,Domestic Violence,Male,31-45,4289,2161,2128,3818,471
2009,Urban,Tripura,Crime Against Children,Child Labor,Male,46-60,1280,242,1038,498,782
2010,Rural,West Bengal,Other Crimes,Cyber Crime,Male,0-12,4919,1777,3142,4222,697
2007,Rural,Bihar,Crime Against Women,Dowry Deaths,Female,46-60,4640,1498,3142,3270,1370
2004,Urban,Jammu & Kashmir,Crime Against Men,Assault,Female,18-30,2868,1434,1434,2207,661
2006,Rural,Assam,Other Crimes,Drug Offense,Female,0-12,1905,1605,300,1846,59
2003,Urban,Bihar,Other Crimes,Drug Offense,Female,31-45,237,217,20,227,10
2006,Urban,Jharkhand,Crime Against Women,Domestic Violence,Female,60+,6601,278,6323,2871,3730
2009,Rural,Haryana,Crime Against Men,Assault,Female,46-60,2208,50,2158,674,1534
2010,Rural,Arunachal Pradesh,Crime Against Children,Trafficking,Female,60+,8570,507,8063,2671,5899
2001,Rural,Odisha,Crime Against Women,Domestic Violence,Female,0-12,1747,1529,218,1597,150
2010,Rural,Tripura,Other Crimes,Drug Offense,Female,18-30,928,381,547,891,37
2004,Rural,Mizoram,Crime Against Children,Trafficking,Male,0-12,7754,4866,2888,6854,900
2002,Rural,Gujarat,Crime Against Women,Dowry Deaths,Male,13-17,8219,2501,5718,6839,1380
2005,Rural,Tamil Nadu,Other Crimes,Fraud,Female,0-12,1228,916,312,969,259
2007,Rural,Kerala,Crime Against Women,Molestation,Female,13-17,7129,4466,2663,5671,1458
2001,Urban,Mizoram,Crime Against Women,Dowry Deaths,Female,0-12,2626,831,1795,2231,395
2008,Urban,Jammu & Kashmir,Crime Against Children,Child Abuse,Male,46-60,7838,314,7524,1604,6234
2009,Urban,Arunachal Pradesh,Other Crimes,Drug Offense,Female,18-30,5717,845,4872,5654,63
2002,Rural,West Bengal,Crime Against Children,Child Abuse,Male,60+,4514,181,4333,1193,3321
2001,Urban,Assam,Crime Against Women,Rape,Male,18-30,8388,3228,5160,6364,2024
2005,Rural,Andhra Pradesh,Crime Against Women,Domestic Violence,Male,0-12,1448,1055,393,1188,260
2007,Rural,Arunachal Pradesh,Crime Against Women,Molestation,Male,46-60,6470,2332,4138,5147,1323
2006,Urban,Mizoram,Property Crime,Burglary,Male,60+,2741,1282,1459,1371,1370
2002,Urban,Himachal Pradesh,Crime Against Children,Trafficking,Female,13-17,3017,1810,1207,1995,1022
2010,Rural,Meghalaya,Crime Against Women,Domestic Violence,Male,31-45,3830,2600,1230,3450,380
2008,Rural,West Bengal,Crime Against Women,Domestic Violence,Female,18-30,8069,3264,4805,6753,1316
2001,Rural,Andhra Pradesh,Crime Against Children,Trafficking,Male,46-60,1790,899,891,1522,268
2002,Urban,Uttarakhand,Crime Against Women,Molestation,Male,60+,4957,2331,2626,3805,1152
2004,Urban,Haryana,Crime Against Women,Dowry Deaths,Male,18-30,7639,2465,5174,5553,2086
2008,Urban,Maharashtra,Other Crimes,Drug Offense,Male,18-30,112,7,105,16,96
2003,Rural,Nagaland,Other Crimes,Drug Offense,Male,13-17,2018,1086,932,1308,710
2008,Urban,Madhya Pradesh,Crime Against Children,Child Abuse,Female,0-12,2076,1,2075,1159,917
2007,Urban,Madhya Pradesh,Crime Against Children,Child Abuse,Female,31-45,7242,2972,4270,5067,2175
2004,Rural,Uttar Pradesh,Crime Against Children,Kidnapping,Male,0-12,347,218,129,238,109
2003,Rural,Rajasthan,Crime Against Children,Trafficking,Male,46-60,4531,2663,1868,3178,1353
2007,Rural,Himachal Pradesh,Crime Against Men,Assault,Female,31-45,1666,1156,510,1213,453
2002,Urban,Assam,Property Crime,Theft,Male,13-17,1043,872,171,969,74
2005,Urban,Rajasthan,Crime Against Women,Rape,Male,31-45,5347,4914,433,5291,56
2008,Urban,Assam,Crime Against Women,Molestation,Female,46-60,7729,4930,2799,6760,969
2003,Urban,Gujarat,Crime Against Men,Robbery,Male,46-60,9594,6917,2677,8495,1099
2008,Urban,Mizoram,Property Crime,Theft,Male,31-45,7819,3504,4315,6593,1226
2002,Urban,Uttar Pradesh,Property Crime,Vandalism,Male,18-30,2818,437,2381,1246,1572
2004,Urban,Delhi,Other Crimes,Fraud,Male,18-30,417,5,412,212,205
2003,Rural,Meghalaya,Crime Against Children,Child Abuse,Male,60+,2189,468,1721,1091,1098
2009,Rural,Chhattisgarh,Property Crime,Arson,Female,31-45,9888,557,9331,5649,4239
2009,Urban,Assam,Crime Against Women,Domestic Violence,Male,31-45,6515,3522,2993,5935,580
2001,Urban,Punjab,Crime Against Men,Assault,Male,60+,1655,1354,301,1645,10
2010,Urban,Sikkim,Crime Against Men,Murder,Female,18-30,835,771,64,816,19
2009,Urban,Jharkhand,Crime Against Women,Domestic Violence,Male,13-17,3159,1020,2139,1572,1587
2008,Urban,Tamil Nadu,Crime Against Children,Trafficking,Male,31-45,6726,1523,5203,2952,3774
2010,Rural,Andhra Pradesh,Crime Against Men,Murder,Female,60+,4844,4544,300,4552,292
2005,Urban,Punjab,Property Crime,Arson,Male,31-45,9968,6217,3751,8631,1337
2007,Urban,Madhya Pradesh,Crime Against Women,Rape,Female,0-12,7077,1774,5303,3196,3881
2003,Urban,Odisha,Property Crime,Burglary,Female,0-12,5480,3282,2198,4113,1367
2005,Rural,Maharashtra,Crime Against Men,Robbery,Female,31-45,3455,3386,69,3413,42
2004,Rural,Madhya Pradesh,Crime Against Children,Child Labor,Female,18-30,1420,183,1237,837,583
2006,Urban,Arunachal Pradesh,Property Crime,Theft,Female,46-60,3767,1535,2232,3444,323
2009,Rural,Chhattisgarh,Crime Against Men,Murder,Female,60+,4256,2352,1904,2405,1851
2002,Rural,Kerala,Other Crimes,Corruption,Male,31-45,1910,1568,342,1848,62
2002,Rural,Assam,Other Crimes,Cyber Crime,Female,60+,4991,1333,3658,2557,2434
2001,Urban,Goa,Crime Against Men,Assault,Female,13-17,4186,3500,686,3866,320
2001,Urban,Himachal Pradesh,Other Crimes,Cyber Crime,Male,60+,6523,5160,1363,5508,1015
2002,Rural,Tamil Nadu,Crime Against Women,Domestic Violence,Male,18-30,7581,2831,4750,5574,2007
2006,Rural,Tamil Nadu,Crime Against Children,Kidnapping,Female,0-12,7989,6984,1005,7212,777
2003,Urban,Telangana,Property Crime,Theft,Male,60+,5227,305,4922,5063,164
2006,Rural,Gujarat,Property Crime,Burglary,Female,60+,78,69,9,77,1
2002,Rural,Assam,Crime Against Women,Dowry Deaths,Female,0-12,99,59,40,94,5
2010,Rural,Tripura,Other Crimes,Cyber Crime,Male,31-45,4455,3693,762,3909,546
2010,Rural,Uttar Pradesh,Crime Against Children,Trafficking,Male,60+,982,880,102,975,7
2002,Urban,Nagaland,Crime Against Children,Trafficking,Female,0-12,6645,484,6161,645,6000
2009,Urban,Arunachal Pradesh,Other Crimes,Corruption,Male,13-17,9064,4641,4423,4989,4075
2009,Urban,Kerala,Property Crime,Vandalism,Female,46-60,8597,8013,584,8554,43
2005,Rural,Meghalaya,Crime Against Men,Assault,Female,0-12,897,396,501,646,251
2005,Urban,Rajasthan,Crime Against Women,Dowry Deaths,Male,18-30,3933,2543,1390,3068,865
2010,Rural,Goa,Other Crimes,Cyber Crime,Female,46-60,7359,2348,5011,5549,1810
2007,Rural,West Bengal,Crime Against Women,Dowry Deaths,Female,46-60,2970,1953,1017,2500,470
2002,Urban,Uttar Pradesh,Other Crimes,Cyber Crime,Male,60+,6554,3782,2772,5752,802
2004,Rural,Sikkim,Property Crime,Theft,Female,60+,2877,2519,358,2591,286
2005,Rural,Gujarat,Crime Against Men,Robbery,Male,0-12,4206,3717,489,3792,414
2007,Rural,Goa,Crime Against Women,Molestation,Female,13-17,3764,2405,1359,2891,873
2004,Urban,Punjab,Crime Against Women,Molestation,Female,13-17,6131,4123,2008,4850,1281
2009,Rural,Mizoram,Crime Against Women,Dowry Deaths,Male,60+,5703,2598,3105,3392,2311
2001,Urban,Meghalaya,Crime Against Women,Dowry Deaths,Male,60+,5803,2034,3769,5402,401
2009,Urban,Sikkim,Crime Against Children,Kidnapping,Male,46-60,6152,1518,4634,5903,249
2009,Rural,Rajasthan,Other Crimes,Drug Offense,Male,60+,6529,3251,3278,5089,1440
2002,Rural,Punjab,Crime Against Men,Murder,Female,0-12,3808,2424,1384,2666,1142
2006,Rural,Jharkhand,Other Crimes,Drug Offense,Male,0-12,5598,2922,2676,4098,1500
2008,Rural,Meghalaya,Crime Against Women,Molestation,Female,60+,6577,1597,4980,4896,1681
2007,Rural,Gujarat,Crime Against Men,Murder,Female,60+,2322,1491,831,1992,330
2009,Rural,Haryana,Crime Against Women,Molestation,Female,31-45,9377,3871,5506,5903,3474
2010,Urban,Telangana,Property Crime,Burglary,Female,13-17,7700,4097,3603,6681,1019
2010,Urban,Sikkim,Crime Against Women,Rape,Male,60+,1028,396,632,564,464
2004,Urban,Jharkhand,Crime Against Women,Rape,Male,31-45,1694,737,957,935,759
2007,Rural,Chhattisgarh,Other Crimes,Corruption,Male,46-60,7394,1707,5687,2290,5104
2009,Rural,Madhya Pradesh,Other Crimes,Fraud,Male,60+,9592,5465,4127,8185,1407
2006,Rural,Tamil Nadu,Other Crimes,Cyber Crime,Female,46-60,6141,5011,1130,5208,933
2002,Rural,Arunachal Pradesh,Crime Against Women,Domestic Violence,Male,13-17,7931,231,7700,7094,837
2003,Urban,Nagaland,Property Crime,Theft,Female,0-12,2112,861,1251,2022,90
2005,Rural,Haryana,Other Crimes,Corruption,Male,0-12,7928,5811,2117,7531,397
2004,Urban,Maharashtra,Crime Against Children,Child Labor,Female,60+,1685,1064,621,1188,497
2010,Rural,Himachal Pradesh,Property Crime,Theft,Male,13-17,8249,3830,4419,7685,564
2007,Rural,Tripura,Property Crime,Burglary,Female,13-17,4880,3711,1169,4201,679
2008,Urban,Jammu & Kashmir,Crime Against Women,Molestation,Male,31-45,2540,2358,182,2518,22
2010,Rural,Uttar Pradesh,Crime Against Men,Robbery,Male,31-45,2471,903,1568,1101,1370
2002,Rural,Uttar Pradesh,Crime Against Women,Rape,Male,18-30,4585,1757,2828,2176,2409
2003,Urban,Goa,Crime Against Men,Assault,Female,60+,7609,4417,3192,7455,154
2001,Rural,Madhya Pradesh,Property Crime,Arson,Male,60+,9986,1072,8914,4755,5231
2007,Rural,Tripura,Crime Against Women,Domestic Violence,Female,18-30,9782,347,9435,644,9138
2004,Rural,Delhi,Crime Against Children,Child Labor,Male,31-45,9041,6000,3041,7084,1957
2004,Rural,Assam,Crime Against Children,Child Abuse,Female,0-12,7360,796,6564,3339,4021
2004,Urban,Kerala,Crime Against Children,Kidnapping,Male,60+,1561,831,730,1530,31
2006,Urban,Nagaland,Other Crimes,Fraud,Female,60+,2298,1111,1187,1922,376
2009,Rural,Rajasthan,Property Crime,Burglary,Male,31-45,1809,1157,652,1431,378
2001,Rural,Tamil Nadu,Other Crimes,Cyber Crime,Male,0-12,5636,1053,4583,4184,1452
2001,Urban,West Bengal,Crime Against Women,Rape,Female,60+,3334,2843,491,2975,359
2005,Urban,Andhra Pradesh,Crime Against Women,Rape,Female,18-30,708,438,270,468,240
2008,Rural,West Bengal,Crime Against Men,Extortion,Male,18-30,7332,3937,3395,4872,2460
2005,Rural,Madhya Pradesh,Crime Against Children,Child Labor,Male,46-60,8910,8548,362,8903,7
2003,Urban,Assam,Crime Against Children,Kidnapping,Male,60+,9321,7350,1971,9250,71
2004,Urban,Bihar,Other Crimes,Cyber Crime,Male,13-17,7237,2493,4744,2847,4390
2005,Rural,Madhya Pradesh,Property Crime,Vandalism,Female,60+,5672,2563,3109,4155,1517
2005,Urban,Tripura,Crime Against Women,Dowry Deaths,Female,13-17,8668,7491,1177,8272,396
2002,Rural,Andhra Pradesh,Crime Against Men,Extortion,Female,13-17,8031,846,7185,3987,4044
2009,Rural,Jharkhand,Crime Against Women,Domestic Violence,Female,13-17,8920,1921,6999,8126,794
2001,Rural,Nagaland,Other Crimes,Drug Offense,Female,60+,4014,1526,2488,2879,1135
2009,Rural,West Bengal,Crime Against Women,Rape,Female,0-12,7011,5861,1150,6534,477
2004,Urban,Meghalaya,Property Crime,Theft,Male,0-12,3328,3061,267,3232,96
2010,Rural,Punjab,Property Crime,Vandalism,Female,0-12,6461,1328,5133,2856,3605
2002,Urban,Mizoram,Other Crimes,Cyber Crime,Male,31-45,1043,716,327,823,220
2003,Urban,Tripura,Crime Against Men,Murder,Female,13-17,4135,2493,1642,3778,357
2001,Urban,Rajasthan,Crime Against Men,Murder,Female,46-60,5230,4616,614,5019,211
2009,Urban,Manipur,Crime Against Women,Domestic Violence,Female,46-60,9642,8214,1428,8450,1192
2003,Rural,Meghalaya,Property Crime,Arson,Male,60+,7801,686,7115,5040,2761
2008,Rural,Nagaland,Property Crime,Vandalism,Female,0-12,976,305,671,898,78
2006,Rural,Goa,Crime Against Children,Trafficking,Female,60+,7992,3851,4141,5690,2302
2007,Urban,Assam,Other Crimes,Cyber Crime,Male,46-60,3055,1532,1523,2323,732
2003,Urban,Uttarakhand,Crime Against Women,Domestic Violence,Female,31-45,660,549,111,642,18
2006,Rural,Odisha,Other Crimes,Fraud,Female,46-60,6056,4380,1676,5602,454
2001,Rural,Punjab,Crime Against Children,Trafficking,Male,46-60,8050,4084,3966,4924,3126
2006,Rural,Arunachal Pradesh,Property Crime,Vandalism,Male,13-17,5956,222,5734,3971,1985
2003,Urban,Karnataka,Other Crimes,Corruption,Male,31-45,4702,841,3861,1873,2829
2005,Rural,Andhra Pradesh,Crime Against Men,Extortion,Female,18-30,3899,1983,1916,2346,1553
2001,Rural,Meghalaya,Property Crime,Theft,Male,46-60,1008,146,862,790,218
2003,Rural,Delhi,Property Crime,Burglary,Female,46-60,8546,5704,2842,7620,926
2003,Rural,Jharkhand,Crime Against Men,Extortion,Male,31-45,3723,3523,200,3716,7
2006,Rural,Kerala,Crime Against Women,Molestation,Female,0-12,5540,2647,2893,3621,1919
2006,Urban,Jharkhand,Crime Against Women,Molestation,Male,18-30,5540,209,5331,5138,402
2005,Urban,Meghalaya,Crime Against Men,Assault,Female,31-45,3926,3301,625,3616,310
2004,Rural,Chhattisgarh,Crime Against Children,Child Labor,Male,0-12,5263,1942,3321,4557,706
2002,Rural,Himachal Pradesh,Property Crime,Arson,Female,46-60,3540,329,3211,1491,2049
2009,Rural,Goa,Crime Against Men,Robbery,Male,31-45,8598,1212,7386,3256,5342
2008,Rural,Nagaland,Crime Against Men,Robbery,Male,31-45,3713,1047,2666,2217,1496
2004,Urban,Odisha,Other Crimes,Drug Offense,Female,0-12,9555,3812,5743,7888,1667
2008,Rural,Uttar Pradesh,Crime Against Children,Trafficking,Female,18-30,4223,532,3691,4187,36
2001,Rural,Manipur,Crime Against Women,Molestation,Male,60+,5677,2575,3102,3950,1727
2002,Urban,Uttarakhand,Crime Against Children,Trafficking,Male,46-60,9159,8564,595,8782,377
2007,Rural,Odisha,Crime Against Children,Trafficking,Male,31-45,480,428,52,431,49
2006,Urban,Sikkim,Crime Against Men,Extortion,Male,0-12,7850,142,7708,5721,2129
2003,Urban,Goa,Crime Against Women,Domestic Violence,Female,31-45,5488,1876,3612,4096,1392
2010,Urban,Karnataka,Crime Against Women,Domestic Violence,Female,60+,8203,4701,3502,7922,281
2010,Urban,Delhi,Crime Against Children,Child Labor,Female,46-60,3172,2570,602,2852,320
2010,Rural,Himachal Pradesh,Crime Against Men,Murder,Female,60+,174,83,91,157,17
2009,Rural,Nagaland,Other Crimes,Corruption,Female,13-17,8880,5673,3207,5771,3109
2002,Rural,Kerala,Property Crime,Vandalism,Male,31-45,2851,554,2297,1260,1591
2006,Rural,Manipur,Crime Against Men,Murder,Female,60+,2334,729,1605,926,1408
2006,Urban,Arunachal Pradesh,Other Crimes,Drug Offense,Female,60+,3614,2122,1492,3445,169
2002,Urban,Tamil Nadu,Crime Against Women,Dowry Deaths,Female,18-30,5918,3592,2326,5356,562
2006,Urban,Odisha,Crime Against Women,Domestic Violence,Female,46-60,1302,561,741,928,374
2006,Urban,Odisha,Crime Against Children,Child Labor,Male,60+,663,551,112,662,1
2003,Urban,Mizoram,Crime Against Women,Domestic Violence,Female,60+,8066,593,7473,3855,4211
2005,Rural,Himachal Pradesh,Other Crimes,Cyber Crime,Female,60+,6190,2456,3734,5310,880
2007,Urban,Manipur,Crime Against Children,Trafficking,Male,18-30,754,551,203,666,88
2006,Rural,Uttar Pradesh,Property Crime,Burglary,Male,18-30,1516,934,582,1286,230
2010,Urban,Tripura,Other Crimes,Drug Offense,Female,0-12,7099,4906,2193,5976,1123
2005,Urban,Chhattisgarh,Crime Against Children,Kidnapping,Female,13-17,6301,4265,2036,4477,1824
2004,Rural,Tripura,Crime Against Women,Molestation,Male,13-17,9491,4737,4754,6546,2945
2001,Rural,Telangana,Crime Against Men,Assault,Male,60+,2600,1939,661,2165,435
2005,Urban,Madhya Pradesh,Crime Against Children,Kidnapping,Female,18-30,5429,2585,2844,2894,2535
2007,Rural,Tamil Nadu,Crime Against Women,Dowry Deaths,Male,60+,4277,2153,2124,2899,1378
2007,Rural,Rajasthan,Crime Against Children,Trafficking,Female,18-30,5394,4,5390,4361,1033
2007,Rural,Manipur,Crime Against Women,Domestic Violence,Female,18-30,8793,5336,3457,8283,510
2002,Rural,Karnataka,Crime Against Women,Rape,Female,18-30,2087,1826,261,1871,216
2001,Rural,Himachal Pradesh,Property Crime,Theft,Male,13-17,1394,326,1068,1301,93
2009,Urban,Maharashtra,Crime Against Women,Dowry Deaths,Female,46-60,9531,1317,8214,6914,2617
2008,Rural,Maharashtra,Crime Against Children,Child Abuse,Male,46-60,7199,2157,5042,6607,592
2002,Rural,Assam,Property Crime,Theft,Male,13-17,7449,666,6783,2745,4704
2004,Urban,Rajasthan,Crime Against Women,Molestation,Male,0-12,56,49,7,55,1
2009,Urban,Odisha,Other Crimes,Fraud,Female,13-17,895,437,458,616,279
2005,Urban,Tripura,Crime Against Men,Extortion,Female,60+,6690,1278,5412,6088,602
2002,Urban,Arunachal Pradesh,Property Crime,Theft,Male,31-45,818,616,202,812,6
2010,Rural,Himachal Pradesh,Other Crimes,Fraud,Female,60+,1816,1023,793,1031,785
2005,Rural,Gujarat,Other Crimes,Fraud,Male,31-45,7550,7093,457,7330,220
2003,Urban,Madhya Pradesh,Crime Against Men,Assault,Female,31-45,6091,1655,4436,3447,2644
2006,Rural,Uttarakhand,Other Crimes,Drug Offense,Male,13-17,7026,1804,5222,3914,3112
2004,Rural,Arunachal Pradesh,Crime Against Men,Extortion,Male,31-45,6226,2028,4198,5315,911
2007,Urban,Madhya Pradesh,Crime Against Women,Molestation,Female,31-45,2865,900,1965,1015,1850
2008,Rural,Andhra Pradesh,Property Crime,Burglary,Female,46-60,2257,1499,758,1613,644
2005,Urban,Telangana,Other Crimes,Cyber Crime,Male,0-12,9629,3993,5636,4513,5116
2006,Rural,Chhattisgarh,Property Crime,Theft,Male,18-30,5623,4231,1392,5173,450
2009,Rural,Bihar,Crime Against Men,Assault,Male,18-30,6210,1389,4821,2284,3926
2009,Rural,West Bengal,Crime Against Women,Dowry Deaths,Male,0-12,6938,3800,3138,5175,1763
2006,Rural,Nagaland,Crime Against Men,Extortion,Male,18-30,8173,6070,2103,7271,902
2006,Rural,Punjab,Crime Against Men,Extortion,Male,60+,7834,1317,6517,7687,147
2005,Rural,Manipur,Crime Against Children,Child Labor,Female,13-17,7514,3241,4273,7348,166
2009,Urban,Assam,Crime Against Children,Child Abuse,Male,31-45,1354,964,390,1351,3
2005,Rural,Andhra Pradesh,Other Crimes,Drug Offense,Male,13-17,3579,2747,832,2998,581
2004,Urban,Meghalaya,Other Crimes,Drug Offense,Male,31-45,7106,891,6215,2751,4355
2009,Rural,Andhra Pradesh,Crime Against Men,Extortion,Male,46-60,5100,3474,1626,4049,1051
2009,Urban,Mizoram,Other Crimes,Fraud,Female,18-30,5131,506,4625,2702,2429
2005,Urban,Uttarakhand,Property Crime,Vandalism,Female,31-45,4892,858,4034,4726,166
2010,Urban,Tamil Nadu,Property Crime,Burglary,Female,60+,4756,1146,3610,2104,2652
2002,Urban,Gujarat,Crime Against Women,Rape,Female,18-30,2299,534,1765,1423,876
2009,Rural,Meghalaya,Crime Against Men,Assault,Male,60+,8110,542,7568,4699,3411
2004,Rural,West Bengal,Crime Against Women,Rape,Male,60+,954,38,916,64,890
2009,Rural,Karnataka,Property Crime,Arson,Male,60+,628,608,20,615,13
2008,Urban,Madhya Pradesh,Other Crimes,Fraud,Male,46-60,9743,5986,3757,8856,887
2009,Urban,Sikkim,Crime Against Children,Child Labor,Male,18-30,3752,1123,2629,1356,2396
2004,Rural,Chhattisgarh,Other Crimes,Drug Offense,Female,13-17,219,64,155,97,122
2007,Urban,Uttar Pradesh,Crime Against Women,Dowry Deaths,Male,13-17,8787,5539,3248,7132,1655
2001,Rural,Rajasthan,Crime Against Children,Child Labor,Female,13-17,3007,2213,794,2270,737
2005,Urban,Tamil Nadu,Other Crimes,Drug Offense,Female,60+,6294,2573,3721,5098,1196
2010,Urban,Uttar Pradesh,Crime Against Women,Domestic Violence,Male,46-60,9881,3353,6528,9308,573
2006,Urban,Mizoram,Crime Against Children,Child Labor,Male,31-45,5715,4521,1194,5363,352
2005,Rural,Assam,Crime Against Women,Rape,Male,60+,1769,221,1548,407,1362
2010,Rural,Punjab,Property Crime,Vandalism,Female,18-30,9679,2251,7428,6341,3338
2001,Urban,Jharkhand,Property Crime,Vandalism,Male,13-17,7012,2977,4035,4385,2627
2002,Rural,Uttarakhand,Property Crime,Arson,Female,31-45,8636,186,8450,202,8434
2008,Urban,Jammu & Kashmir,Crime Against Women,Domestic Violence,Male,0-12,3878,2771,1107,2931,947
2001,Urban,Meghalaya,Crime Against Children,Trafficking,Female,31-45,7248,1138,6110,6724,524
2007,Rural,Goa,Property Crime,Theft,Female,18-30,6421,3294,3127,4078,2343
2004,Rural,Odisha,Other Crimes,Drug Offense,Male,13-17,3172,3108,64,3109,63
2008,Rural,Arunachal Pradesh,Crime Against Women,Domestic Violence,Female,13-17,9711,4846,4865,7201,2510
2003,Urban,Goa,Other Crimes,Fraud,Female,18-30,1997,716,1281,1275,722
2003,Rural,Uttarakhand,Crime Against Women,Molestation,Male,46-60,4560,1693,2867,4116,444
2003,Rural,Chhattisgarh,Crime Against Women,Rape,Male,18-30,4522,2334,2188,3392,1130
2001,Rural,Tripura,Crime Against Women,Molestation,Female,46-60,9850,8643,1207,9258,592
2001,Urban,Meghalaya,Crime Against Women,Molestation,Female,18-30,5016,2181,2835,3496,1520
2008,Urban,Madhya Pradesh,Other Crimes,Fraud,Male,0-12,95,43,52,93,2
2009,Rural,Odisha,Property Crime,Theft,Male,31-45,8914,1175,7739,2515,6399
2006,Urban,Delhi,Crime Against Children,Child Abuse,Male,0-12,3896,3111,785,3782,114
2010,Urban,Assam,Crime Against Men,Murder,Male,0-12,2113,666,1447,1775,338
2007,Urban,Arunachal Pradesh,Crime Against Men,Murder,Female,18-30,2938,1585,1353,2105,833
2003,Urban,Arunachal Pradesh,Property Crime,Burglary,Male,60+,1775,1488,287,1502,273
2005,Rural,Jharkhand,Crime Against Men,Extortion,Female,0-12,3330,2277,1053,2473,857
2001,Urban,Gujarat,Crime Against Children,Child Abuse,Female,18-30,5699,3338,2361,4730,969
2004,Urban,Meghalaya,Other Crimes,Cyber Crime,Female,18-30,2948,1390,1558,2298,650
2001,Urban,Jharkhand,Other Crimes,Corruption,Female,46-60,3842,1072,2770,2556,1286
2005,Rural,Tripura,Crime Against Children,Child Labor,Female,46-60,2823,2138,685,2784,39
2008,Urban,Mizoram,Crime Against Men,Assault,Male,31-45,1797,1753,44,1757,40
2009,Rural,Bihar,Crime Against Children,Child Labor,Female,0-12,2730,181,2549,1830,900
2007,Rural,Punjab,Crime Against Men,Murder,Male,18-30,749,45,704,159,590
2002,Urban,Manipur,Crime Against Children,Child Labor,Female,18-30,8721,6714,2007,8329,392
2002,Rural,Kerala,Crime Against Children,Trafficking,Male,60+,9722,3197,6525,6235,3487
2001,Rural,Tamil Nadu,Crime Against Women,Molestation,Male,13-17,98,91,7,95,3
2001,Urban,Goa,Crime Against Women,Dowry Deaths,Female,46-60,7381,5512,1869,7273,108
2001,Urban,Andhra Pradesh,Property Crime,Burglary,Male,13-17,6388,2068,4320,3629,2759
2007,Urban,Uttar Pradesh,Other Crimes,Cyber Crime,Male,18-30,4841,1240,3601,1347,3494
2010,Urban,Assam,Crime Against Children,Kidnapping,Male,13-17,5515,5278,237,5492,23
2007,Urban,Sikkim,Crime Against Children,Trafficking,Female,31-45,4115,3036,1079,3637,478
2005,Urban,Rajasthan,Crime Against Men,Robbery,Female,0-12,6124,386,5738,3053,3071
2005,Rural,Karnataka,Crime Against Men,Assault,Male,13-17,2689,318,2371,2034,655
2003,Rural,Telangana,Other Crimes,Corruption,Male,0-12,1538,212,1326,1240,298
2006,Urban,Manipur,Crime Against Children,Trafficking,Female,46-60,5974,1973,4001,3744,2230
2010,Rural,Meghalaya,Property Crime,Burglary,Male,0-12,6735,2708,4027,6641,94
2006,Rural,Tripura,Crime Against Men,Robbery,Male,18-30,1258,889,369,1037,221
2005,Rural,Maharashtra,Property Crime,Theft,Male,0-12,1446,1019,427,1343,103
2005,Rural,Kerala,Crime Against Children,Child Abuse,Male,46-60,8253,1782,6471,3028,5225
2007,Urban,Delhi,Property Crime,Arson,Female,18-30,3475,1888,1587,2304,1171
2002,Urban,Goa,Other Crimes,Corruption,Female,0-12,5956,5054,902,5475,481
2007,Rural,Goa,Crime Against Children,Kidnapping,Male,18-30,9476,484,8992,5301,4175
2010,Urban,Telangana,Property Crime,Theft,Female,31-45,7916,1136,6780,7017,899
2010,Urban,Tamil Nadu,Crime Against Men,Assault,Female,46-60,6221,160,6061,2927,3294
2001,Urban,Tripura,Crime Against Women,Dowry Deaths,Male,60+,115,30,85,73,42
2009,Rural,Assam,Other Crimes,Corruption,Female,0-12,501,459,42,496,5
2002,Urban,Sikkim,Property Crime,Burglary,Female,60+,9064,7549,1515,8636,428
2006,Urban,West Bengal,Other Crimes,Fraud,Female,13-17,548,253,295,382,166
2001,Rural,Kerala,Crime Against Children,Trafficking,Male,60+,3357,2039,1318,3247,110
2001,Rural,Kerala,Crime Against Children,Kidnapping,Male,0-12,4024,3627,397,3851,173
2009,Rural,Bihar,Crime Against Children,Child Labor,Female,0-12,2151,328,1823,1997,154
2001,Rural,Karnataka,Property Crime,Arson,Male,46-60,3080,2968,112,3068,12
2006,Urban,West Bengal,Crime Against Women,Domestic Violence,Female,0-12,6521,2729,3792,5635,886
2002,Urban,Odisha,Other Crimes,Fraud,Male,46-60,9394,6766,2628,8374,1020
2003,Urban,Andhra Pradesh,Crime Against Children,Kidnapping,Male,60+,9273,2139,7134,7356,1917
2002,Rural,Gujarat,Property Crime,Arson,Male,46-60,5239,556,4683,2422,2817
2003,Rural,Madhya Pradesh,Property Crime,Burglary,Female,60+,5492,59,5433,1315,4177
2008,Rural,Mizoram,Property Crime,Arson,Male,46-60,901,330,571,810,91
2004,Rural,Rajasthan,Crime Against Children,Kidnapping,Male,13-17,7855,1655,6200,7073,782
2003,Rural,Chhattisgarh,Crime Against Men,Murder,Male,0-12,5999,257,5742,3382,2617
2007,Rural,Delhi,Crime Against Women,Rape,Male,31-45,7112,6146,966,6661,451
2010,Rural,Uttar Pradesh,Property Crime,Theft,Female,46-60,349,300,49,322,27
2007,Urban,Sikkim,Crime Against Women,Dowry Deaths,Male,0-12,3230,70,3160,844,2386
2008,Rural,Andhra Pradesh,Property Crime,Burglary,Male,0-12,9840,5145,4695,8833,1007
2010,Rural,Himachal Pradesh,Crime Against Women,Rape,Male,60+,6667,3526,3141,5589,1078
2002,Urban,Uttar Pradesh,Property Crime,Vandalism,Male,18-30,8700,7168,1532,8214,486
2003,Rural,Goa,Crime Against Women,Domestic Violence,Female,13-17,5203,2289,2914,4393,810
2009,Urban,Himachal Pradesh,Crime Against Women,Rape,Male,13-17,1290,72,1218,355,935
2005,Rural,Karnataka,Crime Against Women,Rape,Male,18-30,1542,1280,262,1530,12
2009,Urban,Assam,Crime Against Women,Molestation,Male,46-60,835,304,531,808,27
2004,Rural,Madhya Pradesh,Crime Against Men,Assault,Female,18-30,2662,2217,445,2405,257
2006,Rural,Uttar Pradesh,Crime Against Children,Trafficking,Male,60+,2535,279,2256,945,1590
2005,Rural,Sikkim,Crime Against Women,Dowry Deaths,Female,13-17,5213,669,4544,4083,1130
2004,Rural,Chhattisgarh,Crime Against Children,Kidnapping,Male,13-17,5924,1451,4473,2010,3914
2001,Rural,Uttar Pradesh,Crime Against Men,Murder,Female,31-45,2655,1106,1549,2172,483
2010,Rural,Telangana,Crime Against Men,Robbery,Male,13-17,428,72,356,326,102
2008,Urban,Telangana,Property Crime,Arson,Male,46-60,5786,2679,3107,4852,934
2010,Urban,Uttar Pradesh,Property Crime,Theft,Female,18-30,2464,2331,133,2351,113
2006,Rural,Punjab,Crime Against Children,Child Labor,Male,0-12,7706,3840,3866,4845,2861
2005,Urban,Rajasthan,Crime Against Women,Rape,Male,31-45,5395,2371,3024,5163,232
2010,Rural,Uttar Pradesh,Crime Against Women,Dowry Deaths,Female,60+,3161,1066,2095,2572,589
2001,Urban,Chhattisgarh,Crime Against Women,Domestic Violence,Male,60+,5110,2608,2502,2907,2203
2007,Rural,Karnataka,Crime Against Women,Rape,Female,18-30,7737,7020,717,7516,221
2001,Rural,Nagaland,Crime Against Men,Murder,Female,31-45,548,256,292,513,35
2007,Urban,Karnataka,Crime Against Children,Child Abuse,Female,18-30,6657,1392,5265,1833,4824
2006,Rural,Bihar,Other Crimes,Fraud,Male,46-60,9978,4207,5771,6056,3922
2003,Rural,Mizoram,Property Crime,Theft,Male,60+,9148,5579,3569,7800,1348
2009,Urban,Arunachal Pradesh,Other Crimes,Cyber Crime,Female,46-60,6737,639,6098,3110,3627
2009,Rural,Uttar Pradesh,Other Crimes,Cyber Crime,Male,60+,5256,4106,1150,4799,457
2002,Urban,Andhra Pradesh,Other Crimes,Corruption,Male,46-60,5690,3051,2639,5565,125
2001,Rural,Haryana,Crime Against Children,Child Abuse,Male,13-17,8435,4905,3530,5208,3227
2006,Urban,Delhi,Other Crimes,Cyber Crime,Male,0-12,508,297,211,437,71
2003,Urban,Arunachal Pradesh,Crime Against Children,Kidnapping,Male,46-60,3374,1491,1883,1569,1805
2006,Rural,Goa,Crime Against Men,Robbery,Male,13-17,3908,1225,2683,3711,197
2006,Rural,Rajasthan,Other Crimes,Corruption,Male,18-30,1444,921,523,1301,143
2010,Urban,Meghalaya,Other Crimes,Drug Offense,Male,60+,5313,3831,1482,5100,213
2003,Urban,West Bengal,Crime Against Women,Molestation,Male,46-60,1851,1365,486,1407,444
2006,Urban,Uttar Pradesh,Crime Against Women,Rape,Male,18-30,5609,2629,2980,2907,2702
2003,Rural,Uttarakhand,Crime Against Women,Rape,Female,60+,1406,980,426,1235,171
2005,Urban,Sikkim,Property Crime,Theft,Male,31-45,8075,226,7849,5718,2357
2006,Rural,Tripura,Crime Against Women,Domestic Violence,Male,18-30,6573,3645,2928,6459,114
2003,Rural,Uttar Pradesh,Other Crimes,Fraud,Male,31-45,3040,578,2462,2082,958
2001,Urban,Mizoram,Crime Against Women,Domestic Violence,Female,0-12,9031,1028,8003,7515,1516
2007,Rural,Kerala,Other Crimes,Cyber Crime,Female,60+,1308,507,801,678,630
2002,Urban,Bihar,Property Crime,Burglary,Male,31-45,2372,1697,675,2147,225
2003,Rural,Bihar,Crime Against Children,Trafficking,Male,60+,4300,3108,1192,3461,839
2007,Rural,Assam,Crime Against Children,Kidnapping,Female,0-12,3273,1744,1529,2571,702
2003,Rural,Jammu & Kashmir,Crime Against Women,Domestic Violence,Male,18-30,6757,2409,4348,5387,1370
2008,Rural,Telangana,Property Crime,Burglary,Male,60+,5503,967,4536,2063,3440
2007,Rural,Meghalaya,Property Crime,Theft,Male,46-60,8974,623,8351,8392,582
2008,Urban,Nagaland,Crime Against Children,Child Labor,Female,13-17,1321,1039,282,1215,106
2008,Urban,Chhattisgarh,Other Crimes,Drug Offense,Female,31-45,8699,2105,6594,7379,1320
2008,Urban,Mizoram,Crime Against Women,Molestation,Female,60+,6985,6153,832,6528,457
2008,Rural,Himachal Pradesh,Crime Against Men,Robbery,Female,18-30,5872,4124,1748,5270,602
2008,Urban,Andhra Pradesh,Crime Against Women,Dowry Deaths,Male,0-12,8670,5398,3272,6924,1746
2002,Rural,Chhattisgarh,Property Crime,Burglary,Female,46-60,5836,1720,4116,3666,2170
2002,Urban,Delhi,Crime Against Men,Extortion,Female,31-45,3106,2046,1060,2855,251
2006,Rural,Tripura,Property Crime,Vandalism,Male,60+,1485,1032,453,1265,220
2010,Urban,Rajasthan,Crime Against Men,Robbery,Male,13-17,1299,371,928,1138,161
2008,Urban,Karnataka,Crime Against Children,Trafficking,Male,60+,5494,104,5390,1434,4060
2003,Urban,Telangana,Crime Against Men,Robbery,Female,13-17,1903,1284,619,1815,88
2001,Rural,Mizoram,Property Crime,Vandalism,Male,31-45,1969,1435,534,1732,237
2005,Urban,Bihar,Other Crimes,Drug Offense,Female,18-30,9846,8107,1739,9460,386
2008,Rural,Chhattisgarh,Crime Against Children,Child Abuse,Female,18-30,8278,7385,893,8086,192
2002,Urban,Bihar,Crime Against Men,Assault,Female,31-45,8815,5611,3204,6325,2490
2001,Urban,Sikkim,Crime Against Children,Kidnapping,Male,18-30,6399,5692,707,6370,29
2003,Urban,Rajasthan,Property Crime,Vandalism,Female,0-12,3517,1664,1853,1691,1826
2006,Rural,Uttarakhand,Property Crime,Vandalism,Female,18-30,5508,3737,1771,4622,886
2006,Rural,Andhra Pradesh,Crime Against Men,Assault,Female,13-17,2699,1874,825,2129,570
2008,Urban,Jharkhand,Crime Against Children,Child Labor,Female,13-17,5212,1190,4022,5145,67
2008,Urban,Manipur,Other Crimes,Corruption,Female,46-60,7632,2584,5048,3888,3744
2002,Urban,Jharkhand,Crime Against Men,Extortion,Female,18-30,9598,7951,1647,9051,547
2005,Urban,Delhi,Property Crime,Theft,Female,0-12,1881,1846,35,1876,5
2003,Urban,Goa,Crime Against Women,Rape,Female,31-45,802,207,595,526,276
2009,Urban,Uttar Pradesh,Other Crimes,Corruption,Female,31-45,2650,2416,234,2499,151
2002,Urban,West Bengal,Property Crime,Vandalism,Female,46-60,1348,129,1219,359,989
2005,Urban,Uttar Pradesh,Crime Against Men,Extortion,Female,0-12,7945,2324,5621,4799,3146
2010,Urban,Meghalaya,Other Crimes,Drug Offense,Male,13-17,2610,1967,643,2147,463
2006,Urban,Kerala,Property Crime,Vandalism,Male,31-45,6826,3883,2943,5454,1372
2008,Rural,Arunachal Pradesh,Property Crime,Burglary,Female,18-30,2791,804,1987,2707,84
2004,Rural,Sikkim,Crime Against Children,Trafficking,Female,60+,4649,2892,1757,4187,462
2006,Urban,Chhattisgarh,Property Crime,Theft,Female,60+,8386,5918,2468,6636,1750
2008,Rural,West Bengal,Crime Against Children,Kidnapping,Female,46-60,9352,2875,6477,4509,4843
2001,Rural,Goa,Crime Against Children,Trafficking,Male,46-60,6822,1067,5755,5561,1261
2004,Rural,Mizoram,Crime Against Men,Robbery,Male,60+,5246,3603,1643,4255,991
2010,Rural,Jharkhand,Other Crimes,Fraud,Male,18-30,8787,462,8325,5281,3506
2005,Urban,Bihar,Crime Against Men,Murder,Male,18-30,2293,647,1646,1913,380
2001,Urban,Meghalaya,Other Crimes,Drug Offense,Female,46-60,3867,1449,2418,2921,946
2001,Urban,Odisha,Property Crime,Burglary,Female,60+,1079,1055,24,1071,8
2007,Urban,Tripura,Crime Against Men,Extortion,Male,46-60,4237,2134,2103,4176,61
2008,Rural,Chhattisgarh,Property Crime,Arson,Male,18-30,5487,4617,870,5080,407
2008,Urban,Chhattisgarh,Property Crime,Burglary,Female,13-17,2677,1753,924,1799,878
2002,Rural,Jharkhand,Crime Against Men,Assault,Female,0-12,6800,3843,2957,6298,502
2001,Rural,Rajasthan,Crime Against Children,Trafficking,Male,60+,5353,660,4693,837,4516
2002,Rural,Arunachal Pradesh,Other Crimes,Cyber Crime,Female,13-17,9505,8827,678,9125,380
2007,Urban,Mizoram,Property Crime,Burglary,Female,13-17,3512,2534,978,3460,52
2010,Urban,Meghalaya,Other Crimes,Drug Offense,Female,18-30,7125,6434,691,6762,363
2006,Urban,Delhi,Property Crime,Theft,Male,18-30,5949,4466,1483,5765,184
2004,Rural,Uttar Pradesh,Property Crime,Arson,Female,31-45,3570,1696,1874,1962,1608
2009,Rural,Maharashtra,Crime Against Men,Extortion,Female,31-45,8161,904,7257,5489,2672
2006,Rural,Haryana,Crime Against Men,Robbery,Female,46-60,8250,5911,2339,6490,1760
2010,Rural,Meghalaya,Property Crime,Theft,Male,0-12,4794,184,4610,457,4337
2008,Urban,Gujarat,Other Crimes,Cyber Crime,Male,60+,419,191,228,289,130
2003,Rural,Himachal Pradesh,Crime Against Women,Dowry Deaths,Female,18-30,4795,4451,344,4610,185
2003,Urban,Kerala,Property Crime,Burglary,Male,31-45,9920,5678,4242,7781,2139
2008,Rural,Uttar Pradesh,Crime Against Women,Dowry Deaths,Female,31-45,2202,1851,351,1901,301
2004,Rural,Odisha,Other Crimes,Corruption,Female,60+,3488,1123,2365,2718,770
2004,Rural,Mizoram,Crime Against Men,Murder,Female,31-45,9547,8321,1226,8453,1094
2004,Rural,Tripura,Crime Against Men,Murder,Female,46-60,5702,3989,1713,3996,1706
2008,Urban,Goa,Property Crime,Burglary,Female,46-60,905,165,740,303,602
2010,Urban,Andhra Pradesh,Crime Against Men,Murder,Female,0-12,4488,1052,3436,1905,2583
2005,Urban,Sikkim,Other Crimes,Drug Offense,Female,46-60,460,159,301,244,216
2005,Rural,Manipur,Crime Against Women,Rape,Female,13-17,3869,3039,830,3412,457
2003,Urban,Arunachal Pradesh,Crime Against Men,Murder,Female,46-60,6585,2936,3649,6157,428
2009,Rural,Chhattisgarh,Property Crime,Arson,Male,13-17,7135,1250,5885,5857,1278
2005,Urban,Karnataka,Other Crimes,Drug Offense,Female,0-12,765,316,449,351,414
2007,Rural,Goa,Crime Against Women,Molestation,Male,18-30,6820,44,6776,703,6117
2004,Urban,Haryana,Crime Against Men,Murder,Male,18-30,7923,6832,1091,7672,251
2004,Urban,Gujarat,Crime Against Children,Child Abuse,Female,13-17,8290,6777,1513,7064,1226
2006,Rural,Gujarat,Crime Against Men,Murder,Male,13-17,3900,229,3671,583,3317
2010,Rural,Andhra Pradesh,Crime Against Children,Trafficking,Female,0-12,8992,1366,7626,4529,4463
2010,Rural,Karnataka,Crime Against Men,Assault,Female,18-30,4413,2373,2040,4172,241
2006,Rural,Mizoram,Crime Against Men,Extortion,Female,46-60,3795,940,2855,2960,835
2004,Urban,Uttarakhand,Crime Against Men,Murder,Male,60+,5185,688,4497,4421,764
2009,Rural,Rajasthan,Crime Against Children,Kidnapping,Female,18-30,7575,5208,2367,6088,1487
2002,Rural,Punjab,Crime Against Men,Robbery,Male,60+,3946,1161,2785,1168,2778
2010,Rural,Uttar Pradesh,Crime Against Men,Murder,Female,0-12,5928,313,5615,4616,1312
2010,Rural,Tamil Nadu,Crime Against Men,Robbery,Female,31-45,3788,457,3331,1388,2400
2009,Urban,Arunachal Pradesh,Crime Against Children,Kidnapping,Male,0-12,1588,1306,282,1489,99
2007,Urban,West Bengal,Property Crime,Theft,Male,46-60,9936,9451,485,9458,478
2003,Rural,Meghalaya,Crime Against Women,Domestic Violence,Female,46-60,6898,4202,2696,6669,229
2005,Urban,Chhattisgarh,Other Crimes,Corruption,Female,13-17,3253,1272,1981,1675,1578
2006,Urban,Delhi,Property Crime,Arson,Male,60+,807,219,588,392,415
2007,Urban,Meghalaya,Crime Against Children,Child Abuse,Female,31-45,6449,5661,788,6343,106
2007,Urban,Delhi,Crime Against Men,Assault,Female,0-12,1618,305,1313,485,1133
2006,Rural,Mizoram,Other Crimes,Fraud,Male,13-17,7859,1583,6276,3802,4057
2010,Rural,Jharkhand,Crime Against Men,Extortion,Male,31-45,1829,1288,541,1322,507
2005,Urban,Assam,Crime Against Children,Child Abuse,Male,46-60,7123,6732,391,6963,160
2010,Rural,Assam,Crime Against Women,Rape,Female,18-30,8131,569,7562,5002,3129
2007,Rural,Haryana,Crime Against Men,Assault,Male,0-12,1660,1181,479,1579,81
2009,Rural,Kerala,Crime Against Men,Extortion,Female,31-45,6162,2975,3187,4009,2153
2005,Rural,Arunachal Pradesh,Other Crimes,Cyber Crime,Female,46-60,5552,1471,4081,2946,2606
2008,Rural,Arunachal Pradesh,Other Crimes,Drug Offense,Female,13-17,2798,1372,1426,2144,654
2007,Urban,Kerala,Crime Against Children,Kidnapping,Female,31-45,9506,6270,3236,7085,2421
2007,Rural,Goa,Property Crime,Arson,Male,31-45,5047,612,4435,4055,992
2001,Rural,Sikkim,Other Crimes,Drug Offense,Male,13-17,8361,6182,2179,7023,1338
2005,Urban,Karnataka,Crime Against Children,Child Abuse,Male,13-17,8659,4926,3733,6507,2152
2007,Rural,Kerala,Other Crimes,Fraud,Male,31-45,9523,6054,3469,7865,1658
2006,Rural,Jharkhand,Property Crime,Burglary,Male,60+,7969,1309,6660,1685,6284
2009,Urban,Karnataka,Other Crimes,Corruption,Female,46-60,3886,2863,1023,3304,582
2003,Urban,Mizoram,Crime Against Children,Kidnapping,Male,31-45,4076,2409,1667,3339,737
2009,Rural,Mizoram,Crime Against Women,Rape,Female,31-45,6540,6131,409,6536,4
2003,Urban,Uttar Pradesh,Crime Against Men,Assault,Female,31-45,2900,2884,16,2896,4
2006,Urban,Jharkhand,Crime Against Women,Dowry Deaths,Male,18-30,6122,5501,621,6099,23
2005,Rural,Madhya Pradesh,Crime Against Women,Rape,Male,60+,9109,964,8145,4754,4355
2002,Rural,Tripura,Crime Against Children,Trafficking,Male,46-60,9296,7908,1388,8322,974
2004,Urban,Kerala,Crime Against Men,Assault,Male,18-30,6426,4092,2334,4606,1820
2005,Urban,Delhi,Crime Against Men,Murder,Female,13-17,153,143,10,144,9
2006,Rural,Manipur,Crime Against Women,Rape,Male,60+,5375,3695,1680,4647,728
2008,Urban,West Bengal,Property Crime,Theft,Female,60+,3659,771,2888,2939,720
2003,Urban,Kerala,Property Crime,Burglary,Male,60+,9937,8592,1345,8794,1143
2003,Urban,Uttar Pradesh,Other Crimes,Corruption,Male,60+,7410,7098,312,7402,8
2007,Rural,Uttarakhand,Crime Against Women,Rape,Female,13-17,2053,1167,886,1754,299
2010,Rural,Haryana,Property Crime,Theft,Male,46-60,4197,3121,1076,3129,1068
2003,Rural,Assam,Crime Against Men,Murder,Female,60+,3118,1280,1838,1825,1293
2008,Rural,Assam,Property Crime,Vandalism,Female,31-45,5432,2448,2984,4532,900
2007,Rural,Madhya Pradesh,Crime Against Children,Child Abuse,Male,18-30,9242,4562,4680,6290,2952
2010,Urban,Karnataka,Other Crimes,Corruption,Female,13-17,8419,5387,3032,5874,2545
2003,Rural,Sikkim,Crime Against Men,Robbery,Male,13-17,2491,453,2038,1060,1431
2004,Urban,Jammu & Kashmir,Crime Against Women,Domestic Violence,Male,60+,5424,4227,1197,4684,740
2005,Rural,Bihar,Crime Against Children,Child Abuse,Male,0-12,1178,229,949,834,344
2002,Rural,Karnataka,Other Crimes,Drug Offense,Male,13-17,8433,5666,2767,7902,531
2004,Rural,Punjab,Crime Against Men,Robbery,Male,31-45,7355,3604,3751,3915,3440
2009,Rural,Rajasthan,Crime Against Children,Trafficking,Female,13-17,9917,7346,2571,9324,593
2002,Urban,Mizoram,Crime Against Women,Dowry Deaths,Male,0-12,4064,1846,2218,2907,1157
2009,Urban,Haryana,Crime Against Children,Kidnapping,Male,31-45,3887,1003,2884,2309,1578
2007,Urban,Karnataka,Property Crime,Vandalism,Male,31-45,8149,7129,1020,8074,75
2006,Urban,Jharkhand,Other Crimes,Corruption,Female,31-45,485,304,181,353,132
2010,Urban,Meghalaya,Property Crime,Vandalism,Female,31-45,8327,4201,4126,6985,1342
2004,Rural,Mizoram,Crime Against Men,Assault,Female,18-30,9338,634,8704,1390,7948
2003,Urban,Nagaland,Property Crime,Arson,Female,60+,2582,719,1863,888,1694
2004,Urban,Telangana,Crime Against Women,Dowry Deaths,Male,46-60,1983,315,1668,557,1426
2005,Urban,Nagaland,Crime Against Women,Molestation,Female,0-12,2269,706,1563,2235,34
2004,Urban,Tripura,Crime Against Children,Child Labor,Male,46-60,2242,1984,258,2185,57
2002,Urban,Uttarakhand,Crime Against Children,Kidnapping,Female,0-12,6588,2243,4345,5896,692
2005,Urban,West Bengal,Crime Against Women,Molestation,Male,18-30,5278,978,4300,2513,2765
2004,Rural,Andhra Pradesh,Crime Against Children,Trafficking,Female,60+,3142,766,2376,2723,419
2005,Urban,Mizoram,Crime Against Men,Extortion,Female,13-17,6600,157,6443,5457,1143
2003,Urban,Delhi,Crime Against Women,Rape,Female,60+,8276,5305,2971,6922,1354
2008,Urban,Punjab,Other Crimes,Cyber Crime,Female,31-45,2184,109,2075,1673,511
2010,Rural,Tripura,Other Crimes,Corruption,Male,0-12,9553,5041,4512,5869,3684
2002,Rural,Rajasthan,Crime Against Men,Murder,Male,31-45,4556,2137,2419,2494,2062
2008,Urban,Uttar Pradesh,Crime Against Children,Child Labor,Female,31-45,1828,676,1152,1815,13
2002,Rural,Manipur,Crime Against Women,Molestation,Female,18-30,5795,3909,1886,5381,414
2010,Urban,Madhya Pradesh,Crime Against Women,Dowry Deaths,Male,31-45,414,173,241,308,106
2008,Urban,Jammu & Kashmir,Property Crime,Arson,Male,46-60,3262,1533,1729,1794,1468
2006,Rural,Bihar,Crime Against Women,Domestic Violence,Male,18-30,3616,1226,2390,1456,2160
2001,Rural,Delhi,Other Crimes,Fraud,Female,46-60,2485,1541,944,1910,575
2007,Urban,Meghalaya,Crime Against Women,Domestic Violence,Male,18-30,6285,4278,2007,4798,1487
2002,Rural,Arunachal Pradesh,Property Crime,Theft,Male,0-12,3759,3114,645,3389,370
2009,Urban,Andhra Pradesh,Crime Against Men,Murder,Male,18-30,4245,1475,2770,1943,2302
2008,Urban,Gujarat,Property Crime,Arson,Female,31-45,7415,5020,2395,6959,456
2005,Rural,Jammu & Kashmir,Other Crimes,Fraud,Female,13-17,5969,5033,936,5677,292
2007,Urban,Arunachal Pradesh,Crime Against Men,Extortion,Male,18-30,5969,3153,2816,3193,2776
2001,Urban,Jharkhand,Property Crime,Theft,Male,46-60,6756,2348,4408,4526,2230
2010,Urban,Odisha,Property Crime,Vandalism,Female,31-45,349,154,195,235,114
2010,Rural,Nagaland,Property Crime,Theft,Male,0-12,6461,658,5803,5497,964
2009,Rural,Delhi,Other Crimes,Drug Offense,Male,31-45,9736,4923,4813,5220,4516
2002,Urban,Assam,Crime Against Women,Domestic Violence,Female,31-45,1270,718,552,774,496
2004,Rural,Haryana,Crime Against Men,Extortion,Male,31-45,8715,3200,5515,4304,4411
2001,Rural,Telangana,Crime Against Men,Extortion,Female,18-30,2027,1178,849,1692,335
2002,Rural,Rajasthan,Crime Against Men,Robbery,Male,60+,4078,3560,518,4048,30
2007,Urban,Bihar,Crime Against Women,Molestation,Male,18-30,8670,3827,4843,5310,3360
2001,Urban,Mizoram,Property Crime,Theft,Male,46-60,9943,5406,4537,8826,1117
2010,Rural,Chhattisgarh,Crime Against Women,Domestic Violence,Female,60+,6195,2280,3915,5694,501
2009,Urban,Tripura,Crime Against Children,Kidnapping,Female,46-60,7476,61,7415,1582,5894
2001,Urban,Madhya Pradesh,Crime Against Children,Child Abuse,Male,0-12,2935,188,2747,2240,695
2005,Urban,Nagaland,Crime Against Men,Extortion,Male,60+,6590,2252,4338,2319,4271
2002,Urban,Telangana,Other Crimes,Fraud,Male,13-17,5559,4589,970,4988,571
2010,Rural,Meghalaya,Crime Against Women,Domestic Violence,Female,0-12,8264,5613,2651,5756,2508
2002,Rural,Arunachal Pradesh,Crime Against Men,Extortion,Male,46-60,7888,3065,4823,6828,1060
2004,Rural,Odisha,Other Crimes,Corruption,Female,0-12,1344,284,1060,572,772
2006,Rural,West Bengal,Crime Against Children,Kidnapping,Male,0-12,4106,252,3854,2737,1369
2008,Urban,Uttarakhand,Crime Against Children,Child Labor,Female,46-60,1033,874,159,979,54
2010,Rural,Telangana,Property Crime,Vandalism,Male,46-60,6674,2503,4171,5139,1535
2006,Urban,Nagaland,Crime Against Men,Robbery,Female,46-60,8089,7931,158,8083,6
2003,Urban,Rajasthan,Other Crimes,Cyber Crime,Male,31-45,3095,640,2455,1032,2063
2001,Urban,Meghalaya,Other Crimes,Drug Offense,Female,46-60,5784,5005,779,5679,105
2002,Rural,Chhattisgarh,Property Crime,Arson,Female,60+,8017,6808,1209,7758,259
2008,Urban,Telangana,Other Crimes,Cyber Crime,Female,31-45,4040,1422,2618,2684,1356
2007,Rural,Jharkhand,Crime Against Men,Extortion,Female,31-45,7922,6579,1343,7257,665
2007,Urban,Himachal Pradesh,Crime Against Children,Kidnapping,Male,13-17,2057,1978,79,2025,32
2006,Rural,Gujarat,Property Crime,Arson,Male,46-60,5648,4991,657,5347,301
2005,Urban,Punjab,Other Crimes,Cyber Crime,Male,60+,3931,984,2947,1857,2074
2010,Urban,Punjab,Crime Against Children,Kidnapping,Male,60+,3169,2813,356,3067,102
2008,Rural,Gujarat,Crime Against Men,Murder,Male,0-12,1067,719,348,858,209
2006,Urban,West Bengal,Crime Against Men,Assault,Male,18-30,2015,907,1108,1119,896
2007,Urban,Himachal Pradesh,Property Crime,Theft,Female,18-30,8659,7303,1356,7936,723
2010,Rural,Uttar Pradesh,Crime Against Men,Extortion,Female,18-30,77,6,71,57,20
2010,Urban,Bihar,Crime Against Men,Assault,Female,13-17,9010,768,8242,8295,715
2001,Urban,Arunachal Pradesh,Other Crimes,Fraud,Female,31-45,1348,880,468,993,355
2002,Rural,Andhra Pradesh,Property Crime,Burglary,Male,31-45,2830,1421,1409,2298,532
2001,Urban,Kerala,Property Crime,Vandalism,Female,46-60,5895,3910,1985,3974,1921
2004,Rural,Uttarakhand,Crime Against Children,Trafficking,Male,18-30,1318,996,322,1267,51
2002,Urban,Rajasthan,Crime Against Men,Murder,Male,0-12,5211,2581,2630,3546,1665
2004,Rural,Arunachal Pradesh,Other Crimes,Drug Offense,Female,13-17,198,159,39,182,16
2008,Rural,Goa,Other Crimes,Fraud,Male,13-17,9376,3739,5637,3904,5472
2008,Rural,Himachal Pradesh,Property Crime,Arson,Male,0-12,8624,8526,98,8611,13
2009,Urban,West Bengal,Property Crime,Theft,Female,0-12,1394,265,1129,1361,33
2009,Urban,Rajasthan,Crime Against Men,Assault,Female,31-45,7491,632,6859,6625,866
2008,Urban,Jammu & Kashmir,Crime Against Men,Murder,Male,18-30,7835,2489,5346,2631,5204
2002,Urban,Uttar Pradesh,Other Crimes,Drug Offense,Male,18-30,5028,1476,3552,1587,3441
2006,Urban,Rajasthan,Crime Against Women,Domestic Violence,Female,0-12,1401,712,689,1285,116
2005,Rural,Chhattisgarh,Crime Against Men,Extortion,Female,46-60,7065,1932,5133,6944,121
2002,Urban,Jharkhand,Crime Against Women,Dowry Deaths,Male,31-45,2379,690,1689,1933,446
2010,Rural,Sikkim,Crime Against Men,Robbery,Male,60+,3283,354,2929,1331,1952
2007,Urban,Tamil Nadu,Other Crimes,Fraud,Female,46-60,7827,1331,6496,2195,5632
2010,Urban,Jharkhand,Property Crime,Theft,Male,0-12,8931,898,8033,7345,1586
2008,Urban,Tamil Nadu,Crime Against Men,Robbery,Female,18-30,739,470,269,595,144
2001,Urban,Gujarat,Crime Against Women,Molestation,Male,13-17,7075,4914,2161,5020,2055
2004,Rural,Jammu & Kashmir,Property Crime,Arson,Male,31-45,5024,2880,2144,2895,2129
2004,Urban,Sikkim,Crime Against Children,Child Labor,Female,31-45,9766,5771,3995,7518,2248
2010,Rural,Uttar Pradesh,Property Crime,Burglary,Female,0-12,9081,711,8370,3048,6033
2003,Rural,Kerala,Crime Against Women,Molestation,Female,18-30,2102,1539,563,2081,21
2005,Urban,Kerala,Property Crime,Vandalism,Female,0-12,1434,693,741,717,717
2002,Urban,Tripura,Crime Against Men,Murder,Female,18-30,8520,4923,3597,7100,1420
2003,Rural,Odisha,Other Crimes,Corruption,Male,60+,9951,4033,5918,4915,5036
2010,Urban,Assam,Crime Against Men,Robbery,Female,13-17,3163,2901,262,2976,187
2010,Rural,Manipur,Property Crime,Theft,Male,18-30,542,6,536,100,442
2006,Rural,West Bengal,Property Crime,Arson,Male,0-12,6424,4986,1438,6015,409
2007,Urban,Delhi,Crime Against Men,Extortion,Male,18-30,8055,2720,5335,5362,2693
2003,Rural,Uttar Pradesh,Property Crime,Arson,Female,31-45,8073,860,7213,4763,3310
2005,Urban,Jammu & Kashmir,Crime Against Men,Assault,Male,60+,3551,3481,70,3511,40
2006,Urban,Manipur,Crime Against Women,Molestation,Female,60+,5165,1269,3896,4949,216
2008,Rural,Haryana,Crime Against Children,Kidnapping,Male,60+,7591,1707,5884,2494,5097
2003,Urban,Telangana,Crime Against Children,Trafficking,Female,18-30,5516,5115,401,5243,273
2001,Urban,Uttar Pradesh,Crime Against Women,Domestic Violence,Female,31-45,614,57,557,369,245
2008,Rural,Jharkhand,Crime Against Women,Domestic Violence,Female,0-12,7136,2405,4731,2564,4572
2009,Urban,Andhra Pradesh,Crime Against Children,Kidnapping,Female,46-60,3651,2235,1416,2791,860
2009,Urban,Madhya Pradesh,Crime Against Women,Dowry Deaths,Female,18-30,3843,1676,2167,2825,1018
2001,Rural,West Bengal,Property Crime,Arson,Male,0-12,9421,5185,4236,8134,1287
2006,Rural,Andhra Pradesh,Crime Against Men,Robbery,Male,13-17,681,100,581,106,575
2004,Urban,Odisha,Crime Against Children,Child Abuse,Female,13-17,4971,4009,962,4918,53
2002,Rural,Tamil Nadu,Crime Against Women,Domestic Violence,Female,60+,2523,1877,646,2320,203
2010,Rural,Assam,Property Crime,Vandalism,Male,31-45,2210,1895,315,2140,70
2008,Urban,Haryana,Crime Against Women,Molestation,Female,0-12,4576,2411,2165,2516,2060
2009,Urban,Sikkim,Crime Against Children,Trafficking,Male,31-45,3754,2841,913,2913,841
2006,Urban,Manipur,Crime Against Men,Assault,Female,46-60,2586,1303,1283,2418,168
2009,Rural,Manipur,Crime Against Men,Murder,Female,60+,8701,5574,3127,7155,1546
2003,Rural,Madhya Pradesh,Crime Against Children,Trafficking,Female,46-60,5651,2657,2994,4551,1100
2005,Urban,Jharkhand,Crime Against Men,Murder,Female,18-30,4253,1516,2737,1657,2596
2004,Urban,Meghalaya,Property Crime,Arson,Female,0-12,1703,1501,202,1598,105
2006,Urban,Chhattisgarh,Property Crime,Burglary,Male,60+,1732,1045,687,1384,348
2005,Urban,Tripura,Other Crimes,Corruption,Female,31-45,6087,1921,4166,2041,4046
2001,Rural,West Bengal,Crime Against Men,Murder,Male,31-45,1433,351,1082,1295,138
2007,Urban,Assam,Other Crimes,Cyber Crime,Male,46-60,7288,7015,273,7086,202
2009,Rural,Uttarakhand,Crime Against Men,Assault,Female,0-12,2747,1111,1636,2256,491
2008,Rural,Kerala,Crime Against Women,Molestation,Male,31-45,3260,790,2470,2603,657
2003,Rural,Tripura,Crime Against Children,Trafficking,Female,18-30,6276,4389,1887,4745,1531
2006,Urban,Punjab,Other Crimes,Corruption,Male,31-45,4068,2414,1654,2619,1449
2003,Rural,Kerala,Other Crimes,Drug Offense,Male,46-60,8827,954,7873,7001,1826
2001,Urban,Manipur,Crime Against Men,Robbery,Male,60+,6549,2626,3923,4297,2252
2004,Urban,Tamil Nadu,Other Crimes,Cyber Crime,Male,13-17,6008,752,5256,2077,3931
2009,Urban,Karnataka,Other Crimes,Drug Offense,Male,0-12,9204,5414,3790,6752,2452
2001,Urban,Uttar Pradesh,Property Crime,Arson,Female,60+,578,437,141,503,75
2008,Urban,Meghalaya,Crime Against Men,Murder,Female,31-45,4887,1536,3351,2626,2261
2001,Rural,Sikkim,Crime Against Children,Child Abuse,Male,13-17,5511,2724,2787,3910,1601
2004,Rural,West Bengal,Other Crimes,Drug Offense,Female,46-60,2193,1690,503,2097,96
2001,Rural,Mizoram,Property Crime,Vandalism,Female,60+,6204,332,5872,5377,827
2007,Rural,Assam,Crime Against Children,Kidnapping,Female,18-30,1205,941,264,1159,46
2006,Urban,Uttarakhand,Other Crimes,Fraud,Female,60+,9199,2249,6950,4410,4789
2008,Rural,Karnataka,Crime Against Women,Molestation,Male,46-60,2414,59,2355,513,1901
2009,Rural,Maharashtra,Crime Against Women,Molestation,Female,0-12,9970,2438,7532,5738,4232
2008,Rural,Delhi,Crime Against Women,Molestation,Male,31-45,832,34,798,70,762
2009,Urban,Manipur,Property Crime,Arson,Male,46-60,3435,427,3008,831,2604
2009,Rural,Tamil Nadu,Crime Against Children,Trafficking,Female,60+,1320,778,542,1273,47
2008,Rural,Arunachal Pradesh,Crime Against Women,Rape,Female,13-17,726,410,316,494,232
2002,Rural,West Bengal,Crime Against Women,Rape,Female,0-12,490,247,243,263,227
2001,Urban,Tamil Nadu,Property Crime,Arson,Female,13-17,3246,892,2354,3041,205
2004,Rural,Madhya Pradesh,Crime Against Women,Rape,Male,0-12,5307,4660,647,4758,549
2003,Urban,Bihar,Crime Against Women,Dowry Deaths,Male,18-30,8539,1244,7295,4630,3909
2003,Rural,Arunachal Pradesh,Crime Against Men,Murder,Male,31-45,6683,3078,3605,3140,3543
2007,Urban,Jammu & Kashmir,Crime Against Men,Assault,Male,18-30,7572,1697,5875,1700,5872
2004,Urban,Uttarakhand,Crime Against Men,Murder,Male,0-12,4243,380,3863,424,3819
2010,Urban,Delhi,Crime Against Women,Dowry Deaths,Male,13-17,8999,2165,6834,5567,3432
2008,Urban,Odisha,Other Crimes,Corruption,Male,0-12,9670,4060,5610,4713,4957
2002,Urban,Jammu & Kashmir,Crime Against Men,Extortion,Female,31-45,9657,3738,5919,6717,2940
2010,Urban,Tamil Nadu,Crime Against Children,Child Abuse,Male,31-45,248,82,166,187,61
2009,Urban,Jharkhand,Other Crimes,Corruption,Male,31-45,1282,170,1112,724,558
2002,Urban,Nagaland,Crime Against Children,Child Abuse,Male,46-60,8742,3823,4919,8201,541
2006,Urban,Bihar,Crime Against Children,Kidnapping,Male,46-60,6702,4570,2132,6264,438
2007,Urban,Arunachal Pradesh,Property Crime,Vandalism,Male,60+,1541,424,1117,1102,439
2005,Rural,Tripura,Other Crimes,Corruption,Female,31-45,3877,2431,1446,3217,660
2008,Urban,Jammu & Kashmir,Crime Against Children,Trafficking,Male,13-17,8847,2171,6676,6570,2277
2010,Urban,Punjab,Other Crimes,Cyber Crime,Male,60+,8151,6986,1165,7469,682
2001,Urban,Andhra Pradesh,Property Crime,Arson,Female,31-45,4148,1197,2951,3097,1051
2008,Rural,Odisha,Crime Against Children,Child Labor,Male,31-45,8071,61,8010,2470,5601
2001,Rural,Assam,Property Crime,Theft,Male,31-45,3436,249,3187,2289,1147
2003,Urban,Chhattisgarh,Crime Against Men,Assault,Female,60+,5721,4816,905,5147,574
2006,Urban,Uttarakhand,Crime Against Children,Kidnapping,Male,46-60,4097,3091,1006,3523,574
2008,Urban,Bihar,Crime Against Men,Assault,Male,18-30,385,68,317,101,284
2007,Rural,Jammu & Kashmir,Crime Against Children,Child Labor,Female,18-30,8162,4942,3220,5325,2837
2009,Urban,Delhi,Other Crimes,Cyber Crime,Male,18-30,4961,2099,2862,3555,1406
2006,Urban,Rajasthan,Crime Against Children,Child Labor,Female,60+,2584,1832,752,1835,749
2001,Urban,Jammu & Kashmir,Property Crime,Vandalism,Female,60+,1087,13,1074,1037,50
2008,Urban,Kerala,Other Crimes,Drug Offense,Male,60+,2782,2632,150,2635,147
2009,Rural,Gujarat,Other Crimes,Drug Offense,Female,60+,4836,3537,1299,3865,971
2005,Urban,Kerala,Crime Against Men,Murder,Male,31-45,4928,2904,2024,4854,74
2010,Rural,Maharashtra,Property Crime,Vandalism,Male,60+,1888,1739,149,1885,3
2008,Rural,Meghalaya,Property Crime,Arson,Female,31-45,6568,6293,275,6396,172
2004,Rural,Mizoram,Property Crime,Arson,Male,13-17,8980,1150,7830,5263,3717
2008,Urban,Delhi,Other Crimes,Cyber Crime,Female,0-12,1256,66,1190,91,1165
2009,Urban,Goa,Crime Against Children,Child Labor,Female,31-45,6937,1138,5799,2831,4106
2008,Urban,Maharashtra,Crime Against Children,Child Abuse,Male,31-45,2692,905,1787,2091,601
2002,Urban,Odisha,Crime Against Children,Trafficking,Male,18-30,6714,2422,4292,4693,2021
2004,Rural,Odisha,Crime Against Men,Murder,Male,0-12,5831,1515,4316,5586,245
2003,Rural,Gujarat,Crime Against Women,Dowry Deaths,Female,60+,1367,1242,125,1365,2
2004,Rural,Gujarat,Other Crimes,Fraud,Male,13-17,3514,2803,711,3117,397
2003,Urban,Madhya Pradesh,Crime Against Children,Child Labor,Female,13-17,6196,1983,4213,2564,3632
2010,Urban,Bihar,Other Crimes,Drug Offense,Female,31-45,4754,3822,932,4159,595
2001,Urban,Gujarat,Crime Against Men,Extortion,Male,0-12,7336,4917,2419,6476,860
2007,Urban,Karnataka,Crime Against Children,Child Labor,Female,46-60,7126,1006,6120,6101,1025
2002,Rural,Delhi,Crime Against Women,Domestic Violence,Female,46-60,4605,3332,1273,4597,8
2002,Urban,Bihar,Crime Against Children,Child Abuse,Female,60+,802,20,782,589,213
2004,Rural,Madhya Pradesh,Crime Against Women,Molestation,Male,31-45,3743,3414,329,3662,81
2009,Urban,Bihar,Crime Against Women,Molestation,Female,0-12,5134,561,4573,1769,3365
2007,Urban,Odisha,Crime Against Children,Child Labor,Male,60+,8421,5014,3407,7339,1082
2006,Urban,Madhya Pradesh,Crime Against Children,Child Labor,Female,46-60,8251,7403,848,7971,280
2005,Rural,Assam,Other Crimes,Cyber Crime,Female,13-17,6001,3604,2397,4913,1088
2001,Urban,Bihar,Other Crimes,Corruption,Female,0-12,1804,13,1791,515,1289
2009,Rural,West Bengal,Other Crimes,Corruption,Male,31-45,4276,2806,1470,3094,1182
2004,Urban,Goa,Crime Against Women,Molestation,Female,13-17,623,615,8,622,1
2001,Urban,Jharkhand,Property Crime,Vandalism,Female,18-30,2139,711,1428,1776,363
2008,Rural,Uttar Pradesh,Crime Against Women,Dowry Deaths,Female,46-60,4303,3665,638,4022,281
2010,Rural,Jammu & Kashmir,Crime Against Children,Child Abuse,Female,0-12,5971,1349,4622,1923,4048
2001,Urban,Telangana,Crime Against Women,Dowry Deaths,Female,31-45,8396,3629,4767,6084,2312
2002,Urban,Telangana,Property Crime,Arson,Female,31-45,3367,3212,155,3250,117
2008,Urban,Maharashtra,Crime Against Women,Rape,Male,60+,6641,5608,1033,6518,123
2003,Urban,Goa,Crime Against Children,Trafficking,Female,18-30,4644,4625,19,4625,19
2009,Urban,Tamil Nadu,Crime Against Children,Child Labor,Male,60+,2133,724,1409,1801,332
2006,Rural,Odisha,Property Crime,Arson,Female,0-12,9693,5090,4603,7450,2243
2003,Rural,Delhi,Other Crimes,Drug Offense,Female,60+,765,240,525,764,1
2009,Urban,Kerala,Crime Against Women,Domestic Violence,Female,46-60,5532,3296,2236,3752,1780
2002,Urban,Bihar,Property Crime,Arson,Male,31-45,4514,1828,2686,4219,295
2002,Urban,Haryana,Other Crimes,Cyber Crime,Female,13-17,9341,7298,2043,8081,1260
2005,Urban,West Bengal,Crime Against Men,Robbery,Male,18-30,9308,1456,7852,7539,1769
2010,Rural,Nagaland,Crime Against Children,Kidnapping,Male,31-45,9876,8863,1013,9421,455
2002,Rural,Goa,Crime Against Men,Murder,Male,0-12,1454,802,652,825,629
2003,Urban,Tamil Nadu,Other Crimes,Corruption,Female,60+,8641,7170,1471,7336,1305
2005,Urban,Himachal Pradesh,Crime Against Women,Rape,Male,60+,4211,3057,1154,4048,163
2006,Urban,Uttar Pradesh,Crime Against Women,Molestation,Female,0-12,4452,2521,1931,3279,1173
2005,Urban,Telangana,Property Crime,Burglary,Female,13-17,7718,3136,4582,5620,2098
2001,Rural,Punjab,Crime Against Men,Assault,Female,18-30,3846,1233,2613,2415,1431
2004,Urban,Goa,Other Crimes,Drug Offense,Male,0-12,8403,6866,1537,7253,1150
2007,Rural,Haryana,Crime Against Children,Trafficking,Male,0-12,8347,3624,4723,5128,3219
2001,Rural,Kerala,Crime Against Men,Extortion,Female,60+,8063,4653,3410,7760,303
2004,Urban,Bihar,Property Crime,Vandalism,Male,13-17,8285,4271,4014,4662,3623
2007,Urban,Assam,Property Crime,Theft,Female,60+,6641,5049,1592,5612,1029
2010,Rural,Jharkhand,Crime Against Children,Kidnapping,Female,31-45,4051,2185,1866,3183,868
2001,Urban,Manipur,Crime Against Children,Trafficking,Female,13-17,3051,2803,248,2820,231
2010,Rural,Jharkhand,Other Crimes,Cyber Crime,Male,0-12,5562,4153,1409,4180,1382
2005,Urban,Assam,Crime Against Men,Robbery,Male,13-17,4288,2183,2105,4026,262
2008,Rural,Tripura,Property Crime,Arson,Female,46-60,2913,2203,710,2458,455
2001,Rural,Haryana,Crime Against Children,Child Labor,Female,31-45,4978,3918,1060,4047,931
2004,Rural,West Bengal,Property Crime,Vandalism,Female,13-17,3399,970,2429,3007,392
2009,Rural,Sikkim,Crime Against Children,Child Abuse,Male,46-60,2713,2331,382,2486,227
2008,Rural,Bihar,Crime Against Men,Assault,Female,46-60,1903,478,1425,1622,281
2010,Urban,Jharkhand,Crime Against Women,Molestation,Male,0-12,1291,508,783,1265,26
2001,Urban,Odisha,Crime Against Men,Extortion,Female,60+,4795,4653,142,4754,41
2004,Rural,Nagaland,Crime Against Children,Kidnapping,Female,46-60,603,500,103,514,89
2002,Urban,Meghalaya,Other Crimes,Cyber Crime,Male,18-30,7778,4443,3335,7709,69
2004,Rural,Mizoram,Crime Against Children,Child Abuse,Male,31-45,5340,3524,1816,4188,1152
2003,Rural,Uttar Pradesh,Crime Against Children,Child Labor,Male,18-30,3603,1901,1702,2673,930
2006,Urban,Uttarakhand,Property Crime,Arson,Male,13-17,7069,3491,3578,5780,1289
2002,Urban,Tamil Nadu,Other Crimes,Cyber Crime,Male,18-30,6872,2487,4385,2905,3967
2002,Urban,Goa,Crime Against Children,Trafficking,Male,60+,2638,575,2063,1100,1538
2003,Urban,Gujarat,Crime Against Men,Assault,Female,46-60,5164,879,4285,3383,1781
2004,Urban,Madhya Pradesh,Crime Against Women,Dowry Deaths,Female,31-45,8778,3376,5402,7489,1289
2001,Rural,Goa,Crime Against Women,Rape,Male,60+,4068,1619,2449,2838,1230
2007,Urban,Andhra Pradesh,Crime Against Children,Kidnapping,Female,31-45,1647,1207,440,1364,283
2009,Rural,Uttar Pradesh,Crime Against Men,Assault,Male,60+,6667,1682,4985,5401,1266
2007,Rural,Odisha,Other Crimes,Fraud,Male,13-17,9404,711,8693,7298,2106
2007,Urban,Odisha,Crime Against Men,Extortion,Male,31-45,2838,331,2507,1643,1195
2004,Urban,Chhattisgarh,Crime Against Children,Child Labor,Female,18-30,3731,735,2996,1519,2212
2004,Rural,Telangana,Property Crime,Vandalism,Female,13-17,1382,1201,181,1283,99
2007,Rural,Punjab,Other Crimes,Corruption,Female,60+,7095,945,6150,6865,230
2010,Urban,Goa,Other Crimes,Corruption,Female,13-17,3622,581,3041,2825,797
2004,Rural,Tamil Nadu,Crime Against Men,Extortion,Female,46-60,2087,1883,204,1901,186
2002,Urban,Bihar,Crime Against Men,Murder,Female,18-30,8124,6403,1721,8120,4
2008,Urban,Nagaland,Crime Against Women,Domestic Violence,Male,0-12,9707,244,9463,545,9162
2004,Urban,Arunachal Pradesh,Crime Against Children,Trafficking,Female,13-17,968,1,967,911,57
2009,Rural,Nagaland,Crime Against Men,Assault,Female,31-45,7428,2428,5000,5548,1880
2006,Rural,Arunachal Pradesh,Crime Against Children,Child Abuse,Male,13-17,9888,7940,1948,8956,932
2009,Urban,Maharashtra,Other Crimes,Fraud,Male,18-30,6034,2564,3470,3994,2040
2004,Urban,Andhra Pradesh,Property Crime,Burglary,Male,46-60,1309,1136,173,1179,130
2010,Rural,Bihar,Property Crime,Theft,Male,0-12,5527,4478,1049,5065,462
2005,Urban,Arunachal Pradesh,Crime Against Women,Dowry Deaths,Male,18-30,2308,587,1721,2202,106
2008,Urban,Goa,Other Crimes,Drug Offense,Male,18-30,9371,7448,1923,9180,191
2010,Rural,Himachal Pradesh,Crime Against Children,Kidnapping,Female,0-12,6927,364,6563,3150,3777
2006,Rural,Chhattisgarh,Property Crime,Arson,Male,46-60,6014,2829,3185,5465,549
2004,Urban,Jharkhand,Crime Against Children,Child Abuse,Male,31-45,9173,458,8715,5677,3496
2003,Urban,Manipur,Crime Against Men,Murder,Female,18-30,6545,6521,24,6538,7
2008,Rural,Jharkhand,Property Crime,Theft,Female,0-12,7097,1659,5438,4710,2387
2004,Rural,Delhi,Property Crime,Burglary,Male,60+,8996,6541,2455,7460,1536
2007,Urban,West Bengal,Property Crime,Arson,Male,18-30,1819,1122,697,1671,148
2009,Urban,Meghalaya,Crime Against Men,Extortion,Female,18-30,7594,7306,288,7569,25
2008,Urban,Manipur,Crime Against Men,Extortion,Male,18-30,7353,1249,6104,4629,2724
2008,Rural,Uttar Pradesh,Other Crimes,Fraud,Male,13-17,2664,1120,1544,2403,261
2006,Rural,Punjab,Crime Against Children,Child Abuse,Male,18-30,2719,435,2284,2348,371
2006,Urban,Bihar,Other Crimes,Cyber Crime,Male,18-30,3425,1657,1768,3386,39
2007,Rural,Mizoram,Other Crimes,Corruption,Male,60+,5705,1534,4171,2902,2803
2001,Rural,Rajasthan,Crime Against Children,Trafficking,Male,31-45,1587,1364,223,1578,9
2010,Urban,Jammu & Kashmir,Crime Against Women,Rape,Male,13-17,4697,1811,2886,2105,2592
2001,Urban,Tripura,Crime Against Children,Trafficking,Male,31-45,1911,1800,111,1811,100
2006,Rural,Tripura,Crime Against Men,Assault,Male,31-45,9381,8987,394,9028,353
2003,Rural,Assam,Property Crime,Arson,Male,46-60,2501,1187,1314,1732,769
2006,Urban,Tamil Nadu,Property Crime,Burglary,Male,0-12,610,20,590,220,390
2002,Rural,Gujarat,Crime Against Men,Murder,Female,60+,4532,3141,1391,4050,482
2004,Rural,Mizoram,Crime Against Children,Child Labor,Male,31-45,842,352,490,368,474
2003,Rural,Tamil Nadu,Crime Against Women,Dowry Deaths,Female,0-12,8297,6231,2066,7644,653
2005,Rural,Jammu & Kashmir,Property Crime,Vandalism,Male,31-45,3346,815,2531,1028,2318
2003,Rural,Karnataka,Property Crime,Vandalism,Female,18-30,548,137,411,338,210
2005,Urban,Mizoram,Crime Against Women,Molestation,Male,18-30,2224,1861,363,2018,206
2008,Urban,Goa,Crime Against Men,Robbery,Female,13-17,5305,5059,246,5123,182
2001,Rural,Jharkhand,Crime Against Children,Kidnapping,Female,31-45,5145,645,4500,5021,124
2005,Rural,Maharashtra,Property Crime,Vandalism,Male,0-12,8773,4394,4379,5892,2881
2002,Rural,Rajasthan,Crime Against Women,Dowry Deaths,Female,18-30,3360,2984,376,3312,48
2010,Urban,Tamil Nadu,Crime Against Women,Domestic Violence,Female,31-45,9466,126,9340,5105,4361
2001,Urban,Meghalaya,Crime Against Men,Murder,Male,18-30,5217,4898,319,5070,147
2002,Rural,Delhi,Property Crime,Vandalism,Female,13-17,8624,5435,3189,7955,669
2002,Rural,Meghalaya,Crime Against Men,Robbery,Female,18-30,7486,6345,1141,6902,584
2002,Rural,Tripura,Crime Against Women,Domestic Violence,Female,60+,2346,1985,361,1997,349
2001,Urban,Karnataka,Crime Against Children,Kidnapping,Male,60+,2245,1695,550,2018,227
2003,Rural,Madhya Pradesh,Crime Against Children,Kidnapping,Male,0-12,8856,1201,7655,2945,5911
2010,Rural,Chhattisgarh,Crime Against Men,Robbery,Male,0-12,6960,3358,3602,5518,1442
2001,Rural,Punjab,Crime Against Children,Child Labor,Male,13-17,9398,2255,7143,9055,343
2010,Rural,Meghalaya,Crime Against Women,Rape,Male,18-30,8858,5439,3419,6984,1874
2004,Rural,Mizoram,Crime Against Men,Assault,Male,13-17,3666,2409,1257,3447,219
2005,Urban,Uttarakhand,Crime Against Men,Robbery,Male,0-12,5431,424,5007,2904,2527
2002,Urban,Kerala,Crime Against Women,Molestation,Female,31-45,4065,1647,2418,2452,1613
2008,Rural,Bihar,Other Crimes,Drug Offense,Female,46-60,350,304,46,323,27
2001,Urban,Madhya Pradesh,Crime Against Men,Murder,Female,13-17,9065,3009,6056,7483,1582
2010,Rural,Nagaland,Crime Against Children,Kidnapping,Female,46-60,8705,337,8368,3597,5108
2004,Urban,West Bengal,Other Crimes,Drug Offense,Male,31-45,3710,2451,1259,3452,258
2010,Rural,Kerala,Crime Against Women,Molestation,Male,60+,9130,4915,4215,7366,1764
2010,Rural,Punjab,Crime Against Children,Kidnapping,Female,0-12,9306,2332,6974,2730,6576
2003,Urban,Arunachal Pradesh,Crime Against Children,Child Labor,Female,0-12,6744,913,5831,5151,1593
2010,Rural,Nagaland,Other Crimes,Drug Offense,Male,46-60,4711,3940,771,3957,754
2005,Urban,Telangana,Property Crime,Vandalism,Male,60+,225,67,158,95,130
2009,Urban,Uttar Pradesh,Crime Against Children,Child Abuse,Male,46-60,8803,4820,3983,4829,3974
2006,Rural,Arunachal Pradesh,Property Crime,Burglary,Female,13-17,603,279,324,318,285
2005,Rural,Tripura,Crime Against Men,Assault,Female,18-30,4641,1168,3473,1922,2719
2007,Rural,Telangana,Crime Against Men,Robbery,Male,60+,6008,5909,99,5971,37
2005,Rural,West Bengal,Other Crimes,Cyber Crime,Female,0-12,5462,2757,2705,4549,913
2010,Rural,Chhattisgarh,Crime Against Women,Domestic Violence,Male,46-60,9126,4596,4530,8950,176
2008,Rural,Arunachal Pradesh,Other Crimes,Drug Offense,Male,13-17,3898,1358,2540,3174,724
2001,Rural,Haryana,Property Crime,Theft,Male,0-12,9070,7866,1204,8939,131
2005,Urban,Karnataka,Other Crimes,Cyber Crime,Female,60+,9857,5493,4364,6744,3113
2007,Urban,Haryana,Crime Against Men,Assault,Female,31-45,6108,4847,1261,5320,788
2002,Urban,West Bengal,Crime Against Women,Domestic Violence,Male,46-60,6025,5275,750,5936,89
2006,Rural,Manipur,Other Crimes,Drug Offense,Male,46-60,9570,335,9235,4385,5185
2002,Rural,Delhi,Crime Against Children,Child Labor,Female,60+,4342,1467,2875,4018,324
2003,Urban,Nagaland,Property Crime,Arson,Female,0-12,1540,955,585,1516,24
2001,Rural,Manipur,Crime Against Women,Domestic Violence,Female,31-45,3934,2821,1113,3252,682
2008,Urban,Chhattisgarh,Crime Against Women,Domestic Violence,Female,0-12,6478,1501,4977,3861,2617
2007,Urban,Goa,Crime Against Women,Domestic Violence,Male,13-17,3258,1989,1269,2868,390
2006,Urban,Andhra Pradesh,Crime Against Children,Kidnapping,Female,31-45,4782,2741,2041,4119,663
2003,Rural,Telangana,Other Crimes,Drug Offense,Female,31-45,411,207,204,343,68
2001,Urban,Bihar,Crime Against Men,Assault,Female,60+,9487,2137,7350,3502,5985
2009,Urban,Meghalaya,Crime Against Women,Dowry Deaths,Female,13-17,8911,2724,6187,8299,612
2004,Urban,Karnataka,Other Crimes,Corruption,Female,31-45,7753,4281,3472,6359,1394
2010,Rural,Kerala,Crime Against Men,Murder,Male,0-12,8063,1703,6360,3422,4641
2007,Urban,Bihar,Other Crimes,Cyber Crime,Female,18-30,759,448,311,641,118
2010,Rural,Karnataka,Other Crimes,Fraud,Male,13-17,3760,1371,2389,3740,20
2006,Rural,Jharkhand,Crime Against Children,Child Labor,Female,60+,9753,8275,1478,8965,788
2005,Rural,Kerala,Crime Against Children,Kidnapping,Female,31-45,66,10,56,23,43
2002,Rural,Punjab,Other Crimes,Corruption,Female,46-60,2644,925,1719,956,1688
2004,Rural,Meghalaya,Crime Against Men,Murder,Male,18-30,1071,790,281,1069,2
2008,Urban,Himachal Pradesh,Property Crime,Vandalism,Female,31-45,9098,2775,6323,5295,3803
2006,Urban,Jharkhand,Crime Against Women,Domestic Violence,Male,46-60,1477,726,751,1383,94
2006,Rural,Odisha,Other Crimes,Fraud,Male,31-45,1466,763,703,1349,117
2006,Urban,Tamil Nadu,Crime Against Women,Molestation,Male,60+,4036,3069,967,3884,152
2001,Urban,Arunachal Pradesh,Crime Against Men,Extortion,Female,0-12,8613,1489,7124,8321,292
2002,Rural,Nagaland,Property Crime,Arson,Male,46-60,9502,4625,4877,7211,2291
2008,Rural,Andhra Pradesh,Crime Against Men,Robbery,Male,0-12,261,43,218,116,145
2004,Urban,Andhra Pradesh,Property Crime,Arson,Male,18-30,7899,4983,2916,5932,1967
2008,Rural,West Bengal,Crime Against Men,Robbery,Female,46-60,7472,6277,1195,6924,548
2004,Rural,Kerala,Crime Against Men,Extortion,Female,18-30,6096,3516,2580,5883,213
2004,Urban,Jammu & Kashmir,Other Crimes,Corruption,Male,60+,8189,2971,5218,7840,349
2005,Rural,Rajasthan,Crime Against Women,Domestic Violence,Female,46-60,8856,4746,4110,4926,3930
2009,Urban,Punjab,Crime Against Men,Extortion,Female,18-30,8936,1112,7824,5672,3264
2004,Rural,Delhi,Crime Against Men,Robbery,Female,46-60,8220,1560,6660,5195,3025
2004,Urban,Sikkim,Other Crimes,Fraud,Female,31-45,856,332,524,472,384
2008,Urban,Odisha,Crime Against Men,Robbery,Female,46-60,3064,2813,251,2958,106
2009,Urban,Sikkim,Other Crimes,Cyber Crime,Female,46-60,5797,913,4884,4915,882
2003,Urban,Assam,Property Crime,Vandalism,Male,13-17,6854,1372,5482,3649,3205
2005,Rural,Karnataka,Property Crime,Burglary,Female,60+,9038,2843,6195,7893,1145
2005,Rural,Jammu & Kashmir,Crime Against Children,Trafficking,Female,18-30,2717,1520,1197,2109,608
2001,Rural,Rajasthan,Crime Against Women,Dowry Deaths,Female,46-60,1402,563,839,1231,171
2007,Urban,Kerala,Property Crime,Burglary,Female,13-17,7174,683,6491,4471,2703
2002,Urban,Jammu & Kashmir,Property Crime,Burglary,Female,60+,9327,6177,3150,8299,1028
2008,Rural,Odisha,Crime Against Men,Murder,Male,0-12,9699,8499,1200,9196,503
2005,Rural,Tripura,Property Crime,Vandalism,Male,0-12,8477,3806,4671,5062,3415
2003,Rural,Mizoram,Crime Against Women,Rape,Male,13-17,9242,440,8802,6417,2825
2002,Rural,Jharkhand,Crime Against Women,Domestic Violence,Male,31-45,5526,4387,1139,5439,87
2010,Rural,Karnataka,Crime Against Men,Assault,Female,31-45,9900,2570,7330,7832,2068
2002,Urban,Sikkim,Crime Against Men,Murder,Female,18-30,6607,3188,3419,5322,1285
2004,Rural,Himachal Pradesh,Property Crime,Burglary,Female,0-12,6840,2236,4604,6818,22
2005,Rural,Delhi,Crime Against Children,Kidnapping,Female,46-60,6443,4099,2344,5746,697
2007,Urban,Uttarakhand,Crime Against Children,Trafficking,Male,18-30,5895,204,5691,5795,100
2005,Rural,Rajasthan,Crime Against Men,Assault,Male,60+,3317,327,2990,1114,2203
2003,Urban,Jharkhand,Property Crime,Arson,Female,18-30,5796,2723,3073,2945,2851
2009,Urban,Sikkim,Crime Against Children,Kidnapping,Male,0-12,7960,3079,4881,5346,2614
2003,Urban,Uttar Pradesh,Other Crimes,Cyber Crime,Male,0-12,8642,5398,3244,5446,3196
2010,Rural,Himachal Pradesh,Other Crimes,Cyber Crime,Female,13-17,1927,1041,886,1064,863
2003,Urban,Sikkim,Crime Against Men,Assault,Female,31-45,5843,1940,3903,5532,311
2005,Rural,Assam,Crime Against Women,Molestation,Male,31-45,9561,8930,631,9487,74
2007,Rural,Chhattisgarh,Property Crime,Burglary,Female,18-30,956,404,552,576,380
2005,Urban,Assam,Crime Against Men,Robbery,Female,0-12,7383,2020,5363,2336,5047
2006,Rural,Nagaland,Crime Against Children,Child Labor,Female,13-17,2136,53,2083,1724,412
2003,Rural,Sikkim,Other Crimes,Cyber Crime,Female,60+,1983,1531,452,1884,99
2005,Urban,Uttarakhand,Property Crime,Vandalism,Male,31-45,9540,693,8847,7375,2165
2005,Urban,Meghalaya,Property Crime,Burglary,Male,60+,5927,2345,3582,5773,154
2001,Rural,Jharkhand,Property Crime,Theft,Female,18-30,5748,5683,65,5736,12
2005,Urban,Uttar Pradesh,Crime Against Children,Trafficking,Male,0-12,3380,1015,2365,2901,479
2002,Rural,Tripura,Crime Against Children,Kidnapping,Male,18-30,5198,3865,1333,4131,1067
2008,Rural,Arunachal Pradesh,Crime Against Women,Dowry Deaths,Female,13-17,5457,5195,262,5210,247
2003,Urban,West Bengal,Other Crimes,Cyber Crime,Female,31-45,6942,511,6431,980,5962
2010,Rural,Odisha,Crime Against Children,Kidnapping,Male,18-30,7961,1863,6098,5557,2404
2006,Rural,Meghalaya,Property Crime,Burglary,Male,18-30,500,119,381,466,34
2005,Urban,Mizoram,Property Crime,Vandalism,Female,46-60,7798,1512,6286,3647,4151
2001,Rural,Chhattisgarh,Crime Against Women,Molestation,Male,18-30,2202,1815,387,1974,228
2004,Rural,Tripura,Crime Against Women,Molestation,Female,13-17,9253,6033,3220,8082,1171
2002,Rural,Odisha,Crime Against Women,Dowry Deaths,Female,0-12,8122,7125,997,7808,314
2002,Rural,Jharkhand,Crime Against Women,Molestation,Male,31-45,9108,8492,616,8600,508
2001,Urban,Chhattisgarh,Property Crime,Arson,Female,0-12,7595,4773,2822,7328,267
2008,Rural,Assam,Other Crimes,Corruption,Female,60+,9270,7719,1551,8673,597
2010,Rural,Bihar,Crime Against Children,Kidnapping,Female,31-45,4536,2574,1962,3929,607
2006,Rural,Delhi,Crime Against Women,Domestic Violence,Male,31-45,5930,2683,3247,5097,833
2002,Urban,West Bengal,Other Crimes,Drug Offense,Female,18-30,8626,7337,1289,7431,1195
2005,Urban,Arunachal Pradesh,Crime Against Children,Kidnapping,Male,46-60,5322,2281,3041,3332,1990
2005,Rural,Manipur,Other Crimes,Fraud,Female,13-17,3008,1311,1697,2507,501
2007,Rural,Uttar Pradesh,Property Crime,Burglary,Male,0-12,1632,1551,81,1579,53
2007,Urban,Assam,Other Crimes,Fraud,Female,31-45,9251,5996,3255,8282,969
2006,Rural,Manipur,Crime Against Men,Assault,Female,31-45,197,194,3,194,3
2003,Urban,Meghalaya,Crime Against Men,Extortion,Male,46-60,1420,1017,403,1268,152
2008,Rural,Kerala,Crime Against Children,Child Labor,Male,0-12,9446,4267,5179,7557,1889
2006,Rural,Nagaland,Crime Against Children,Trafficking,Female,18-30,5576,3125,2451,3425,2151
2004,Urban,Tripura,Crime Against Men,Murder,Male,60+,621,212,409,537,84
2009,Rural,Karnataka,Crime Against Women,Molestation,Female,13-17,2722,848,1874,1240,1482
2008,Rural,Manipur,Crime Against Men,Robbery,Male,46-60,6304,2348,3956,3217,3087
2007,Urban,Madhya Pradesh,Other Crimes,Cyber Crime,Male,60+,6606,6249,357,6450,156
2010,Urban,Odisha,Crime Against Women,Rape,Male,13-17,7907,3125,4782,6694,1213
2004,Urban,Tamil Nadu,Property Crime,Burglary,Female,31-45,3575,422,3153,2271,1304
2001,Rural,Odisha,Crime Against Women,Rape,Male,18-30,718,127,591,461,257
2008,Rural,Tamil Nadu,Property Crime,Burglary,Female,31-45,1081,311,770,535,546
2004,Urban,Manipur,Other Crimes,Fraud,Female,18-30,8200,1650,6550,2118,6082
2001,Urban,Arunachal Pradesh,Property Crime,Theft,Female,0-12,1207,668,539,1202,5
2009,Rural,Uttarakhand,Crime Against Women,Molestation,Female,60+,4603,889,3714,1294,3309
2005,Urban,Gujarat,Other Crimes,Fraud,Male,60+,8278,453,7825,7532,746
2005,Urban,Odisha,Other Crimes,Drug Offense,Female,46-60,559,169,390,510,49
2003,Urban,Manipur,Property Crime,Theft,Female,46-60,7206,3402,3804,4917,2289
2010,Rural,Maharashtra,Other Crimes,Drug Offense,Female,46-60,8169,5887,2282,6257,1912
2008,Urban,Sikkim,Other Crimes,Cyber Crime,Female,46-60,6766,1277,5489,3185,3581
2004,Urban,Meghalaya,Crime Against Men,Assault,Female,0-12,2125,1748,377,2045,80
2010,Rural,Meghalaya,Property Crime,Theft,Female,31-45,9180,255,8925,9165,15
2005,Urban,Manipur,Crime Against Women,Domestic Violence,Female,31-45,5658,5366,292,5635,23
2004,Rural,Odisha,Crime Against Women,Rape,Female,0-12,9462,6882,2580,7774,1688
2001,Rural,Assam,Other Crimes,Cyber Crime,Female,31-45,6610,2555,4055,5264,1346
2010,Rural,Sikkim,Crime Against Men,Murder,Male,31-45,7044,2854,4190,3560,3484
2005,Rural,Nagaland,Crime Against Men,Assault,Female,18-30,3486,248,3238,1263,2223
2007,Rural,Meghalaya,Crime Against Women,Rape,Female,0-12,7830,4908,2922,6650,1180
2010,Rural,Sikkim,Crime Against Women,Molestation,Male,18-30,7135,2696,4439,3638,3497
2010,Rural,Odisha,Crime Against Women,Domestic Violence,Female,0-12,4592,4069,523,4578,14
2005,Rural,Punjab,Crime Against Men,Murder,Male,46-60,7754,4986,2768,5194,2560
2010,Urban,Haryana,Crime Against Men,Robbery,Female,60+,5233,4367,866,4795,438
2004,Urban,Kerala,Property Crime,Arson,Male,13-17,305,173,132,263,42
2002,Rural,Odisha,Other Crimes,Drug Offense,Male,18-30,8353,3397,4956,8328,25
2006,Rural,Manipur,Property Crime,Vandalism,Male,46-60,6920,5732,1188,6730,190
2007,Rural,Gujarat,Crime Against Children,Trafficking,Female,18-30,1904,517,1387,1813,91
2003,Urban,Goa,Crime Against Men,Assault,Female,0-12,7778,658,7120,2622,5156
2010,Urban,Gujarat,Other Crimes,Fraud,Male,0-12,2302,879,1423,1774,528
2009,Rural,Andhra Pradesh,Crime Against Children,Kidnapping,Male,13-17,9586,7898,1688,8086,1500
2003,Rural,Arunachal Pradesh,Other Crimes,Corruption,Male,60+,8934,293,8641,3728,5206
2003,Urban,Gujarat,Crime Against Men,Murder,Female,0-12,6677,1602,5075,6133,544
2009,Rural,Bihar,Crime Against Men,Extortion,Female,31-45,5009,633,4376,2127,2882
2010,Rural,Bihar,Crime Against Women,Domestic Violence,Female,18-30,4268,2645,1623,3082,1186
2007,Rural,Chhattisgarh,Crime Against Children,Child Abuse,Female,13-17,5558,415,5143,3747,1811
2001,Urban,West Bengal,Other Crimes,Cyber Crime,Male,46-60,2960,726,2234,1441,1519
2009,Rural,Kerala,Property Crime,Arson,Male,31-45,7851,1894,5957,3314,4537
2007,Rural,Jharkhand,Crime Against Children,Kidnapping,Female,60+,8119,3567,4552,5019,3100
2004,Rural,Bihar,Property Crime,Vandalism,Male,60+,3937,210,3727,3234,703
2006,Urban,Tripura,Crime Against Women,Rape,Male,13-17,831,795,36,826,5
2003,Rural,Gujarat,Property Crime,Theft,Female,0-12,4915,3432,1483,4710,205
2004,Rural,Jammu & Kashmir,Property Crime,Arson,Female,46-60,6314,4243,2071,5883,431
2005,Urban,Bihar,Crime Against Children,Trafficking,Female,60+,488,172,316,366,122
2009,Rural,Telangana,Crime Against Men,Assault,Male,60+,2456,2100,356,2295,161
2002,Rural,Delhi,Property Crime,Theft,Male,13-17,5172,4084,1088,4826,346
2010,Rural,Manipur,Property Crime,Burglary,Female,31-45,857,471,386,661,196
2009,Urban,Chhattisgarh,Other Crimes,Drug Offense,Male,13-17,157,27,130,89,68
2009,Urban,Kerala,Other Crimes,Fraud,Female,18-30,5818,107,5711,5250,568
2009,Urban,Tripura,Crime Against Women,Domestic Violence,Male,0-12,7702,6316,1386,7237,465
2009,Rural,West Bengal,Crime Against Women,Molestation,Female,0-12,7968,4312,3656,6589,1379
2006,Urban,Jharkhand,Property Crime,Theft,Male,13-17,1327,1172,155,1234,93
2003,Urban,Rajasthan,Crime Against Children,Child Labor,Female,46-60,1632,1372,260,1621,11
2004,Rural,Tamil Nadu,Crime Against Women,Rape,Female,60+,4773,2978,1795,4267,506
2009,Rural,Haryana,Crime Against Women,Dowry Deaths,Male,31-45,6556,2888,3668,3036,3520
2007,Rural,Gujarat,Crime Against Men,Murder,Male,0-12,71,37,34,71,0
2003,Rural,Assam,Crime Against Men,Extortion,Male,13-17,2789,1093,1696,2185,604
2007,Rural,West Bengal,Crime Against Men,Murder,Female,18-30,5976,2312,3664,4316,1660
2010,Rural,Bihar,Crime Against Children,Trafficking,Female,18-30,94,53,41,63,31
2003,Rural,Arunachal Pradesh,Crime Against Children,Child Abuse,Female,18-30,1887,1240,647,1804,83
2004,Urban,Punjab,Crime Against Men,Assault,Female,18-30,7772,2430,5342,4468,3304
2008,Rural,Jammu & Kashmir,Crime Against Children,Child Abuse,Female,31-45,8889,3932,4957,6346,2543
2002,Urban,Jharkhand,Property Crime,Burglary,Female,18-30,3240,2729,511,2772,468
2010,Urban,Meghalaya,Crime Against Men,Murder,Male,13-17,174,99,75,148,26
2003,Urban,Bihar,Other Crimes,Fraud,Male,46-60,4816,4383,433,4475,341
2010,Rural,Telangana,Property Crime,Burglary,Male,46-60,9474,7828,1646,8561,913
2008,Urban,Himachal Pradesh,Other Crimes,Corruption,Male,31-45,1469,50,1419,1383,86
2009,Rural,Tripura,Crime Against Children,Child Labor,Male,46-60,9467,7106,2361,7287,2180
2009,Rural,Rajasthan,Crime Against Women,Molestation,Female,46-60,2236,1591,645,1648,588
2003,Rural,West Bengal,Crime Against Men,Murder,Female,31-45,1972,469,1503,1595,377
2009,Rural,Assam,Crime Against Women,Domestic Violence,Female,13-17,9821,9426,395,9777,44
2003,Rural,Meghalaya,Crime Against Women,Dowry Deaths,Female,0-12,9809,7003,2806,8220,1589
2007,Rural,Assam,Crime Against Men,Assault,Female,31-45,6674,2276,4398,5716,958
2010,Urban,Tripura,Property Crime,Theft,Male,46-60,9358,6318,3040,6758,2600
2002,Rural,Mizoram,Crime Against Women,Rape,Male,13-17,5495,1151,4344,4055,1440
2008,Urban,Mizoram,Crime Against Children,Child Labor,Female,0-12,3813,1859,1954,3436,377
2001,Urban,Odisha,Crime Against Men,Assault,Male,0-12,4816,1047,3769,4421,395
2008,Rural,Mizoram,Crime Against Men,Robbery,Female,18-30,178,74,104,171,7
2009,Rural,Uttarakhand,Crime Against Children,Child Labor,Female,18-30,2781,633,2148,921,1860
2003,Urban,Sikkim,Property Crime,Burglary,Female,13-17,9520,167,9353,9363,157
2009,Urban,Haryana,Crime Against Women,Dowry Deaths,Female,0-12,690,654,36,678,12
2005,Rural,Uttar Pradesh,Crime Against Men,Extortion,Male,18-30,6041,3611,2430,4512,1529
2001,Rural,Bihar,Crime Against Men,Robbery,Female,46-60,3747,3687,60,3716,31
2010,Urban,Assam,Crime Against Children,Child Abuse,Male,13-17,8814,7885,929,8288,526
2004,Rural,Uttar Pradesh,Other Crimes,Cyber Crime,Female,13-17,8794,8235,559,8316,478
2005,Urban,Manipur,Other Crimes,Drug Offense,Male,0-12,4806,3811,995,4263,543
2004,Rural,Himachal Pradesh,Crime Against Children,Child Abuse,Male,60+,6014,929,5085,3786,2228
2006,Urban,Haryana,Crime Against Children,Kidnapping,Female,31-45,6690,1828,4862,3307,3383
2003,Urban,Arunachal Pradesh,Property Crime,Vandalism,Female,18-30,105,45,60,48,57
2001,Urban,Delhi,Crime Against Men,Assault,Female,46-60,7352,5304,2048,6085,1267
2008,Urban,Meghalaya,Crime Against Women,Rape,Male,31-45,190,131,59,146,44
2004,Rural,Gujarat,Crime Against Men,Murder,Male,18-30,3618,2090,1528,3557,61
2009,Rural,Madhya Pradesh,Crime Against Children,Child Labor,Female,60+,2708,2687,21,2697,11
2007,Rural,Chhattisgarh,Crime Against Men,Assault,Female,31-45,5546,55,5491,636,4910
2009,Urban,Jammu & Kashmir,Other Crimes,Cyber Crime,Male,46-60,8898,684,8214,8021,877
2001,Rural,Meghalaya,Crime Against Women,Rape,Male,31-45,1926,1443,483,1565,361
2005,Rural,Karnataka,Other Crimes,Corruption,Male,46-60,2442,853,1589,2029,413
2010,Rural,Jharkhand,Other Crimes,Fraud,Female,18-30,2248,425,1823,1197,1051
2009,Urban,Bihar,Crime Against Men,Robbery,Female,18-30,6283,566,5717,2937,3346
2002,Urban,Maharashtra,Crime Against Children,Kidnapping,Female,0-12,5689,2929,2760,5237,452
2003,Rural,Rajasthan,Crime Against Women,Domestic Violence,Female,18-30,186,30,156,127,59
2010,Urban,Maharashtra,Crime Against Children,Child Abuse,Male,18-30,5805,3869,1936,5354,451
2005,Rural,Mizoram,Crime Against Men,Murder,Female,0-12,4798,1979,2819,4386,412
2001,Rural,Tripura,Crime Against Women,Dowry Deaths,Female,60+,3043,2120,923,2298,745
2010,Rural,Gujarat,Crime Against Children,Trafficking,Male,60+,6478,5392,1086,5996,482
2001,Rural,Uttar Pradesh,Crime Against Children,Child Labor,Female,46-60,6060,5135,925,5647,413
2010,Urban,Andhra Pradesh,Crime Against Women,Molestation,Female,13-17,9573,7238,2335,9325,248
2005,Urban,Tripura,Crime Against Men,Assault,Female,0-12,2503,2309,194,2457,46
2001,Urban,Tamil Nadu,Crime Against Men,Extortion,Male,18-30,4481,805,3676,2770,1711
2010,Rural,Manipur,Crime Against Children,Child Abuse,Female,60+,6027,3578,2449,4490,1537
2001,Rural,Karnataka,Property Crime,Arson,Male,31-45,2319,1790,529,1930,389
2010,Rural,Meghalaya,Other Crimes,Drug Offense,Male,60+,5889,4019,1870,4977,912
2007,Urban,Odisha,Crime Against Children,Child Labor,Female,0-12,1744,600,1144,1189,555
2001,Rural,Punjab,Crime Against Men,Robbery,Female,46-60,4771,838,3933,4517,254
2005,Urban,Chhattisgarh,Crime Against Women,Dowry Deaths,Male,46-60,5376,4641,735,5319,57
2005,Rural,Jharkhand,Crime Against Men,Assault,Female,60+,9503,5008,4495,7012,2491
2009,Rural,Tripura,Property Crime,Vandalism,Male,0-12,2306,1548,758,1877,429
2006,Urban,Goa,Crime Against Children,Child Labor,Male,0-12,8868,3284,5584,6649,2219
2004,Rural,Odisha,Crime Against Women,Molestation,Male,13-17,6976,1981,4995,5601,1375
2001,Rural,Uttar Pradesh,Crime Against Women,Molestation,Female,18-30,9492,2727,6765,4025,5467
2005,Rural,Rajasthan,Crime Against Children,Child Labor,Female,46-60,3235,2319,916,2625,610
2010,Rural,Goa,Crime Against Children,Trafficking,Female,31-45,5638,4334,1304,4748,890
2007,Urban,Odisha,Other Crimes,Fraud,Female,31-45,4386,2264,2122,2744,1642
2005,Urban,Mizoram,Property Crime,Vandalism,Female,0-12,5466,2526,2940,4209,1257
2010,Rural,Sikkim,Other Crimes,Drug Offense,Female,13-17,2907,503,2404,1681,1226
2006,Rural,Rajasthan,Property Crime,Arson,Male,18-30,5908,4952,956,5432,476
2001,Urban,Uttarakhand,Crime Against Women,Domestic Violence,Female,13-17,5194,3036,2158,4688,506
2003,Rural,Haryana,Property Crime,Burglary,Male,60+,4347,2692,1655,3153,1194
2004,Rural,Arunachal Pradesh,Crime Against Children,Child Labor,Female,46-60,2945,2456,489,2672,273
2005,Urban,Rajasthan,Crime Against Women,Rape,Male,60+,7462,6053,1409,7318,144
2007,Rural,Bihar,Crime Against Children,Kidnapping,Female,18-30,9095,3380,5715,4335,4760
2001,Rural,Tripura,Crime Against Women,Rape,Female,46-60,7759,3367,4392,6134,1625
2010,Urban,Jammu & Kashmir,Crime Against Women,Molestation,Male,60+,1209,977,232,1170,39
2009,Rural,Nagaland,Crime Against Women,Domestic Violence,Male,13-17,1574,69,1505,867,707
2010,Rural,Uttar Pradesh,Crime Against Men,Murder,Female,31-45,1336,1238,98,1277,59
2009,Urban,Tamil Nadu,Property Crime,Arson,Female,0-12,7062,6054,1008,6849,213
2005,Rural,Manipur,Crime Against Men,Murder,Male,0-12,4567,587,3980,1565,3002
2004,Rural,Chhattisgarh,Crime Against Men,Robbery,Female,60+,8659,6173,2486,6433,2226
2007,Urban,Manipur,Property Crime,Arson,Female,60+,2323,329,1994,1268,1055
2002,Urban,Jharkhand,Other Crimes,Corruption,Female,13-17,9078,5546,3532,8880,198
2005,Urban,Uttarakhand,Crime Against Men,Extortion,Female,31-45,6894,6201,693,6856,38
2003,Urban,Gujarat,Crime Against Men,Murder,Female,31-45,3802,3142,660,3612,190
2003,Urban,Punjab,Crime Against Women,Rape,Male,0-12,1361,5,1356,157,1204
2003,Urban,Manipur,Crime Against Men,Assault,Female,18-30,1593,385,1208,1342,251
2004,Urban,West Bengal,Crime Against Women,Dowry Deaths,Male,46-60,6686,5092,1594,6035,651
2005,Urban,Goa,Property Crime,Vandalism,Female,18-30,8369,832,7537,3772,4597
2005,Rural,Haryana,Other Crimes,Cyber Crime,Female,13-17,4804,3254,1550,3539,1265
2008,Urban,Meghalaya,Crime Against Men,Assault,Male,31-45,4786,2804,1982,3543,1243
2006,Urban,Andhra Pradesh,Crime Against Men,Extortion,Male,13-17,4761,475,4286,4428,333
2008,Rural,Andhra Pradesh,Other Crimes,Fraud,Female,13-17,2420,184,2236,1918,502
2003,Rural,West Bengal,Crime Against Men,Extortion,Male,0-12,7064,946,6118,4357,2707
2010,Urban,Meghalaya,Property Crime,Arson,Female,13-17,1337,886,451,983,354
2002,Rural,Delhi,Crime Against Women,Domestic Violence,Male,18-30,1683,219,1464,835,848
2007,Urban,Goa,Other Crimes,Drug Offense,Female,18-30,8565,85,8480,7111,1454
2004,Rural,Chhattisgarh,Other Crimes,Fraud,Female,0-12,5112,2407,2705,4086,1026
2004,Urban,Haryana,Property Crime,Vandalism,Female,60+,8231,2950,5281,6020,2211
2009,Rural,Manipur,Property Crime,Theft,Female,31-45,6264,473,5791,926,5338
2009,Rural,Tamil Nadu,Crime Against Men,Extortion,Male,13-17,8176,4353,3823,4840,3336
2001,Rural,Meghalaya,Crime Against Children,Child Labor,Female,60+,5801,3475,2326,4863,938
2004,Urban,Haryana,Crime Against Men,Extortion,Male,18-30,1119,448,671,872,247
2009,Rural,Rajasthan,Crime Against Women,Molestation,Male,18-30,5398,3912,1486,5234,164
2010,Urban,Uttar Pradesh,Property Crime,Vandalism,Female,60+,545,474,71,500,45
2006,Rural,Kerala,Crime Against Children,Child Abuse,Male,31-45,2639,1987,652,2531,108
2002,Urban,Tamil Nadu,Crime Against Women,Domestic Violence,Male,0-12,1102,1097,5,1098,4
2004,Urban,Rajasthan,Crime Against Children,Trafficking,Male,18-30,6294,3199,3095,4873,1421
2008,Urban,Jharkhand,Crime Against Children,Child Labor,Female,31-45,8563,2690,5873,4146,4417
2006,Urban,Nagaland,Crime Against Women,Domestic Violence,Male,13-17,9703,5403,4300,6525,3178
2008,Rural,Karnataka,Crime Against Women,Rape,Female,18-30,8601,6879,1722,8329,272
2001,Rural,Jharkhand,Other Crimes,Cyber Crime,Female,18-30,4420,124,4296,3847,573
2005,Urban,Manipur,Other Crimes,Corruption,Male,13-17,6223,5848,375,6121,102
2003,Urban,Rajasthan,Crime Against Women,Domestic Violence,Female,0-12,6885,3147,3738,6030,855
2002,Urban,Mizoram,Crime Against Men,Extortion,Male,0-12,1103,798,305,987,116
2007,Urban,Telangana,Other Crimes,Drug Offense,Male,13-17,6716,4810,1906,5405,1311
2004,Rural,Meghalaya,Other Crimes,Corruption,Male,0-12,1175,630,545,1144,31
2008,Urban,Kerala,Crime Against Women,Molestation,Male,13-17,6040,160,5880,3236,2804
2009,Urban,Nagaland,Other Crimes,Fraud,Female,18-30,7175,3253,3922,6134,1041
2003,Urban,Tripura,Property Crime,Theft,Male,13-17,3233,1234,1999,2150,1083
2010,Rural,Uttarakhand,Property Crime,Arson,Male,13-17,2302,1553,749,1678,624
2001,Urban,Uttarakhand,Crime Against Children,Child Abuse,Female,13-17,6472,2118,4354,6234,238
2003,Urban,Haryana,Property Crime,Vandalism,Male,46-60,8822,3211,5611,3353,5469
2010,Rural,Delhi,Property Crime,Burglary,Female,13-17,1385,720,665,1079,306
2009,Urban,Andhra Pradesh,Property Crime,Vandalism,Male,0-12,2086,534,1552,943,1143
2008,Rural,Tamil Nadu,Crime Against Women,Rape,Female,60+,4669,2607,2062,4432,237
2004,Rural,Sikkim,Crime Against Children,Kidnapping,Male,0-12,9645,4315,5330,7904,1741
2008,Rural,Nagaland,Crime Against Children,Child Abuse,Male,13-17,391,162,229,260,131
2003,Rural,Himachal Pradesh,Other Crimes,Cyber Crime,Female,31-45,4647,3963,684,4238,409
2005,Urban,Gujarat,Crime Against Women,Domestic Violence,Male,0-12,3448,3330,118,3354,94
2009,Urban,Odisha,Property Crime,Vandalism,Male,0-12,4927,65,4862,150,4777
2004,Urban,Bihar,Property Crime,Theft,Female,18-30,700,172,528,522,178
2001,Urban,Assam,Property Crime,Theft,Female,13-17,5907,3260,2647,4047,1860
2005,Rural,Tripura,Crime Against Women,Dowry Deaths,Female,13-17,3953,659,3294,2619,1334
2004,Rural,Delhi,Property Crime,Burglary,Female,13-17,2631,464,2167,2269,362
2010,Rural,Tamil Nadu,Property Crime,Vandalism,Female,31-45,8599,2690,5909,8433,166
2008,Rural,Jammu & Kashmir,Property Crime,Arson,Female,0-12,4831,171,4660,1094,3737
2006,Urban,Mizoram,Property Crime,Arson,Male,60+,9684,6805,2879,7798,1886
2001,Urban,Uttarakhand,Property Crime,Vandalism,Male,46-60,4162,1228,2934,1297,2865
2006,Urban,Gujarat,Other Crimes,Cyber Crime,Male,0-12,3672,396,3276,2113,1559
2007,Urban,Himachal Pradesh,Crime Against Children,Kidnapping,Male,60+,9696,6749,2947,8371,1325
2006,Rural,Uttar Pradesh,Property Crime,Arson,Male,31-45,7246,3511,3735,3745,3501
2010,Rural,Bihar,Property Crime,Theft,Female,46-60,2000,946,1054,1206,794
2010,Urban,Punjab,Crime Against Men,Robbery,Female,46-60,5672,5076,596,5464,208
2005,Rural,Maharashtra,Crime Against Children,Child Labor,Female,46-60,7618,4520,3098,6251,1367
2001,Urban,Telangana,Property Crime,Theft,Female,13-17,899,516,383,632,267
2004,Rural,Jharkhand,Other Crimes,Drug Offense,Female,13-17,740,54,686,658,82
2008,Rural,Karnataka,Crime Against Women,Molestation,Female,18-30,9164,6743,2421,7373,1791
2001,Rural,Mizoram,Crime Against Women,Molestation,Male,60+,5070,2932,2138,4077,993
2010,Rural,Tamil Nadu,Property Crime,Burglary,Female,0-12,8682,4651,4031,6515,2167
2002,Urban,Assam,Crime Against Children,Child Labor,Female,13-17,9918,9117,801,9408,510
2008,Rural,Odisha,Crime Against Children,Child Abuse,Female,13-17,8763,4670,4093,6908,1855
2007,Rural,Punjab,Other Crimes,Fraud,Male,0-12,2550,1710,840,1839,711
2009,Rural,Maharashtra,Crime Against Men,Robbery,Female,0-12,6562,6362,200,6396,166
2002,Rural,Goa,Crime Against Children,Child Labor,Female,60+,3271,1931,1340,2270,1001
2001,Rural,Assam,Crime Against Men,Murder,Male,0-12,381,196,185,316,65
2009,Urban,Rajasthan,Crime Against Children,Trafficking,Male,18-30,5565,4339,1226,5079,486
2005,Rural,Manipur,Crime Against Children,Kidnapping,Female,60+,858,267,591,470,388
2004,Urban,Himachal Pradesh,Crime Against Men,Extortion,Male,31-45,5522,4588,934,4784,738
2003,Urban,Telangana,Crime Against Men,Robbery,Female,31-45,6034,468,5566,2396,3638
2001,Urban,Tripura,Crime Against Children,Trafficking,Female,46-60,5748,4613,1135,5096,652
2007,Urban,Delhi,Property Crime,Vandalism,Male,60+,8210,2591,5619,6603,1607
2008,Urban,Chhattisgarh,Crime Against Men,Extortion,Male,31-45,8153,2357,5796,6743,1410
2006,Urban,West Bengal,Crime Against Women,Molestation,Male,46-60,7426,7059,367,7164,262
2004,Urban,Meghalaya,Other Crimes,Cyber Crime,Female,13-17,9594,3806,5788,6601,2993
2008,Rural,West Bengal,Crime Against Children,Child Labor,Female,18-30,4662,2105,2557,4565,97
2004,Rural,Goa,Other Crimes,Cyber Crime,Male,18-30,2364,1431,933,1720,644
2001,Rural,Haryana,Crime Against Children,Child Abuse,Female,18-30,8851,4876,3975,7291,1560
2008,Urban,Bihar,Crime Against Men,Robbery,Female,13-17,621,88,533,422,199
2009,Urban,Assam,Property Crime,Arson,Female,31-45,7225,2286,4939,5792,1433
2007,Urban,Gujarat,Crime Against Children,Child Abuse,Female,60+,3345,1828,1517,2334,1011
2006,Urban,Uttarakhand,Crime Against Men,Extortion,Female,46-60,6001,4372,1629,4525,1476
2003,Urban,Telangana,Crime Against Men,Assault,Male,18-30,5217,3298,1919,3933,1284
2001,Urban,Jammu & Kashmir,Crime Against Men,Murder,Male,18-30,2175,1357,818,1643,532
2007,Urban,Assam,Other Crimes,Drug Offense,Male,18-30,543,250,293,347,196
2001,Urban,Madhya Pradesh,Crime Against Women,Rape,Female,31-45,241,74,167,133,108
2001,Rural,Uttarakhand,Other Crimes,Fraud,Female,60+,3579,475,3104,1867,1712
2006,Rural,Maharashtra,Crime Against Women,Domestic Violence,Male,46-60,93,28,65,91,2
2009,Urban,Haryana,Crime Against Women,Molestation,Male,46-60,672,246,426,425,247
2003,Urban,Himachal Pradesh,Crime Against Children,Child Abuse,Male,18-30,661,188,473,418,243
2007,Rural,Rajasthan,Crime Against Women,Domestic Violence,Female,13-17,8890,1911,6979,3445,5445
2002,Urban,Uttarakhand,Crime Against Men,Extortion,Male,13-17,2180,1204,976,1498,682
2009,Rural,Punjab,Other Crimes,Cyber Crime,Male,60+,328,99,229,255,73
2005,Urban,Haryana,Crime Against Women,Molestation,Male,18-30,767,323,444,374,393
2010,Urban,Telangana,Property Crime,Vandalism,Male,31-45,3402,1296,2106,3019,383
2002,Urban,Uttarakhand,Crime Against Children,Kidnapping,Female,0-12,9566,4741,4825,5301,4265
2008,Urban,Tamil Nadu,Crime Against Men,Assault,Female,13-17,294,20,274,97,197
2010,Urban,Haryana,Property Crime,Arson,Female,60+,3575,774,2801,2661,914
2003,Rural,Delhi,Crime Against Children,Child Labor,Male,0-12,5804,917,4887,2261,3543
2006,Rural,Haryana,Crime Against Children,Child Labor,Male,0-12,1563,397,1166,931,632
2007,Urban,Uttarakhand,Property Crime,Burglary,Male,60+,3623,2949,674,3150,473
2004,Urban,Sikkim,Crime Against Men,Extortion,Male,0-12,1251,124,1127,1091,160
2004,Rural,Tripura,Other Crimes,Drug Offense,Female,0-12,395,137,258,313,82
2005,Urban,Tripura,Other Crimes,Corruption,Male,18-30,3563,1531,2032,2360,1203
2003,Urban,Sikkim,Property Crime,Burglary,Female,60+,2700,33,2667,1672,1028
2004,Urban,Maharashtra,Crime Against Men,Assault,Male,60+,6687,5747,940,5942,745
2010,Rural,Delhi,Crime Against Women,Rape,Male,31-45,8723,633,8090,2533,6190
2007,Rural,Odisha,Crime Against Women,Domestic Violence,Female,31-45,7538,2186,5352,4113,3425
2002,Urban,Himachal Pradesh,Property Crime,Vandalism,Female,13-17,3395,2145,1250,3359,36
2009,Urban,Gujarat,Crime Against Women,Domestic Violence,Male,60+,8884,8474,410,8839,45
2009,Rural,Gujarat,Other Crimes,Drug Offense,Male,13-17,1173,324,849,714,459
2003,Urban,Odisha,Crime Against Children,Child Abuse,Male,13-17,1027,360,667,645,382
2007,Urban,Uttar Pradesh,Crime Against Children,Child Abuse,Male,13-17,7392,1347,6045,2660,4732
2008,Urban,Madhya Pradesh,Crime Against Children,Trafficking,Male,13-17,5290,4432,858,5083,207
2007,Urban,Maharashtra,Crime Against Women,Dowry Deaths,Female,46-60,932,851,81,932,0
2002,Rural,West Bengal,Crime Against Men,Robbery,Male,31-45,2754,1457,1297,1493,1261
2004,Rural,Assam,Crime Against Children,Kidnapping,Female,18-30,5087,2941,2146,4185,902
2004,Urban,Uttar Pradesh,Crime Against Children,Kidnapping,Female,31-45,2027,1206,821,1843,184
2002,Urban,Haryana,Crime Against Women,Dowry Deaths,Male,0-12,5178,954,4224,4398,780
2005,Urban,Sikkim,Other Crimes,Cyber Crime,Female,13-17,2030,360,1670,825,1205
2008,Urban,Jharkhand,Other Crimes,Fraud,Female,60+,2716,1022,1694,1217,1499
2006,Urban,Rajasthan,Other Crimes,Corruption,Female,31-45,8557,1786,6771,8099,458
2002,Urban,Meghalaya,Property Crime,Vandalism,Male,13-17,4139,3687,452,3854,285
2003,Rural,Arunachal Pradesh,Crime Against Children,Child Labor,Male,0-12,1253,1088,165,1251,2
2008,Urban,Goa,Property Crime,Arson,Female,0-12,3348,1694,1654,2858,490
2006,Urban,Nagaland,Crime Against Women,Domestic Violence,Female,13-17,134,60,74,64,70
2001,Urban,Gujarat,Crime Against Men,Extortion,Female,0-12,7093,1591,5502,3576,3517
2002,Rural,Himachal Pradesh,Property Crime,Vandalism,Male,31-45,1185,1130,55,1165,20
2010,Rural,Telangana,Property Crime,Arson,Female,46-60,5065,1704,3361,2267,2798
2006,Urban,Uttarakhand,Property Crime,Burglary,Female,60+,1792,569,1223,1714,78
2004,Urban,Uttarakhand,Crime Against Children,Kidnapping,Female,0-12,5250,1208,4042,4200,1050
2001,Urban,Punjab,Crime Against Children,Child Labor,Female,0-12,2855,2658,197,2702,153
2008,Urban,Rajasthan,Crime Against Women,Domestic Violence,Female,0-12,7012,4982,2030,6111,901
2005,Urban,West Bengal,Property Crime,Burglary,Female,46-60,8520,4875,3645,6217,2303
2001,Urban,Jharkhand,Crime Against Children,Trafficking,Female,31-45,2312,1872,440,1932,380
2005,Rural,Mizoram,Crime Against Men,Extortion,Female,31-45,2296,538,1758,1581,715
2006,Rural,West Bengal,Crime Against Women,Rape,Male,13-17,3487,3442,45,3485,2
2001,Rural,Maharashtra,Crime Against Women,Molestation,Female,13-17,5337,3416,1921,4807,530
2009,Rural,Arunachal Pradesh,Other Crimes,Drug Offense,Female,13-17,1150,1046,104,1061,89
2005,Rural,Maharashtra,Other Crimes,Corruption,Female,18-30,2836,769,2067,864,1972
2002,Urban,Delhi,Other Crimes,Fraud,Female,31-45,7025,2318,4707,3972,3053
2009,Rural,Tripura,Crime Against Women,Dowry Deaths,Male,18-30,5169,4070,1099,4428,741
2005,Rural,Delhi,Crime Against Men,Murder,Female,18-30,8583,1171,7412,5994,2589
2004,Urban,Jharkhand,Crime Against Men,Robbery,Male,31-45,7976,2470,5506,3911,4065
2002,Rural,Assam,Property Crime,Theft,Female,31-45,9199,557,8642,2589,6610
2008,Rural,Goa,Crime Against Men,Extortion,Male,60+,2840,1454,1386,2582,258
2007,Urban,Odisha,Property Crime,Theft,Female,13-17,9445,6960,2485,9193,252
2003,Urban,Haryana,Crime Against Children,Child Abuse,Female,18-30,6302,1265,5037,4483,1819
2005,Urban,Manipur,Property Crime,Theft,Male,60+,2486,638,1848,2366,120
2001,Urban,Goa,Crime Against Children,Child Abuse,Male,0-12,3345,2589,756,3231,114
2008,Urban,Kerala,Crime Against Men,Extortion,Male,0-12,8219,5220,2999,6780,1439
2001,Rural,Bihar,Crime Against Women,Rape,Male,13-17,4397,4113,284,4140,257
2010,Urban,Maharashtra,Property Crime,Vandalism,Female,18-30,859,555,304,663,196
2001,Urban,Arunachal Pradesh,Other Crimes,Corruption,Male,18-30,5067,1462,3605,3513,1554
2010,Urban,Uttarakhand,Property Crime,Burglary,Female,13-17,3380,3365,15,3379,1
2007,Rural,Uttar Pradesh,Crime Against Women,Molestation,Male,0-12,602,132,470,540,62
2001,Rural,Himachal Pradesh,Crime Against Children,Trafficking,Male,0-12,4197,1872,2325,3360,837
2010,Rural,Haryana,Crime Against Men,Extortion,Female,0-12,891,678,213,891,0
2005,Urban,Punjab,Crime Against Women,Rape,Female,0-12,7815,4806,3009,6512,1303
2010,Rural,Assam,Property Crime,Theft,Male,18-30,1103,633,470,723,380
2003,Rural,Haryana,Crime Against Men,Extortion,Male,0-12,9670,1027,8643,6632,3038
2006,Rural,Nagaland,Crime Against Children,Child Abuse,Female,31-45,5777,1912,3865,3001,2776
2003,Urban,Himachal Pradesh,Crime Against Children,Kidnapping,Female,46-60,5334,443,4891,4162,1172
2008,Rural,Nagaland,Crime Against Men,Murder,Female,18-30,9022,5091,3931,6547,2475
2004,Urban,Nagaland,Other Crimes,Fraud,Female,18-30,2364,2182,182,2324,40
2004,Urban,Bihar,Other Crimes,Fraud,Male,60+,8461,4137,4324,5887,2574
2004,Rural,Uttarakhand,Other Crimes,Cyber Crime,Female,0-12,6469,3125,3344,5044,1425
2001,Urban,Manipur,Crime Against Women,Dowry Deaths,Male,46-60,4485,2603,1882,4218,267
2005,Urban,Jharkhand,Property Crime,Vandalism,Female,46-60,1041,574,467,836,205
2009,Rural,Jharkhand,Crime Against Women,Molestation,Male,46-60,9952,8713,1239,9852,100
2004,Urban,Punjab,Property Crime,Theft,Female,31-45,2086,510,1576,1158,928
2006,Urban,Karnataka,Crime Against Children,Child Labor,Female,46-60,3296,2656,640,2934,362
2008,Urban,Punjab,Crime Against Children,Trafficking,Male,0-12,5596,4327,1269,4357,1239
2003,Urban,Arunachal Pradesh,Crime Against Women,Domestic Violence,Female,46-60,9593,2313,7280,6246,3347
2004,Urban,Andhra Pradesh,Crime Against Women,Dowry Deaths,Female,60+,1273,296,977,987,286
2001,Urban,Maharashtra,Crime Against Men,Robbery,Female,46-60,5996,2638,3358,4398,1598
2007,Rural,West Bengal,Property Crime,Burglary,Female,60+,3093,2812,281,3083,10
2003,Urban,West Bengal,Other Crimes,Corruption,Female,18-30,9178,3858,5320,7599,1579
2010,Urban,Odisha,Crime Against Men,Extortion,Male,18-30,7474,1366,6108,3166,4308
2005,Rural,Arunachal Pradesh,Property Crime,Burglary,Female,18-30,4507,3564,943,3751,756
2008,Urban,Maharashtra,Crime Against Men,Extortion,Female,31-45,9029,1149,7880,7918,1111
2005,Urban,Mizoram,Crime Against Women,Domestic Violence,Male,31-45,1142,468,674,941,201
2004,Rural,Rajasthan,Other Crimes,Drug Offense,Male,13-17,9036,671,8365,3219,5817
2008,Urban,Uttarakhand,Crime Against Women,Rape,Male,0-12,3355,1516,1839,3056,299
2008,Urban,Uttar Pradesh,Property Crime,Burglary,Female,46-60,4262,1414,2848,1903,2359
2002,Urban,Uttarakhand,Other Crimes,Fraud,Female,46-60,1705,893,812,1216,489
2007,Rural,Himachal Pradesh,Crime Against Women,Molestation,Female,60+,384,47,337,320,64
2007,Rural,Assam,Property Crime,Vandalism,Male,18-30,8987,2985,6002,6680,2307
2003,Rural,Maharashtra,Crime Against Men,Murder,Female,13-17,3795,1031,2764,1716,2079
2008,Rural,Himachal Pradesh,Crime Against Children,Trafficking,Female,46-60,2393,1266,1127,2300,93
2009,Urban,Arunachal Pradesh,Crime Against Women,Dowry Deaths,Male,60+,5996,2857,3139,2908,3088
2007,Urban,Karnataka,Crime Against Men,Robbery,Female,31-45,1345,496,849,990,355
2006,Urban,Madhya Pradesh,Property Crime,Vandalism,Male,31-45,4358,661,3697,4283,75
2002,Urban,Kerala,Other Crimes,Corruption,Female,60+,4911,541,4370,2780,2131
2006,Urban,Bihar,Crime Against Women,Domestic Violence,Male,13-17,5192,3908,1284,4509,683
2003,Urban,Tamil Nadu,Other Crimes,Corruption,Female,46-60,7623,1226,6397,7055,568
2004,Urban,Himachal Pradesh,Property Crime,Theft,Female,60+,6670,5785,885,6402,268
2003,Rural,Tripura,Crime Against Children,Trafficking,Male,0-12,3891,2603,1288,3536,355
2003,Urban,Himachal Pradesh,Other Crimes,Drug Offense,Male,60+,9703,264,9439,6291,3412
2008,Urban,Haryana,Crime Against Men,Extortion,Male,13-17,4779,2578,2201,3078,1701
2010,Urban,Uttar Pradesh,Crime Against Women,Domestic Violence,Female,18-30,8438,1556,6882,1871,6567
2005,Urban,Andhra Pradesh,Property Crime,Theft,Male,31-45,5795,3114,2681,3586,2209
2009,Urban,West Bengal,Crime Against Children,Kidnapping,Female,13-17,9688,7734,1954,8297,1391
2002,Rural,Uttar Pradesh,Crime Against Women,Molestation,Female,13-17,8163,4211,3952,7010,1153
2010,Rural,Uttar Pradesh,Crime Against Women,Dowry Deaths,Female,60+,1204,1169,35,1190,14
2007,Rural,Jharkhand,Property Crime,Vandalism,Male,13-17,1541,1233,308,1370,171
2007,Rural,Haryana,Crime Against Men,Murder,Male,46-60,5945,817,5128,2219,3726
2006,Rural,Kerala,Crime Against Children,Child Labor,Male,0-12,255,101,154,106,149
2005,Urban,Himachal Pradesh,Property Crime,Arson,Female,18-30,358,190,168,281,77
2001,Urban,Uttarakhand,Property Crime,Theft,Female,46-60,8046,449,7597,4446,3600
2003,Rural,Meghalaya,Crime Against Women,Rape,Male,13-17,4945,3051,1894,4510,435
2003,Rural,Andhra Pradesh,Property Crime,Burglary,Male,31-45,3428,2403,1025,2682,746
2002,Rural,Manipur,Crime Against Men,Murder,Male,31-45,7878,1429,6449,2001,5877
2005,Urban,Manipur,Property Crime,Vandalism,Male,31-45,8512,4262,4250,7215,1297
2010,Rural,Gujarat,Property Crime,Vandalism,Male,60+,5191,3772,1419,4932,259
2008,Urban,Odisha,Crime Against Men,Assault,Male,0-12,9192,2184,7008,6325,2867
2002,Rural,Tripura,Property Crime,Theft,Male,31-45,6398,4953,1445,5148,1250
2007,Urban,Goa,Crime Against Women,Molestation,Female,0-12,5307,3777,1530,3885,1422
2003,Urban,Odisha,Property Crime,Arson,Female,13-17,6745,5552,1193,6185,560
2007,Urban,Goa,Other Crimes,Fraud,Male,18-30,8428,3799,4629,8137,291
2004,Urban,Sikkim,Crime Against Children,Trafficking,Male,0-12,1591,414,1177,525,1066
2003,Urban,Maharashtra,Property Crime,Burglary,Male,31-45,8310,1607,6703,3374,4936
2002,Rural,Tamil Nadu,Property Crime,Arson,Female,46-60,578,173,405,333,245
2008,Urban,Assam,Other Crimes,Fraud,Female,60+,6503,4868,1635,5314,1189
2003,Rural,Uttarakhand,Crime Against Women,Rape,Female,31-45,5699,4619,1080,5580,119
2002,Urban,Karnataka,Property Crime,Vandalism,Female,18-30,3462,1127,2335,1934,1528
2003,Urban,Jammu & Kashmir,Crime Against Women,Molestation,Female,13-17,5863,4801,1062,5757,106
2005,Rural,Gujarat,Other Crimes,Corruption,Male,0-12,6579,1293,5286,2484,4095
2005,Urban,Madhya Pradesh,Other Crimes,Cyber Crime,Female,60+,908,131,777,532,376
2004,Rural,Tamil Nadu,Crime Against Women,Domestic Violence,Male,46-60,148,125,23,127,21
2010,Rural,Madhya Pradesh,Other Crimes,Fraud,Male,13-17,2668,243,2425,1519,1149
2009,Urban,Sikkim,Crime Against Children,Child Labor,Male,46-60,2676,1484,1192,2546,130
2006,Urban,Uttar Pradesh,Crime Against Children,Kidnapping,Male,0-12,7097,1352,5745,3851,3246
2006,Urban,Delhi,Property Crime,Burglary,Male,31-45,5451,566,4885,1626,3825
2001,Urban,Uttar Pradesh,Property Crime,Burglary,Male,18-30,1272,629,643,1092,180
2009,Urban,Jharkhand,Other Crimes,Drug Offense,Female,0-12,6405,4135,2270,5919,486
2001,Urban,Meghalaya,Crime Against Men,Robbery,Male,31-45,206,205,1,205,1
2001,Urban,Karnataka,Property Crime,Theft,Male,0-12,1106,590,516,821,285
2002,Rural,Arunachal Pradesh,Other Crimes,Drug Offense,Male,18-30,1244,1111,133,1236,8
2003,Urban,Telangana,Crime Against Women,Molestation,Female,0-12,2371,1495,876,2294,77
2001,Urban,Tamil Nadu,Property Crime,Vandalism,Male,18-30,2006,140,1866,452,1554
2007,Rural,Goa,Crime Against Women,Domestic Violence,Male,31-45,2931,2609,322,2924,7
2001,Urban,Arunachal Pradesh,Crime Against Children,Trafficking,Female,18-30,7326,1423,5903,4680,2646
2010,Rural,Madhya Pradesh,Crime Against Children,Child Labor,Male,0-12,9607,5482,4125,8386,1221
2008,Rural,Arunachal Pradesh,Other Crimes,Corruption,Female,13-17,8912,6170,2742,8261,651
2010,Rural,Andhra Pradesh,Crime Against Children,Trafficking,Male,46-60,593,110,483,299,294
2006,Urban,Odisha,Crime Against Women,Molestation,Male,0-12,8266,8066,200,8248,18
2009,Rural,Punjab,Other Crimes,Cyber Crime,Female,18-30,961,713,248,942,19
2002,Rural,Haryana,Crime Against Children,Trafficking,Female,0-12,4087,2474,1613,4071,16
2009,Urban,Tripura,Property Crime,Vandalism,Male,31-45,7683,5298,2385,5848,1835
2008,Urban,Maharashtra,Crime Against Men,Assault,Female,18-30,9966,2997,6969,5884,4082
2006,Urban,Maharashtra,Property Crime,Vandalism,Female,31-45,2687,2674,13,2685,2
2001,Urban,Manipur,Crime Against Women,Rape,Male,46-60,1341,473,868,686,655
2008,Rural,West Bengal,Other Crimes,Corruption,Male,31-45,3439,629,2810,2052,1387
2003,Urban,Telangana,Other Crimes,Corruption,Male,31-45,2064,836,1228,1811,253
2004,Urban,Gujarat,Crime Against Women,Dowry Deaths,Male,60+,7461,5194,2267,6391,1070
2009,Urban,Maharashtra,Other Crimes,Corruption,Male,13-17,752,538,214,628,124
2005,Rural,Tamil Nadu,Crime Against Children,Kidnapping,Male,31-45,717,148,569,649,68
2009,Urban,Karnataka,Other Crimes,Fraud,Female,13-17,3155,2348,807,2367,788
2003,Urban,Uttarakhand,Property Crime,Vandalism,Female,18-30,5364,4013,1351,4776,588
2006,Urban,Manipur,Other Crimes,Drug Offense,Male,0-12,2537,2454,83,2470,67
2001,Urban,Gujarat,Crime Against Children,Trafficking,Female,13-17,972,720,252,774,198
2002,Rural,Telangana,Property Crime,Burglary,Female,60+,8861,1129,7732,2017,6844
2001,Rural,Uttarakhand,Other Crimes,Drug Offense,Female,31-45,5643,290,5353,2943,2700
2004,Rural,Uttar Pradesh,Crime Against Men,Assault,Female,18-30,8233,888,7345,4347,3886
2005,Urban,Mizoram,Property Crime,Arson,Female,31-45,6783,996,5787,5700,1083
2006,Urban,Gujarat,Crime Against Men,Extortion,Male,18-30,3271,1615,1656,2345,926
2006,Urban,Haryana,Other Crimes,Fraud,Female,60+,6700,4921,1779,5392,1308
2002,Rural,Uttarakhand,Crime Against Women,Molestation,Male,60+,3390,1474,1916,1872,1518
2010,Rural,Uttarakhand,Crime Against Children,Kidnapping,Male,13-17,5067,1844,3223,4694,373
2007,Urban,Telangana,Crime Against Women,Molestation,Male,13-17,7385,3034,4351,3399,3986
2004,Urban,Uttarakhand,Crime Against Children,Child Labor,Female,46-60,4949,2910,2039,4657,292
2001,Urban,Mizoram,Property Crime,Theft,Male,0-12,6216,3285,2931,3617,2599
2001,Rural,Haryana,Crime Against Men,Extortion,Male,60+,4324,2255,2069,3892,432
2001,Urban,Punjab,Crime Against Women,Rape,Female,0-12,3226,1355,1871,2294,932
2009,Rural,Manipur,Other Crimes,Drug Offense,Male,13-17,9054,4067,4987,5616,3438
2003,Urban,Jharkhand,Property Crime,Arson,Female,60+,5829,1683,4146,5183,646
2007,Rural,Delhi,Property Crime,Burglary,Male,0-12,4996,2145,2851,2769,2227
2004,Rural,Manipur,Property Crime,Burglary,Female,60+,7653,3373,4280,6157,1496
2004,Urban,Nagaland,Other Crimes,Corruption,Male,0-12,3511,1764,1747,3484,27
2006,Urban,Meghalaya,Crime Against Children,Child Abuse,Male,0-12,2153,1616,537,2123,30
2004,Urban,Madhya Pradesh,Crime Against Women,Domestic Violence,Female,18-30,5928,156,5772,225,5703
2004,Urban,Assam,Other Crimes,Fraud,Female,0-12,1827,604,1223,1047,780
2009,Rural,Nagaland,Other Crimes,Cyber Crime,Male,31-45,1179,58,1121,102,1077
2007,Rural,Tamil Nadu,Other Crimes,Fraud,Male,60+,4686,4639,47,4651,35
2004,Urban,Telangana,Other Crimes,Cyber Crime,Male,0-12,4011,2163,1848,3387,624
2006,Rural,Himachal Pradesh,Crime Against Men,Murder,Female,31-45,6786,2790,3996,5148,1638
2008,Urban,Manipur,Crime Against Women,Rape,Male,60+,5953,1356,4597,3856,2097
2008,Rural,Haryana,Other Crimes,Fraud,Male,31-45,1600,187,1413,1538,62
2010,Rural,Rajasthan,Crime Against Children,Kidnapping,Female,0-12,6076,323,5753,5210,866
2001,Urban,Assam,Crime Against Men,Assault,Female,0-12,5582,2206,3376,4583,999
2010,Rural,Maharashtra,Other Crimes,Drug Offense,Female,31-45,2757,1876,881,2111,646
2007,Urban,Uttar Pradesh,Crime Against Women,Dowry Deaths,Male,0-12,5737,4716,1021,4855,882
2005,Rural,Tamil Nadu,Crime Against Men,Extortion,Female,46-60,6374,1631,4743,4609,1765
2004,Urban,Mizoram,Crime Against Women,Molestation,Female,13-17,1887,1660,227,1749,138
2002,Rural,Delhi,Crime Against Men,Assault,Male,13-17,8912,2766,6146,7569,1343
2002,Rural,Meghalaya,Crime Against Men,Robbery,Female,18-30,4095,1322,2773,3835,260
2003,Rural,Rajasthan,Property Crime,Vandalism,Female,46-60,2010,1839,171,1880,130
2001,Rural,Tripura,Crime Against Children,Trafficking,Male,31-45,5279,2942,2337,4443,836
2002,Urban,Maharashtra,Crime Against Women,Dowry Deaths,Female,60+,7251,1503,5748,5001,2250
2002,Rural,Himachal Pradesh,Other Crimes,Drug Offense,Male,0-12,8791,6951,1840,8618,173
2006,Rural,Jammu & Kashmir,Other Crimes,Corruption,Male,13-17,1970,984,986,1644,326
2007,Rural,Karnataka,Other Crimes,Corruption,Female,13-17,63,55,8,60,3
2005,Urban,Nagaland,Other Crimes,Fraud,Female,18-30,5074,2259,2815,3930,1144
2008,Rural,Gujarat,Crime Against Men,Assault,Female,0-12,5438,1472,3966,3904,1534
2007,Rural,Arunachal Pradesh,Crime Against Men,Assault,Male,46-60,3284,2552,732,2779,505
2010,Urban,Meghalaya,Crime Against Women,Domestic Violence,Female,13-17,68,6,62,28,40
2004,Urban,Maharashtra,Crime Against Women,Domestic Violence,Female,0-12,5979,3634,2345,3657,2322
2009,Urban,Sikkim,Crime Against Men,Extortion,Female,31-45,4250,446,3804,1363,2887
2008,Urban,Telangana,Other Crimes,Drug Offense,Female,0-12,5671,5430,241,5550,121
2003,Rural,Uttar Pradesh,Other Crimes,Cyber Crime,Female,0-12,8171,5527,2644,6314,1857
2010,Rural,Manipur,Property Crime,Arson,Female,13-17,5901,1214,4687,4640,1261
2006,Urban,Bihar,Crime Against Men,Robbery,Female,60+,6254,4582,1672,5773,481
2005,Rural,Manipur,Other Crimes,Drug Offense,Female,31-45,9777,5828,3949,8597,1180
2002,Urban,Kerala,Crime Against Women,Molestation,Male,60+,8999,3253,5746,4481,4518
2008,Rural,Arunachal Pradesh,Crime Against Men,Robbery,Male,60+,3159,1155,2004,1613,1546
2001,Urban,Uttar Pradesh,Crime Against Children,Child Labor,Male,0-12,7081,3570,3511,6487,594
2002,Urban,Uttar Pradesh,Crime Against Men,Robbery,Female,0-12,5543,2131,3412,3813,1730
2002,Rural,Punjab,Crime Against Children,Trafficking,Male,46-60,6764,3022,3742,6507,257
2004,Urban,Bihar,Property Crime,Burglary,Female,60+,265,78,187,168,97
2004,Urban,Uttar Pradesh,Property Crime,Arson,Male,46-60,2596,2411,185,2563,33
2002,Rural,Maharashtra,Crime Against Children,Kidnapping,Female,46-60,2305,1787,518,1871,434
2005,Rural,Himachal Pradesh,Other Crimes,Fraud,Male,46-60,3271,1104,2167,3184,87
2005,Urban,Kerala,Crime Against Men,Murder,Female,13-17,7276,905,6371,5143,2133
2004,Urban,Karnataka,Property Crime,Vandalism,Male,46-60,8236,2498,5738,3106,5130
2010,Urban,Uttarakhand,Property Crime,Burglary,Male,0-12,251,174,77,192,59
2006,Urban,Tamil Nadu,Crime Against Women,Domestic Violence,Female,31-45,3419,45,3374,2081,1338
2004,Rural,Odisha,Property Crime,Burglary,Male,0-12,9876,5500,4376,7491,2385
2009,Rural,Andhra Pradesh,Other Crimes,Fraud,Female,13-17,1893,1133,760,1847,46
2006,Rural,West Bengal,Other Crimes,Fraud,Male,31-45,3527,2258,1269,3477,50
2008,Urban,Andhra Pradesh,Crime Against Children,Trafficking,Female,31-45,471,137,334,310,161
2008,Rural,Himachal Pradesh,Crime Against Children,Trafficking,Male,0-12,5684,245,5439,5241,443
2005,Urban,Sikkim,Other Crimes,Corruption,Female,46-60,5895,3270,2625,3417,2478
2006,Urban,Uttarakhand,Other Crimes,Cyber Crime,Male,18-30,2359,1725,634,1825,534
2009,Urban,Bihar,Crime Against Children,Child Labor,Male,0-12,4395,3448,947,3453,942
2008,Urban,Sikkim,Property Crime,Arson,Female,46-60,7902,6066,1836,6182,1720
2007,Rural,Madhya Pradesh,Property Crime,Vandalism,Female,0-12,7146,5988,1158,6604,542
2003,Rural,Karnataka,Crime Against Men,Assault,Male,31-45,1636,86,1550,262,1374
2002,Rural,Arunachal Pradesh,Crime Against Men,Murder,Male,13-17,5802,1127,4675,3850,1952
2010,Rural,Rajasthan,Other Crimes,Fraud,Female,60+,6966,5699,1267,6408,558
2003,Rural,Gujarat,Other Crimes,Cyber Crime,Male,60+,1364,175,1189,282,1082
2008,Rural,Goa,Other Crimes,Drug Offense,Male,31-45,3529,2246,1283,3173,356
2003,Urban,Meghalaya,Crime Against Women,Rape,Male,31-45,9358,4250,5108,6616,2742
2007,Urban,Tamil Nadu,Crime Against Men,Robbery,Female,60+,4280,3601,679,4139,141
2003,Urban,Nagaland,Crime Against Women,Domestic Violence,Female,18-30,9053,6269,2784,6814,2239
2007,Rural,Mizoram,Other Crimes,Drug Offense,Male,31-45,1334,34,1300,1157,177
2010,Rural,Madhya Pradesh,Other Crimes,Drug Offense,Female,31-45,3815,2540,1275,2706,1109
2009,Rural,Sikkim,Other Crimes,Fraud,Female,60+,135,27,108,79,56
2004,Rural,Meghalaya,Crime Against Men,Murder,Female,31-45,9941,5503,4438,9114,827
2010,Urban,Haryana,Crime Against Women,Domestic Violence,Male,31-45,4575,4137,438,4199,376
2005,Urban,Telangana,Other Crimes,Fraud,Female,60+,2391,1231,1160,1658,733
2001,Rural,Odisha,Crime Against Men,Murder,Female,13-17,2772,604,2168,1723,1049
2003,Rural,Telangana,Crime Against Men,Murder,Male,18-30,2862,382,2480,795,2067
2006,Urban,Kerala,Crime Against Women,Molestation,Female,60+,1270,480,790,859,411
2005,Urban,Mizoram,Crime Against Children,Child Labor,Female,18-30,6451,3515,2936,5075,1376
2001,Rural,Jammu & Kashmir,Crime Against Children,Child Abuse,Female,46-60,1151,519,632,1017,134
2006,Rural,Manipur,Crime Against Women,Domestic Violence,Female,46-60,5675,2868,2807,4086,1589
2002,Urban,Delhi,Crime Against Children,Child Labor,Male,31-45,2601,83,2518,534,2067
2005,Urban,Himachal Pradesh,Other Crimes,Fraud,Female,18-30,3814,188,3626,721,3093
2009,Urban,Assam,Crime Against Women,Molestation,Female,13-17,8655,2516,6139,3782,4873
2005,Rural,Kerala,Property Crime,Vandalism,Female,13-17,7869,4325,3544,4400,3469
2006,Urban,Odisha,Other Crimes,Corruption,Male,60+,8142,6307,1835,6843,1299
2010,Urban,Mizoram,Crime Against Men,Extortion,Female,60+,6293,266,6027,4414,1879
2010,Urban,Kerala,Crime Against Children,Trafficking,Female,60+,8332,3922,4410,4074,4258
2008,Urban,Karnataka,Crime Against Children,Child Abuse,Female,31-45,7942,1574,6368,7291,651
2008,Urban,Tamil Nadu,Crime Against Children,Trafficking,Male,0-12,3893,2412,1481,3151,742
2001,Urban,Himachal Pradesh,Crime Against Men,Extortion,Male,60+,3043,2038,1005,2782,261
2007,Urban,Sikkim,Property Crime,Arson,Female,31-45,1225,96,1129,219,1006
2003,Urban,Mizoram,Crime Against Men,Murder,Male,0-12,6044,864,5180,5196,848
2009,Urban,Andhra Pradesh,Crime Against Children,Trafficking,Female,31-45,6933,6476,457,6800,133
2006,Urban,Madhya Pradesh,Crime Against Women,Molestation,Female,31-45,6328,3217,3111,3336,2992
2003,Urban,Kerala,Other Crimes,Cyber Crime,Female,13-17,6559,3671,2888,6384,175
2003,Rural,Rajasthan,Crime Against Women,Molestation,Female,46-60,6254,1785,4469,4507,1747
2006,Rural,Assam,Crime Against Women,Rape,Male,46-60,8367,1069,7298,1916,6451
2006,Rural,Andhra Pradesh,Crime Against Children,Child Abuse,Female,0-12,6903,4829,2074,5562,1341
2010,Rural,Rajasthan,Crime Against Women,Domestic Violence,Male,0-12,9192,2150,7042,2422,6770
2004,Urban,Telangana,Crime Against Men,Extortion,Female,60+,7031,5703,1328,6746,285
2002,Rural,Uttarakhand,Crime Against Children,Kidnapping,Male,46-60,1175,178,997,202,973
2008,Rural,Bihar,Other Crimes,Fraud,Male,46-60,4953,3441,1512,4793,160
2005,Rural,West Bengal,Crime Against Children,Child Abuse,Female,60+,2367,2319,48,2335,32
2009,Rural,Assam,Crime Against Men,Robbery,Female,46-60,9443,8338,1105,9009,434
2008,Urban,Tripura,Crime Against Children,Child Labor,Male,13-17,5460,2121,3339,2304,3156
2009,Rural,Tamil Nadu,Crime Against Men,Robbery,Male,31-45,5470,4057,1413,4293,1177
2007,Rural,Karnataka,Crime Against Children,Child Labor,Female,0-12,6620,3194,3426,5584,1036
2005,Urban,Haryana,Crime Against Women,Rape,Female,13-17,7872,6438,1434,7310,562
2004,Rural,Punjab,Other Crimes,Cyber Crime,Female,13-17,6414,2520,3894,3846,2568
2003,Urban,Mizoram,Property Crime,Theft,Male,46-60,9786,4860,4926,5930,3856
2010,Rural,Maharashtra,Crime Against Children,Child Abuse,Male,18-30,7883,5611,2272,7079,804
2008,Rural,Uttar Pradesh,Crime Against Men,Assault,Male,31-45,1378,495,883,531,847
2002,Rural,Punjab,Crime Against Children,Child Abuse,Female,46-60,8515,1147,7368,8407,108
2010,Urban,Jharkhand,Property Crime,Arson,Female,18-30,6709,6605,104,6708,1
2007,Urban,Gujarat,Crime Against Children,Trafficking,Male,46-60,2959,1695,1264,1723,1236
2008,Rural,Telangana,Crime Against Women,Dowry Deaths,Male,31-45,2042,1715,327,1760,282
2001,Rural,Madhya Pradesh,Crime Against Children,Child Labor,Male,60+,3703,2888,815,3234,469
2010,Urban,Haryana,Crime Against Men,Extortion,Male,18-30,5718,2262,3456,4979,739
2005,Urban,Telangana,Other Crimes,Drug Offense,Female,60+,8919,5593,3326,5667,3252
2001,Rural,Rajasthan,Property Crime,Burglary,Female,46-60,2445,299,2146,683,1762
2002,Urban,Madhya Pradesh,Crime Against Women,Domestic Violence,Male,46-60,2548,2122,426,2384,164
2002,Urban,Andhra Pradesh,Crime Against Women,Rape,Male,18-30,6690,5806,884,6059,631
2008,Urban,Assam,Property Crime,Burglary,Male,60+,857,98,759,425,432
2008,Rural,Chhattisgarh,Crime Against Children,Kidnapping,Female,46-60,956,438,518,735,221
2009,Rural,Assam,Property Crime,Theft,Female,18-30,609,13,596,437,172
2001,Rural,Odisha,Crime Against Men,Assault,Female,13-17,7664,2106,5558,3478,4186
2002,Rural,Delhi,Crime Against Women,Dowry Deaths,Male,46-60,848,170,678,522,326
2008,Rural,Arunachal Pradesh,Other Crimes,Drug Offense,Female,13-17,1789,1402,387,1660,129
2003,Urban,Haryana,Crime Against Children,Child Labor,Male,46-60,4892,2884,2008,4632,260
2001,Urban,Haryana,Crime Against Children,Child Abuse,Female,13-17,2342,1747,595,2191,151
2001,Rural,Goa,Crime Against Children,Child Abuse,Female,0-12,5754,1095,4659,2046,3708
2006,Urban,Delhi,Crime Against Men,Robbery,Female,31-45,568,355,213,417,151
2010,Urban,Jammu & Kashmir,Property Crime,Arson,Male,13-17,9825,7044,2781,8240,1585
2008,Rural,Nagaland,Crime Against Women,Molestation,Female,18-30,598,35,563,368,230
2002,Rural,Nagaland,Crime Against Women,Dowry Deaths,Male,31-45,2071,2002,69,2024,47
2001,Urban,Sikkim,Crime Against Children,Trafficking,Female,31-45,2349,923,1426,2022,327
2007,Rural,Sikkim,Crime Against Men,Assault,Female,13-17,8422,3486,4936,3669,4753
2002,Urban,Goa,Crime Against Men,Murder,Male,31-45,2298,2210,88,2296,2
2004,Rural,Meghalaya,Property Crime,Theft,Female,31-45,3165,2435,730,2754,411
2003,Urban,Maharashtra,Crime Against Men,Murder,Male,31-45,1012,60,952,459,553
2005,Urban,Kerala,Other Crimes,Drug Offense,Female,13-17,9754,6600,3154,9678,76
2002,Urban,Delhi,Crime Against Women,Domestic Violence,Male,0-12,4343,2205,2138,2465,1878
2007,Rural,Gujarat,Other Crimes,Corruption,Female,18-30,3904,2478,1426,3368,536
2002,Rural,Meghalaya,Crime Against Men,Extortion,Male,18-30,6736,4700,2036,6065,671
2008,Urban,Rajasthan,Crime Against Children,Child Labor,Male,46-60,4408,4157,251,4331,77
2003,Urban,Nagaland,Property Crime,Vandalism,Female,0-12,5255,3117,2138,3862,1393
2007,Rural,Goa,Property Crime,Theft,Female,31-45,8481,2682,5799,7349,1132
2002,Rural,Andhra Pradesh,Crime Against Children,Child Labor,Female,31-45,2285,1825,460,1941,344
2002,Urban,Tripura,Other Crimes,Cyber Crime,Male,60+,5914,3903,2011,4480,1434
2010,Rural,Chhattisgarh,Other Crimes,Corruption,Female,60+,1313,808,505,1010,303
2005,Rural,Madhya Pradesh,Crime Against Women,Molestation,Male,0-12,3996,3147,849,3460,536
2006,Rural,Karnataka,Crime Against Children,Kidnapping,Male,13-17,9567,5478,4089,8131,1436
2006,Urban,Sikkim,Crime Against Children,Kidnapping,Male,18-30,1202,860,342,1118,84
2007,Rural,Meghalaya,Crime Against Men,Robbery,Female,31-45,6061,4955,1106,5845,216
2006,Rural,Andhra Pradesh,Crime Against Children,Child Labor,Female,0-12,2428,1419,1009,2388,40
2001,Urban,Delhi,Other Crimes,Drug Offense,Male,46-60,2743,1940,803,2382,361
2010,Rural,Kerala,Crime Against Women,Rape,Male,0-12,9384,5588,3796,5963,3421
2007,Rural,Haryana,Crime Against Women,Dowry Deaths,Female,0-12,5818,2890,2928,3348,2470
2002,Rural,Tamil Nadu,Crime Against Children,Child Abuse,Female,13-17,6078,123,5955,4928,1150
2010,Urban,Haryana,Other Crimes,Corruption,Female,0-12,5699,4487,1212,4631,1068
2008,Urban,Karnataka,Other Crimes,Fraud,Male,31-45,1568,200,1368,465,1103
2010,Rural,Uttarakhand,Other Crimes,Drug Offense,Male,60+,381,194,187,271,110
2003,Urban,Delhi,Property Crime,Vandalism,Male,18-30,6746,5515,1231,5879,867
2007,Urban,Chhattisgarh,Crime Against Men,Robbery,Male,46-60,3338,2456,882,2484,854
2009,Rural,Karnataka,Other Crimes,Cyber Crime,Female,31-45,8103,4882,3221,6899,1204
2006,Rural,Meghalaya,Property Crime,Vandalism,Male,13-17,9261,2138,7123,3720,5541
2010,Rural,Kerala,Crime Against Children,Trafficking,Male,18-30,3025,1829,1196,2880,145
2009,Rural,Manipur,Crime Against Women,Dowry Deaths,Female,0-12,8163,2063,6100,6807,1356
2001,Rural,Gujarat,Property Crime,Arson,Male,31-45,7812,125,7687,4688,3124
2006,Urban,Odisha,Property Crime,Vandalism,Male,18-30,3966,1359,2607,3272,694
2002,Rural,Telangana,Crime Against Men,Murder,Male,46-60,3234,38,3196,75,3159
2009,Urban,Chhattisgarh,Other Crimes,Cyber Crime,Male,31-45,5335,397,4938,3353,1982
2002,Rural,Haryana,Crime Against Women,Dowry Deaths,Female,13-17,4980,4118,862,4647,333
2008,Rural,Tamil Nadu,Crime Against Women,Molestation,Male,46-60,316,99,217,100,216
2010,Urban,Assam,Other Crimes,Corruption,Male,31-45,3300,2331,969,2748,552
2007,Rural,Punjab,Crime Against Men,Assault,Female,31-45,3302,673,2629,1210,2092
2007,Rural,Punjab,Crime Against Men,Robbery,Female,13-17,3677,745,2932,2898,779
2006,Urban,Arunachal Pradesh,Crime Against Women,Rape,Female,60+,7677,6439,1238,7266,411
2008,Rural,Arunachal Pradesh,Crime Against Children,Child Labor,Male,18-30,6836,2327,4509,6099,737
2001,Rural,Sikkim,Property Crime,Theft,Male,0-12,2905,703,2202,1175,1730
2003,Rural,Tripura,Crime Against Men,Robbery,Male,18-30,2972,1381,1591,2250,722
2005,Rural,Karnataka,Crime Against Children,Child Labor,Female,31-45,5811,3235,2576,4736,1075
2003,Rural,Assam,Crime Against Men,Murder,Female,60+,3213,1574,1639,2948,265
2003,Urban,Nagaland,Crime Against Men,Murder,Male,60+,2864,1485,1379,1530,1334
2006,Rural,Manipur,Crime Against Men,Extortion,Female,13-17,7535,6017,1518,6637,898
2005,Urban,Gujarat,Crime Against Children,Trafficking,Female,18-30,7063,4876,2187,6935,128
2007,Urban,Uttar Pradesh,Crime Against Women,Rape,Male,13-17,4555,2434,2121,3925,630
2002,Rural,Mizoram,Crime Against Children,Trafficking,Male,60+,5671,2420,3251,2997,2674
2002,Urban,Tamil Nadu,Crime Against Children,Kidnapping,Female,60+,2741,791,1950,1913,828
2006,Urban,Nagaland,Crime Against Women,Dowry Deaths,Male,0-12,9943,1802,8141,7313,2630
2004,Urban,Arunachal Pradesh,Other Crimes,Corruption,Male,60+,5862,2385,3477,5283,579
2001,Rural,Gujarat,Property Crime,Theft,Female,18-30,6660,447,6213,5615,1045
2010,Rural,West Bengal,Property Crime,Theft,Female,31-45,5397,5091,306,5099,298
2005,Rural,Rajasthan,Crime Against Men,Extortion,Female,60+,7841,5868,1973,7034,807
2002,Urban,Tripura,Other Crimes,Corruption,Male,13-17,4426,2120,2306,4326,100
2001,Rural,Gujarat,Crime Against Men,Assault,Female,31-45,6101,2618,3483,5324,777
2007,Urban,Tamil Nadu,Crime Against Children,Kidnapping,Female,46-60,362,99,263,353,9
2005,Rural,Tamil Nadu,Crime Against Children,Child Abuse,Female,60+,1370,1087,283,1289,81
2010,Rural,Punjab,Other Crimes,Drug Offense,Female,46-60,1221,265,956,1117,104
2004,Rural,Odisha,Crime Against Women,Rape,Male,18-30,7453,6163,1290,7161,292
2005,Rural,West Bengal,Other Crimes,Drug Offense,Female,46-60,5801,2331,3470,3676,2125
2005,Rural,Delhi,Crime Against Women,Rape,Female,0-12,4790,1108,3682,3260,1530
2005,Rural,Uttarakhand,Crime Against Men,Robbery,Female,46-60,1532,366,1166,605,927
2003,Urban,Assam,Crime Against Men,Assault,Male,46-60,2141,159,1982,759,1382
2005,Urban,Karnataka,Crime Against Men,Assault,Male,18-30,6919,187,6732,5910,1009
2003,Rural,Chhattisgarh,Crime Against Women,Molestation,Female,60+,5338,4996,342,5258,80
2009,Urban,Madhya Pradesh,Crime Against Women,Rape,Female,13-17,9659,2702,6957,5172,4487
2009,Urban,Tamil Nadu,Property Crime,Vandalism,Female,18-30,1033,47,986,663,370
2007,Rural,Kerala,Crime Against Women,Dowry Deaths,Male,0-12,2024,939,1085,1944,80
2002,Rural,Tamil Nadu,Property Crime,Theft,Female,18-30,6120,5099,1021,6024,96
2005,Rural,Haryana,Other Crimes,Corruption,Male,13-17,3935,348,3587,3549,386
2006,Rural,Gujarat,Property Crime,Theft,Female,60+,846,300,546,804,42
2006,Urban,Arunachal Pradesh,Crime Against Women,Molestation,Female,18-30,749,577,172,722,27
2001,Urban,Nagaland,Crime Against Women,Rape,Male,0-12,9270,3225,6045,4805,4465
2005,Urban,Delhi,Crime Against Men,Murder,Male,31-45,7496,3118,4378,6578,918
2004,Rural,Sikkim,Crime Against Children,Child Abuse,Female,0-12,8646,6842,1804,8396,250
2005,Rural,Sikkim,Property Crime,Vandalism,Male,0-12,2517,1703,814,2268,249
2002,Rural,Rajasthan,Other Crimes,Drug Offense,Male,0-12,7845,5452,2393,6154,1691
2004,Urban,Himachal Pradesh,Property Crime,Theft,Male,60+,1189,239,950,1164,25
2010,Rural,Uttar Pradesh,Property Crime,Vandalism,Male,60+,7214,3734,3480,6348,866
2002,Rural,Andhra Pradesh,Other Crimes,Fraud,Female,46-60,1696,835,861,1179,517
2007,Urban,Maharashtra,Other Crimes,Cyber Crime,Female,31-45,6488,2512,3976,4661,1827
2006,Urban,Mizoram,Crime Against Children,Kidnapping,Male,31-45,6938,472,6466,3502,3436
2006,Urban,Goa,Other Crimes,Drug Offense,Male,31-45,9580,379,9201,514,9066
2002,Rural,Sikkim,Property Crime,Theft,Male,60+,3079,2919,160,2959,120
2002,Rural,Rajasthan,Other Crimes,Fraud,Male,18-30,7170,473,6697,1479,5691
2004,Urban,Gujarat,Crime Against Women,Dowry Deaths,Male,60+,1647,1232,415,1491,156
2001,Rural,Andhra Pradesh,Crime Against Children,Child Abuse,Male,13-17,4072,2579,1493,3481,591
2002,Rural,Odisha,Property Crime,Burglary,Female,18-30,161,118,43,159,2
2006,Rural,Maharashtra,Property Crime,Burglary,Male,0-12,414,337,77,394,20
2009,Urban,Assam,Property Crime,Burglary,Female,60+,9686,3035,6651,8923,763
2006,Urban,Jharkhand,Crime Against Men,Murder,Male,18-30,1397,922,475,1284,113
2003,Urban,Uttarakhand,Crime Against Children,Trafficking,Male,0-12,5666,4273,1393,5003,663
2004,Rural,Manipur,Crime Against Children,Trafficking,Female,0-12,3452,3093,359,3114,338
2001,Rural,Jharkhand,Property Crime,Arson,Male,60+,3484,2779,705,3463,21
2006,Urban,Kerala,Crime Against Women,Molestation,Female,46-60,3205,3112,93,3129,76
2009,Urban,Haryana,Other Crimes,Fraud,Male,0-12,5856,558,5298,594,5262
2001,Rural,Andhra Pradesh,Crime Against Women,Domestic Violence,Male,0-12,3526,1708,1818,2448,1078
2005,Rural,Telangana,Other Crimes,Drug Offense,Female,13-17,4600,3718,882,4133,467
2010,Rural,Jammu & Kashmir,Crime Against Men,Murder,Male,18-30,6262,206,6056,5168,1094
2009,Urban,Uttar Pradesh,Crime Against Children,Child Labor,Female,31-45,8730,5183,3547,6503,2227
2007,Rural,Kerala,Property Crime,Arson,Male,46-60,3273,1954,1319,2676,597
2006,Urban,Haryana,Crime Against Women,Rape,Female,0-12,480,356,124,394,86
2008,Rural,Andhra Pradesh,Crime Against Women,Rape,Male,31-45,550,363,187,482,68
2009,Rural,Jharkhand,Crime Against Children,Child Abuse,Male,18-30,117,66,51,98,19
2001,Rural,Chhattisgarh,Crime Against Women,Domestic Violence,Male,46-60,5208,5080,128,5131,77
2010,Rural,Mizoram,Crime Against Children,Trafficking,Male,0-12,7602,2176,5426,7341,261
2005,Rural,Assam,Other Crimes,Corruption,Female,60+,2208,1945,263,2206,2
2005,Rural,Arunachal Pradesh,Crime Against Women,Rape,Male,60+,3214,1897,1317,2167,1047
2008,Rural,Arunachal Pradesh,Other Crimes,Corruption,Female,46-60,3952,2875,1077,3447,505
2006,Rural,Andhra Pradesh,Crime Against Women,Rape,Female,60+,5322,976,4346,4484,838
2010,Urban,Uttarakhand,Crime Against Children,Trafficking,Male,31-45,7443,6060,1383,6377,1066
2006,Urban,Uttar Pradesh,Crime Against Men,Robbery,Female,18-30,9294,5215,4079,9240,54
2003,Urban,Mizoram,Crime Against Men,Assault,Male,0-12,9530,3771,5759,8000,1530
2010,Rural,Uttarakhand,Crime Against Children,Child Abuse,Female,0-12,665,164,501,528,137
2009,Rural,Chhattisgarh,Crime Against Children,Child Labor,Male,31-45,3446,3329,117,3371,75
2007,Rural,Uttar Pradesh,Crime Against Men,Robbery,Male,31-45,6407,991,5416,2687,3720
2007,Urban,Nagaland,Crime Against Men,Robbery,Female,18-30,7677,3322,4355,5027,2650
2007,Urban,Uttarakhand,Other Crimes,Corruption,Female,0-12,3805,117,3688,3645,160
2006,Rural,Manipur,Crime Against Women,Molestation,Male,46-60,6345,4767,1578,6142,203
2008,Urban,Goa,Crime Against Women,Domestic Violence,Male,60+,2552,1899,653,2402,150
2008,Rural,Kerala,Crime Against Men,Extortion,Male,60+,9271,1449,7822,8721,550
2005,Rural,Meghalaya,Property Crime,Vandalism,Female,31-45,9316,8922,394,9294,22
2005,Urban,Arunachal Pradesh,Other Crimes,Cyber Crime,Female,0-12,1189,712,477,1150,39
2003,Urban,Kerala,Crime Against Children,Trafficking,Female,31-45,4305,4234,71,4269,36
2009,Urban,Punjab,Crime Against Children,Kidnapping,Female,60+,8417,6736,1681,7886,531
2004,Rural,Sikkim,Property Crime,Arson,Female,0-12,7401,3295,4106,6596,805
2007,Urban,Bihar,Crime Against Women,Rape,Female,31-45,3564,363,3201,1095,2469
2005,Urban,Karnataka,Other Crimes,Cyber Crime,Female,0-12,1205,444,761,626,579
2004,Urban,Assam,Other Crimes,Fraud,Female,46-60,9566,8723,843,8927,639
2007,Urban,Maharashtra,Other Crimes,Cyber Crime,Female,46-60,187,45,142,130,57
2002,Rural,Kerala,Crime Against Women,Rape,Female,60+,1494,932,562,1386,108
2009,Urban,Gujarat,Crime Against Women,Molestation,Male,60+,112,107,5,107,5
2007,Rural,Manipur,Crime Against Men,Extortion,Female,31-45,1394,954,440,1123,271
2003,Urban,Kerala,Crime Against Children,Child Abuse,Female,18-30,3283,837,2446,1536,1747
2001,Urban,Tamil Nadu,Property Crime,Burglary,Female,46-60,9624,1639,7985,4200,5424
2009,Rural,Andhra Pradesh,Crime Against Children,Child Abuse,Female,0-12,786,38,748,176,610
2006,Urban,Andhra Pradesh,Crime Against Men,Extortion,Male,46-60,9786,1713,8073,7272,2514
2009,Urban,Tripura,Crime Against Children,Kidnapping,Male,46-60,5645,4336,1309,5123,522
2008,Rural,Himachal Pradesh,Crime Against Children,Child Abuse,Female,46-60,1030,68,962,788,242
2005,Urban,Andhra Pradesh,Crime Against Men,Extortion,Female,46-60,7532,5251,2281,7211,321
2005,Urban,Gujarat,Crime Against Women,Dowry Deaths,Male,18-30,9375,510,8865,5178,4197
2009,Urban,Kerala,Crime Against Men,Assault,Female,18-30,7708,1460,6248,2811,4897
2008,Urban,Chhattisgarh,Crime Against Women,Molestation,Male,0-12,9284,1293,7991,9178,106
2005,Rural,Andhra Pradesh,Crime Against Children,Kidnapping,Male,0-12,7359,1643,5716,2582,4777
2004,Urban,Chhattisgarh,Crime Against Men,Extortion,Male,31-45,6218,752,5466,1100,5118
2002,Rural,Chhattisgarh,Crime Against Men,Extortion,Male,60+,1401,923,478,1380,21
2008,Rural,Nagaland,Crime Against Children,Child Labor,Male,0-12,784,1,783,77,707
2002,Rural,Nagaland,Other Crimes,Drug Offense,Female,46-60,3018,820,2198,1555,1463
2002,Rural,Tripura,Property Crime,Vandalism,Male,31-45,1575,809,766,847,728
2010,Urban,Nagaland,Other Crimes,Fraud,Female,13-17,9402,9032,370,9173,229
2003,Rural,Nagaland,Other Crimes,Drug Offense,Female,31-45,4854,210,4644,3814,1040
2006,Urban,Meghalaya,Crime Against Women,Domestic Violence,Female,0-12,3109,427,2682,2356,753
2010,Urban,Goa,Crime Against Children,Trafficking,Female,31-45,1332,1285,47,1329,3
2006,Urban,Chhattisgarh,Crime Against Men,Assault,Male,13-17,6822,3391,3431,6025,797
2003,Urban,Meghalaya,Crime Against Women,Molestation,Male,60+,6287,1865,4422,4015,2272
2010,Urban,Tripura,Crime Against Men,Assault,Male,13-17,904,448,456,515,389
2008,Rural,Tripura,Property Crime,Burglary,Female,60+,7145,3768,3377,6658,487
2002,Urban,Haryana,Crime Against Women,Molestation,Male,0-12,9784,6692,3092,8374,1410
2009,Rural,Jammu & Kashmir,Crime Against Men,Robbery,Male,0-12,2212,146,2066,2192,20
2002,Urban,Mizoram,Other Crimes,Corruption,Female,60+,5289,4203,1086,4848,441
2007,Urban,Jharkhand,Other Crimes,Fraud,Female,31-45,6808,3474,3334,3676,3132
2010,Urban,Chhattisgarh,Crime Against Women,Dowry Deaths,Male,0-12,3917,300,3617,489,3428
2006,Rural,Jharkhand,Crime Against Children,Trafficking,Female,13-17,5530,728,4802,2161,3369
2004,Rural,West Bengal,Property Crime,Arson,Female,18-30,8508,6660,1848,7457,1051
2001,Urban,Sikkim,Crime Against Children,Kidnapping,Female,60+,1441,1368,73,1395,46
2005,Urban,Mizoram,Crime Against Women,Dowry Deaths,Female,18-30,5978,1052,4926,3433,2545
2007,Rural,Jammu & Kashmir,Crime Against Men,Assault,Female,13-17,4159,677,3482,3199,960
2006,Urban,Goa,Crime Against Children,Trafficking,Male,31-45,5781,4176,1605,5590,191
2001,Rural,Jharkhand,Crime Against Women,Domestic Violence,Male,13-17,3914,1688,2226,1983,1931
2009,Rural,Odisha,Crime Against Women,Domestic Violence,Male,60+,9042,8010,1032,8612,430
2010,Rural,Tamil Nadu,Other Crimes,Fraud,Male,18-30,8833,8664,169,8718,115
2002,Urban,Gujarat,Property Crime,Theft,Female,0-12,1460,155,1305,737,723
2010,Urban,Manipur,Property Crime,Theft,Male,0-12,9426,657,8769,1916,7510
2009,Rural,Punjab,Crime Against Men,Murder,Female,31-45,2262,567,1695,604,1658
2006,Urban,Gujarat,Crime Against Men,Robbery,Female,18-30,1511,1295,216,1456,55
2008,Rural,Manipur,Crime Against Men,Assault,Male,31-45,6675,2688,3987,2756,3919
2001,Rural,Arunachal Pradesh,Property Crime,Arson,Male,31-45,4436,1869,2567,1941,2495
2001,Urban,Arunachal Pradesh,Crime Against Women,Dowry Deaths,Female,18-30,7171,387,6784,6881,290
2009,Urban,Arunachal Pradesh,Crime Against Women,Molestation,Male,60+,7263,3982,3281,5996,1267
2003,Urban,Odisha,Other Crimes,Corruption,Female,0-12,1013,366,647,656,357
2003,Urban,Jammu & Kashmir,Crime Against Women,Molestation,Male,13-17,703,98,605,443,260
2002,Urban,Himachal Pradesh,Property Crime,Burglary,Female,0-12,6557,2707,3850,4265,2292
2002,Urban,Gujarat,Crime Against Men,Extortion,Female,60+,9038,4050,4988,7767,1271
2010,Urban,Kerala,Crime Against Women,Molestation,Female,46-60,9777,8252,1525,9776,1
2002,Urban,Jammu & Kashmir,Other Crimes,Cyber Crime,Male,31-45,1359,1158,201,1195,164
2004,Rural,Tripura,Crime Against Men,Assault,Male,60+,2990,1437,1553,2747,243
2006,Rural,Tamil Nadu,Other Crimes,Cyber Crime,Male,46-60,5321,2208,3113,5299,22
2001,Urban,Madhya Pradesh,Other Crimes,Drug Offense,Male,31-45,9904,3210,6694,3706,6198
2008,Rural,Rajasthan,Other Crimes,Fraud,Female,13-17,2170,199,1971,1632,538
2001,Urban,Uttarakhand,Crime Against Children,Child Labor,Female,18-30,1053,898,155,1010,43
2008,Rural,Haryana,Crime Against Men,Murder,Male,13-17,5828,1429,4399,3348,2480
2005,Rural,Chhattisgarh,Other Crimes,Fraud,Female,0-12,2472,902,1570,1673,799
2002,Urban,Jharkhand,Crime Against Children,Child Labor,Female,18-30,1279,1253,26,1256,23
2004,Rural,Andhra Pradesh,Property Crime,Vandalism,Female,31-45,1719,1046,673,1271,448
2005,Rural,Telangana,Crime Against Children,Kidnapping,Female,46-60,8838,8041,797,8166,672
2003,Urban,Uttarakhand,Crime Against Women,Dowry Deaths,Male,13-17,5074,1575,3499,2842,2232
2005,Rural,Karnataka,Crime Against Men,Robbery,Female,46-60,9588,3881,5707,8619,969
2010,Rural,Arunachal Pradesh,Property Crime,Arson,Male,31-45,4035,814,3221,2694,1341
2008,Urban,Karnataka,Crime Against Children,Trafficking,Male,60+,1208,290,918,594,614
2005,Urban,Uttar Pradesh,Other Crimes,Corruption,Female,0-12,2531,564,1967,1705,826
2006,Rural,Gujarat,Other Crimes,Drug Offense,Female,60+,1386,607,779,1060,326
2004,Urban,Goa,Crime Against Children,Kidnapping,Female,18-30,5875,1249,4626,4154,1721
2001,Urban,Goa,Property Crime,Vandalism,Female,60+,1335,593,742,987,348
2005,Rural,Manipur,Property Crime,Arson,Male,46-60,6975,5472,1503,6252,723
2007,Rural,Assam,Other Crimes,Drug Offense,Female,60+,8567,2978,5589,7173,1394
2008,Urban,Goa,Property Crime,Arson,Male,60+,9410,7075,2335,9291,119
2005,Rural,Assam,Crime Against Men,Robbery,Female,13-17,9797,4590,5207,9036,761
2004,Urban,Tamil Nadu,Crime Against Women,Dowry Deaths,Female,0-12,1468,805,663,923,545
2003,Rural,Mizoram,Property Crime,Burglary,Female,60+,4198,1861,2337,2816,1382
2010,Urban,Karnataka,Other Crimes,Drug Offense,Female,13-17,51,20,31,46,5
2004,Urban,Mizoram,Property Crime,Arson,Female,0-12,8422,4472,3950,7094,1328
2004,Rural,Karnataka,Crime Against Children,Child Labor,Female,18-30,9281,339,8942,5501,3780
2006,Rural,Meghalaya,Crime Against Children,Trafficking,Male,60+,2710,1233,1477,2101,609
2008,Rural,Chhattisgarh,Other Crimes,Drug Offense,Male,0-12,5600,927,4673,1611,3989
2002,Urban,Uttar Pradesh,Other Crimes,Drug Offense,Male,18-30,2720,1156,1564,1578,1142
2008,Rural,Sikkim,Crime Against Children,Child Labor,Female,13-17,8276,6855,1421,7984,292
2006,Urban,Tamil Nadu,Crime Against Men,Murder,Male,0-12,9233,594,8639,8242,991
2003,Urban,Odisha,Crime Against Men,Extortion,Female,46-60,3051,1928,1123,2906,145
2005,Rural,Telangana,Property Crime,Vandalism,Female,60+,5505,3452,2053,4994,511
2003,Rural,Rajasthan,Crime Against Women,Dowry Deaths,Male,0-12,4667,2887,1780,3721,946
2008,Rural,Chhattisgarh,Crime Against Children,Trafficking,Male,46-60,5488,3329,2159,3473,2015
2001,Rural,Maharashtra,Crime Against Men,Extortion,Female,13-17,3729,768,2961,2412,1317
2007,Urban,Tamil Nadu,Crime Against Men,Assault,Male,31-45,3901,1844,2057,2751,1150
2005,Urban,Gujarat,Crime Against Women,Molestation,Male,18-30,5201,1664,3537,3732,1469
2007,Rural,Telangana,Other Crimes,Cyber Crime,Female,60+,5774,4462,1312,5270,504
2007,Urban,Tamil Nadu,Crime Against Children,Kidnapping,Female,60+,1859,1216,643,1624,235
2005,Urban,Haryana,Crime Against Children,Kidnapping,Female,46-60,2926,2539,387,2803,123
2005,Rural,Himachal Pradesh,Crime Against Men,Assault,Female,13-17,4000,2152,1848,3021,979
2010,Rural,Kerala,Crime Against Men,Extortion,Female,60+,3574,1397,2177,2355,1219
2006,Urban,Goa,Crime Against Children,Child Labor,Male,31-45,5554,3550,2004,5193,361
2010,Urban,Odisha,Other Crimes,Corruption,Female,18-30,250,3,247,239,11
2004,Rural,Tripura,Crime Against Men,Extortion,Female,31-45,3727,644,3083,1286,2441
2005,Rural,Meghalaya,Property Crime,Vandalism,Female,60+,5434,4448,986,4605,829
2010,Rural,Telangana,Other Crimes,Cyber Crime,Female,31-45,4755,3780,975,4131,624
2008,Rural,Andhra Pradesh,Crime Against Men,Extortion,Female,0-12,3252,226,3026,971,2281
2007,Urban,Odisha,Other Crimes,Fraud,Male,18-30,9059,3998,5061,5425,3634
2007,Urban,Punjab,Crime Against Children,Child Labor,Male,18-30,77,30,47,38,39
2002,Urban,Assam,Property Crime,Burglary,Female,0-12,4118,3833,285,3909,209
2006,Rural,Manipur,Other Crimes,Corruption,Male,18-30,7075,2256,4819,2658,4417
2010,Rural,Mizoram,Crime Against Children,Trafficking,Female,31-45,3204,1692,1512,1851,1353
2009,Rural,Nagaland,Crime Against Women,Molestation,Male,46-60,9495,9485,10,9493,2
2009,Urban,Uttarakhand,Property Crime,Theft,Male,13-17,9135,4236,4899,5701,3434
2005,Urban,Mizoram,Crime Against Women,Domestic Violence,Female,18-30,7621,1092,6529,2752,4869
2006,Urban,Odisha,Property Crime,Theft,Female,46-60,7860,1943,5917,7297,563
2010,Rural,Delhi,Property Crime,Arson,Male,60+,8185,5165,3020,6861,1324
2007,Urban,Karnataka,Property Crime,Arson,Female,46-60,4569,1334,3235,2529,2040
2004,Rural,Tripura,Property Crime,Arson,Female,18-30,8725,5709,3016,6156,2569
2002,Urban,Bihar,Property Crime,Arson,Male,46-60,4435,898,3537,1956,2479
2002,Rural,Karnataka,Crime Against Children,Child Abuse,Male,13-17,5555,3170,2385,4863,692
2007,Urban,Punjab,Property Crime,Vandalism,Male,31-45,5744,3518,2226,4959,785
2006,Urban,Telangana,Crime Against Men,Murder,Female,46-60,9769,6246,3523,7401,2368
2008,Urban,Tripura,Other Crimes,Cyber Crime,Male,60+,8594,697,7897,5569,3025
2006,Rural,Nagaland,Crime Against Children,Child Abuse,Female,31-45,7953,7933,20,7943,10
2002,Rural,Goa,Crime Against Women,Dowry Deaths,Male,46-60,6528,1197,5331,5783,745
2001,Rural,Arunachal Pradesh,Other Crimes,Corruption,Male,60+,353,170,183,290,63
2003,Rural,Andhra Pradesh,Crime Against Children,Child Abuse,Female,60+,364,176,188,213,151
2008,Urban,Uttar Pradesh,Other Crimes,Corruption,Female,31-45,4906,2438,2468,4730,176
2003,Rural,Tripura,Crime Against Children,Child Abuse,Male,60+,8065,7052,1013,7569,496
2001,Rural,Jharkhand,Other Crimes,Cyber Crime,Female,18-30,4542,2768,1774,3610,932
2003,Rural,Karnataka,Crime Against Children,Trafficking,Male,18-30,501,101,400,280,221
2006,Rural,Karnataka,Crime Against Children,Child Abuse,Male,60+,5412,1760,3652,3596,1816
2004,Urban,Sikkim,Other Crimes,Fraud,Male,0-12,6369,1694,4675,5057,1312
2009,Urban,West Bengal,Crime Against Children,Kidnapping,Male,46-60,8179,4506,3673,5045,3134
2005,Rural,Tripura,Other Crimes,Cyber Crime,Male,13-17,8477,8231,246,8458,19
2001,Rural,Uttar Pradesh,Crime Against Women,Domestic Violence,Male,0-12,4700,782,3918,1053,3647
2007,Rural,Sikkim,Crime Against Children,Kidnapping,Male,18-30,1854,1416,438,1779,75
2006,Urban,Gujarat,Crime Against Women,Domestic Violence,Female,60+,4876,1990,2886,3067,1809
2002,Rural,Odisha,Other Crimes,Fraud,Female,60+,5340,4714,626,5141,199
2010,Urban,Assam,Property Crime,Arson,Male,46-60,1248,421,827,1012,236
2010,Rural,Rajasthan,Other Crimes,Cyber Crime,Female,60+,5042,1210,3832,4285,757
2001,Rural,Uttar Pradesh,Crime Against Women,Molestation,Male,46-60,1587,67,1520,287,1300
2005,Urban,Haryana,Property Crime,Theft,Female,46-60,4239,3335,904,3424,815
2004,Rural,Uttar Pradesh,Crime Against Men,Robbery,Male,46-60,4551,2815,1736,2957,1594
2001,Urban,Andhra Pradesh,Crime Against Children,Trafficking,Male,18-30,6088,2751,3337,3389,2699
2008,Rural,Delhi,Other Crimes,Corruption,Male,31-45,634,594,40,613,21
2003,Rural,Andhra Pradesh,Crime Against Women,Rape,Female,0-12,7254,1469,5785,5270,1984
2008,Urban,Rajasthan,Other Crimes,Corruption,Male,18-30,9768,4199,5569,6527,3241
2009,Rural,Jammu & Kashmir,Other Crimes,Corruption,Male,13-17,285,1,284,35,250
2006,Rural,West Bengal,Crime Against Women,Dowry Deaths,Female,31-45,3891,3681,210,3728,163
2004,Rural,Karnataka,Crime Against Men,Murder,Female,18-30,7422,6044,1378,6531,891
2010,Urban,Telangana,Crime Against Children,Kidnapping,Male,18-30,1053,480,573,887,166
2006,Urban,Jharkhand,Crime Against Children,Child Labor,Male,0-12,5721,4890,831,5303,418
2005,Rural,Goa,Crime Against Women,Molestation,Female,0-12,3122,1412,1710,2876,246
2004,Urban,Haryana,Crime Against Women,Rape,Male,60+,7037,3748,3289,5507,1530
2003,Rural,Tamil Nadu,Other Crimes,Corruption,Male,31-45,3624,3154,470,3610,14
2001,Rural,Nagaland,Crime Against Children,Kidnapping,Male,13-17,2202,192,2010,1757,445
2006,Rural,Punjab,Crime Against Men,Assault,Male,18-30,8885,1923,6962,7224,1661
2001,Urban,Uttarakhand,Crime Against Women,Rape,Male,18-30,8280,540,7740,4295,3985
2005,Urban,Mizoram,Crime Against Women,Molestation,Male,31-45,5894,1233,4661,5830,64
2009,Rural,Nagaland,Other Crimes,Cyber Crime,Female,13-17,3247,2607,640,2857,390
2001,Urban,Himachal Pradesh,Crime Against Women,Domestic Violence,Male,0-12,3222,1413,1809,2302,920
2009,Urban,Himachal Pradesh,Crime Against Men,Robbery,Female,18-30,3194,1378,1816,2173,1021
2006,Urban,Madhya Pradesh,Crime Against Men,Extortion,Male,18-30,4573,3143,1430,4465,108
2003,Rural,Delhi,Crime Against Children,Trafficking,Female,60+,5273,1965,3308,2897,2376
2001,Urban,West Bengal,Crime Against Children,Trafficking,Male,46-60,7490,4707,2783,6176,1314
2004,Rural,Meghalaya,Crime Against Women,Domestic Violence,Female,46-60,7750,4120,3630,4443,3307
2004,Urban,Bihar,Other Crimes,Corruption,Male,13-17,6644,2970,3674,4113,2531
2001,Rural,Goa,Crime Against Children,Kidnapping,Male,31-45,9534,2122,7412,8253,1281
2005,Rural,Telangana,Crime Against Men,Robbery,Male,0-12,4583,1419,3164,3538,1045
2007,Urban,Andhra Pradesh,Crime Against Children,Kidnapping,Female,13-17,8317,4349,3968,8128,189
2001,Rural,Punjab,Property Crime,Theft,Male,0-12,4667,3055,1612,4267,400
2002,Rural,Andhra Pradesh,Property Crime,Arson,Male,31-45,5294,4319,975,4324,970
2003,Urban,Chhattisgarh,Crime Against Men,Assault,Female,46-60,572,269,303,352,220
2010,Urban,Uttar Pradesh,Crime Against Women,Rape,Male,46-60,908,282,626,450,458
2001,Urban,Delhi,Crime Against Children,Child Labor,Male,13-17,987,379,608,966,21
2010,Urban,Arunachal Pradesh,Crime Against Women,Dowry Deaths,Male,60+,3893,1340,2553,1355,2538
2004,Rural,Kerala,Property Crime,Theft,Female,18-30,4882,678,4204,3555,1327
2009,Rural,Madhya Pradesh,Property Crime,Burglary,Male,18-30,4242,105,4137,168,4074
2009,Rural,Odisha,Crime Against Women,Domestic Violence,Male,46-60,9740,1233,8507,9208,532
2010,Urban,Goa,Other Crimes,Fraud,Male,46-60,5740,450,5290,4667,1073
2009,Rural,Bihar,Property Crime,Theft,Male,31-45,6004,3802,2202,5480,524
2008,Urban,Mizoram,Crime Against Men,Murder,Male,46-60,4173,1817,2356,2874,1299
2004,Rural,Delhi,Property Crime,Burglary,Male,31-45,8536,2711,5825,7527,1009
2002,Urban,Gujarat,Crime Against Men,Assault,Female,13-17,408,206,202,251,157
2006,Urban,Manipur,Property Crime,Arson,Female,31-45,1662,189,1473,1265,397
2006,Rural,Karnataka,Crime Against Women,Molestation,Female,18-30,1931,651,1280,1780,151
2006,Rural,Maharashtra,Crime Against Children,Kidnapping,Male,46-60,3295,2127,1168,2548,747
2010,Rural,Karnataka,Crime Against Men,Extortion,Female,18-30,8731,1753,6978,5154,3577
2010,Urban,Uttarakhand,Crime Against Men,Extortion,Male,0-12,9359,5213,4146,5881,3478
2005,Urban,Tamil Nadu,Other Crimes,Drug Offense,Male,0-12,7156,201,6955,3061,4095
2001,Urban,Manipur,Property Crime,Burglary,Male,31-45,9348,2673,6675,5786,3562
2006,Rural,Manipur,Property Crime,Vandalism,Male,46-60,7644,1280,6364,2278,5366
2007,Rural,West Bengal,Other Crimes,Fraud,Male,60+,7286,6821,465,6965,321
2001,Rural,Assam,Crime Against Women,Rape,Male,46-60,2585,2267,318,2519,66
2003,Urban,Arunachal Pradesh,Crime Against Women,Dowry Deaths,Female,31-45,3982,1864,2118,3260,722
2007,Rural,Sikkim,Crime Against Men,Assault,Female,13-17,8934,1434,7500,5788,3146
2008,Rural,Tripura,Crime Against Children,Trafficking,Female,31-45,4072,948,3124,4010,62
2010,Urban,Assam,Crime Against Men,Robbery,Male,60+,9570,5528,4042,6454,3116
2001,Rural,Meghalaya,Crime Against Women,Rape,Female,18-30,8993,6536,2457,7390,1603
2010,Rural,Uttar Pradesh,Crime Against Men,Robbery,Female,0-12,1859,665,1194,1418,441
2004,Rural,Meghalaya,Other Crimes,Corruption,Female,0-12,559,70,489,338,221
2009,Rural,Bihar,Crime Against Children,Child Labor,Male,46-60,8333,3754,4579,5813,2520
2010,Urban,Goa,Crime Against Men,Assault,Male,18-30,7963,6604,1359,6798,1165
2004,Rural,Jharkhand,Property Crime,Burglary,Male,60+,8458,4246,4212,7064,1394
2004,Urban,Sikkim,Crime Against Men,Assault,Female,18-30,2188,163,2025,463,1725
2002,Urban,Maharashtra,Crime Against Women,Rape,Female,31-45,8415,1440,6975,4744,3671
2010,Rural,Tripura,Crime Against Women,Rape,Female,18-30,5700,4867,833,5349,351
2009,Rural,Mizoram,Property Crime,Arson,Female,13-17,1624,386,1238,835,789
2005,Urban,Bihar,Crime Against Men,Murder,Female,46-60,7059,6141,918,6306,753
2007,Rural,Himachal Pradesh,Crime Against Men,Murder,Female,60+,478,118,360,393,85
2001,Urban,Jammu & Kashmir,Crime Against Men,Extortion,Female,18-30,6119,84,6035,3329,2790
2003,Urban,Jammu & Kashmir,Crime Against Men,Robbery,Female,13-17,4648,166,4482,837,3811
2006,Urban,Jammu & Kashmir,Crime Against Children,Child Labor,Female,31-45,4885,4329,556,4516,369
2001,Rural,Nagaland,Other Crimes,Fraud,Female,31-45,745,575,170,586,159
2001,Rural,Tripura,Crime Against Men,Robbery,Male,46-60,2516,1023,1493,1963,553
2001,Urban,Uttar Pradesh,Crime Against Children,Trafficking,Male,0-12,4642,3017,1625,3982,660
2003,Urban,Rajasthan,Crime Against Children,Child Abuse,Female,18-30,7117,2953,4164,5343,1774
2009,Urban,Meghalaya,Crime Against Men,Assault,Male,46-60,6204,4009,2195,4441,1763
2004,Rural,Sikkim,Crime Against Children,Kidnapping,Male,0-12,6816,3697,3119,6006,810
2006,Rural,Telangana,Crime Against Children,Kidnapping,Male,18-30,8141,5087,3054,7331,810
2010,Rural,Karnataka,Crime Against Children,Kidnapping,Female,0-12,4781,1503,3278,4490,291
2004,Rural,Goa,Crime Against Men,Assault,Male,60+,6469,1079,5390,3424,3045
2007,Rural,Punjab,Crime Against Children,Child Labor,Male,31-45,2548,737,1811,807,1741
2002,Urban,Andhra Pradesh,Crime Against Children,Child Abuse,Male,60+,3475,2868,607,3201,274
2008,Urban,Delhi,Crime Against Men,Robbery,Male,13-17,1384,274,1110,776,608
2005,Rural,Tripura,Crime Against Men,Extortion,Male,0-12,6908,1326,5582,3963,2945
2004,Rural,Assam,Crime Against Men,Murder,Male,31-45,4173,579,3594,1342,2831
2009,Rural,Madhya Pradesh,Property Crime,Vandalism,Female,0-12,4357,540,3817,3536,821
2009,Rural,Madhya Pradesh,Crime Against Children,Trafficking,Female,18-30,9515,9105,410,9187,328
2009,Urban,Maharashtra,Crime Against Children,Kidnapping,Female,46-60,8664,2949,5715,4082,4582
2002,Urban,Jammu & Kashmir,Crime Against Children,Trafficking,Female,0-12,8799,1889,6910,6235,2564
2002,Rural,Rajasthan,Other Crimes,Drug Offense,Female,18-30,8664,8231,433,8493,171
2006,Urban,Manipur,Other Crimes,Drug Offense,Female,46-60,493,390,103,394,99
2006,Rural,Jammu & Kashmir,Other Crimes,Drug Offense,Male,60+,4854,3624,1230,3822,1032
2010,Rural,Himachal Pradesh,Property Crime,Vandalism,Female,13-17,8110,1563,6547,6448,1662
2004,Rural,Punjab,Crime Against Women,Molestation,Female,31-45,1819,1055,764,1462,357
2010,Urban,Chhattisgarh,Other Crimes,Corruption,Male,60+,4672,4381,291,4473,199
2007,Urban,Chhattisgarh,Property Crime,Burglary,Male,18-30,9812,7887,1925,9547,265
2007,Rural,Mizoram,Crime Against Women,Dowry Deaths,Male,46-60,6296,2808,3488,5352,944
2003,Rural,Haryana,Property Crime,Vandalism,Male,60+,9682,6801,2881,9169,513
2005,Urban,Uttar Pradesh,Other Crimes,Fraud,Male,46-60,354,208,146,294,60
2005,Urban,Telangana,Property Crime,Vandalism,Female,31-45,6406,4771,1635,5182,1224
2005,Rural,Sikkim,Crime Against Women,Domestic Violence,Male,13-17,1700,174,1526,1008,692
2007,Rural,Mizoram,Crime Against Men,Assault,Female,31-45,3843,3564,279,3649,194
2004,Urban,Goa,Crime Against Children,Trafficking,Male,60+,1403,857,546,1201,202
2007,Rural,Punjab,Crime Against Children,Trafficking,Male,31-45,1726,155,1571,587,1139
2005,Urban,Jharkhand,Other Crimes,Corruption,Female,46-60,1041,148,893,701,340
2007,Rural,Tamil Nadu,Crime Against Children,Trafficking,Male,46-60,811,642,169,744,67
2003,Urban,Sikkim,Crime Against Women,Molestation,Male,46-60,2832,1536,1296,2099,733
2004,Rural,Uttar Pradesh,Crime Against Women,Domestic Violence,Male,31-45,2483,577,1906,1572,911
2001,Rural,Rajasthan,Other Crimes,Cyber Crime,Female,46-60,6054,5621,433,5768,286
2003,Urban,Sikkim,Crime Against Men,Robbery,Male,18-30,7382,4606,2776,7057,325
2005,Rural,Bihar,Property Crime,Burglary,Male,18-30,7088,1876,5212,3054,4034
2002,Urban,Goa,Property Crime,Vandalism,Female,31-45,4398,4092,306,4116,282
2007,Rural,Meghalaya,Crime Against Women,Dowry Deaths,Female,18-30,4072,137,3935,3329,743
2009,Rural,Odisha,Crime Against Women,Molestation,Male,13-17,2883,524,2359,617,2266
2001,Rural,Telangana,Crime Against Children,Child Abuse,Female,0-12,6800,3711,3089,4935,1865
2005,Urban,Tripura,Other Crimes,Drug Offense,Female,18-30,7945,1904,6041,7488,457
2001,Rural,Arunachal Pradesh,Other Crimes,Fraud,Male,31-45,8786,458,8328,4704,4082
2010,Urban,West Bengal,Property Crime,Vandalism,Male,0-12,9693,8410,1283,8662,1031
2009,Rural,Gujarat,Property Crime,Arson,Female,13-17,9720,4776,4944,7873,1847
2010,Rural,Tamil Nadu,Other Crimes,Fraud,Male,13-17,6258,5023,1235,6005,253
2008,Urban,Punjab,Crime Against Men,Murder,Male,13-17,101,97,4,100,1
2001,Rural,Madhya Pradesh,Property Crime,Burglary,Female,31-45,4944,1794,3150,3646,1298
2001,Rural,Kerala,Crime Against Women,Rape,Male,46-60,3532,2761,771,3470,62
2005,Urban,Odisha,Crime Against Women,Dowry Deaths,Male,60+,9134,1464,7670,3505,5629
2007,Rural,Mizoram,Crime Against Men,Robbery,Male,18-30,4912,4686,226,4696,216
2001,Rural,Madhya Pradesh,Other Crimes,Corruption,Male,13-17,3064,1329,1735,1859,1205
2006,Urban,Uttar Pradesh,Crime Against Men,Extortion,Female,18-30,2251,858,1393,1433,818
2007,Urban,Andhra Pradesh,Other Crimes,Drug Offense,Female,46-60,57,45,12,51,6
2010,Urban,Andhra Pradesh,Crime Against Women,Dowry Deaths,Male,60+,4797,4284,513,4347,450
2008,Urban,Mizoram,Crime Against Women,Dowry Deaths,Male,13-17,9451,554,8897,1848,7603
2009,Rural,Haryana,Crime Against Men,Extortion,Female,60+,2613,1213,1400,2336,277
2008,Urban,Nagaland,Property Crime,Theft,Female,60+,8491,1950,6541,2669,5822
2007,Urban,Andhra Pradesh,Crime Against Children,Child Abuse,Female,13-17,4722,79,4643,2961,1761
2009,Rural,Goa,Crime Against Men,Extortion,Female,31-45,2266,1390,876,1638,628
2010,Urban,Uttarakhand,Other Crimes,Fraud,Male,46-60,8141,221,7920,6242,1899
2010,Urban,Tripura,Crime Against Children,Kidnapping,Male,13-17,5280,1691,3589,3394,1886
2010,Urban,Assam,Other Crimes,Fraud,Female,18-30,8031,6283,1748,7830,201
2002,Rural,West Bengal,Crime Against Children,Kidnapping,Female,46-60,4605,4560,45,4564,41
2005,Urban,Uttarakhand,Property Crime,Vandalism,Female,0-12,4226,2225,2001,3184,1042
2008,Urban,Rajasthan,Property Crime,Burglary,Female,60+,8272,591,7681,4765,3507
2006,Urban,Odisha,Other Crimes,Fraud,Male,60+,8022,1457,6565,6245,1777
2006,Rural,Nagaland,Property Crime,Burglary,Male,60+,3360,1902,1458,2671,689
2003,Urban,Bihar,Crime Against Women,Rape,Female,0-12,3321,2016,1305,3058,263
2004,Rural,Madhya Pradesh,Crime Against Children,Trafficking,Female,31-45,459,396,63,448,11
2004,Urban,Bihar,Crime Against Men,Murder,Male,31-45,993,788,205,829,164
2003,Urban,Haryana,Property Crime,Burglary,Female,31-45,8746,1724,7022,7457,1289
2006,Rural,Meghalaya,Property Crime,Vandalism,Female,46-60,3464,1873,1591,2858,606
2001,Urban,Tamil Nadu,Property Crime,Burglary,Female,0-12,2003,1299,704,1464,539
2003,Urban,Bihar,Other Crimes,Cyber Crime,Male,31-45,9562,9527,35,9558,4
2008,Urban,West Bengal,Crime Against Women,Dowry Deaths,Male,60+,4668,3000,1668,3046,1622
2010,Urban,Himachal Pradesh,Crime Against Children,Child Labor,Female,46-60,378,157,221,159,219
2008,Urban,Nagaland,Crime Against Men,Extortion,Female,0-12,6877,1604,5273,5445,1432
2002,Rural,Madhya Pradesh,Other Crimes,Drug Offense,Female,0-12,4109,2269,1840,2854,1255
2004,Rural,Madhya Pradesh,Crime Against Children,Trafficking,Female,31-45,5551,2382,3169,4156,1395
2005,Rural,Jammu & Kashmir,Property Crime,Arson,Male,31-45,7325,5220,2105,6809,516
2004,Urban,West Bengal,Crime Against Women,Molestation,Female,46-60,301,146,155,294,7
2001,Rural,Delhi,Property Crime,Theft,Female,46-60,2004,860,1144,1178,826
2002,Rural,Meghalaya,Crime Against Women,Molestation,Male,18-30,6958,3124,3834,3711,3247
2002,Urban,Maharashtra,Crime Against Children,Kidnapping,Female,46-60,5620,1191,4429,1704,3916
2003,Urban,Bihar,Other Crimes,Fraud,Male,60+,8217,1752,6465,4185,4032
2005,Rural,Odisha,Crime Against Women,Dowry Deaths,Female,60+,9231,7808,1423,8160,1071
2001,Urban,Haryana,Other Crimes,Drug Offense,Male,13-17,5669,1271,4398,1783,3886
2005,Urban,Goa,Other Crimes,Fraud,Male,46-60,6281,4388,1893,5116,1165
2009,Urban,Sikkim,Other Crimes,Cyber Crime,Female,18-30,5714,4782,932,5480,234
2003,Rural,Goa,Crime Against Men,Assault,Male,18-30,6150,3705,2445,5348,802
2004,Urban,West Bengal,Crime Against Women,Rape,Female,46-60,1457,1428,29,1453,4
2007,Urban,Nagaland,Crime Against Children,Child Labor,Male,18-30,2053,545,1508,745,1308
2010,Urban,Goa,Crime Against Children,Child Abuse,Male,18-30,8338,388,7950,5986,2352
2007,Urban,Rajasthan,Crime Against Men,Robbery,Male,31-45,1432,631,801,841,591
2007,Rural,Delhi,Other Crimes,Corruption,Female,31-45,1785,974,811,1039,746
2002,Rural,Bihar,Crime Against Women,Rape,Male,13-17,57,49,8,51,6
2009,Rural,Karnataka,Crime Against Children,Child Labor,Male,31-45,1053,966,87,1040,13
2009,Urban,Manipur,Crime Against Children,Child Abuse,Male,60+,7964,4322,3642,6211,1753
2007,Urban,Tripura,Crime Against Men,Extortion,Female,13-17,2035,1413,622,1546,489
2001,Rural,Uttarakhand,Other Crimes,Cyber Crime,Male,13-17,373,367,6,373,0
2004,Rural,Goa,Other Crimes,Drug Offense,Female,13-17,2366,171,2195,1051,1315
2004,Urban,Meghalaya,Other Crimes,Drug Offense,Male,46-60,9574,4851,4723,5473,4101
2001,Urban,Maharashtra,Property Crime,Vandalism,Male,31-45,4746,1592,3154,2582,2164
2003,Urban,Jammu & Kashmir,Crime Against Women,Rape,Female,46-60,8994,2000,6994,4803,4191
2010,Rural,Jammu & Kashmir,Crime Against Children,Child Abuse,Male,31-45,9009,7754,1255,8552,457
2003,Rural,Goa,Other Crimes,Drug Offense,Male,31-45,9942,6655,3287,8901,1041
2010,Rural,Nagaland,Crime Against Children,Trafficking,Male,31-45,9326,1483,7843,7014,2312
2009,Rural,Rajasthan,Crime Against Men,Extortion,Female,60+,9867,3439,6428,3907,5960
2010,Rural,Karnataka,Crime Against Women,Domestic Violence,Female,46-60,6009,8,6001,2441,3568
2005,Urban,Maharashtra,Crime Against Children,Child Abuse,Male,31-45,4580,69,4511,4386,194
2003,Rural,Maharashtra,Crime Against Men,Assault,Male,18-30,5708,145,5563,4466,1242
2005,Urban,Mizoram,Crime Against Men,Assault,Female,13-17,7581,7121,460,7169,412
2002,Rural,Odisha,Crime Against Women,Rape,Female,13-17,7583,6521,1062,6849,734
2010,Urban,West Bengal,Property Crime,Arson,Male,31-45,5388,3809,1579,4849,539
2008,Rural,Meghalaya,Property Crime,Arson,Female,60+,2532,2395,137,2433,99
2009,Rural,Himachal Pradesh,Other Crimes,Fraud,Male,0-12,9807,6727,3080,9022,785
2009,Urban,Nagaland,Other Crimes,Corruption,Female,0-12,2995,1306,1689,1709,1286
2007,Urban,Jharkhand,Crime Against Children,Child Labor,Male,13-17,1569,41,1528,876,693
2007,Rural,Madhya Pradesh,Other Crimes,Cyber Crime,Male,46-60,3846,584,3262,950,2896
2008,Rural,Tamil Nadu,Crime Against Women,Rape,Male,46-60,194,54,140,108,86
2009,Rural,Haryana,Crime Against Women,Rape,Male,46-60,3387,2290,1097,2438,949
2002,Rural,Goa,Crime Against Women,Dowry Deaths,Female,13-17,6301,4476,1825,4822,1479
2008,Rural,Sikkim,Crime Against Men,Robbery,Female,31-45,4530,655,3875,2708,1822
2006,Rural,Telangana,Other Crimes,Corruption,Female,0-12,9978,3566,6412,7916,2062
2003,Rural,Meghalaya,Other Crimes,Drug Offense,Female,46-60,1977,1771,206,1966,11
2009,Rural,Sikkim,Other Crimes,Cyber Crime,Female,0-12,4378,3264,1114,3690,688
2003,Urban,Arunachal Pradesh,Other Crimes,Cyber Crime,Female,46-60,7796,2135,5661,3897,3899
2006,Rural,Maharashtra,Crime Against Women,Molestation,Female,13-17,8448,7132,1316,7728,720
2002,Urban,Telangana,Crime Against Men,Extortion,Male,31-45,76,9,67,34,42
2006,Rural,Mizoram,Property Crime,Theft,Female,0-12,6529,4906,1623,4949,1580
2006,Urban,Chhattisgarh,Property Crime,Theft,Male,46-60,4480,2472,2008,4138,342
2006,Rural,Meghalaya,Crime Against Women,Domestic Violence,Male,31-45,5637,1592,4045,2506,3131
2003,Rural,Andhra Pradesh,Other Crimes,Drug Offense,Female,0-12,7511,4166,3345,4768,2743
2003,Urban,Maharashtra,Crime Against Men,Murder,Male,0-12,5254,4365,889,5082,172
2003,Urban,Rajasthan,Crime Against Men,Extortion,Female,18-30,514,390,124,466,48
2002,Rural,Tamil Nadu,Crime Against Women,Domestic Violence,Female,46-60,5040,1847,3193,4377,663
2008,Rural,Arunachal Pradesh,Other Crimes,Drug Offense,Female,31-45,3733,627,3106,851,2882
2006,Urban,Andhra Pradesh,Other Crimes,Drug Offense,Female,46-60,7242,6604,638,6634,608
2003,Rural,Karnataka,Crime Against Women,Dowry Deaths,Female,13-17,1493,827,666,835,658
2003,Rural,Telangana,Crime Against Women,Domestic Violence,Male,31-45,3853,3629,224,3847,6
2006,Rural,Jammu & Kashmir,Property Crime,Vandalism,Male,60+,1249,1040,209,1193,56
2010,Rural,Arunachal Pradesh,Property Crime,Burglary,Male,13-17,4467,1620,2847,1780,2687
2001,Rural,Uttar Pradesh,Crime Against Children,Child Abuse,Male,46-60,3413,2616,797,2810,603
2008,Rural,Uttarakhand,Crime Against Children,Kidnapping,Male,18-30,4367,1990,2377,2253,2114
2002,Rural,Tripura,Crime Against Men,Extortion,Male,18-30,5690,5354,336,5439,251
2008,Rural,Tamil Nadu,Crime Against Women,Domestic Violence,Male,60+,9848,5869,3979,9404,444
2010,Urban,Meghalaya,Crime Against Children,Child Labor,Female,60+,5922,1138,4784,3265,2657
2006,Rural,Delhi,Other Crimes,Drug Offense,Female,46-60,7509,3327,4182,5270,2239
2003,Urban,Madhya Pradesh,Property Crime,Burglary,Female,46-60,582,236,346,266,316
2001,Urban,Rajasthan,Other Crimes,Drug Offense,Male,46-60,625,183,442,604,21
2002,Urban,Karnataka,Crime Against Children,Child Abuse,Female,13-17,487,227,260,280,207
2001,Urban,Andhra Pradesh,Crime Against Men,Murder,Female,18-30,9214,2672,6542,4074,5140
2006,Urban,Delhi,Property Crime,Theft,Male,46-60,4322,997,3325,2045,2277
2003,Urban,Bihar,Other Crimes,Drug Offense,Female,31-45,9419,5428,3991,6800,2619
2004,Urban,Manipur,Other Crimes,Drug Offense,Female,31-45,7201,302,6899,5536,1665
2003,Urban,Gujarat,Crime Against Children,Child Labor,Female,60+,7739,2935,4804,4899,2840
2002,Urban,Arunachal Pradesh,Other Crimes,Cyber Crime,Female,46-60,6112,1129,4983,1431,4681
2009,Urban,Uttar Pradesh,Property Crime,Arson,Male,0-12,9398,2725,6673,2956,6442
2010,Rural,Bihar,Crime Against Men,Extortion,Male,0-12,6272,467,5805,3860,2412
2004,Urban,Mizoram,Crime Against Women,Domestic Violence,Male,0-12,1174,977,197,1094,80
2007,Urban,Telangana,Crime Against Children,Child Labor,Female,31-45,6929,5234,1695,6544,385
2004,Rural,Tamil Nadu,Property Crime,Burglary,Female,18-30,3314,1790,1524,2761,553
2002,Rural,Tripura,Property Crime,Arson,Female,60+,4692,923,3769,3617,1075
2010,Urban,Uttarakhand,Other Crimes,Cyber Crime,Male,13-17,4675,2985,1690,4319,356
2002,Urban,Assam,Crime Against Men,Murder,Male,18-30,9503,6938,2565,7508,1995
2009,Urban,Arunachal Pradesh,Crime Against Women,Dowry Deaths,Female,31-45,9295,647,8648,6744,2551
2008,Urban,Rajasthan,Crime Against Women,Dowry Deaths,Female,18-30,6685,4139,2546,4291,2394
2005,Urban,Odisha,Crime Against Women,Domestic Violence,Male,46-60,4678,156,4522,2653,2025
2007,Rural,Chhattisgarh,Crime Against Men,Robbery,Female,60+,5422,4380,1042,5322,100
2001,Rural,Nagaland,Crime Against Men,Assault,Male,18-30,6224,3973,2251,6199,25
2009,Rural,Meghalaya,Crime Against Children,Child Abuse,Female,46-60,5232,3648,1584,4764,468
2002,Urban,Gujarat,Property Crime,Theft,Male,0-12,2827,2331,496,2567,260
2009,Urban,Sikkim,Crime Against Men,Assault,Female,0-12,8253,6185,2068,8153,100
2001,Rural,Arunachal Pradesh,Crime Against Women,Dowry Deaths,Female,18-30,3568,384,3184,1361,2207
2005,Rural,Andhra Pradesh,Crime Against Men,Assault,Female,18-30,1750,1748,2,1749,1
2008,Rural,Madhya Pradesh,Crime Against Children,Child Abuse,Male,18-30,9229,2,9227,3226,6003
2007,Rural,Odisha,Crime Against Women,Domestic Violence,Male,13-17,9122,8294,828,8686,436
2006,Rural,Arunachal Pradesh,Crime Against Men,Murder,Male,18-30,8251,7943,308,7952,299
2006,Rural,Kerala,Other Crimes,Drug Offense,Male,18-30,8679,5731,2948,6570,2109
2005,Urban,Manipur,Crime Against Women,Rape,Female,0-12,7423,2271,5152,4233,3190
2010,Rural,Karnataka,Crime Against Women,Dowry Deaths,Male,0-12,3651,1595,2056,1701,1950
2004,Urban,Uttar Pradesh,Property Crime,Theft,Female,18-30,2250,1759,491,2128,122
2003,Rural,Chhattisgarh,Other Crimes,Corruption,Male,46-60,4841,2991,1850,4803,38
2010,Urban,Kerala,Crime Against Men,Murder,Female,46-60,4048,3425,623,3618,430
2005,Rural,Telangana,Property Crime,Burglary,Male,46-60,6363,1937,4426,5953,410
2008,Urban,Telangana,Property Crime,Burglary,Male,0-12,494,2,492,27,467
2009,Rural,Madhya Pradesh,Crime Against Women,Molestation,Female,46-60,3216,1952,1264,3078,138
2002,Urban,Mizoram,Crime Against Women,Rape,Male,60+,9290,4380,4910,5502,3788
2005,Rural,Nagaland,Crime Against Children,Child Labor,Female,46-60,6091,937,5154,1081,5010
2009,Rural,Himachal Pradesh,Crime Against Men,Robbery,Male,60+,3551,1557,1994,2063,1488
2005,Urban,Delhi,Crime Against Children,Child Labor,Female,18-30,6318,5755,563,5902,416
2005,Urban,Assam,Crime Against Men,Extortion,Female,13-17,8716,7457,1259,8382,334
2002,Rural,Jammu & Kashmir,Crime Against Men,Extortion,Female,13-17,1863,1206,657,1595,268
2002,Urban,Jammu & Kashmir,Property Crime,Theft,Male,46-60,5167,511,4656,1221,3946
2004,Urban,Jammu & Kashmir,Property Crime,Vandalism,Female,0-12,6185,1980,4205,3470,2715
2008,Urban,Karnataka,Property Crime,Vandalism,Female,60+,1118,1109,9,1117,1
2010,Rural,Maharashtra,Crime Against Men,Robbery,Female,18-30,2295,1,2294,2028,267
2005,Rural,Chhattisgarh,Crime Against Men,Assault,Female,18-30,1285,642,643,1190,95
2005,Rural,Mizoram,Crime Against Women,Molestation,Female,13-17,7581,6848,733,7028,553
2002,Urban,Uttarakhand,Crime Against Women,Domestic Violence,Female,0-12,4385,1595,2790,2622,1763
2009,Rural,Uttarakhand,Crime Against Men,Assault,Female,18-30,4576,2769,1807,3355,1221
2008,Rural,Jharkhand,Crime Against Men,Assault,Male,31-45,645,381,264,445,200
2003,Rural,Gujarat,Crime Against Children,Child Abuse,Male,60+,4923,481,4442,4319,604
2008,Rural,Uttarakhand,Crime Against Men,Assault,Male,60+,2602,14,2588,334,2268
2007,Rural,Andhra Pradesh,Crime Against Men,Robbery,Female,60+,9699,4644,5055,7299,2400
2006,Urban,Nagaland,Crime Against Children,Child Labor,Male,13-17,6029,1468,4561,6020,9
2002,Urban,Madhya Pradesh,Crime Against Men,Murder,Male,31-45,1484,1201,283,1234,250
2003,Rural,Kerala,Property Crime,Theft,Male,31-45,666,547,119,569,97
2009,Urban,West Bengal,Crime Against Children,Trafficking,Male,0-12,4723,101,4622,2890,1833
2001,Urban,Maharashtra,Other Crimes,Cyber Crime,Female,0-12,2808,775,2033,1900,908
2006,Urban,Bihar,Property Crime,Burglary,Female,31-45,5375,27,5348,877,4498
2010,Urban,Kerala,Crime Against Women,Dowry Deaths,Male,18-30,2880,1115,1765,1791,1089
2007,Rural,Manipur,Crime Against Women,Domestic Violence,Female,18-30,7923,1556,6367,5856,2067
2003,Urban,Mizoram,Crime Against Children,Kidnapping,Male,13-17,451,437,14,441,10
2006,Urban,Bihar,Crime Against Children,Child Labor,Male,60+,7014,6945,69,6968,46
2008,Rural,Arunachal Pradesh,Crime Against Women,Molestation,Male,13-17,9830,6762,3068,9628,202
2010,Rural,Madhya Pradesh,Crime Against Children,Kidnapping,Female,0-12,916,75,841,165,751
2005,Rural,West Bengal,Other Crimes,Corruption,Female,46-60,3433,2940,493,3116,317
2007,Rural,Maharashtra,Crime Against Women,Rape,Male,18-30,341,115,226,201,140
2006,Urban,Sikkim,Crime Against Children,Child Labor,Female,18-30,3379,674,2705,3374,5
2006,Rural,Nagaland,Crime Against Women,Rape,Female,18-30,3246,1512,1734,3143,103
2008,Urban,Assam,Crime Against Men,Murder,Female,31-45,8739,1766,6973,5266,3473
2010,Urban,Karnataka,Crime Against Women,Dowry Deaths,Male,0-12,6386,6207,179,6252,134
2010,Rural,Haryana,Crime Against Women,Dowry Deaths,Male,31-45,537,429,108,479,58
2005,Rural,Telangana,Crime Against Women,Domestic Violence,Male,13-17,2803,1700,1103,2754,49
2005,Rural,Chhattisgarh,Property Crime,Theft,Male,46-60,6509,3438,3071,5455,1054
2004,Urban,Bihar,Crime Against Men,Murder,Female,46-60,1001,970,31,984,17
2004,Rural,Andhra Pradesh,Crime Against Children,Kidnapping,Female,0-12,3045,1082,1963,2841,204
2003,Urban,Kerala,Crime Against Children,Child Labor,Female,13-17,8105,1173,6932,4997,3108
2005,Urban,Jammu & Kashmir,Crime Against Women,Dowry Deaths,Female,60+,2597,1004,1593,2244,353
2004,Rural,Tamil Nadu,Crime Against Men,Extortion,Male,46-60,7985,2444,5541,3746,4239
2006,Rural,Kerala,Crime Against Women,Rape,Male,13-17,3346,318,3028,1549,1797
2003,Rural,West Bengal,Other Crimes,Drug Offense,Male,60+,8696,1,8695,1610,7086
2007,Urban,Maharashtra,Crime Against Children,Kidnapping,Male,0-12,9117,5387,3730,5782,3335
2005,Rural,Madhya Pradesh,Other Crimes,Corruption,Male,31-45,6251,5981,270,6079,172
2007,Urban,Odisha,Crime Against Men,Assault,Male,60+,7729,5140,2589,5337,2392
2009,Urban,Odisha,Property Crime,Theft,Female,13-17,9316,1853,7463,7604,1712
2004,Urban,Madhya Pradesh,Crime Against Men,Murder,Female,60+,6278,3708,2570,4956,1322
2001,Rural,Tamil Nadu,Other Crimes,Drug Offense,Male,0-12,8424,166,8258,4409,4015
2004,Urban,Himachal Pradesh,Crime Against Children,Trafficking,Male,60+,7712,3045,4667,7444,268
2007,Rural,Telangana,Crime Against Children,Child Labor,Female,60+,3972,1912,2060,2501,1471
2002,Rural,Rajasthan,Property Crime,Theft,Male,60+,9776,3124,6652,8692,1084
2010,Urban,Arunachal Pradesh,Other Crimes,Corruption,Female,0-12,1292,1253,39,1283,9
2003,Rural,Uttar Pradesh,Crime Against Men,Robbery,Male,18-30,2980,275,2705,2720,260
2004,Rural,Manipur,Crime Against Men,Robbery,Female,31-45,3797,1301,2496,3322,475
2004,Urban,Mizoram,Crime Against Women,Domestic Violence,Female,60+,8279,1794,6485,6451,1828
2004,Urban,Manipur,Crime Against Women,Dowry Deaths,Male,18-30,9993,5946,4047,9035,958
2009,Urban,Telangana,Crime Against Women,Dowry Deaths,Male,60+,6456,4687,1769,6364,92
2003,Rural,Andhra Pradesh,Other Crimes,Drug Offense,Male,46-60,7073,6704,369,6770,303
2003,Urban,Maharashtra,Crime Against Children,Child Labor,Male,18-30,4367,3784,583,4013,354
2002,Rural,Manipur,Property Crime,Vandalism,Female,18-30,2535,83,2452,451,2084
2005,Urban,Delhi,Other Crimes,Fraud,Female,0-12,4967,173,4794,631,4336
2010,Urban,Goa,Crime Against Men,Assault,Female,18-30,9440,553,8887,2613,6827
2004,Urban,Rajasthan,Crime Against Men,Extortion,Female,13-17,89,65,24,77,12
2008,Rural,Karnataka,Crime Against Men,Robbery,Male,18-30,6130,1483,4647,5679,451
2006,Urban,Rajasthan,Crime Against Men,Murder,Female,13-17,1448,1360,88,1379,69
2003,Urban,Madhya Pradesh,Crime Against Children,Trafficking,Female,31-45,6166,375,5791,5811,355
2003,Rural,Haryana,Crime Against Women,Rape,Female,46-60,9985,4217,5768,6813,3172
2005,Urban,Rajasthan,Crime Against Women,Molestation,Female,60+,2098,165,1933,1857,241
2002,Urban,Karnataka,Crime Against Children,Kidnapping,Male,60+,5840,14,5826,1362,4478
2002,Rural,Telangana,Other Crimes,Cyber Crime,Male,0-12,2722,949,1773,2256,466
2010,Urban,Jammu & Kashmir,Crime Against Women,Molestation,Male,46-60,9574,569,9005,9474,100
2006,Urban,Himachal Pradesh,Property Crime,Vandalism,Male,60+,8274,624,7650,6199,2075
2008,Urban,Mizoram,Crime Against Men,Murder,Male,18-30,7901,1926,5975,5095,2806
2001,Rural,Tamil Nadu,Crime Against Women,Molestation,Male,60+,2023,257,1766,1056,967
2008,Rural,Madhya Pradesh,Crime Against Women,Dowry Deaths,Male,60+,5542,1222,4320,1649,3893
2002,Rural,Telangana,Other Crimes,Corruption,Male,46-60,5921,1140,4781,2795,3126
2005,Rural,Delhi,Other Crimes,Cyber Crime,Male,13-17,5986,4587,1399,4861,1125
2003,Urban,Delhi,Crime Against Children,Child Abuse,Female,60+,261,139,122,183,78
2003,Rural,Karnataka,Crime Against Children,Child Abuse,Female,18-30,5121,4608,513,4642,479
2002,Urban,Tripura,Crime Against Women,Dowry Deaths,Male,13-17,4476,3692,784,3721,755
2002,Urban,Telangana,Crime Against Women,Rape,Male,60+,4938,3214,1724,3994,944
2003,Urban,Karnataka,Crime Against Children,Kidnapping,Male,60+,4421,706,3715,3028,1393
2007,Rural,Madhya Pradesh,Property Crime,Vandalism,Male,13-17,9568,9264,304,9387,181
2007,Urban,Delhi,Crime Against Children,Child Abuse,Female,31-45,1159,482,677,553,606
2004,Rural,Delhi,Property Crime,Vandalism,Female,60+,9355,4179,5176,5086,4269
2005,Urban,Tamil Nadu,Property Crime,Burglary,Female,31-45,8392,8254,138,8298,94
2003,Rural,Tripura,Crime Against Men,Extortion,Female,18-30,355,134,221,280,75
2009,Rural,Jharkhand,Crime Against Men,Assault,Female,31-45,2285,304,1981,1915,370
2010,Urban,Chhattisgarh,Crime Against Women,Rape,Male,0-12,805,83,722,756,49
2003,Urban,Uttarakhand,Property Crime,Burglary,Male,60+,4794,1907,2887,2055,2739
2003,Urban,Manipur,Other Crimes,Drug Offense,Male,31-45,3645,3321,324,3390,255
2007,Rural,Arunachal Pradesh,Crime Against Men,Assault,Male,18-30,3855,2193,1662,2248,1607
2008,Rural,Rajasthan,Property Crime,Theft,Female,18-30,9167,2718,6449,4680,4487
2007,Urban,Goa,Property Crime,Burglary,Male,0-12,4123,1347,2776,2103,2020
2009,Rural,Uttarakhand,Other Crimes,Cyber Crime,Female,46-60,1212,467,745,729,483
2007,Rural,Jharkhand,Property Crime,Theft,Male,0-12,6070,6064,6,6068,2
2002,Urban,Madhya Pradesh,Other Crimes,Corruption,Female,18-30,8606,1790,6816,4056,4550
2004,Rural,Maharashtra,Other Crimes,Fraud,Male,31-45,8713,5103,3610,7835,878
2006,Urban,Karnataka,Crime Against Men,Assault,Female,13-17,2070,1579,491,1883,187
2001,Urban,Punjab,Crime Against Men,Extortion,Female,0-12,4657,4338,319,4581,76
2005,Urban,Sikkim,Other Crimes,Corruption,Male,13-17,2858,249,2609,1132,1726
2006,Rural,Gujarat,Property Crime,Burglary,Male,60+,9970,2224,7746,2709,7261
2009,Rural,Sikkim,Crime Against Women,Rape,Female,46-60,4408,1430,2978,3553,855
2009,Rural,Andhra Pradesh,Crime Against Men,Assault,Female,46-60,2668,166,2502,422,2246
2010,Rural,Bihar,Property Crime,Burglary,Male,60+,5819,4810,1009,5087,732
2004,Urban,Jammu & Kashmir,Crime Against Men,Robbery,Male,18-30,1385,530,855,672,713
2005,Rural,Odisha,Crime Against Men,Murder,Male,31-45,968,92,876,820,148
2001,Rural,Odisha,Crime Against Children,Trafficking,Male,0-12,7567,5241,2326,6603,964
2009,Rural,Karnataka,Property Crime,Arson,Female,31-45,3051,299,2752,1549,1502
2005,Rural,Jharkhand,Property Crime,Arson,Male,60+,876,386,490,500,376
2004,Rural,West Bengal,Crime Against Children,Child Labor,Female,0-12,3778,510,3268,3488,290
2003,Rural,Bihar,Crime Against Children,Kidnapping,Male,18-30,4247,1895,2352,3250,997
2009,Rural,Sikkim,Crime Against Men,Murder,Male,18-30,6510,1727,4783,5438,1072
2001,Urban,Arunachal Pradesh,Crime Against Children,Kidnapping,Male,31-45,3884,2937,947,3434,450
2006,Urban,Uttarakhand,Crime Against Children,Trafficking,Male,31-45,2794,749,2045,1002,1792
2005,Urban,Mizoram,Crime Against Women,Rape,Female,60+,6823,1355,5468,1612,5211
2007,Rural,West Bengal,Crime Against Men,Murder,Male,18-30,4785,2336,2449,3722,1063
2009,Rural,Punjab,Crime Against Men,Assault,Female,13-17,3415,3342,73,3364,51
2002,Rural,Madhya Pradesh,Crime Against Children,Child Abuse,Male,18-30,9564,3560,6004,5502,4062
2006,Rural,Rajasthan,Crime Against Men,Assault,Female,18-30,283,236,47,252,31
2002,Urban,Maharashtra,Crime Against Men,Robbery,Female,46-60,3327,65,3262,200,3127
2003,Urban,Nagaland,Other Crimes,Fraud,Male,0-12,3604,2066,1538,2743,861
2008,Urban,Sikkim,Property Crime,Vandalism,Female,18-30,3276,426,2850,1463,1813
2008,Rural,Jammu & Kashmir,Crime Against Men,Robbery,Female,46-60,9159,7389,1770,7433,1726
2001,Rural,Telangana,Other Crimes,Fraud,Male,13-17,6537,1117,5420,6443,94
2005,Urban,Tamil Nadu,Property Crime,Vandalism,Female,0-12,8551,4970,3581,5748,2803
2005,Urban,Bihar,Crime Against Children,Child Labor,Male,13-17,326,90,236,320,6
2010,Urban,Jharkhand,Other Crimes,Corruption,Male,18-30,1215,463,752,931,284
2007,Urban,Telangana,Crime Against Children,Trafficking,Male,0-12,8795,545,8250,2100,6695
2004,Urban,Bihar,Other Crimes,Fraud,Female,46-60,2927,525,2402,1479,1448
2007,Rural,Tripura,Crime Against Children,Kidnapping,Male,18-30,937,338,599,560,377
2004,Rural,Telangana,Crime Against Men,Assault,Female,46-60,7552,7350,202,7387,165
2010,Urban,Jharkhand,Property Crime,Vandalism,Male,46-60,1272,148,1124,370,902
2005,Rural,Jammu & Kashmir,Other Crimes,Fraud,Male,46-60,4249,3556,693,3752,497
2001,Rural,Jharkhand,Crime Against Women,Domestic Violence,Female,31-45,4543,1507,3036,3476,1067
2007,Urban,Punjab,Crime Against Children,Trafficking,Male,60+,3183,1845,1338,2232,951
2004,Urban,Himachal Pradesh,Other Crimes,Corruption,Male,46-60,4748,228,4520,3712,1036
2001,Urban,Himachal Pradesh,Other Crimes,Corruption,Male,13-17,8030,4075,3955,5476,2554
2007,Rural,Maharashtra,Crime Against Children,Kidnapping,Male,31-45,5780,3517,2263,4398,1382
2006,Rural,Delhi,Crime Against Women,Molestation,Male,31-45,1714,1669,45,1704,10
2009,Urban,Telangana,Crime Against Children,Child Labor,Female,46-60,1785,1728,57,1754,31
2003,Urban,Telangana,Crime Against Men,Assault,Male,46-60,7481,3653,3828,5970,1511
2006,Rural,Telangana,Crime Against Men,Assault,Female,46-60,5469,4814,655,4929,540
2003,Rural,Uttar Pradesh,Crime Against Children,Trafficking,Female,60+,770,325,445,714,56
2002,Rural,Haryana,Crime Against Women,Rape,Male,31-45,7019,1385,5634,3080,3939
2003,Urban,Gujarat,Crime Against Women,Domestic Violence,Male,18-30,3082,2972,110,3041,41
2008,Urban,Odisha,Property Crime,Arson,Female,18-30,7771,4986,2785,6075,1696
2004,Urban,Madhya Pradesh,Other Crimes,Fraud,Male,0-12,3966,3171,795,3360,606
2005,Rural,Telangana,Other Crimes,Drug Offense,Female,31-45,5356,952,4404,5082,274
2010,Urban,Uttar Pradesh,Crime Against Women,Dowry Deaths,Female,60+,9528,7954,1574,9314,214
2006,Rural,Haryana,Crime Against Women,Rape,Male,0-12,6310,5634,676,5793,517
2008,Urban,Jammu & Kashmir,Crime Against Women,Dowry Deaths,Female,18-30,7191,6138,1053,6813,378
2003,Rural,Madhya Pradesh,Property Crime,Arson,Female,60+,4244,2080,2164,3822,422
2003,Urban,Andhra Pradesh,Property Crime,Vandalism,Male,18-30,1901,740,1161,943,958
2003,Urban,Jammu & Kashmir,Other Crimes,Fraud,Male,60+,2803,1851,952,2463,340
2006,Urban,Meghalaya,Crime Against Women,Rape,Female,31-45,1369,193,1176,885,484
2002,Urban,Jammu & Kashmir,Crime Against Men,Assault,Male,13-17,7954,7423,531,7434,520
2003,Urban,Tamil Nadu,Other Crimes,Cyber Crime,Female,0-12,4755,2691,2064,4208,547
2009,Urban,Tripura,Other Crimes,Corruption,Female,31-45,5375,1528,3847,2248,3127
2001,Rural,Nagaland,Property Crime,Vandalism,Female,31-45,708,415,293,548,160
2007,Urban,Bihar,Other Crimes,Drug Offense,Female,0-12,812,298,514,525,287
2006,Rural,Jammu & Kashmir,Property Crime,Arson,Female,31-45,5513,4145,1368,4830,683
2010,Urban,Gujarat,Crime Against Women,Domestic Violence,Female,31-45,2254,2043,211,2116,138
2005,Rural,Jammu & Kashmir,Crime Against Children,Trafficking,Male,18-30,2035,1750,285,1910,125
2003,Urban,West Bengal,Other Crimes,Cyber Crime,Male,0-12,3327,1283,2044,2171,1156
2004,Rural,Andhra Pradesh,Property Crime,Burglary,Male,13-17,9198,1332,7866,9148,50
2006,Rural,Punjab,Crime Against Women,Molestation,Male,18-30,885,104,781,505,380
2006,Rural,Himachal Pradesh,Crime Against Women,Rape,Male,31-45,5861,735,5126,5639,222
2006,Urban,Delhi,Other Crimes,Drug Offense,Female,0-12,8697,104,8593,2467,6230
2006,Urban,Punjab,Other Crimes,Drug Offense,Female,46-60,8119,3313,4806,3648,4471
2005,Rural,Andhra Pradesh,Property Crime,Burglary,Male,46-60,4331,1742,2589,3553,778
2007,Urban,Arunachal Pradesh,Crime Against Women,Dowry Deaths,Male,18-30,6892,1258,5634,2706,4186
2002,Urban,West Bengal,Property Crime,Vandalism,Female,31-45,9908,5763,4145,6737,3171
2005,Rural,Goa,Crime Against Women,Domestic Violence,Female,46-60,4813,2137,2676,3666,1147
2001,Rural,Delhi,Other Crimes,Fraud,Male,31-45,5231,959,4272,4043,1188
2002,Urban,Arunachal Pradesh,Property Crime,Burglary,Male,60+,1888,829,1059,1572,316
2009,Rural,Goa,Property Crime,Vandalism,Female,60+,6212,2128,4084,3905,2307
2009,Urban,Jharkhand,Crime Against Women,Dowry Deaths,Female,46-60,9042,7608,1434,8048,994
2005,Rural,Assam,Crime Against Children,Child Labor,Male,60+,2323,2264,59,2296,27
2007,Urban,Uttarakhand,Crime Against Women,Domestic Violence,Female,60+,3807,3455,352,3643,164
2003,Rural,Bihar,Crime Against Men,Robbery,Male,60+,493,148,345,261,232
2005,Rural,Punjab,Other Crimes,Cyber Crime,Female,13-17,5293,893,4400,996,4297
2002,Urban,Odisha,Property Crime,Vandalism,Female,46-60,5164,587,4577,4501,663
2004,Urban,Telangana,Crime Against Men,Robbery,Male,18-30,9211,2479,6732,6053,3158
2002,Urban,Sikkim,Crime Against Women,Rape,Male,13-17,5808,3461,2347,4488,1320
2007,Rural,Karnataka,Crime Against Children,Child Abuse,Female,31-45,2416,1753,663,2329,87
2002,Urban,Nagaland,Crime Against Women,Rape,Male,18-30,3090,873,2217,884,2206
2001,Rural,Bihar,Crime Against Men,Robbery,Female,31-45,1560,1493,67,1502,58
2005,Rural,Mizoram,Crime Against Children,Kidnapping,Female,46-60,4513,1370,3143,3291,1222
2001,Urban,Chhattisgarh,Crime Against Men,Assault,Female,46-60,8494,438,8056,7931,563
2002,Urban,Jammu & Kashmir,Other Crimes,Corruption,Male,13-17,623,611,12,614,9
2004,Rural,Madhya Pradesh,Property Crime,Arson,Female,18-30,6390,3906,2484,4726,1664
2002,Rural,Uttarakhand,Other Crimes,Cyber Crime,Female,60+,6887,3307,3580,4124,2763
2006,Rural,Sikkim,Crime Against Children,Child Abuse,Male,18-30,3464,1290,2174,1700,1764
2003,Rural,Karnataka,Other Crimes,Fraud,Male,13-17,5563,5364,199,5551,12
2008,Rural,Mizoram,Other Crimes,Fraud,Male,0-12,9803,8829,974,8898,905
2005,Urban,Manipur,Other Crimes,Cyber Crime,Male,60+,5969,1423,4546,3588,2381
2007,Urban,West Bengal,Crime Against Women,Domestic Violence,Male,13-17,1360,823,537,1248,112
2010,Rural,Odisha,Crime Against Men,Murder,Male,60+,8098,6941,1157,7499,599
2004,Urban,Tripura,Crime Against Men,Robbery,Female,60+,4673,427,4246,3804,869
2010,Urban,Gujarat,Crime Against Women,Domestic Violence,Male,13-17,2306,1455,851,1873,433
2008,Urban,Sikkim,Property Crime,Burglary,Male,31-45,5712,3610,2102,4549,1163
2002,Urban,Mizoram,Crime Against Women,Domestic Violence,Male,0-12,3149,722,2427,2910,239
2004,Urban,Madhya Pradesh,Other Crimes,Corruption,Male,13-17,2029,127,1902,1602,427
2006,Rural,Sikkim,Crime Against Women,Molestation,Female,18-30,3190,1020,2170,2358,832
2002,Urban,Assam,Other Crimes,Fraud,Male,18-30,8592,8330,262,8375,217
2009,Urban,Jharkhand,Crime Against Women,Molestation,Female,46-60,133,114,19,125,8
2003,Rural,Mizoram,Other Crimes,Drug Offense,Female,31-45,9289,550,8739,6844,2445
2007,Urban,Jammu & Kashmir,Crime Against Women,Dowry Deaths,Male,46-60,4629,2757,1872,4405,224
2010,Rural,Rajasthan,Property Crime,Burglary,Female,0-12,9383,2315,7068,3298,6085
2004,Rural,Goa,Crime Against Children,Trafficking,Female,60+,1839,896,943,917,922
2002,Rural,Odisha,Crime Against Men,Murder,Female,13-17,4760,1493,3267,1898,2862
2007,Urban,Himachal Pradesh,Other Crimes,Corruption,Female,60+,5446,1315,4131,3830,1616
2008,Rural,Uttarakhand,Crime Against Women,Dowry Deaths,Male,31-45,1679,202,1477,1028,651
2004,Rural,Chhattisgarh,Crime Against Children,Child Abuse,Female,0-12,6261,6086,175,6231,30
2002,Urban,Tamil Nadu,Crime Against Women,Molestation,Male,46-60,8183,6521,1662,7641,542
2009,Rural,Arunachal Pradesh,Property Crime,Arson,Male,0-12,3108,944,2164,1171,1937
2008,Rural,Karnataka,Crime Against Men,Extortion,Female,60+,139,45,94,87,52
2005,Urban,Karnataka,Property Crime,Vandalism,Female,60+,2778,222,2556,2324,454
2010,Rural,Sikkim,Crime Against Children,Child Abuse,Male,60+,7737,5999,1738,7697,40
2005,Rural,Madhya Pradesh,Property Crime,Burglary,Male,60+,5842,1166,4676,2464,3378
2004,Rural,Rajasthan,Crime Against Women,Domestic Violence,Female,13-17,6508,3974,2534,6071,437
2008,Urban,Haryana,Crime Against Men,Assault,Female,60+,6449,383,6066,992,5457
2003,Rural,Odisha,Crime Against Children,Child Labor,Male,46-60,4120,1292,2828,3992,128
2009,Rural,Jharkhand,Other Crimes,Drug Offense,Female,60+,103,84,19,95,8
2007,Rural,Delhi,Crime Against Women,Domestic Violence,Female,31-45,3065,1715,1350,2533,532
2010,Rural,Meghalaya,Crime Against Children,Child Labor,Female,18-30,7272,1988,5284,5092,2180
2008,Urban,Manipur,Crime Against Children,Kidnapping,Male,31-45,8091,820,7271,7979,112
2001,Rural,Uttar Pradesh,Crime Against Children,Child Labor,Female,13-17,1530,1052,478,1209,321
2005,Urban,Himachal Pradesh,Other Crimes,Drug Offense,Male,60+,1448,543,905,846,602
2003,Rural,Jharkhand,Other Crimes,Corruption,Female,18-30,6913,643,6270,651,6262
2009,Rural,Jharkhand,Property Crime,Theft,Female,18-30,6213,6049,164,6079,134
2006,Rural,Punjab,Property Crime,Arson,Male,13-17,1007,27,980,338,669
2008,Rural,Karnataka,Crime Against Children,Kidnapping,Male,46-60,4131,2322,1809,3392,739
2002,Rural,Assam,Crime Against Women,Rape,Male,0-12,1413,475,938,889,524
2001,Rural,Kerala,Crime Against Women,Domestic Violence,Female,46-60,3230,1002,2228,2330,900
2003,Rural,Mizoram,Property Crime,Arson,Male,18-30,4929,4374,555,4521,408
2005,Urban,Jammu & Kashmir,Crime Against Children,Trafficking,Female,13-17,3715,1230,2485,1709,2006
2008,Urban,Goa,Crime Against Men,Extortion,Female,46-60,167,97,70,141,26
2009,Urban,Mizoram,Crime Against Men,Assault,Female,31-45,1386,298,1088,576,810
2002,Rural,Chhattisgarh,Crime Against Women,Molestation,Female,18-30,5350,1990,3360,3346,2004
2009,Urban,Tripura,Property Crime,Theft,Female,18-30,5755,1302,4453,2805,2950
2009,Rural,Haryana,Crime Against Men,Extortion,Male,31-45,792,202,590,552,240
2006,Urban,Punjab,Property Crime,Arson,Male,60+,7683,711,6972,1943,5740
2006,Rural,Arunachal Pradesh,Other Crimes,Drug Offense,Male,60+,4150,4119,31,4121,29
2006,Urban,Odisha,Crime Against Children,Child Abuse,Male,0-12,6180,1431,4749,2445,3735
2008,Urban,Jammu & Kashmir,Crime Against Children,Trafficking,Male,60+,5765,3793,1972,5512,253
2007,Rural,Haryana,Other Crimes,Drug Offense,Female,60+,9129,1440,7689,9057,72
2002,Rural,Telangana,Property Crime,Arson,Male,18-30,6347,4854,1493,5243,1104
2001,Urban,Karnataka,Crime Against Women,Rape,Female,60+,7056,2218,4838,4138,2918
2006,Urban,Bihar,Crime Against Women,Domestic Violence,Male,46-60,5837,3989,1848,4679,1158
2002,Urban,West Bengal,Crime Against Children,Child Abuse,Male,46-60,7979,1400,6579,5802,2177
2003,Urban,Himachal Pradesh,Crime Against Children,Kidnapping,Male,0-12,7023,6226,797,6270,753
2009,Rural,Odisha,Crime Against Children,Kidnapping,Male,13-17,5225,3611,1614,3751,1474
2002,Urban,Jammu & Kashmir,Crime Against Women,Molestation,Male,46-60,6157,2327,3830,5328,829
2005,Urban,Punjab,Crime Against Women,Rape,Male,60+,1422,711,711,1402,20
2002,Urban,Haryana,Crime Against Children,Child Abuse,Male,18-30,3251,428,2823,2291,960
2003,Urban,Chhattisgarh,Other Crimes,Drug Offense,Female,13-17,6445,2634,3811,2676,3769
2005,Urban,Odisha,Crime Against Men,Assault,Male,13-17,9814,3824,5990,8439,1375
2007,Rural,Andhra Pradesh,Property Crime,Arson,Female,60+,238,159,79,207,31
2006,Urban,Mizoram,Other Crimes,Cyber Crime,Male,46-60,1539,310,1229,363,1176
2003,Rural,Odisha,Crime Against Children,Child Abuse,Male,60+,3383,3258,125,3365,18
2002,Urban,Haryana,Crime Against Men,Assault,Female,46-60,9098,6941,2157,7671,1427
2006,Rural,Uttar Pradesh,Crime Against Women,Molestation,Female,31-45,6031,4747,1284,5592,439
2007,Urban,Nagaland,Crime Against Women,Rape,Male,13-17,5678,3667,2011,5676,2
2002,Rural,Sikkim,Crime Against Men,Extortion,Female,46-60,8711,5191,3520,6417,2294
2003,Rural,Manipur,Property Crime,Arson,Female,0-12,9672,8747,925,9347,325
2007,Urban,Madhya Pradesh,Crime Against Men,Robbery,Male,13-17,9019,4143,4876,5407,3612
2010,Rural,Rajasthan,Crime Against Children,Child Abuse,Female,60+,2256,1575,681,2235,21
2008,Urban,Rajasthan,Crime Against Men,Extortion,Female,60+,1046,791,255,903,143
2002,Rural,Mizoram,Crime Against Men,Murder,Male,60+,9508,1223,8285,2059,7449
2009,Rural,Manipur,Property Crime,Vandalism,Female,18-30,2462,21,2441,176,2286
2002,Rural,Jammu & Kashmir,Crime Against Children,Kidnapping,Female,0-12,4086,3760,326,3901,185
2001,Urban,Tripura,Property Crime,Burglary,Male,18-30,6441,5636,805,6276,165
2006,Rural,Assam,Crime Against Men,Extortion,Female,31-45,6537,2213,4324,5665,872
2009,Urban,Manipur,Other Crimes,Fraud,Male,46-60,3939,3751,188,3817,122
2001,Rural,Rajasthan,Other Crimes,Cyber Crime,Female,46-60,950,102,848,503,447
2005,Urban,Kerala,Other Crimes,Drug Offense,Female,13-17,6076,5334,742,5891,185
2009,Rural,Goa,Property Crime,Arson,Female,60+,6107,3556,2551,4887,1220
2007,Rural,Tripura,Crime Against Children,Child Abuse,Female,46-60,6616,5310,1306,5620,996
2008,Urban,Jharkhand,Other Crimes,Corruption,Male,18-30,1646,1565,81,1575,71
2009,Urban,Manipur,Crime Against Men,Assault,Male,18-30,8560,3838,4722,7965,595
2002,Urban,Sikkim,Crime Against Children,Child Abuse,Female,0-12,1355,912,443,1094,261
2006,Urban,Karnataka,Other Crimes,Fraud,Female,0-12,9720,134,9586,8519,1201
2001,Urban,Madhya Pradesh,Crime Against Women,Rape,Female,46-60,2893,70,2823,1753,1140
2003,Rural,Himachal Pradesh,Crime Against Men,Extortion,Male,13-17,4227,2300,1927,3946,281
2009,Urban,Haryana,Crime Against Women,Domestic Violence,Female,31-45,5519,2226,3293,4673,846
2006,Urban,Andhra Pradesh,Other Crimes,Cyber Crime,Female,18-30,710,581,129,674,36
2001,Urban,Arunachal Pradesh,Crime Against Children,Child Labor,Female,60+,5662,5100,562,5492,170
2002,Rural,Nagaland,Property Crime,Theft,Female,60+,4967,4023,944,4404,563
2007,Urban,Himachal Pradesh,Crime Against Women,Rape,Female,18-30,4011,1728,2283,3643,368
2003,Rural,Himachal Pradesh,Property Crime,Vandalism,Male,31-45,4573,808,3765,819,3754
2007,Urban,Tamil Nadu,Crime Against Men,Robbery,Female,46-60,8946,3445,5501,8589,357
2007,Urban,West Bengal,Crime Against Men,Assault,Male,13-17,9227,9104,123,9207,20
2008,Rural,Jammu & Kashmir,Crime Against Women,Domestic Violence,Female,31-45,3007,494,2513,2257,750
2010,Rural,Himachal Pradesh,Other Crimes,Cyber Crime,Male,31-45,8083,5604,2479,6039,2044
2007,Urban,Tamil Nadu,Other Crimes,Fraud,Female,18-30,9951,4450,5501,6561,3390
2008,Urban,Gujarat,Property Crime,Burglary,Male,60+,8838,1459,7379,5396,3442
2004,Urban,Telangana,Crime Against Women,Rape,Female,13-17,2351,933,1418,2329,22
2007,Urban,Tamil Nadu,Property Crime,Theft,Male,60+,5760,2677,3083,3584,2176
2004,Rural,Delhi,Crime Against Women,Dowry Deaths,Female,46-60,2584,1216,1368,1233,1351
2010,Urban,Himachal Pradesh,Crime Against Children,Kidnapping,Male,60+,5624,4818,806,5538,86
2005,Rural,Jharkhand,Other Crimes,Fraud,Female,46-60,4499,1510,2989,2502,1997
2007,Urban,Chhattisgarh,Crime Against Women,Domestic Violence,Male,18-30,1255,401,854,1210,45
2007,Rural,Manipur,Crime Against Men,Robbery,Male,18-30,6362,2684,3678,4906,1456
2007,Urban,Assam,Other Crimes,Drug Offense,Female,31-45,3863,2709,1154,3561,302
2006,Urban,Gujarat,Crime Against Children,Trafficking,Female,0-12,4806,2144,2662,4404,402
2006,Urban,Bihar,Crime Against Women,Molestation,Female,46-60,7449,5536,1913,6303,1146
2003,Urban,Madhya Pradesh,Crime Against Men,Murder,Female,0-12,8354,5308,3046,6704,1650
2004,Rural,Sikkim,Crime Against Women,Domestic Violence,Male,31-45,2488,166,2322,2082,406
2009,Rural,Jammu & Kashmir,Crime Against Women,Domestic Violence,Female,0-12,5196,3558,1638,3619,1577
2008,Urban,Sikkim,Crime Against Men,Extortion,Female,31-45,7783,1242,6541,3883,3900
2002,Rural,Karnataka,Crime Against Children,Child Labor,Male,31-45,9880,5859,4021,7397,2483
2008,Urban,Madhya Pradesh,Other Crimes,Corruption,Male,31-45,295,8,287,293,2
2009,Urban,Jharkhand,Other Crimes,Fraud,Male,31-45,6022,5449,573,5881,141
2005,Urban,Nagaland,Other Crimes,Fraud,Male,13-17,1769,473,1296,898,871
2009,Rural,Haryana,Property Crime,Burglary,Male,13-17,4240,180,4060,2387,1853
2002,Urban,Andhra Pradesh,Property Crime,Burglary,Male,46-60,6287,4486,1801,4633,1654
2001,Rural,Arunachal Pradesh,Other Crimes,Fraud,Male,18-30,3072,1788,1284,2850,222
2005,Rural,Chhattisgarh,Crime Against Men,Extortion,Male,60+,4563,3896,667,4390,173
2003,Urban,Uttar Pradesh,Property Crime,Arson,Female,18-30,8084,3497,4587,5603,2481
2008,Rural,Jammu & Kashmir,Other Crimes,Corruption,Male,18-30,9352,5888,3464,6340,3012
2006,Urban,Jammu & Kashmir,Crime Against Women,Domestic Violence,Male,13-17,1613,420,1193,866,747
2006,Urban,Delhi,Property Crime,Arson,Female,60+,3969,1181,2788,3688,281
2006,Rural,Jammu & Kashmir,Crime Against Women,Rape,Female,60+,3483,2052,1431,2936,547
2010,Urban,Goa,Crime Against Men,Robbery,Male,18-30,6650,3584,3066,6013,637
2007,Rural,Odisha,Crime Against Men,Assault,Male,31-45,7188,2504,4684,6565,623
2001,Urban,Haryana,Crime Against Children,Child Abuse,Male,18-30,7100,1457,5643,6130,970
2008,Urban,Gujarat,Crime Against Men,Assault,Male,60+,4136,264,3872,4052,84
2010,Urban,Tripura,Other Crimes,Corruption,Female,0-12,9416,1107,8309,4551,4865
2003,Rural,Jammu & Kashmir,Crime Against Men,Murder,Male,46-60,1252,340,912,917,335
2002,Rural,Kerala,Crime Against Women,Dowry Deaths,Female,13-17,1751,420,1331,722,1029
2005,Rural,Haryana,Other Crimes,Fraud,Male,0-12,4121,3051,1070,3111,1010
2004,Urban,Jharkhand,Crime Against Women,Molestation,Female,13-17,3303,2370,933,2664,639
2006,Rural,Manipur,Property Crime,Burglary,Male,13-17,3839,1792,2047,3064,775
2007,Urban,Meghalaya,Property Crime,Arson,Male,0-12,4847,1791,3056,4234,613
2010,Urban,Maharashtra,Crime Against Women,Molestation,Male,31-45,4176,1625,2551,3725,451
2004,Rural,Uttar Pradesh,Property Crime,Arson,Male,46-60,5566,2466,3100,5361,205
2002,Urban,Sikkim,Other Crimes,Fraud,Male,31-45,8875,7836,1039,8450,425
2002,Urban,Delhi,Crime Against Women,Dowry Deaths,Female,0-12,7377,3775,3602,7130,247
2004,Urban,Mizoram,Other Crimes,Drug Offense,Male,18-30,6554,4711,1843,5821,733
2007,Urban,Uttar Pradesh,Crime Against Men,Robbery,Female,0-12,7643,1871,5772,2285,5358
2001,Urban,Maharashtra,Crime Against Men,Murder,Female,18-30,2289,2151,138,2158,131
2010,Urban,Bihar,Crime Against Women,Molestation,Female,60+,6693,6661,32,6675,18
2007,Rural,Delhi,Property Crime,Burglary,Male,60+,73,28,45,35,38
2002,Rural,Meghalaya,Crime Against Women,Molestation,Female,13-17,9539,7466,2073,7940,1599
2001,Rural,Meghalaya,Crime Against Men,Robbery,Female,60+,4365,1594,2771,3818,547
2005,Rural,Bihar,Crime Against Men,Assault,Male,0-12,144,142,2,142,2
2006,Urban,Chhattisgarh,Crime Against Women,Domestic Violence,Male,0-12,81,12,69,59,22
2007,Rural,Assam,Crime Against Men,Extortion,Female,60+,9763,9234,529,9590,173
2005,Rural,Karnataka,Property Crime,Burglary,Female,0-12,2238,666,1572,982,1256
2004,Urban,Meghalaya,Other Crimes,Fraud,Male,31-45,8923,7246,1677,8679,244
2001,Urban,Nagaland,Crime Against Men,Extortion,Female,18-30,5711,1314,4397,5161,550
2007,Rural,West Bengal,Crime Against Men,Murder,Female,46-60,4633,1367,3266,1885,2748
2006,Urban,Rajasthan,Crime Against Women,Dowry Deaths,Male,60+,9350,6491,2859,8294,1056
2001,Urban,Jharkhand,Other Crimes,Cyber Crime,Male,13-17,7847,3101,4746,6264,1583
2007,Urban,Arunachal Pradesh,Other Crimes,Drug Offense,Female,46-60,2720,1726,994,2426,294
2005,Urban,Himachal Pradesh,Crime Against Women,Molestation,Male,18-30,9798,6396,3402,9092,706
2009,Rural,Delhi,Property Crime,Theft,Female,31-45,4209,267,3942,1133,3076
2003,Rural,Tamil Nadu,Other Crimes,Fraud,Male,46-60,6309,6309,0,6309,0
2004,Urban,Haryana,Crime Against Men,Assault,Male,18-30,1942,1661,281,1869,73
2002,Rural,Jharkhand,Crime Against Children,Kidnapping,Male,31-45,4132,1263,2869,3471,661
2006,Urban,Punjab,Other Crimes,Drug Offense,Female,31-45,3238,8,3230,2770,468
2007,Rural,Sikkim,Crime Against Children,Kidnapping,Female,13-17,8811,8007,804,8211,600
2008,Urban,Haryana,Other Crimes,Fraud,Male,31-45,3803,980,2823,2563,1240
2008,Urban,Haryana,Crime Against Women,Dowry Deaths,Female,0-12,5465,2561,2904,4645,820
2007,Urban,Chhattisgarh,Crime Against Women,Molestation,Male,31-45,289,229,60,242,47
2009,Rural,Karnataka,Property Crime,Arson,Male,31-45,1576,1541,35,1553,23
2002,Urban,Maharashtra,Crime Against Children,Child Labor,Male,18-30,6477,6294,183,6475,2
2004,Rural,Uttarakhand,Crime Against Children,Child Abuse,Male,31-45,5959,2938,3021,3891,2068
2006,Rural,Chhattisgarh,Crime Against Women,Molestation,Female,60+,7833,1641,6192,2288,5545
2002,Urban,Tripura,Crime Against Women,Domestic Violence,Male,31-45,9204,737,8467,3937,5267
2003,Rural,Madhya Pradesh,Property Crime,Arson,Male,31-45,892,479,413,566,326
2002,Urban,Manipur,Crime Against Children,Child Labor,Male,18-30,7252,3498,3754,3529,3723
2005,Rural,Kerala,Crime Against Children,Kidnapping,Female,31-45,8912,4655,4257,7957,955
2009,Rural,Uttarakhand,Crime Against Men,Assault,Male,13-17,8718,8130,588,8421,297
2008,Rural,Gujarat,Property Crime,Vandalism,Male,31-45,8944,4463,4481,7394,1550
2007,Rural,Nagaland,Crime Against Children,Child Labor,Female,60+,1203,628,575,1191,12
2002,Urban,West Bengal,Crime Against Women,Domestic Violence,Female,31-45,3366,2024,1342,3025,341
2008,Rural,Chhattisgarh,Crime Against Children,Child Labor,Male,60+,4840,1078,3762,3123,1717
2004,Rural,Gujarat,Crime Against Children,Child Labor,Female,18-30,6901,2557,4344,6538,363
2003,Rural,West Bengal,Crime Against Children,Child Abuse,Female,0-12,3350,410,2940,2540,810
2005,Rural,Andhra Pradesh,Other Crimes,Corruption,Male,13-17,6347,4311,2036,6101,246
2005,Rural,Delhi,Crime Against Men,Extortion,Male,46-60,4396,1684,2712,2401,1995
2010,Urban,Odisha,Property Crime,Burglary,Male,0-12,4411,1950,2461,3327,1084
2004,Rural,Karnataka,Crime Against Men,Assault,Male,0-12,9752,8667,1085,9225,527
2008,Rural,Bihar,Crime Against Children,Kidnapping,Female,13-17,5919,2321,3598,3063,2856
2009,Rural,Tripura,Crime Against Men,Assault,Male,60+,4956,1405,3551,2762,2194
2009,Urban,Chhattisgarh,Crime Against Children,Trafficking,Male,46-60,3684,1460,2224,1727,1957
2005,Urban,West Bengal,Property Crime,Vandalism,Female,0-12,9454,4772,4682,7442,2012
2006,Urban,Jharkhand,Property Crime,Burglary,Male,31-45,4059,613,3446,2135,1924
2008,Urban,Delhi,Other Crimes,Fraud,Female,13-17,8387,731,7656,6105,2282
2004,Urban,Maharashtra,Property Crime,Burglary,Female,18-30,9572,4654,4918,6996,2576
2009,Urban,Manipur,Property Crime,Theft,Female,18-30,3267,2669,598,2897,370
2004,Urban,West Bengal,Crime Against Women,Domestic Violence,Male,31-45,3535,1750,1785,2122,1413
2002,Urban,Odisha,Crime Against Children,Trafficking,Female,46-60,2495,2257,238,2390,105
2001,Rural,Maharashtra,Property Crime,Theft,Female,0-12,4546,2573,1973,4378,168
2009,Rural,Arunachal Pradesh,Other Crimes,Fraud,Male,18-30,3406,2863,543,3305,101
2004,Urban,Uttarakhand,Crime Against Men,Extortion,Male,0-12,6837,506,6331,3260,3577
2002,Rural,Assam,Crime Against Women,Rape,Male,18-30,3847,2099,1748,3024,823
2002,Rural,Manipur,Crime Against Women,Domestic Violence,Female,60+,5206,473,4733,1714,3492
2008,Urban,Nagaland,Crime Against Women,Molestation,Male,46-60,1467,869,598,1146,321
2003,Urban,Chhattisgarh,Property Crime,Arson,Female,18-30,2076,1432,644,1525,551
2008,Urban,Maharashtra,Crime Against Children,Child Labor,Female,13-17,1109,251,858,688,421
2003,Rural,Gujarat,Other Crimes,Fraud,Female,0-12,3842,2307,1535,3090,752
2001,Rural,Odisha,Property Crime,Arson,Female,18-30,2882,969,1913,1178,1704
2010,Rural,Chhattisgarh,Other Crimes,Cyber Crime,Male,31-45,1617,1491,126,1510,107
2007,Urban,Mizoram,Crime Against Children,Child Labor,Female,0-12,8844,7972,872,8413,431
2005,Urban,Rajasthan,Crime Against Men,Murder,Male,60+,297,41,256,60,237
2007,Rural,Jharkhand,Crime Against Women,Dowry Deaths,Male,31-45,1146,937,209,1141,5
2003,Rural,Rajasthan,Crime Against Men,Assault,Male,0-12,8560,5621,2939,6559,2001
2002,Urban,Chhattisgarh,Other Crimes,Drug Offense,Female,13-17,8860,6903,1957,8671,189
2002,Urban,Maharashtra,Crime Against Men,Assault,Female,46-60,6023,1885,4138,3645,2378
2010,Urban,Manipur,Other Crimes,Corruption,Male,18-30,7282,5889,1393,6062,1220
2001,Urban,Sikkim,Other Crimes,Cyber Crime,Female,0-12,935,857,78,866,69
2007,Rural,Tripura,Crime Against Children,Child Abuse,Male,31-45,921,678,243,680,241
2009,Urban,Madhya Pradesh,Crime Against Women,Molestation,Male,60+,6512,1615,4897,5096,1416
2009,Urban,Punjab,Crime Against Men,Extortion,Female,13-17,7892,1011,6881,7423,469
2001,Rural,Maharashtra,Crime Against Women,Dowry Deaths,Female,13-17,6475,6133,342,6264,211
2006,Rural,Maharashtra,Other Crimes,Cyber Crime,Female,18-30,8382,4549,3833,4949,3433
2009,Rural,Mizoram,Property Crime,Arson,Male,60+,4600,1687,2913,2466,2134
2004,Urban,Gujarat,Property Crime,Burglary,Male,13-17,3309,1376,1933,2601,708
2010,Urban,Uttarakhand,Other Crimes,Corruption,Male,31-45,2664,2659,5,2663,1
2010,Rural,Gujarat,Other Crimes,Cyber Crime,Female,46-60,9595,8106,1489,9161,434
2010,Urban,Andhra Pradesh,Other Crimes,Corruption,Male,46-60,6524,2783,3741,3473,3051
2001,Urban,Assam,Crime Against Men,Murder,Female,46-60,3772,1614,2158,1860,1912
2002,Rural,Arunachal Pradesh,Crime Against Men,Robbery,Male,13-17,2457,1872,585,2448,9
2009,Rural,Arunachal Pradesh,Crime Against Children,Kidnapping,Male,31-45,8762,7798,964,7902,860
2007,Urban,Jammu & Kashmir,Crime Against Women,Rape,Female,60+,1568,50,1518,824,744
2009,Urban,Himachal Pradesh,Crime Against Men,Robbery,Male,18-30,7058,1754,5304,6718,340
2010,Urban,Telangana,Property Crime,Vandalism,Male,46-60,9241,3010,6231,4053,5188
2006,Urban,Sikkim,Property Crime,Theft,Male,31-45,893,267,626,801,92
2005,Rural,Uttarakhand,Crime Against Men,Robbery,Female,31-45,611,148,463,495,116
2008,Rural,Bihar,Property Crime,Vandalism,Female,46-60,3378,358,3020,2987,391
2007,Rural,Punjab,Crime Against Children,Trafficking,Female,31-45,1047,849,198,926,121
2003,Urban,Chhattisgarh,Crime Against Women,Dowry Deaths,Female,0-12,8903,2729,6174,8745,158
2008,Urban,Meghalaya,Crime Against Men,Extortion,Male,31-45,5660,3665,1995,3945,1715
2008,Rural,Rajasthan,Crime Against Women,Molestation,Female,31-45,2113,176,1937,1699,414
2003,Rural,Gujarat,Other Crimes,Corruption,Male,18-30,7147,7044,103,7056,91
2010,Urban,Uttar Pradesh,Property Crime,Arson,Female,46-60,1507,899,608,1320,187
2009,Rural,Uttar Pradesh,Other Crimes,Cyber Crime,Male,18-30,3945,2722,1223,3793,152
2008,Urban,Madhya Pradesh,Crime Against Women,Domestic Violence,Male,18-30,1700,1563,137,1671,29
2002,Rural,Jammu & Kashmir,Crime Against Women,Rape,Female,60+,7128,4123,3005,4272,2856
2006,Rural,Uttar Pradesh,Crime Against Men,Extortion,Male,0-12,9957,3435,6522,5572,4385
2001,Rural,Jharkhand,Crime Against Women,Dowry Deaths,Female,13-17,5480,3765,1715,4846,634
2004,Urban,Himachal Pradesh,Property Crime,Burglary,Male,0-12,4014,3911,103,3941,73
2003,Urban,Madhya Pradesh,Other Crimes,Fraud,Female,0-12,2926,371,2555,1674,1252
2008,Urban,West Bengal,Crime Against Children,Kidnapping,Female,31-45,6134,2573,3561,4415,1719
2010,Urban,Jammu & Kashmir,Crime Against Women,Dowry Deaths,Male,46-60,7730,3726,4004,6392,1338
2006,Urban,Delhi,Crime Against Children,Child Abuse,Male,46-60,6701,6273,428,6521,180
2003,Rural,Tripura,Crime Against Women,Molestation,Female,18-30,9281,8019,1262,8110,1171
2008,Rural,Assam,Crime Against Men,Murder,Female,31-45,8300,6783,1517,8239,61
2005,Rural,Telangana,Property Crime,Theft,Male,13-17,5023,4019,1004,4990,33
2007,Urban,Rajasthan,Crime Against Women,Domestic Violence,Female,0-12,1455,516,939,788,667
2003,Rural,Meghalaya,Crime Against Women,Molestation,Male,31-45,7012,3534,3478,5723,1289
2010,Rural,Sikkim,Crime Against Men,Murder,Male,13-17,3611,2365,1246,2984,627
2008,Urban,Jharkhand,Crime Against Women,Dowry Deaths,Male,60+,6543,3072,3471,6281,262
2009,Urban,Goa,Property Crime,Theft,Female,18-30,339,79,260,158,181
2010,Urban,Mizoram,Crime Against Children,Trafficking,Female,18-30,5654,2140,3514,4924,730
2002,Urban,Tamil Nadu,Crime Against Women,Rape,Male,18-30,6571,5127,1444,5477,1094
2009,Rural,Assam,Crime Against Women,Domestic Violence,Female,60+,6730,5659,1071,6722,8
2007,Urban,Meghalaya,Other Crimes,Fraud,Female,13-17,5622,1654,3968,4825,797
2004,Urban,Meghalaya,Crime Against Women,Dowry Deaths,Female,13-17,9889,6086,3803,7734,2155
2008,Urban,Bihar,Crime Against Women,Dowry Deaths,Male,13-17,9287,5185,4102,6659,2628
2005,Rural,Meghalaya,Property Crime,Vandalism,Male,46-60,7510,6501,1009,6600,910
2007,Rural,Sikkim,Other Crimes,Cyber Crime,Female,46-60,9093,6696,2397,7149,1944
2004,Rural,Sikkim,Other Crimes,Cyber Crime,Male,18-30,4682,3126,1556,4561,121
2007,Urban,West Bengal,Crime Against Men,Robbery,Male,0-12,5286,1744,3542,3579,1707
2009,Rural,Maharashtra,Property Crime,Theft,Male,31-45,9100,1491,7609,2394,6706
2001,Rural,Sikkim,Crime Against Children,Child Labor,Male,60+,4893,2279,2614,4349,544
2005,Urban,Telangana,Other Crimes,Corruption,Female,46-60,6691,508,6183,3064,3627
2006,Rural,Karnataka,Crime Against Men,Assault,Female,13-17,1144,1120,24,1138,6
2006,Urban,Assam,Crime Against Women,Rape,Male,46-60,3993,410,3583,701,3292
2009,Rural,Haryana,Crime Against Children,Child Abuse,Male,31-45,3242,1035,2207,2815,427
2001,Urban,Jammu & Kashmir,Property Crime,Burglary,Female,46-60,3271,238,3033,353,2918
2003,Rural,Chhattisgarh,Crime Against Men,Robbery,Female,60+,9979,6367,3612,8847,1132
2010,Urban,Punjab,Crime Against Men,Extortion,Male,13-17,3296,2602,694,2880,416
2008,Urban,Meghalaya,Crime Against Children,Trafficking,Male,0-12,7434,6642,792,6848,586
2005,Urban,Jammu & Kashmir,Crime Against Children,Child Abuse,Female,60+,4662,1101,3561,3142,1520
2008,Rural,Gujarat,Crime Against Men,Assault,Male,60+,1668,1491,177,1602,66
2004,Urban,Mizoram,Crime Against Women,Molestation,Female,31-45,8967,606,8361,6522,2445
2003,Rural,Rajasthan,Property Crime,Burglary,Male,0-12,6574,979,5595,4864,1710
2002,Urban,Goa,Crime Against Men,Assault,Female,46-60,9275,7651,1624,8348,927
2007,Urban,Uttarakhand,Crime Against Men,Extortion,Male,60+,1011,623,388,907,104
2007,Urban,Andhra Pradesh,Crime Against Women,Molestation,Female,31-45,4324,3335,989,4163,161
2005,Rural,Kerala,Crime Against Children,Trafficking,Female,18-30,5039,1526,3513,2513,2526
2005,Rural,Tripura,Crime Against Men,Murder,Male,18-30,321,66,255,191,130
2006,Rural,Madhya Pradesh,Property Crime,Arson,Female,60+,431,60,371,94,337
2006,Urban,Goa,Crime Against Women,Rape,Female,13-17,1078,733,345,1071,7
2002,Urban,Jammu & Kashmir,Crime Against Men,Robbery,Female,18-30,3831,1026,2805,2305,1526
2008,Urban,Sikkim,Other Crimes,Fraud,Female,31-45,7097,3362,3735,4934,2163
2002,Urban,Uttar Pradesh,Property Crime,Vandalism,Female,0-12,7841,6374,1467,6612,1229
2006,Urban,Delhi,Crime Against Women,Molestation,Male,60+,5656,1691,3965,4357,1299
2003,Urban,West Bengal,Other Crimes,Corruption,Female,0-12,2678,761,1917,1279,1399
2008,Rural,Delhi,Crime Against Children,Trafficking,Male,60+,5305,4419,886,4752,553
2008,Rural,Rajasthan,Crime Against Men,Murder,Female,46-60,5285,449,4836,5177,108
2001,Urban,Haryana,Crime Against Women,Dowry Deaths,Male,0-12,6220,5279,941,6189,31
2004,Urban,Bihar,Crime Against Women,Rape,Female,13-17,2544,1459,1085,1776,768
2001,Rural,Chhattisgarh,Crime Against Women,Rape,Female,0-12,4714,1256,3458,3380,1334
2008,Urban,Mizoram,Crime Against Children,Child Abuse,Male,18-30,9375,9261,114,9314,61
2002,Rural,Tripura,Crime Against Children,Child Labor,Female,13-17,4643,1027,3616,3128,1515
2010,Urban,Assam,Crime Against Children,Child Labor,Male,60+,1187,719,468,959,228
2009,Rural,West Bengal,Crime Against Men,Assault,Female,60+,9044,5421,3623,7641,1403
2002,Rural,Goa,Property Crime,Vandalism,Female,60+,3945,1152,2793,2094,1851
2005,Urban,Meghalaya,Crime Against Men,Murder,Male,0-12,5444,3424,2020,4407,1037
2010,Urban,Uttarakhand,Property Crime,Arson,Male,13-17,7625,1049,6576,5907,1718
2010,Rural,Tripura,Crime Against Men,Assault,Female,60+,87,60,27,87,0
2004,Rural,Kerala,Crime Against Women,Molestation,Male,18-30,4437,2526,1911,4008,429
2006,Urban,Sikkim,Property Crime,Burglary,Female,18-30,4819,3683,1136,4222,597
2006,Rural,Himachal Pradesh,Crime Against Children,Child Labor,Female,13-17,6435,2523,3912,3162,3273
2008,Rural,Tamil Nadu,Property Crime,Vandalism,Female,0-12,4271,2288,1983,3417,854
2005,Urban,Sikkim,Crime Against Children,Kidnapping,Male,46-60,2360,1811,549,2147,213
2003,Urban,Kerala,Other Crimes,Corruption,Female,0-12,3740,1059,2681,1494,2246
2002,Rural,Rajasthan,Crime Against Women,Molestation,Male,46-60,4351,1697,2654,3480,871
2009,Urban,West Bengal,Crime Against Children,Trafficking,Female,18-30,3189,1601,1588,2389,800
2002,Rural,Odisha,Crime Against Children,Kidnapping,Female,46-60,6536,929,5607,1379,5157
2001,Urban,Meghalaya,Crime Against Men,Extortion,Female,18-30,839,265,574,825,14
2004,Urban,Jammu & Kashmir,Property Crime,Arson,Male,60+,2289,1492,797,1569,720
2005,Rural,Uttar Pradesh,Property Crime,Arson,Male,60+,4588,2479,2109,3947,641
2004,Urban,Telangana,Crime Against Women,Molestation,Female,18-30,3163,2637,526,3016,147
2002,Urban,Tamil Nadu,Other Crimes,Cyber Crime,Male,46-60,8846,7550,1296,8757,89
2001,Urban,Andhra Pradesh,Crime Against Children,Kidnapping,Male,0-12,7838,5528,2310,6183,1655
2009,Rural,Jharkhand,Crime Against Children,Child Labor,Female,31-45,5443,1429,4014,2673,2770
2006,Rural,Punjab,Property Crime,Vandalism,Female,31-45,7478,2375,5103,3383,4095
2002,Urban,Sikkim,Crime Against Men,Murder,Male,31-45,2306,1854,452,1942,364
2008,Urban,Uttarakhand,Crime Against Children,Child Labor,Male,31-45,9164,7223,1941,8438,726
2007,Rural,Haryana,Property Crime,Arson,Female,60+,6490,5672,818,6260,230
2007,Urban,West Bengal,Crime Against Men,Robbery,Female,60+,9572,4644,4928,6416,3156
2002,Rural,Andhra Pradesh,Other Crimes,Drug Offense,Male,31-45,8778,2000,6778,5908,2870
2007,Rural,Chhattisgarh,Crime Against Men,Robbery,Male,18-30,3759,456,3303,2354,1405
2005,Urban,West Bengal,Property Crime,Arson,Male,60+,7982,115,7867,7310,672
2008,Urban,Jharkhand,Other Crimes,Fraud,Female,46-60,7916,3970,3946,5359,2557
2001,Rural,Delhi,Property Crime,Vandalism,Male,46-60,9737,9012,725,9719,18
2006,Urban,Rajasthan,Property Crime,Theft,Male,18-30,7235,3431,3804,3766,3469
2008,Rural,West Bengal,Property Crime,Burglary,Female,46-60,2057,589,1468,1715,342
2004,Urban,Meghalaya,Other Crimes,Drug Offense,Female,13-17,466,16,450,82,384
2002,Urban,Andhra Pradesh,Crime Against Men,Extortion,Male,13-17,5978,991,4987,3729,2249
2006,Urban,Maharashtra,Other Crimes,Fraud,Female,46-60,4743,2797,1946,3139,1604
2008,Urban,Bihar,Crime Against Women,Molestation,Male,0-12,7500,7349,151,7396,104
2002,Rural,Telangana,Other Crimes,Drug Offense,Female,18-30,2632,1808,824,2026,606
2003,Urban,Haryana,Crime Against Men,Murder,Female,46-60,3197,2290,907,3099,98
2002,Urban,Manipur,Crime Against Children,Child Labor,Male,0-12,4593,4094,499,4410,183
2002,Rural,Bihar,Crime Against Women,Molestation,Female,18-30,4269,797,3472,2634,1635
2002,Urban,Andhra Pradesh,Crime Against Women,Molestation,Female,18-30,1778,778,1000,1479,299
2005,Rural,Jammu & Kashmir,Crime Against Women,Rape,Female,18-30,4730,4120,610,4190,540
2006,Urban,Assam,Crime Against Women,Domestic Violence,Female,13-17,770,558,212,573,197
2001,Rural,Nagaland,Property Crime,Vandalism,Male,13-17,1532,664,868,1379,153
2008,Urban,Assam,Crime Against Women,Molestation,Female,31-45,5323,935,4388,3989,1334
2004,Rural,Kerala,Crime Against Men,Robbery,Female,0-12,1456,888,568,1188,268
2009,Rural,Odisha,Crime Against Men,Murder,Male,13-17,1186,0,1186,525,661
2008,Rural,Andhra Pradesh,Property Crime,Vandalism,Male,0-12,1726,1119,607,1311,415
2001,Urban,West Bengal,Property Crime,Arson,Male,0-12,448,412,36,435,13
2007,Urban,Maharashtra,Property Crime,Theft,Male,46-60,1213,1063,150,1164,49
2005,Rural,Maharashtra,Property Crime,Theft,Male,18-30,9280,8387,893,8519,761
2007,Rural,Delhi,Property Crime,Burglary,Female,46-60,3990,3029,961,3123,867
2004,Rural,Uttar Pradesh,Property Crime,Theft,Male,60+,1849,443,1406,670,1179
2002,Rural,Uttarakhand,Crime Against Women,Molestation,Male,46-60,9409,6711,2698,8736,673
2001,Rural,Delhi,Other Crimes,Fraud,Female,60+,2507,546,1961,764,1743
2003,Rural,Himachal Pradesh,Other Crimes,Cyber Crime,Male,46-60,8309,7815,494,8025,284
2005,Urban,Mizoram,Property Crime,Arson,Female,46-60,9816,9694,122,9766,50
2006,Urban,Meghalaya,Crime Against Women,Domestic Violence,Male,60+,2380,563,1817,1400,980
2009,Rural,Uttarakhand,Other Crimes,Corruption,Female,0-12,1043,771,272,805,238
2007,Rural,Tamil Nadu,Crime Against Women,Molestation,Male,18-30,8190,400,7790,1086,7104
2007,Urban,Tripura,Crime Against Women,Rape,Female,13-17,2443,1590,853,2062,381
2002,Urban,Andhra Pradesh,Crime Against Women,Molestation,Female,46-60,3158,86,3072,1625,1533
2005,Urban,Goa,Crime Against Men,Extortion,Female,13-17,4949,1932,3017,4040,909
2006,Rural,Madhya Pradesh,Crime Against Women,Dowry Deaths,Female,31-45,6528,3197,3331,3338,3190
2010,Urban,Odisha,Crime Against Women,Rape,Male,18-30,8459,6639,1820,7303,1156
2004,Urban,Uttar Pradesh,Property Crime,Burglary,Female,60+,2226,1068,1158,2027,199
2003,Urban,Meghalaya,Other Crimes,Fraud,Female,0-12,2752,1056,1696,1422,1330
2010,Urban,Jammu & Kashmir,Crime Against Children,Child Labor,Male,46-60,7456,4407,3049,6959,497
2002,Urban,Himachal Pradesh,Crime Against Women,Dowry Deaths,Male,18-30,7281,1667,5614,6707,574
2010,Urban,Madhya Pradesh,Crime Against Women,Rape,Female,18-30,9793,8542,1251,8798,995
2003,Urban,West Bengal,Crime Against Women,Molestation,Male,31-45,6818,2218,4600,4230,2588
2010,Urban,Tripura,Crime Against Men,Robbery,Male,0-12,4998,998,4000,4240,758
2003,Rural,Haryana,Crime Against Women,Domestic Violence,Male,18-30,1925,852,1073,1741,184
2002,Urban,Sikkim,Crime Against Children,Child Abuse,Male,18-30,4334,4126,208,4183,151
2009,Urban,Jammu & Kashmir,Crime Against Men,Extortion,Male,31-45,4279,1822,2457,3079,1200
2005,Rural,Himachal Pradesh,Property Crime,Burglary,Female,13-17,1592,519,1073,985,607
2008,Urban,Nagaland,Property Crime,Burglary,Male,13-17,3346,2640,706,3117,229
2001,Rural,Jharkhand,Crime Against Women,Domestic Violence,Male,31-45,9943,2248,7695,4219,5724
2004,Rural,Chhattisgarh,Crime Against Children,Child Abuse,Female,18-30,8814,8470,344,8667,147
2006,Rural,Bihar,Other Crimes,Fraud,Male,13-17,728,95,633,361,367
2010,Urban,Tamil Nadu,Crime Against Men,Robbery,Male,31-45,281,76,205,248,33
2006,Urban,Jammu & Kashmir,Crime Against Men,Assault,Female,31-45,8916,1871,7045,8660,256
2002,Rural,Assam,Property Crime,Arson,Male,60+,4865,2094,2771,2325,2540
2002,Urban,Jammu & Kashmir,Crime Against Women,Domestic Violence,Male,18-30,2833,14,2819,1501,1332
2009,Rural,Delhi,Crime Against Children,Kidnapping,Male,46-60,1629,1102,527,1223,406
2009,Rural,Bihar,Property Crime,Theft,Female,0-12,5010,1002,4008,3427,1583
2001,Rural,Nagaland,Crime Against Men,Extortion,Male,13-17,7205,4802,2403,5885,1320
2006,Urban,Bihar,Property Crime,Arson,Female,18-30,9840,7631,2209,9354,486
2002,Rural,Arunachal Pradesh,Crime Against Children,Trafficking,Male,13-17,8933,152,8781,7245,1688
2005,Urban,Uttarakhand,Crime Against Children,Trafficking,Male,18-30,9252,5578,3674,9089,163
2004,Rural,Mizoram,Property Crime,Burglary,Female,13-17,2312,1584,728,2190,122
2006,Rural,Gujarat,Crime Against Women,Domestic Violence,Male,18-30,364,329,35,355,9
2003,Urban,Andhra Pradesh,Crime Against Children,Child Labor,Male,18-30,356,241,115,284,72
2005,Urban,West Bengal,Crime Against Women,Dowry Deaths,Male,46-60,3593,3040,553,3059,534
2002,Urban,Uttarakhand,Crime Against Men,Assault,Male,60+,9947,1176,8771,7966,1981
2004,Urban,Gujarat,Crime Against Men,Murder,Female,13-17,6783,203,6580,5501,1282
2005,Urban,Madhya Pradesh,Crime Against Women,Domestic Violence,Female,60+,81,49,32,70,11
2003,Rural,Kerala,Crime Against Women,Molestation,Male,18-30,6505,1450,5055,5465,1040
2004,Rural,Himachal Pradesh,Crime Against Children,Child Abuse,Male,18-30,4762,681,4081,3701,1061
2010,Rural,Rajasthan,Crime Against Men,Murder,Female,18-30,230,157,73,197,33
2007,Urban,Karnataka,Crime Against Children,Kidnapping,Female,46-60,3744,3409,335,3717,27
2004,Urban,Mizoram,Crime Against Children,Trafficking,Female,31-45,8564,7653,911,7918,646
2005,Rural,Tamil Nadu,Property Crime,Arson,Male,0-12,995,441,554,597,398
2004,Urban,Delhi,Property Crime,Theft,Male,18-30,6386,2050,4336,6229,157
2001,Rural,Chhattisgarh,Crime Against Women,Domestic Violence,Female,18-30,1244,838,406,1201,43
2009,Rural,Arunachal Pradesh,Crime Against Women,Rape,Male,60+,4401,3977,424,4304,97
2009,Urban,Jharkhand,Property Crime,Vandalism,Female,31-45,8179,904,7275,5421,2758
2004,Urban,Arunachal Pradesh,Other Crimes,Corruption,Female,31-45,4920,107,4813,3143,1777
2002,Rural,Odisha,Crime Against Women,Molestation,Male,13-17,4951,333,4618,3293,1658
2007,Urban,Jammu & Kashmir,Other Crimes,Corruption,Female,0-12,6400,3389,3011,6084,316
2006,Rural,Kerala,Crime Against Women,Domestic Violence,Female,0-12,3008,1413,1595,2035,973
2004,Rural,Arunachal Pradesh,Crime Against Children,Child Labor,Female,31-45,7622,6694,928,7122,500
2004,Rural,Madhya Pradesh,Crime Against Women,Dowry Deaths,Male,31-45,8623,5496,3127,7685,938
2009,Urban,Madhya Pradesh,Crime Against Men,Robbery,Female,46-60,2176,1896,280,1909,267
2004,Rural,Sikkim,Crime Against Women,Rape,Female,13-17,7712,3357,4355,7022,690
2003,Urban,Chhattisgarh,Other Crimes,Cyber Crime,Male,13-17,2098,565,1533,799,1299
2008,Urban,Arunachal Pradesh,Property Crime,Burglary,Male,46-60,4008,84,3924,2012,1996
2009,Urban,Mizoram,Other Crimes,Cyber Crime,Female,46-60,4593,1646,2947,1811,2782
2004,Urban,Chhattisgarh,Property Crime,Vandalism,Male,46-60,1685,727,958,843,842
2008,Rural,Nagaland,Crime Against Children,Child Abuse,Male,60+,5470,5335,135,5468,2
2009,Rural,Mizoram,Crime Against Children,Child Abuse,Female,60+,5661,1254,4407,3198,2463
2001,Rural,Gujarat,Property Crime,Theft,Male,60+,4250,3237,1013,3802,448
2004,Urban,Chhattisgarh,Other Crimes,Corruption,Male,60+,4065,1571,2494,4050,15
2008,Urban,Tripura,Crime Against Men,Murder,Male,13-17,517,465,52,517,0
2007,Rural,Karnataka,Crime Against Children,Trafficking,Male,31-45,9942,2703,7239,2847,7095
2007,Urban,Mizoram,Other Crimes,Drug Offense,Male,18-30,5987,104,5883,247,5740
2006,Urban,Karnataka,Property Crime,Vandalism,Male,0-12,8756,3661,5095,6956,1800
2009,Rural,Madhya Pradesh,Property Crime,Burglary,Female,13-17,8640,5990,2650,8062,578
2007,Rural,Arunachal Pradesh,Crime Against Children,Trafficking,Male,60+,5107,792,4315,5029,78
2007,Urban,Mizoram,Crime Against Children,Child Abuse,Male,31-45,1760,605,1155,1643,117
2001,Rural,Uttarakhand,Crime Against Men,Murder,Female,0-12,9529,2434,7095,3581,5948
2006,Urban,Himachal Pradesh,Crime Against Children,Trafficking,Male,46-60,9004,5139,3865,7176,1828
2006,Urban,Uttarakhand,Crime Against Women,Rape,Male,46-60,9739,1830,7909,2973,6766
2009,Rural,Delhi,Crime Against Children,Child Abuse,Male,60+,5592,3563,2029,4642,950
2007,Urban,Odisha,Crime Against Children,Child Labor,Male,13-17,9412,3068,6344,4317,5095
2004,Rural,Gujarat,Crime Against Children,Trafficking,Male,46-60,5258,1361,3897,4076,1182
2007,Rural,Andhra Pradesh,Crime Against Women,Molestation,Male,13-17,3596,2458,1138,3554,42
2009,Rural,Delhi,Other Crimes,Fraud,Male,0-12,3677,2387,1290,2416,1261
2002,Rural,Andhra Pradesh,Crime Against Children,Trafficking,Female,18-30,7195,3006,4189,3893,3302
2008,Urban,Andhra Pradesh,Crime Against Children,Kidnapping,Female,13-17,5909,565,5344,784,5125
2006,Rural,Arunachal Pradesh,Crime Against Children,Child Labor,Female,31-45,1019,542,477,868,151
2008,Rural,Chhattisgarh,Crime Against Children,Child Abuse,Female,31-45,4217,1549,2668,1888,2329
2002,Rural,Delhi,Other Crimes,Fraud,Female,31-45,200,115,85,141,59
2007,Urban,Nagaland,Other Crimes,Drug Offense,Male,13-17,2631,31,2600,1355,1276
2008,Rural,Tamil Nadu,Property Crime,Burglary,Male,31-45,6787,3316,3471,5356,1431
2001,Urban,Madhya Pradesh,Crime Against Men,Assault,Female,13-17,2474,244,2230,2096,378
2002,Urban,Jammu & Kashmir,Property Crime,Burglary,Male,31-45,9753,2375,7378,4769,4984
2009,Urban,Delhi,Crime Against Men,Assault,Male,31-45,2189,598,1591,600,1589
2002,Rural,Odisha,Crime Against Children,Child Labor,Female,13-17,7105,169,6936,440,6665
2007,Urban,Gujarat,Crime Against Children,Kidnapping,Female,46-60,2301,2062,239,2133,168
2004,Urban,Gujarat,Crime Against Children,Child Abuse,Male,0-12,9346,1710,7636,6285,3061
2010,Rural,Uttarakhand,Crime Against Men,Robbery,Female,46-60,4344,4012,332,4059,285
2005,Urban,Bihar,Crime Against Children,Child Abuse,Male,31-45,8127,6186,1941,8103,24
2005,Urban,Odisha,Crime Against Children,Trafficking,Male,31-45,4245,1125,3120,3278,967
2005,Urban,Telangana,Property Crime,Theft,Male,60+,7383,2562,4821,4393,2990
2003,Urban,Andhra Pradesh,Crime Against Children,Child Abuse,Male,46-60,83,27,56,72,11
2004,Urban,Arunachal Pradesh,Property Crime,Arson,Female,0-12,1855,588,1267,793,1062
2005,Urban,Arunachal Pradesh,Crime Against Women,Domestic Violence,Female,31-45,9822,1501,8321,5502,4320
2004,Rural,Arunachal Pradesh,Property Crime,Theft,Female,18-30,6183,92,6091,2294,3889
2008,Rural,Manipur,Property Crime,Burglary,Male,18-30,1989,1962,27,1983,6
2005,Urban,Himachal Pradesh,Other Crimes,Drug Offense,Female,18-30,8900,3148,5752,5506,3394
2010,Urban,Rajasthan,Crime Against Women,Domestic Violence,Male,60+,8255,2291,5964,3607,4648
2003,Urban,Tamil Nadu,Other Crimes,Fraud,Male,13-17,8451,725,7726,3242,5209
2008,Rural,Karnataka,Crime Against Men,Murder,Male,18-30,4902,1337,3565,3878,1024
2010,Urban,Uttar Pradesh,Crime Against Children,Child Labor,Male,46-60,7987,6576,1411,7507,480
2009,Urban,Meghalaya,Crime Against Men,Assault,Male,13-17,3256,2085,1171,2320,936
2007,Urban,Nagaland,Crime Against Men,Robbery,Female,60+,1299,184,1115,423,876
2006,Urban,Manipur,Crime Against Children,Child Abuse,Male,18-30,5018,1228,3790,2721,2297
2008,Urban,Mizoram,Other Crimes,Cyber Crime,Male,31-45,999,338,661,859,140
2007,Rural,Uttarakhand,Crime Against Men,Extortion,Male,18-30,3580,1414,2166,2602,978
2005,Rural,Rajasthan,Crime Against Men,Robbery,Male,13-17,2280,1868,412,1898,382
2002,Urban,Arunachal Pradesh,Property Crime,Theft,Female,46-60,9764,4333,5431,5681,4083
2001,Urban,Uttarakhand,Property Crime,Theft,Female,31-45,5091,3671,1420,4268,823
2007,Urban,Sikkim,Crime Against Children,Child Abuse,Male,0-12,460,314,146,393,67
2001,Urban,Maharashtra,Crime Against Men,Murder,Female,60+,5417,4869,548,5271,146
2010,Urban,Jammu & Kashmir,Crime Against Women,Dowry Deaths,Female,13-17,9980,464,9516,4131,5849
2008,Rural,West Bengal,Property Crime,Burglary,Female,0-12,3194,2475,719,2856,338
2007,Rural,Andhra Pradesh,Crime Against Women,Rape,Female,0-12,7823,7473,350,7739,84
2002,Rural,Uttar Pradesh,Crime Against Men,Robbery,Male,18-30,3815,276,3539,1327,2488
2005,Urban,Uttarakhand,Crime Against Women,Dowry Deaths,Male,0-12,826,497,329,693,133
2004,Rural,Jammu & Kashmir,Property Crime,Burglary,Male,18-30,3800,924,2876,1716,2084
2003,Rural,Meghalaya,Crime Against Women,Molestation,Male,13-17,4302,1043,3259,3657,645
2003,Rural,Kerala,Crime Against Men,Robbery,Male,31-45,1558,1423,135,1467,91
2009,Urban,Kerala,Crime Against Women,Dowry Deaths,Female,31-45,9234,2133,7101,6903,2331
2009,Urban,Uttarakhand,Crime Against Women,Rape,Male,0-12,9754,3025,6729,8908,846
2007,Urban,Gujarat,Crime Against Men,Assault,Female,18-30,9655,7719,1936,8743,912
2009,Rural,Madhya Pradesh,Property Crime,Arson,Male,46-60,1125,798,327,955,170
2006,Rural,Arunachal Pradesh,Property Crime,Burglary,Female,0-12,6546,3088,3458,3780,2766
2010,Urban,Tamil Nadu,Crime Against Children,Trafficking,Male,60+,4645,1212,3433,3179,1466
2003,Urban,Madhya Pradesh,Crime Against Children,Kidnapping,Female,31-45,7151,4946,2205,6694,457
2002,Rural,Uttar Pradesh,Crime Against Men,Extortion,Male,18-30,6938,3051,3887,4669,2269
2001,Urban,Goa,Crime Against Men,Extortion,Male,46-60,9137,8232,905,8316,821
2009,Urban,Manipur,Crime Against Children,Child Abuse,Male,0-12,830,825,5,825,5
2008,Urban,Arunachal Pradesh,Other Crimes,Cyber Crime,Female,46-60,8937,3505,5432,4277,4660
2010,Rural,Meghalaya,Property Crime,Arson,Female,46-60,8224,1968,6256,2811,5413
2009,Urban,Rajasthan,Crime Against Women,Rape,Male,18-30,3689,3370,319,3646,43
2005,Urban,Telangana,Crime Against Men,Extortion,Male,60+,8490,1688,6802,6928,1562
2009,Rural,Sikkim,Other Crimes,Fraud,Male,13-17,4695,3508,1187,4086,609
2005,Rural,Delhi,Crime Against Women,Molestation,Female,46-60,3433,33,3400,2025,1408
2001,Rural,West Bengal,Crime Against Men,Robbery,Male,31-45,7354,1437,5917,3737,3617
2001,Rural,Karnataka,Crime Against Women,Dowry Deaths,Female,60+,5865,4953,912,5623,242
2007,Urban,Gujarat,Crime Against Children,Kidnapping,Female,0-12,8636,4747,3889,5756,2880
2008,Urban,Nagaland,Crime Against Women,Rape,Male,0-12,9183,2854,6329,5372,3811
2003,Urban,Goa,Other Crimes,Fraud,Female,31-45,9114,788,8326,4667,4447
2003,Urban,Jammu & Kashmir,Crime Against Men,Murder,Male,0-12,2668,2137,531,2612,56
2008,Urban,Haryana,Other Crimes,Fraud,Female,60+,2716,1475,1241,2504,212
2008,Urban,Nagaland,Property Crime,Vandalism,Female,60+,6298,4123,2175,5480,818
2006,Rural,Uttarakhand,Crime Against Men,Assault,Male,13-17,5134,936,4198,4162,972
2003,Rural,Madhya Pradesh,Crime Against Children,Kidnapping,Female,31-45,7131,2556,4575,5574,1557
2009,Rural,Andhra Pradesh,Crime Against Children,Kidnapping,Male,46-60,6765,4233,2532,6564,201
2009,Rural,Manipur,Property Crime,Theft,Male,60+,9962,6531,3431,9532,430
2007,Rural,Karnataka,Crime Against Children,Trafficking,Male,60+,4706,4456,250,4495,211
2004,Urban,Andhra Pradesh,Crime Against Children,Child Labor,Female,18-30,7739,7494,245,7739,0
2007,Rural,Arunachal Pradesh,Crime Against Women,Molestation,Male,31-45,5237,677,4560,5118,119
2004,Rural,Odisha,Crime Against Children,Child Abuse,Male,13-17,4896,932,3964,2550,2346
2002,Rural,Kerala,Other Crimes,Drug Offense,Male,60+,8359,2487,5872,5679,2680
2002,Urban,Uttarakhand,Crime Against Children,Kidnapping,Female,0-12,3431,554,2877,2310,1121
2002,Urban,Karnataka,Crime Against Children,Trafficking,Female,31-45,7388,5018,2370,7210,178
2006,Rural,Tripura,Property Crime,Theft,Female,31-45,6798,4949,1849,4962,1836
2001,Urban,West Bengal,Other Crimes,Drug Offense,Female,46-60,5543,5389,154,5462,81
2007,Urban,Maharashtra,Crime Against Children,Kidnapping,Female,18-30,167,23,144,149,18
2010,Urban,Mizoram,Property Crime,Vandalism,Female,60+,8303,8131,172,8210,93
2008,Urban,Maharashtra,Property Crime,Theft,Male,13-17,7871,3638,4233,7539,332
2009,Urban,West Bengal,Crime Against Women,Dowry Deaths,Female,18-30,5983,1247,4736,2492,3491
2003,Rural,Tripura,Crime Against Children,Kidnapping,Male,13-17,1602,145,1457,1061,541
2008,Urban,Nagaland,Crime Against Children,Child Labor,Female,0-12,6983,733,6250,3876,3107
2010,Rural,Gujarat,Crime Against Children,Child Abuse,Female,60+,5291,1739,3552,2669,2622
2008,Urban,Jharkhand,Other Crimes,Fraud,Male,31-45,4385,96,4289,981,3404
2008,Urban,Haryana,Property Crime,Burglary,Female,13-17,8286,1484,6802,7130,1156
2006,Urban,Telangana,Crime Against Children,Child Labor,Female,18-30,4483,1974,2509,4076,407
2004,Rural,Himachal Pradesh,Property Crime,Theft,Male,0-12,8254,6810,1444,7476,778
2006,Rural,Madhya Pradesh,Property Crime,Vandalism,Female,60+,8632,6674,1958,6829,1803
2008,Urban,Tamil Nadu,Crime Against Women,Rape,Female,18-30,130,112,18,124,6
2005,Rural,Kerala,Crime Against Women,Molestation,Male,0-12,5380,4881,499,5199,181
2009,Urban,Nagaland,Crime Against Children,Trafficking,Female,31-45,598,365,233,497,101
2001,Rural,Uttar Pradesh,Crime Against Children,Child Labor,Male,13-17,8690,8553,137,8677,13
2002,Rural,Delhi,Crime Against Children,Child Labor,Female,13-17,1335,432,903,1126,209
2009,Rural,Uttar Pradesh,Crime Against Women,Rape,Male,31-45,6195,501,5694,2459,3736
2008,Urban,Madhya Pradesh,Crime Against Children,Trafficking,Female,0-12,625,603,22,610,15
2009,Rural,Maharashtra,Crime Against Children,Trafficking,Male,18-30,3883,2995,888,3238,645
2003,Rural,Telangana,Crime Against Women,Dowry Deaths,Female,0-12,4128,653,3475,3588,540
2006,Urban,Meghalaya,Other Crimes,Cyber Crime,Male,18-30,7797,5990,1807,7584,213
2004,Rural,Uttarakhand,Other Crimes,Cyber Crime,Female,46-60,1198,1,1197,384,814
2002,Rural,Meghalaya,Crime Against Women,Molestation,Male,0-12,2674,1753,921,2345,329
2004,Urban,Odisha,Crime Against Men,Extortion,Male,18-30,1838,1256,582,1517,321
2007,Urban,Goa,Other Crimes,Drug Offense,Male,60+,1115,968,147,1008,107
2007,Rural,Delhi,Crime Against Women,Rape,Male,18-30,6554,2264,4290,3597,2957
2002,Urban,Nagaland,Crime Against Women,Domestic Violence,Female,13-17,9099,2427,6672,7676,1423
2009,Urban,Manipur,Crime Against Children,Child Abuse,Female,60+,2245,204,2041,2051,194
2005,Urban,West Bengal,Crime Against Women,Rape,Female,18-30,3803,646,3157,2101,1702
2004,Rural,Bihar,Crime Against Women,Rape,Male,31-45,7527,3162,4365,7015,512
2009,Urban,Delhi,Crime Against Men,Murder,Female,46-60,4069,2048,2021,4029,40
2001,Rural,Goa,Crime Against Women,Domestic Violence,Female,18-30,1070,374,696,555,515
2003,Rural,Uttarakhand,Crime Against Children,Child Labor,Male,46-60,3579,2462,1117,3009,570
2010,Rural,Maharashtra,Other Crimes,Fraud,Female,18-30,4973,984,3989,4705,268
2003,Urban,Madhya Pradesh,Crime Against Women,Molestation,Female,18-30,7879,384,7495,7100,779
2003,Rural,Gujarat,Crime Against Men,Murder,Male,31-45,1994,1551,443,1701,293
2005,Urban,Delhi,Crime Against Women,Dowry Deaths,Female,13-17,6700,5912,788,6350,350
2008,Rural,Bihar,Crime Against Women,Molestation,Male,13-17,981,132,849,726,255
2004,Rural,Tripura,Crime Against Women,Dowry Deaths,Male,18-30,5468,2780,2688,3370,2098
2005,Urban,Madhya Pradesh,Other Crimes,Fraud,Male,0-12,2941,1174,1767,1697,1244
2003,Urban,Madhya Pradesh,Other Crimes,Corruption,Female,0-12,6136,1793,4343,3604,2532
2005,Rural,Goa,Property Crime,Theft,Male,31-45,7529,2883,4646,3592,3937
2006,Urban,Assam,Crime Against Children,Kidnapping,Male,60+,2112,882,1230,1428,684
2005,Urban,Maharashtra,Crime Against Men,Murder,Female,0-12,6324,3454,2870,3722,2602
2005,Urban,Haryana,Crime Against Women,Dowry Deaths,Female,31-45,7400,6125,1275,6566,834
2009,Rural,Goa,Crime Against Children,Child Abuse,Female,60+,5883,4805,1078,5044,839
2008,Urban,Andhra Pradesh,Other Crimes,Corruption,Male,31-45,1070,865,205,1003,67
2010,Rural,Manipur,Property Crime,Arson,Female,46-60,2344,1874,470,2331,13
2003,Rural,Madhya Pradesh,Crime Against Men,Assault,Female,18-30,9678,6961,2717,8763,915
2008,Urban,Karnataka,Crime Against Men,Robbery,Male,13-17,2865,1444,1421,1460,1405
2010,Rural,Nagaland,Crime Against Women,Dowry Deaths,Male,18-30,6394,917,5477,5882,512
2010,Urban,Madhya Pradesh,Other Crimes,Corruption,Male,31-45,7132,4472,2660,4925,2207
2001,Rural,Assam,Other Crimes,Fraud,Female,13-17,4407,2264,2143,3806,601
2004,Urban,West Bengal,Crime Against Children,Child Labor,Male,31-45,4809,3583,1226,4235,574
2002,Urban,Tripura,Property Crime,Arson,Female,0-12,1101,756,345,949,152
2005,Rural,Uttarakhand,Property Crime,Burglary,Male,46-60,717,670,47,714,3
2007,Urban,Bihar,Crime Against Women,Domestic Violence,Male,13-17,285,70,215,80,205
2004,Urban,Andhra Pradesh,Property Crime,Burglary,Female,18-30,2900,593,2307,1095,1805
2004,Rural,Rajasthan,Other Crimes,Fraud,Female,13-17,545,76,469,110,435
2001,Urban,Maharashtra,Crime Against Women,Rape,Female,31-45,8249,5429,2820,6917,1332
2005,Rural,Bihar,Other Crimes,Drug Offense,Male,46-60,5175,4348,827,4440,735
2003,Rural,Jharkhand,Crime Against Men,Robbery,Female,46-60,1388,62,1326,1179,209
2008,Urban,Tripura,Crime Against Men,Robbery,Female,60+,1111,171,940,241,870
2003,Urban,Chhattisgarh,Crime Against Children,Kidnapping,Female,31-45,6504,3498,3006,5463,1041
2001,Urban,Mizoram,Crime Against Women,Molestation,Male,46-60,1420,247,1173,963,457
2005,Urban,Nagaland,Crime Against Children,Trafficking,Female,60+,4999,2517,2482,3864,1135
2003,Rural,Goa,Crime Against Women,Molestation,Male,46-60,3574,2998,576,3213,361
2010,Rural,Uttar Pradesh,Other Crimes,Cyber Crime,Female,60+,4373,4312,61,4339,34
2008,Rural,Andhra Pradesh,Crime Against Women,Molestation,Male,31-45,9258,8707,551,8905,353
2010,Rural,Nagaland,Property Crime,Burglary,Male,60+,8801,6793,2008,7514,1287
2005,Rural,Bihar,Other Crimes,Cyber Crime,Female,60+,5151,2203,2948,5063,88
2002,Urban,Mizoram,Crime Against Men,Extortion,Male,60+,7539,4028,3511,7132,407
2003,Urban,Punjab,Other Crimes,Cyber Crime,Female,60+,7340,7271,69,7339,1
2010,Rural,Uttar Pradesh,Other Crimes,Fraud,Male,60+,1383,699,684,749,634
2005,Rural,Uttarakhand,Crime Against Men,Murder,Male,60+,4855,2658,2197,4799,56
2002,Urban,West Bengal,Crime Against Women,Domestic Violence,Female,18-30,2240,228,2012,2176,64
2003,Rural,Manipur,Crime Against Children,Kidnapping,Male,46-60,4841,2918,1923,3563,1278
2001,Urban,Uttar Pradesh,Other Crimes,Fraud,Male,0-12,3463,324,3139,2616,847
2005,Rural,Tamil Nadu,Property Crime,Burglary,Female,0-12,7125,4276,2849,5767,1358
2002,Rural,Chhattisgarh,Other Crimes,Corruption,Male,31-45,3340,3181,159,3234,106
2007,Urban,Chhattisgarh,Property Crime,Burglary,Female,46-60,185,42,143,146,39
2006,Rural,Odisha,Crime Against Women,Dowry Deaths,Male,0-12,9620,5561,4059,8365,1255
2010,Urban,Madhya Pradesh,Property Crime,Arson,Male,13-17,472,338,134,436,36
2002,Urban,Madhya Pradesh,Crime Against Men,Murder,Male,60+,7550,6082,1468,6590,960
2008,Rural,Punjab,Crime Against Men,Robbery,Male,46-60,8540,2893,5647,6827,1713
2009,Urban,Jammu & Kashmir,Other Crimes,Corruption,Male,13-17,2831,2199,632,2743,88
2004,Urban,West Bengal,Crime Against Men,Extortion,Female,60+,338,230,108,332,6
2001,Rural,Tamil Nadu,Crime Against Women,Domestic Violence,Male,13-17,951,257,694,773,178
2002,Urban,Jammu & Kashmir,Crime Against Children,Child Abuse,Male,46-60,4369,1746,2623,3914,455
2004,Rural,Andhra Pradesh,Crime Against Children,Trafficking,Male,13-17,7220,3124,4096,6610,610
2006,Urban,Goa,Other Crimes,Cyber Crime,Male,13-17,1202,415,787,716,486
2002,Urban,Kerala,Crime Against Women,Rape,Female,31-45,1695,1663,32,1669,26
2001,Rural,Sikkim,Crime Against Children,Child Labor,Male,13-17,9090,3617,5473,5686,3404
2006,Rural,Mizoram,Crime Against Women,Dowry Deaths,Male,18-30,5350,4871,479,5186,164
2009,Rural,Assam,Other Crimes,Corruption,Female,46-60,9055,8397,658,8811,244
2001,Urban,Chhattisgarh,Crime Against Children,Kidnapping,Male,0-12,4519,2159,2360,2513,2006
2004,Urban,Tamil Nadu,Crime Against Women,Dowry Deaths,Female,46-60,370,330,40,370,0
2009,Rural,Delhi,Crime Against Women,Domestic Violence,Female,13-17,74,74,0,74,0
2004,Urban,Andhra Pradesh,Crime Against Children,Child Abuse,Male,13-17,4048,2706,1342,3390,658
2006,Rural,Rajasthan,Crime Against Men,Extortion,Female,0-12,7828,4216,3612,6707,1121
2003,Urban,Chhattisgarh,Other Crimes,Fraud,Female,13-17,7898,5969,1929,6337,1561
2006,Urban,Punjab,Other Crimes,Fraud,Female,46-60,4684,2092,2592,2264,2420
2001,Rural,Gujarat,Crime Against Women,Rape,Male,60+,3443,87,3356,251,3192
2004,Urban,Nagaland,Property Crime,Vandalism,Female,46-60,6459,548,5911,2166,4293
2005,Urban,Himachal Pradesh,Other Crimes,Fraud,Male,0-12,7784,328,7456,5436,2348
2006,Rural,Kerala,Other Crimes,Fraud,Female,60+,3710,2546,1164,3012,698
2003,Urban,Manipur,Crime Against Men,Extortion,Female,60+,5537,4179,1358,5228,309
2005,Rural,Meghalaya,Crime Against Men,Robbery,Female,13-17,218,145,73,185,33
2004,Urban,Mizoram,Crime Against Children,Child Labor,Female,18-30,8981,7392,1589,7426,1555
2009,Rural,Jammu & Kashmir,Other Crimes,Cyber Crime,Female,60+,7912,1585,6327,3641,4271
2002,Rural,West Bengal,Property Crime,Arson,Male,18-30,8483,1960,6523,8221,262
2003,Urban,Uttarakhand,Crime Against Children,Trafficking,Female,60+,3780,1667,2113,2336,1444
2010,Urban,Tamil Nadu,Property Crime,Arson,Female,31-45,2261,1766,495,2092,169
2010,Urban,Gujarat,Crime Against Men,Extortion,Female,18-30,8086,534,7552,3570,4516
2007,Urban,Jharkhand,Property Crime,Burglary,Female,31-45,7016,3601,3415,4299,2717
2008,Urban,Rajasthan,Other Crimes,Fraud,Female,13-17,4361,2264,2097,4234,127
2002,Urban,Mizoram,Crime Against Men,Assault,Male,60+,2711,103,2608,2329,382
2007,Rural,Jammu & Kashmir,Other Crimes,Fraud,Male,0-12,9394,5964,3430,8306,1088
2010,Rural,Arunachal Pradesh,Crime Against Women,Rape,Female,31-45,7232,4159,3073,5266,1966
2009,Rural,Punjab,Crime Against Men,Robbery,Female,13-17,9545,7688,1857,9125,420
2002,Urban,Karnataka,Crime Against Men,Assault,Female,31-45,5703,1243,4460,5416,287
2009,Urban,Sikkim,Other Crimes,Drug Offense,Male,60+,2359,95,2264,1149,1210
2004,Urban,Punjab,Crime Against Men,Assault,Female,31-45,105,45,60,55,50
2001,Urban,Tamil Nadu,Crime Against Women,Dowry Deaths,Female,0-12,2136,66,2070,1806,330
2006,Rural,Andhra Pradesh,Crime Against Women,Dowry Deaths,Female,60+,6426,1681,4745,6199,227
2005,Urban,Nagaland,Crime Against Children,Child Labor,Male,46-60,6333,1761,4572,2224,4109
2007,Rural,Meghalaya,Crime Against Men,Assault,Male,60+,9120,1372,7748,7069,2051
2009,Rural,Punjab,Crime Against Children,Kidnapping,Male,18-30,1624,711,913,1305,319
2009,Rural,West Bengal,Crime Against Children,Child Labor,Male,0-12,555,157,398,328,227
2001,Rural,Assam,Crime Against Women,Domestic Violence,Male,46-60,1342,841,501,1246,96
2008,Rural,Assam,Property Crime,Arson,Female,18-30,3167,1951,1216,2030,1137
2005,Urban,Jharkhand,Other Crimes,Drug Offense,Female,0-12,5339,3716,1623,4967,372
2004,Urban,Andhra Pradesh,Other Crimes,Cyber Crime,Male,31-45,516,328,188,472,44
2010,Rural,Gujarat,Other Crimes,Fraud,Male,31-45,6191,2539,3652,5210,981
2010,Rural,Uttarakhand,Crime Against Children,Kidnapping,Male,13-17,9901,1109,8792,6987,2914
2010,Urban,Odisha,Property Crime,Vandalism,Male,13-17,4423,3321,1102,4290,133
2003,Urban,Jharkhand,Other Crimes,Cyber Crime,Female,31-45,1904,1174,730,1292,612
2002,Urban,Karnataka,Crime Against Men,Murder,Male,13-17,1312,170,1142,551,761
2009,Urban,West Bengal,Crime Against Men,Robbery,Male,31-45,5846,874,4972,1229,4617
2010,Urban,Sikkim,Crime Against Children,Child Labor,Female,0-12,2701,390,2311,1420,1281
2009,Urban,Assam,Other Crimes,Fraud,Male,60+,5971,133,5838,4260,1711
2005,Urban,Maharashtra,Other Crimes,Drug Offense,Female,18-30,7540,3445,4095,6907,633
2009,Urban,Assam,Crime Against Women,Molestation,Male,18-30,3272,1933,1339,2564,708
2010,Urban,West Bengal,Crime Against Children,Trafficking,Male,0-12,2190,1013,1177,1070,1120
2004,Rural,Punjab,Crime Against Children,Trafficking,Female,0-12,424,301,123,356,68
2006,Urban,Assam,Property Crime,Theft,Female,46-60,8206,333,7873,7681,525
2001,Urban,Mizoram,Property Crime,Vandalism,Male,13-17,9244,7981,1263,8973,271
2002,Rural,Jharkhand,Other Crimes,Drug Offense,Male,13-17,2517,982,1535,2319,198
2010,Rural,Nagaland,Property Crime,Vandalism,Male,13-17,6860,4941,1919,6106,754
2002,Rural,Mizoram,Property Crime,Vandalism,Male,13-17,8776,5477,3299,6916,1860
2010,Urban,Arunachal Pradesh,Crime Against Men,Robbery,Male,18-30,715,208,507,322,393
2007,Rural,Chhattisgarh,Other Crimes,Corruption,Female,46-60,1443,1049,394,1230,213
2006,Rural,Goa,Crime Against Children,Child Abuse,Female,60+,734,51,683,220,514
2002,Urban,Haryana,Property Crime,Burglary,Female,13-17,4828,2936,1892,4822,6
2004,Urban,Uttar Pradesh,Other Crimes,Fraud,Male,18-30,2275,1064,1211,2015,260
2007,Rural,Delhi,Property Crime,Burglary,Male,18-30,6623,5721,902,6546,77
2001,Rural,Jammu & Kashmir,Other Crimes,Corruption,Female,0-12,7201,197,7004,6394,807
2002,Urban,Delhi,Property Crime,Vandalism,Female,18-30,2587,109,2478,969,1618
2002,Rural,Odisha,Crime Against Women,Domestic Violence,Female,0-12,6811,6430,381,6444,367
2006,Rural,Uttarakhand,Crime Against Men,Robbery,Female,18-30,8376,1676,6700,7035,1341
2002,Urban,Uttarakhand,Crime Against Men,Robbery,Male,31-45,6774,927,5847,2603,4171
2006,Rural,Uttar Pradesh,Other Crimes,Corruption,Female,31-45,1580,1400,180,1492,88
2003,Urban,Madhya Pradesh,Crime Against Women,Molestation,Female,60+,5351,382,4969,3229,2122
2002,Urban,Bihar,Other Crimes,Drug Offense,Female,60+,9848,9107,741,9651,197
2003,Urban,Mizoram,Crime Against Women,Molestation,Male,60+,8288,7388,900,8222,66
2001,Rural,Punjab,Crime Against Children,Trafficking,Female,46-60,4424,4254,170,4352,72
2010,Rural,Nagaland,Property Crime,Theft,Female,0-12,8904,7620,1284,7659,1245
2009,Urban,Chhattisgarh,Property Crime,Arson,Male,0-12,1067,444,623,564,503
2007,Urban,Bihar,Property Crime,Arson,Female,31-45,3694,2445,1249,3625,69
2009,Urban,Haryana,Crime Against Children,Kidnapping,Female,31-45,1068,388,680,711,357
2001,Urban,Telangana,Crime Against Men,Extortion,Female,18-30,436,52,384,306,130
2007,Rural,Goa,Crime Against Children,Child Labor,Female,13-17,2141,235,1906,2079,62
2010,Rural,Nagaland,Crime Against Men,Extortion,Female,60+,6919,1955,4964,2592,4327
2010,Urban,Chhattisgarh,Other Crimes,Drug Offense,Male,31-45,4470,2219,2251,3168,1302
2001,Urban,Odisha,Crime Against Men,Assault,Female,60+,6610,4295,2315,4889,1721
2008,Urban,Uttar Pradesh,Property Crime,Burglary,Female,31-45,3131,2463,668,2485,646
2008,Rural,Sikkim,Crime Against Women,Domestic Violence,Female,13-17,8694,664,8030,6854,1840
2003,Urban,Uttarakhand,Property Crime,Theft,Female,13-17,1597,331,1266,1458,139
2008,Rural,Meghalaya,Crime Against Men,Extortion,Male,46-60,7372,4676,2696,4835,2537
2010,Rural,Uttar Pradesh,Crime Against Women,Domestic Violence,Male,13-17,736,326,410,699,37
2007,Urban,Uttarakhand,Crime Against Children,Child Abuse,Male,46-60,1844,1331,513,1736,108
2009,Urban,Bihar,Crime Against Women,Domestic Violence,Female,18-30,1890,1195,695,1214,676
2002,Rural,Odisha,Other Crimes,Corruption,Female,31-45,6973,5727,1246,6122,851
2002,Urban,Tamil Nadu,Crime Against Children,Trafficking,Male,60+,3193,915,2278,1938,1255
2004,Rural,Chhattisgarh,Crime Against Women,Rape,Male,0-12,9781,5563,4218,7857,1924
2007,Urban,Gujarat,Crime Against Children,Child Abuse,Male,46-60,8410,4337,4073,8319,91
2001,Urban,Gujarat,Crime Against Children,Kidnapping,Male,60+,3122,900,2222,3029,93
2001,Rural,Tripura,Crime Against Children,Kidnapping,Male,31-45,8754,2631,6123,6378,2376
2010,Urban,Delhi,Crime Against Children,Kidnapping,Female,13-17,3652,2461,1191,2977,675
2002,Urban,Tripura,Property Crime,Burglary,Male,46-60,6434,1384,5050,3872,2562
2008,Urban,Manipur,Property Crime,Theft,Female,18-30,2000,1579,421,1985,15
2006,Urban,Rajasthan,Property Crime,Vandalism,Male,31-45,891,633,258,759,132
2002,Rural,Telangana,Crime Against Women,Rape,Female,31-45,827,175,652,552,275
2004,Rural,Himachal Pradesh,Crime Against Men,Assault,Female,46-60,3305,556,2749,1076,2229
2002,Urban,Andhra Pradesh,Other Crimes,Fraud,Male,13-17,130,53,77,73,57
2002,Rural,Tamil Nadu,Crime Against Children,Kidnapping,Male,13-17,602,219,383,255,347
2008,Rural,Uttar Pradesh,Crime Against Children,Child Labor,Female,60+,8789,1499,7290,4941,3848
2003,Rural,Meghalaya,Crime Against Men,Murder,Female,31-45,3034,2358,676,2515,519
2006,Urban,Tripura,Crime Against Women,Rape,Male,46-60,1671,1213,458,1222,449
2002,Rural,Sikkim,Property Crime,Arson,Male,46-60,8704,7243,1461,8055,649
2007,Urban,Mizoram,Other Crimes,Fraud,Male,18-30,5788,3935,1853,4027,1761
2002,Urban,Tamil Nadu,Other Crimes,Fraud,Male,18-30,5586,3471,2115,5473,113
2002,Rural,Mizoram,Crime Against Women,Dowry Deaths,Female,46-60,2310,423,1887,2134,176
2003,Rural,Madhya Pradesh,Other Crimes,Drug Offense,Male,46-60,343,15,328,45,298
2007,Urban,Assam,Crime Against Men,Murder,Male,31-45,9585,5482,4103,9229,356
2005,Urban,Tamil Nadu,Crime Against Men,Murder,Female,60+,3047,214,2833,1406,1641
2005,Rural,Tripura,Crime Against Men,Assault,Female,31-45,720,549,171,661,59
2009,Urban,Assam,Crime Against Women,Dowry Deaths,Female,0-12,9581,937,8644,7455,2126
2006,Urban,Haryana,Crime Against Children,Kidnapping,Male,0-12,8538,1349,7189,7788,750
2003,Rural,Manipur,Property Crime,Burglary,Female,0-12,1475,798,677,1258,217
2003,Rural,West Bengal,Other Crimes,Fraud,Male,0-12,8454,1836,6618,7660,794
2005,Rural,Andhra Pradesh,Other Crimes,Fraud,Male,0-12,2422,869,1553,2199,223
2009,Rural,Uttar Pradesh,Crime Against Women,Molestation,Female,46-60,1893,832,1061,1371,522
2003,Rural,Mizoram,Crime Against Women,Rape,Female,31-45,3201,1919,1282,2832,369
2006,Rural,Bihar,Other Crimes,Drug Offense,Male,46-60,7871,5367,2504,7206,665
2001,Rural,Rajasthan,Crime Against Children,Child Labor,Male,46-60,7812,833,6979,7530,282
2003,Urban,Jammu & Kashmir,Property Crime,Theft,Female,46-60,9524,9176,348,9444,80
2002,Rural,Uttarakhand,Other Crimes,Drug Offense,Female,46-60,7571,177,7394,1232,6339
2004,Urban,Tamil Nadu,Crime Against Men,Extortion,Male,0-12,7531,5001,2530,6614,917
2007,Rural,Sikkim,Property Crime,Vandalism,Male,46-60,5480,5194,286,5261,219
2007,Urban,Andhra Pradesh,Crime Against Men,Robbery,Male,60+,4617,121,4496,384,4233
2002,Rural,Karnataka,Property Crime,Arson,Male,31-45,9155,6677,2478,8734,421
2010,Urban,Delhi,Crime Against Men,Robbery,Male,60+,1848,521,1327,745,1103
2004,Urban,Rajasthan,Property Crime,Burglary,Male,31-45,9352,508,8844,9053,299
2003,Urban,Assam,Crime Against Children,Kidnapping,Female,60+,7192,1739,5453,6723,469
2006,Rural,Nagaland,Property Crime,Vandalism,Male,0-12,7050,5084,1966,5793,1257
2004,Rural,Sikkim,Crime Against Children,Child Abuse,Female,60+,6769,5700,1069,6235,534
2004,Rural,Rajasthan,Crime Against Children,Kidnapping,Female,31-45,6806,1189,5617,6744,62
2001,Rural,Assam,Crime Against Men,Assault,Female,0-12,7257,2838,4419,5073,2184
2009,Urban,Jammu & Kashmir,Crime Against Men,Robbery,Female,31-45,459,282,177,380,79
2001,Urban,Assam,Property Crime,Burglary,Male,13-17,5522,1118,4404,5140,382
2006,Urban,Jharkhand,Crime Against Children,Kidnapping,Female,46-60,4780,4095,685,4461,319
2007,Rural,Chhattisgarh,Crime Against Children,Kidnapping,Female,31-45,6015,3661,2354,5575,440
2001,Urban,West Bengal,Property Crime,Arson,Male,0-12,256,219,37,247,9
2009,Rural,Himachal Pradesh,Crime Against Women,Rape,Female,46-60,7947,2856,5091,3048,4899
2004,Rural,Rajasthan,Property Crime,Burglary,Male,18-30,9388,3209,6179,5328,4060
2006,Rural,Punjab,Property Crime,Burglary,Female,31-45,1469,231,1238,244,1225
2006,Rural,Bihar,Other Crimes,Drug Offense,Male,13-17,5964,4793,1171,5937,27
2006,Rural,Delhi,Crime Against Men,Murder,Male,31-45,1912,1248,664,1636,276
2006,Urban,Sikkim,Property Crime,Burglary,Male,60+,6870,1840,5030,3781,3089
2009,Rural,Madhya Pradesh,Crime Against Men,Robbery,Male,60+,6316,2941,3375,5770,546
2008,Rural,Arunachal Pradesh,Crime Against Children,Child Abuse,Female,0-12,8778,7792,986,8158,620
2004,Urban,Haryana,Other Crimes,Corruption,Male,0-12,1087,945,142,956,131
2003,Urban,Uttarakhand,Crime Against Children,Trafficking,Female,0-12,7041,5039,2002,6935,106
2008,Urban,Gujarat,Crime Against Women,Dowry Deaths,Male,31-45,1109,154,955,883,226
2006,Urban,Rajasthan,Crime Against Men,Assault,Male,31-45,9115,4781,4334,4792,4323
2002,Rural,Bihar,Crime Against Women,Domestic Violence,Female,0-12,7923,1340,6583,4873,3050
2005,Urban,Gujarat,Other Crimes,Corruption,Male,13-17,8084,1728,6356,4835,3249
2010,Rural,Nagaland,Crime Against Men,Murder,Male,31-45,8887,3884,5003,8103,784
2008,Urban,Madhya Pradesh,Property Crime,Theft,Male,46-60,7814,3030,4784,6730,1084
2004,Urban,Arunachal Pradesh,Crime Against Children,Kidnapping,Female,18-30,5332,1034,4298,4264,1068
2008,Urban,Arunachal Pradesh,Other Crimes,Fraud,Female,46-60,4280,3850,430,4226,54
2007,Urban,Madhya Pradesh,Other Crimes,Fraud,Female,0-12,3514,265,3249,2865,649
2002,Urban,Uttarakhand,Other Crimes,Drug Offense,Female,0-12,3080,1228,1852,2106,974
2002,Urban,Sikkim,Crime Against Women,Rape,Male,31-45,6049,5490,559,5952,97
2002,Rural,Odisha,Property Crime,Vandalism,Female,18-30,3512,3244,268,3368,144
2007,Rural,Manipur,Crime Against Women,Domestic Violence,Female,18-30,8169,7017,1152,7331,838
2002,Rural,Gujarat,Other Crimes,Corruption,Male,13-17,1134,228,906,694,440
2007,Urban,Jammu & Kashmir,Property Crime,Vandalism,Female,0-12,4155,1090,3065,2688,1467
2007,Urban,Tamil Nadu,Property Crime,Vandalism,Male,0-12,5549,2087,3462,2112,3437
2010,Rural,Madhya Pradesh,Crime Against Children,Child Abuse,Female,31-45,6071,4259,1812,4406,1665
2002,Rural,Andhra Pradesh,Crime Against Children,Child Abuse,Female,31-45,63,8,55,28,35
2010,Rural,Haryana,Property Crime,Burglary,Female,13-17,4010,667,3343,3167,843
2004,Rural,Jharkhand,Other Crimes,Corruption,Female,46-60,1678,767,911,1360,318
2010,Urban,Andhra Pradesh,Crime Against Children,Trafficking,Male,46-60,6880,244,6636,5478,1402
2004,Rural,Meghalaya,Crime Against Children,Child Abuse,Female,18-30,3221,2223,998,2614,607
2004,Rural,Kerala,Crime Against Men,Robbery,Female,13-17,265,201,64,205,60
2008,Rural,Arunachal Pradesh,Crime Against Children,Trafficking,Male,31-45,4517,952,3565,2975,1542
2007,Urban,Manipur,Other Crimes,Fraud,Female,46-60,3374,2826,548,3071,303
2006,Urban,Goa,Crime Against Children,Child Abuse,Female,13-17,6685,2281,4404,3097,3588
2009,Urban,Nagaland,Property Crime,Burglary,Male,13-17,9349,2768,6581,8691,658
2001,Urban,Gujarat,Crime Against Men,Robbery,Male,18-30,1191,803,388,1002,189
2001,Urban,Manipur,Crime Against Men,Assault,Female,0-12,3592,2239,1353,3395,197
2008,Urban,Kerala,Crime Against Men,Robbery,Female,13-17,5790,4345,1445,5261,529
2003,Urban,Kerala,Property Crime,Burglary,Female,60+,2851,1139,1712,2028,823
2009,Urban,Punjab,Other Crimes,Corruption,Male,31-45,1615,881,734,1196,419
2004,Rural,Haryana,Crime Against Children,Kidnapping,Male,13-17,8307,3926,4381,4671,3636
2006,Rural,Sikkim,Other Crimes,Cyber Crime,Female,13-17,7433,7078,355,7198,235
2009,Urban,Karnataka,Other Crimes,Drug Offense,Male,13-17,4691,2084,2607,4469,222
2010,Rural,Punjab,Crime Against Children,Trafficking,Male,31-45,1230,988,242,1086,144
2004,Rural,Uttarakhand,Property Crime,Arson,Male,31-45,4320,1891,2429,2613,1707
2003,Rural,Uttar Pradesh,Crime Against Children,Child Labor,Female,46-60,8258,7710,548,8025,233
2007,Rural,Andhra Pradesh,Crime Against Men,Murder,Male,60+,9468,8970,498,9056,412
2008,Urban,Telangana,Crime Against Children,Kidnapping,Female,0-12,474,307,167,411,63
2006,Rural,Tripura,Crime Against Men,Robbery,Female,31-45,6451,5439,1012,6227,224
2006,Rural,Nagaland,Crime Against Children,Trafficking,Female,18-30,9973,9698,275,9921,52
2002,Urban,Gujarat,Property Crime,Theft,Male,60+,1646,1110,536,1423,223
2010,Urban,Nagaland,Other Crimes,Drug Offense,Female,31-45,161,30,131,80,81
2002,Rural,Tamil Nadu,Property Crime,Arson,Female,0-12,2868,1890,978,1938,930
2002,Rural,Rajasthan,Crime Against Men,Assault,Female,0-12,9630,1632,7998,5409,4221
2009,Rural,Maharashtra,Property Crime,Vandalism,Female,18-30,4237,2646,1591,3805,432
2008,Urban,Uttar Pradesh,Crime Against Women,Molestation,Female,18-30,4063,3433,630,3792,271
2010,Urban,West Bengal,Crime Against Children,Child Abuse,Female,18-30,478,122,356,206,272
2001,Urban,Andhra Pradesh,Other Crimes,Fraud,Female,60+,1799,1583,216,1639,160
2005,Urban,Bihar,Crime Against Children,Trafficking,Male,0-12,6774,4608,2166,6588,186
2010,Urban,Mizoram,Crime Against Women,Molestation,Male,46-60,3736,3257,479,3635,101
2001,Urban,Mizoram,Property Crime,Theft,Female,13-17,9229,4767,4462,8453,776
2002,Urban,Kerala,Crime Against Women,Rape,Male,13-17,5512,2742,2770,4328,1184
2004,Rural,Nagaland,Crime Against Men,Robbery,Female,18-30,1651,722,929,1076,575
2009,Urban,Uttar Pradesh,Crime Against Women,Dowry Deaths,Female,13-17,5594,4959,635,5345,249
2002,Rural,Nagaland,Crime Against Children,Kidnapping,Female,0-12,4422,3715,707,3912,510
2001,Rural,Gujarat,Other Crimes,Cyber Crime,Female,46-60,1122,302,820,435,687
2010,Rural,West Bengal,Crime Against Women,Molestation,Male,60+,5050,1615,3435,3100,1950
2009,Urban,Nagaland,Property Crime,Burglary,Female,13-17,3982,506,3476,1165,2817
2009,Rural,Odisha,Property Crime,Arson,Male,0-12,9195,4595,4600,4685,4510
2001,Urban,Andhra Pradesh,Other Crimes,Cyber Crime,Male,46-60,597,261,336,550,47
2010,Rural,Nagaland,Property Crime,Vandalism,Female,46-60,8503,1439,7064,3200,5303
2008,Urban,Manipur,Other Crimes,Corruption,Male,18-30,9632,2839,6793,4383,5249
2008,Rural,Chhattisgarh,Crime Against Children,Kidnapping,Male,46-60,1807,1729,78,1798,9
2008,Urban,Chhattisgarh,Crime Against Women,Domestic Violence,Female,0-12,1806,978,828,1763,43
2005,Rural,Tamil Nadu,Crime Against Children,Trafficking,Male,31-45,4192,606,3586,2253,1939
2005,Rural,Uttar Pradesh,Property Crime,Arson,Male,0-12,2162,82,2080,777,1385
2003,Urban,Odisha,Crime Against Men,Robbery,Male,31-45,2837,1100,1737,2109,728
2006,Rural,Assam,Crime Against Children,Child Abuse,Female,0-12,6915,3314,3601,3823,3092
2003,Urban,Arunachal Pradesh,Crime Against Women,Domestic Violence,Male,18-30,2231,464,1767,728,1503
2007,Rural,Jammu & Kashmir,Crime Against Women,Rape,Male,18-30,5557,3703,1854,4431,1126
2009,Urban,Maharashtra,Property Crime,Vandalism,Female,18-30,1524,1267,257,1340,184
2008,Rural,Tamil Nadu,Crime Against Children,Kidnapping,Male,60+,4146,2594,1552,3211,935
2005,Urban,Chhattisgarh,Property Crime,Arson,Female,0-12,6664,2787,3877,5775,889
2007,Rural,Jammu & Kashmir,Crime Against Women,Molestation,Male,0-12,7429,1571,5858,2044,5385
2005,Rural,Meghalaya,Crime Against Children,Child Labor,Male,18-30,9204,2920,6284,3845,5359
2006,Urban,Andhra Pradesh,Crime Against Men,Robbery,Male,60+,9646,2672,6974,3372,6274
2003,Urban,Odisha,Property Crime,Vandalism,Female,0-12,2314,707,1607,830,1484
2004,Rural,Mizoram,Crime Against Men,Robbery,Male,13-17,8416,3854,4562,5498,2918
2004,Rural,Tripura,Property Crime,Arson,Female,18-30,3598,603,2995,1718,1880
2008,Rural,Delhi,Property Crime,Theft,Female,31-45,3953,3393,560,3808,145
2007,Urban,Meghalaya,Other Crimes,Fraud,Male,0-12,3754,1313,2441,2148,1606
2004,Urban,Chhattisgarh,Property Crime,Burglary,Male,0-12,7748,6635,1113,6653,1095
2001,Urban,Goa,Property Crime,Theft,Female,60+,2293,549,1744,1466,827
2006,Rural,Andhra Pradesh,Property Crime,Theft,Male,60+,8564,5646,2918,7554,1010
2008,Rural,West Bengal,Other Crimes,Drug Offense,Male,60+,6950,5510,1440,6926,24
2006,Rural,Himachal Pradesh,Crime Against Children,Kidnapping,Female,46-60,2402,2156,246,2232,170
2001,Rural,Haryana,Crime Against Men,Extortion,Male,13-17,8662,2894,5768,8536,126
2008,Urban,Mizoram,Crime Against Women,Molestation,Male,31-45,6450,2974,3476,4646,1804
2009,Rural,Jammu & Kashmir,Crime Against Women,Dowry Deaths,Female,18-30,5128,4290,838,4744,384
2003,Rural,Gujarat,Crime Against Men,Extortion,Male,31-45,8277,5060,3217,5996,2281
2001,Rural,Telangana,Property Crime,Theft,Female,13-17,5690,897,4793,1708,3982
2010,Urban,Tripura,Property Crime,Arson,Female,0-12,470,404,66,436,34
2005,Rural,West Bengal,Crime Against Children,Child Labor,Female,46-60,7328,4737,2591,5929,1399
2001,Urban,Tamil Nadu,Other Crimes,Corruption,Female,31-45,5469,2308,3161,3112,2357
2009,Urban,Kerala,Crime Against Children,Child Abuse,Female,18-30,8642,6397,2245,7598,1044
2010,Urban,Madhya Pradesh,Property Crime,Vandalism,Male,31-45,456,58,398,369,87
2003,Urban,Andhra Pradesh,Crime Against Children,Kidnapping,Female,18-30,782,527,255,529,253
2010,Urban,Uttarakhand,Property Crime,Theft,Male,13-17,5843,117,5726,662,5181
2003,Urban,Arunachal Pradesh,Other Crimes,Cyber Crime,Female,18-30,2329,1231,1098,1635,694
2007,Urban,Karnataka,Property Crime,Theft,Female,13-17,7968,4279,3689,5886,2082
2008,Urban,Madhya Pradesh,Property Crime,Burglary,Female,13-17,7532,5600,1932,7461,71
2008,Rural,Haryana,Crime Against Children,Trafficking,Female,60+,540,98,442,315,225
2002,Urban,Jammu & Kashmir,Property Crime,Arson,Female,46-60,4333,499,3834,2659,1674
2002,Urban,Chhattisgarh,Other Crimes,Drug Offense,Male,60+,1709,952,757,1403,306
2008,Urban,Kerala,Crime Against Women,Domestic Violence,Female,46-60,4110,2146,1964,4052,58
2009,Rural,Sikkim,Property Crime,Theft,Female,13-17,4482,1446,3036,1969,2513
2003,Urban,West Bengal,Property Crime,Theft,Male,0-12,856,303,553,637,219
2001,Urban,Arunachal Pradesh,Crime Against Men,Extortion,Male,46-60,9605,1232,8373,6060,3545
2002,Rural,Chhattisgarh,Property Crime,Theft,Female,60+,502,330,172,459,43
2001,Rural,Telangana,Other Crimes,Cyber Crime,Female,18-30,5623,1364,4259,4135,1488
2006,Rural,Madhya Pradesh,Other Crimes,Corruption,Female,31-45,2809,1997,812,2648,161
2004,Urban,Nagaland,Crime Against Women,Rape,Male,31-45,6882,1946,4936,6519,363
2009,Rural,Manipur,Other Crimes,Drug Offense,Female,18-30,7582,6871,711,6960,622
2005,Urban,Madhya Pradesh,Property Crime,Burglary,Female,60+,78,29,49,31,47
2006,Urban,Meghalaya,Crime Against Women,Rape,Female,13-17,3729,575,3154,1201,2528
2007,Urban,Nagaland,Crime Against Men,Assault,Female,18-30,6323,893,5430,3572,2751
2002,Rural,Delhi,Crime Against Women,Domestic Violence,Male,46-60,449,359,90,444,5
2001,Urban,Maharashtra,Other Crimes,Cyber Crime,Male,31-45,4766,1487,3279,2712,2054
2005,Urban,Punjab,Property Crime,Vandalism,Female,60+,8211,5466,2745,7031,1180
2010,Rural,Jharkhand,Crime Against Children,Kidnapping,Female,60+,2424,1381,1043,2307,117
2002,Rural,Haryana,Other Crimes,Drug Offense,Male,60+,9873,5925,3948,8864,1009
2005,Rural,Karnataka,Crime Against Children,Child Labor,Female,0-12,9358,6754,2604,9100,258
2004,Urban,West Bengal,Other Crimes,Drug Offense,Female,31-45,7391,6648,743,7082,309
2005,Rural,Bihar,Crime Against Children,Trafficking,Male,31-45,5119,2411,2708,3263,1856
2003,Urban,Assam,Crime Against Men,Assault,Female,31-45,4570,262,4308,1022,3548
2003,Urban,Madhya Pradesh,Crime Against Children,Child Abuse,Male,60+,9169,3144,6025,8859,310
2010,Rural,Odisha,Crime Against Women,Rape,Male,18-30,6180,3479,2701,3983,2197
2006,Rural,Jharkhand,Property Crime,Theft,Male,13-17,3818,1550,2268,2936,882
2001,Rural,Uttarakhand,Crime Against Men,Extortion,Female,13-17,9292,3810,5482,6629,2663
2010,Urban,Mizoram,Crime Against Children,Trafficking,Female,0-12,474,81,393,172,302
2007,Rural,Himachal Pradesh,Crime Against Women,Dowry Deaths,Female,46-60,3873,1436,2437,1704,2169
2010,Rural,Gujarat,Crime Against Men,Extortion,Male,0-12,7079,2128,4951,5894,1185
2008,Urban,Jharkhand,Crime Against Women,Molestation,Male,46-60,2646,1660,986,1882,764
2007,Urban,Bihar,Property Crime,Vandalism,Male,18-30,4314,508,3806,1715,2599
2007,Urban,Manipur,Crime Against Children,Trafficking,Female,18-30,50,14,36,24,26
2005,Rural,Manipur,Property Crime,Theft,Female,46-60,3732,3290,442,3371,361
2005,Urban,Nagaland,Other Crimes,Drug Offense,Male,60+,9762,5250,4512,9399,363
2005,Urban,Meghalaya,Other Crimes,Fraud,Male,0-12,4274,2756,1518,3025,1249
2010,Urban,Mizoram,Crime Against Women,Rape,Male,18-30,9974,9222,752,9280,694
2002,Urban,Sikkim,Crime Against Women,Domestic Violence,Female,0-12,6945,1217,5728,5565,1380
2002,Urban,Andhra Pradesh,Crime Against Children,Child Labor,Female,60+,5277,2069,3208,3015,2262
2008,Urban,Delhi,Crime Against Children,Child Labor,Female,60+,3772,1044,2728,2920,852
2009,Rural,Mizoram,Other Crimes,Drug Offense,Female,60+,6718,4360,2358,6691,27
2007,Urban,Tripura,Crime Against Men,Assault,Male,46-60,2354,1559,795,2154,200
2001,Urban,Jammu & Kashmir,Other Crimes,Fraud,Male,60+,3939,3223,716,3715,224
2005,Urban,Punjab,Crime Against Children,Kidnapping,Female,60+,4464,1817,2647,1983,2481
2008,Urban,Madhya Pradesh,Other Crimes,Corruption,Female,46-60,4679,3814,865,4303,376
2010,Rural,Tripura,Crime Against Men,Assault,Male,0-12,6975,4320,2655,6258,717
2008,Urban,Jharkhand,Crime Against Children,Child Labor,Female,46-60,8103,6613,1490,7825,278
2009,Urban,Odisha,Crime Against Men,Murder,Female,60+,5275,3172,2103,4422,853
2001,Urban,Arunachal Pradesh,Crime Against Children,Trafficking,Male,0-12,6312,3191,3121,4340,1972
2007,Urban,Nagaland,Crime Against Children,Trafficking,Male,31-45,6193,55,6138,416,5777
2007,Rural,Arunachal Pradesh,Other Crimes,Drug Offense,Female,18-30,6013,4362,1651,5676,337
2008,Urban,Bihar,Crime Against Children,Kidnapping,Female,46-60,7456,7403,53,7449,7
2006,Urban,Karnataka,Crime Against Women,Domestic Violence,Female,18-30,8164,3843,4321,5347,2817
2010,Urban,Nagaland,Other Crimes,Cyber Crime,Male,60+,5187,975,4212,4853,334
2008,Urban,Telangana,Property Crime,Arson,Female,60+,2046,22,2024,500,1546
2009,Rural,Telangana,Property Crime,Arson,Female,13-17,9248,577,8671,2095,7153
2003,Urban,Meghalaya,Other Crimes,Fraud,Male,46-60,133,101,32,101,32
2010,Urban,Odisha,Crime Against Children,Child Abuse,Female,46-60,8188,4231,3957,6329,1859
2008,Urban,Goa,Property Crime,Arson,Male,31-45,4197,1228,2969,2524,1673
2008,Urban,Jammu & Kashmir,Property Crime,Burglary,Male,18-30,8173,1009,7164,3888,4285
2008,Rural,Mizoram,Other Crimes,Corruption,Female,0-12,8627,7480,1147,7975,652
2004,Urban,West Bengal,Property Crime,Theft,Male,31-45,5829,5695,134,5700,129
2005,Urban,Tamil Nadu,Crime Against Children,Trafficking,Male,46-60,4359,3988,371,4069,290
2009,Urban,Kerala,Crime Against Children,Child Labor,Female,31-45,6670,1429,5241,1992,4678
2003,Urban,Arunachal Pradesh,Other Crimes,Corruption,Female,13-17,1700,717,983,1480,220
2010,Urban,West Bengal,Other Crimes,Drug Offense,Female,13-17,3769,1832,1937,3459,310
2001,Rural,Odisha,Property Crime,Burglary,Female,13-17,4261,178,4083,1560,2701
2008,Rural,Chhattisgarh,Other Crimes,Corruption,Male,46-60,1796,79,1717,156,1640
2005,Rural,Uttar Pradesh,Other Crimes,Drug Offense,Female,46-60,8733,3253,5480,5466,3267
2001,Urban,Tripura,Crime Against Men,Assault,Female,46-60,846,688,158,702,144
2008,Urban,Himachal Pradesh,Crime Against Men,Murder,Male,13-17,552,197,355,388,164
2009,Rural,Kerala,Crime Against Women,Dowry Deaths,Male,60+,2099,2036,63,2084,15
2010,Urban,Meghalaya,Crime Against Men,Extortion,Female,60+,9927,6677,3250,6722,3205
2010,Urban,Tamil Nadu,Crime Against Women,Rape,Female,60+,2212,507,1705,1880,332
2008,Rural,Madhya Pradesh,Crime Against Women,Dowry Deaths,Female,13-17,6417,4721,1696,4805,1612
2002,Urban,Jammu & Kashmir,Property Crime,Vandalism,Female,31-45,5067,1816,3251,4536,531
2008,Rural,Odisha,Crime Against Women,Molestation,Male,46-60,9752,8840,912,9002,750
2010,Rural,Chhattisgarh,Property Crime,Arson,Female,46-60,4164,1509,2655,2114,2050
2009,Urban,Rajasthan,Crime Against Men,Assault,Male,18-30,8928,3984,4944,5478,3450
2004,Rural,Sikkim,Crime Against Women,Domestic Violence,Female,31-45,5702,3229,2473,4062,1640
2010,Urban,Maharashtra,Property Crime,Burglary,Male,18-30,6164,3969,2195,5354,810
2003,Urban,Rajasthan,Property Crime,Arson,Male,13-17,6791,5527,1264,6635,156
2004,Urban,Telangana,Crime Against Men,Robbery,Female,18-30,6142,5540,602,5723,419
2002,Rural,Delhi,Crime Against Women,Dowry Deaths,Male,13-17,7108,2841,4267,4201,2907
2010,Rural,Gujarat,Other Crimes,Fraud,Male,0-12,96,26,70,88,8
2009,Urban,Meghalaya,Crime Against Men,Murder,Female,0-12,2555,1834,721,2502,53
2009,Rural,Madhya Pradesh,Other Crimes,Corruption,Female,13-17,8593,7316,1277,7504,1089
2005,Urban,Assam,Property Crime,Arson,Female,13-17,3951,1329,2622,2139,1812
2006,Rural,Sikkim,Crime Against Children,Child Labor,Female,18-30,9623,9071,552,9079,544
2002,Urban,Tripura,Property Crime,Vandalism,Female,31-45,662,356,306,481,181
2002,Rural,Haryana,Other Crimes,Corruption,Female,18-30,2465,1828,637,2064,401
2004,Urban,Madhya Pradesh,Property Crime,Burglary,Male,0-12,1903,30,1873,595,1308
2003,Urban,Assam,Crime Against Children,Kidnapping,Male,46-60,3561,1007,2554,1768,1793
2003,Urban,Odisha,Property Crime,Arson,Female,13-17,4882,1138,3744,2945,1937
2008,Rural,Karnataka,Other Crimes,Cyber Crime,Female,46-60,9384,3880,5504,4218,5166
2002,Rural,Himachal Pradesh,Crime Against Children,Kidnapping,Female,13-17,997,9,988,629,368
2005,Rural,Sikkim,Crime Against Women,Dowry Deaths,Female,31-45,6130,3768,2362,5568,562
2006,Urban,Andhra Pradesh,Crime Against Children,Child Abuse,Female,0-12,6493,2404,4089,3288,3205
2004,Urban,Telangana,Crime Against Women,Domestic Violence,Male,60+,877,865,12,876,1
2007,Urban,Tripura,Crime Against Children,Kidnapping,Male,31-45,6441,5850,591,5933,508
2010,Rural,Karnataka,Crime Against Children,Trafficking,Female,18-30,5253,3130,2123,5006,247
2005,Urban,Bihar,Crime Against Women,Molestation,Male,46-60,9101,2550,6551,4165,4936
2003,Rural,Tripura,Property Crime,Burglary,Female,60+,59,35,24,56,3
2005,Urban,Jharkhand,Other Crimes,Corruption,Female,0-12,448,104,344,386,62
2010,Rural,Telangana,Crime Against Women,Molestation,Male,31-45,5396,2328,3068,3883,1513
2004,Urban,Himachal Pradesh,Crime Against Children,Trafficking,Female,13-17,151,87,64,125,26
2008,Rural,Bihar,Crime Against Men,Assault,Female,18-30,2982,2936,46,2957,25
2009,Urban,Andhra Pradesh,Crime Against Women,Dowry Deaths,Female,60+,1580,346,1234,505,1075
2003,Urban,Uttarakhand,Property Crime,Burglary,Male,60+,7048,3032,4016,3867,3181
2009,Urban,Jammu & Kashmir,Crime Against Women,Dowry Deaths,Female,31-45,8095,5168,2927,5659,2436
2002,Urban,Haryana,Property Crime,Theft,Female,46-60,6767,3049,3718,5218,1549
2005,Rural,West Bengal,Property Crime,Vandalism,Female,46-60,8316,7805,511,8165,151
2010,Urban,Andhra Pradesh,Other Crimes,Cyber Crime,Male,60+,745,29,716,271,474
2010,Urban,Arunachal Pradesh,Crime Against Women,Rape,Male,18-30,3639,122,3517,860,2779
2010,Rural,Assam,Crime Against Men,Murder,Female,18-30,1090,475,615,720,370
2003,Urban,Tripura,Other Crimes,Drug Offense,Female,60+,2598,1138,1460,1895,703
2004,Rural,Manipur,Property Crime,Vandalism,Female,46-60,2482,1243,1239,2169,313
2007,Rural,Karnataka,Crime Against Women,Rape,Female,18-30,3327,1280,2047,1493,1834
2004,Urban,Odisha,Property Crime,Vandalism,Female,46-60,6761,241,6520,1774,4987
2006,Urban,Nagaland,Crime Against Women,Molestation,Female,60+,2918,2800,118,2810,108
2003,Rural,Bihar,Crime Against Women,Rape,Female,60+,7725,4175,3550,7421,304
2003,Rural,Jharkhand,Crime Against Men,Extortion,Male,0-12,484,87,397,105,379
2008,Urban,Madhya Pradesh,Crime Against Women,Molestation,Male,60+,4440,2401,2039,2957,1483
2004,Rural,Assam,Crime Against Children,Child Abuse,Female,46-60,7639,3896,3743,5877,1762
2001,Rural,Nagaland,Crime Against Men,Robbery,Female,31-45,154,61,93,124,30
2009,Rural,Chhattisgarh,Property Crime,Arson,Male,18-30,4519,751,3768,2503,2016
2008,Urban,Meghalaya,Crime Against Men,Assault,Male,46-60,7435,1470,5965,2873,4562
2009,Urban,Tamil Nadu,Crime Against Men,Assault,Female,13-17,7079,6773,306,6844,235
2003,Urban,Arunachal Pradesh,Crime Against Women,Dowry Deaths,Female,31-45,4784,3796,988,3853,931
2002,Urban,Meghalaya,Property Crime,Vandalism,Female,0-12,7556,4123,3433,6464,1092
2010,Rural,Andhra Pradesh,Crime Against Men,Extortion,Male,46-60,4075,2337,1738,2644,1431
2004,Rural,Andhra Pradesh,Crime Against Women,Rape,Male,18-30,7777,4693,3084,6894,883
2007,Rural,Karnataka,Crime Against Children,Child Labor,Male,60+,99,53,46,59,40
2009,Rural,Nagaland,Crime Against Children,Child Abuse,Female,0-12,2507,706,1801,1149,1358
2006,Rural,Andhra Pradesh,Other Crimes,Fraud,Male,18-30,5050,2681,2369,3609,1441
2008,Rural,Jharkhand,Other Crimes,Cyber Crime,Male,31-45,9034,1293,7741,4810,4224
2006,Urban,Rajasthan,Other Crimes,Corruption,Male,0-12,4058,2307,1751,2681,1377
2001,Rural,Meghalaya,Other Crimes,Cyber Crime,Male,31-45,5579,1267,4312,3589,1990
2006,Urban,Assam,Property Crime,Burglary,Female,60+,1972,56,1916,1126,846
2003,Urban,Rajasthan,Other Crimes,Fraud,Female,0-12,3436,1289,2147,1575,1861
2001,Urban,Andhra Pradesh,Crime Against Men,Murder,Male,18-30,1307,921,386,1281,26
2001,Rural,Bihar,Crime Against Children,Child Abuse,Male,60+,3959,3527,432,3714,245
2009,Rural,Odisha,Crime Against Men,Murder,Female,46-60,4509,3149,1360,3362,1147
2003,Rural,Assam,Crime Against Men,Extortion,Female,0-12,9951,7413,2538,7895,2056
2003,Urban,Karnataka,Other Crimes,Corruption,Male,18-30,9240,2418,6822,4264,4976
2007,Rural,Arunachal Pradesh,Crime Against Children,Child Labor,Male,18-30,3934,3351,583,3633,301
2007,Rural,Goa,Crime Against Children,Child Abuse,Male,46-60,9552,9539,13,9552,0
2003,Rural,Nagaland,Crime Against Children,Kidnapping,Female,13-17,2572,1474,1098,1613,959
2005,Rural,Assam,Crime Against Women,Molestation,Female,46-60,3323,756,2567,2840,483
2003,Urban,Karnataka,Property Crime,Burglary,Male,18-30,3925,1268,2657,3022,903
2008,Rural,Sikkim,Crime Against Women,Dowry Deaths,Male,60+,8538,7317,1221,8463,75
2010,Rural,Manipur,Other Crimes,Cyber Crime,Male,0-12,7951,7775,176,7902,49
2004,Rural,Meghalaya,Crime Against Women,Domestic Violence,Female,13-17,5767,4000,1767,4420,1347
2008,Rural,Mizoram,Crime Against Children,Trafficking,Female,46-60,6863,6642,221,6713,150
2004,Rural,Delhi,Other Crimes,Fraud,Female,46-60,3523,349,3174,2871,652
2003,Rural,Uttar Pradesh,Crime Against Men,Assault,Male,18-30,3589,1282,2307,2692,897
2001,Rural,Maharashtra,Other Crimes,Cyber Crime,Female,60+,1991,1104,887,1570,421
2001,Urban,Uttarakhand,Crime Against Children,Child Abuse,Male,60+,4708,849,3859,2585,2123
2004,Rural,Rajasthan,Property Crime,Burglary,Female,18-30,1423,409,1014,1223,200
2005,Urban,Jharkhand,Property Crime,Arson,Male,18-30,5952,4228,1724,4407,1545
2001,Urban,Chhattisgarh,Crime Against Men,Robbery,Male,31-45,7489,7339,150,7359,130
2006,Urban,Kerala,Crime Against Women,Domestic Violence,Female,31-45,1828,1058,770,1715,113
2002,Urban,West Bengal,Crime Against Men,Robbery,Male,46-60,7346,4502,2844,6083,1263
2001,Rural,Jammu & Kashmir,Other Crimes,Corruption,Male,18-30,486,299,187,474,12
2006,Urban,Manipur,Crime Against Children,Trafficking,Female,13-17,5900,1427,4473,3816,2084
2006,Urban,Uttarakhand,Crime Against Children,Child Abuse,Female,18-30,1231,943,288,993,238
2006,Urban,Jharkhand,Crime Against Children,Trafficking,Female,13-17,6970,5547,1423,5777,1193
2001,Urban,Gujarat,Crime Against Children,Kidnapping,Male,46-60,8340,4696,3644,5227,3113
2002,Urban,Uttarakhand,Crime Against Women,Rape,Male,0-12,9355,6163,3192,9263,92
2005,Urban,Bihar,Crime Against Women,Molestation,Male,46-60,6741,3272,3469,5171,1570
2007,Urban,Jammu & Kashmir,Crime Against Women,Domestic Violence,Female,31-45,5722,2006,3716,5483,239
2010,Rural,Tamil Nadu,Property Crime,Theft,Male,46-60,6393,542,5851,5994,399
2004,Urban,Gujarat,Property Crime,Vandalism,Male,46-60,7026,5561,1465,5584,1442
2008,Rural,Sikkim,Crime Against Women,Dowry Deaths,Male,46-60,8298,4511,3787,7986,312
2006,Rural,Sikkim,Crime Against Children,Trafficking,Male,0-12,5736,0,5736,2714,3022
2005,Urban,Maharashtra,Crime Against Men,Robbery,Female,13-17,9969,1105,8864,8598,1371
2001,Urban,Haryana,Crime Against Children,Child Abuse,Female,46-60,2604,1143,1461,2152,452
2004,Rural,West Bengal,Crime Against Women,Dowry Deaths,Female,0-12,5046,4856,190,4890,156
2004,Urban,Mizoram,Crime Against Women,Rape,Female,0-12,4003,3136,867,3573,430
2007,Rural,Uttarakhand,Crime Against Children,Child Labor,Male,13-17,4952,31,4921,4545,407
2007,Rural,Karnataka,Crime Against Children,Child Labor,Female,13-17,5512,1986,3526,4817,695
2010,Urban,Madhya Pradesh,Other Crimes,Corruption,Female,60+,2803,350,2453,430,2373
2002,Rural,Uttar Pradesh,Crime Against Children,Kidnapping,Female,60+,6902,6280,622,6479,423
2002,Urban,Assam,Crime Against Women,Dowry Deaths,Male,31-45,5161,3051,2110,4528,633
2002,Rural,Andhra Pradesh,Property Crime,Vandalism,Male,60+,5483,1075,4408,4647,836
2008,Urban,Andhra Pradesh,Property Crime,Theft,Female,13-17,769,452,317,574,195
2001,Rural,Gujarat,Crime Against Men,Murder,Female,31-45,71,48,23,66,5
2008,Rural,Sikkim,Crime Against Children,Kidnapping,Female,46-60,6800,830,5970,4315,2485
2010,Rural,Meghalaya,Property Crime,Vandalism,Female,18-30,9625,7645,1980,8349,1276
2009,Urban,Delhi,Crime Against Children,Child Abuse,Female,46-60,4156,2322,1834,2761,1395
2006,Urban,Madhya Pradesh,Crime Against Women,Domestic Violence,Male,31-45,1742,597,1145,831,911
2010,Rural,Uttar Pradesh,Crime Against Children,Trafficking,Male,31-45,998,691,307,947,51
2002,Rural,Jharkhand,Crime Against Women,Rape,Female,13-17,5519,2845,2674,4083,1436
2010,Urban,Nagaland,Crime Against Men,Robbery,Male,0-12,9903,7213,2690,9717,186
2006,Rural,Jharkhand,Other Crimes,Cyber Crime,Male,0-12,3084,1304,1780,1531,1553
2002,Urban,Odisha,Crime Against Men,Extortion,Male,31-45,5534,4445,1089,5308,226
2008,Urban,Delhi,Crime Against Women,Molestation,Male,60+,9589,1023,8566,8891,698
2007,Urban,Madhya Pradesh,Crime Against Women,Domestic Violence,Male,13-17,2691,319,2372,563,2128
2008,Rural,Mizoram,Other Crimes,Fraud,Female,46-60,1943,2,1941,1280,663
2006,Urban,Madhya Pradesh,Other Crimes,Cyber Crime,Female,0-12,5815,3186,2629,4196,1619
2003,Rural,Telangana,Property Crime,Burglary,Female,31-45,2283,704,1579,1288,995
2009,Urban,Uttarakhand,Crime Against Women,Molestation,Male,46-60,8547,6748,1799,8482,65
2004,Urban,Mizoram,Crime Against Children,Child Labor,Female,46-60,5689,3921,1768,5267,422
2010,Rural,Karnataka,Property Crime,Burglary,Female,31-45,1084,1016,68,1041,43
2004,Rural,Jammu & Kashmir,Crime Against Children,Trafficking,Female,31-45,8617,7522,1095,7655,962
2006,Rural,Mizoram,Crime Against Women,Rape,Male,0-12,9069,5090,3979,7083,1986
2005,Urban,Uttarakhand,Other Crimes,Corruption,Female,18-30,1311,1166,145,1274,37
2003,Urban,Haryana,Other Crimes,Drug Offense,Female,31-45,9717,3630,6087,6670,3047
2004,Rural,Uttarakhand,Crime Against Children,Child Labor,Male,60+,8797,7669,1128,7675,1122
2009,Urban,Manipur,Property Crime,Vandalism,Male,31-45,4480,1195,3285,3633,847
2002,Rural,Chhattisgarh,Crime Against Men,Robbery,Male,0-12,119,78,41,114,5
2008,Rural,Mizoram,Property Crime,Vandalism,Male,31-45,3819,1478,2341,2495,1324
2009,Urban,Gujarat,Property Crime,Arson,Male,46-60,1639,1310,329,1541,98
2004,Rural,Nagaland,Crime Against Men,Murder,Male,13-17,2751,380,2371,1223,1528
2006,Urban,Tamil Nadu,Crime Against Men,Assault,Female,13-17,3782,1022,2760,2083,1699
2001,Urban,Delhi,Crime Against Women,Molestation,Male,31-45,3728,316,3412,2762,966
2003,Rural,Odisha,Property Crime,Burglary,Female,46-60,544,436,108,449,95
2010,Rural,Uttarakhand,Property Crime,Burglary,Female,13-17,9630,3832,5798,5382,4248
2002,Urban,Goa,Property Crime,Arson,Male,18-30,1599,1041,558,1125,474
2005,Rural,Maharashtra,Other Crimes,Drug Offense,Female,13-17,534,208,326,263,271
2005,Rural,Telangana,Other Crimes,Fraud,Male,31-45,5559,258,5301,3318,2241
2008,Urban,Chhattisgarh,Crime Against Women,Dowry Deaths,Female,18-30,8913,6374,2539,8670,243
2010,Rural,Gujarat,Property Crime,Arson,Male,13-17,4413,3998,415,4110,303
2004,Rural,Maharashtra,Property Crime,Burglary,Male,13-17,4845,3100,1745,3949,896
2002,Urban,Maharashtra,Other Crimes,Cyber Crime,Female,60+,4109,286,3823,1340,2769
2010,Rural,Gujarat,Crime Against Women,Molestation,Female,0-12,8765,7571,1194,8366,399
2002,Urban,Meghalaya,Crime Against Men,Robbery,Male,60+,4140,3182,958,3852,288
2001,Rural,West Bengal,Other Crimes,Fraud,Female,46-60,7883,4277,3606,6421,1462
2003,Urban,Tripura,Crime Against Men,Assault,Male,0-12,8175,8060,115,8167,8
2007,Rural,Andhra Pradesh,Crime Against Children,Child Abuse,Male,18-30,2197,577,1620,1619,578
2006,Urban,Gujarat,Property Crime,Burglary,Female,13-17,3290,2913,377,3090,200
2002,Urban,Assam,Crime Against Men,Assault,Female,0-12,7395,3840,3555,7020,375
2005,Rural,West Bengal,Crime Against Men,Robbery,Male,31-45,3209,386,2823,2591,618
2003,Rural,Kerala,Crime Against Children,Child Labor,Female,0-12,4377,1712,2665,2985,1392
2010,Rural,Arunachal Pradesh,Property Crime,Vandalism,Male,0-12,1823,1161,662,1427,396
2001,Urban,Jammu & Kashmir,Property Crime,Vandalism,Male,13-17,199,188,11,194,5
2004,Urban,Punjab,Crime Against Children,Trafficking,Female,13-17,4518,3837,681,4098,420
2010,Urban,Andhra Pradesh,Other Crimes,Drug Offense,Female,60+,8845,3213,5632,8441,404
2005,Rural,Karnataka,Other Crimes,Corruption,Female,46-60,5593,1662,3931,3948,1645
2007,Urban,Assam,Crime Against Men,Murder,Female,31-45,2353,2178,175,2243,110
2001,Rural,Sikkim,Property Crime,Burglary,Male,60+,6688,893,5795,4821,1867
2008,Urban,Jammu & Kashmir,Crime Against Women,Domestic Violence,Female,60+,7930,5073,2857,6286,1644
2005,Rural,Gujarat,Crime Against Children,Child Labor,Female,46-60,7034,2820,4214,6839,195
2002,Urban,Gujarat,Crime Against Children,Child Abuse,Male,18-30,5996,3582,2414,5537,459
2006,Urban,Manipur,Crime Against Children,Trafficking,Female,46-60,7767,7584,183,7594,173
2002,Urban,Sikkim,Property Crime,Vandalism,Male,46-60,7845,6509,1336,7672,173
2005,Rural,Mizoram,Crime Against Men,Assault,Female,18-30,4553,4283,270,4359,194
2005,Urban,Meghalaya,Other Crimes,Drug Offense,Female,0-12,2169,1934,235,2022,147
2010,Rural,Delhi,Crime Against Men,Assault,Male,13-17,1062,55,1007,242,820
2007,Rural,Bihar,Crime Against Women,Dowry Deaths,Female,60+,2643,1491,1152,1962,681
2003,Rural,Jharkhand,Crime Against Women,Domestic Violence,Female,13-17,8899,7220,1679,7638,1261
2002,Urban,Karnataka,Property Crime,Theft,Female,0-12,2777,2179,598,2395,382
2008,Rural,West Bengal,Crime Against Children,Kidnapping,Female,46-60,2140,775,1365,1675,465
2003,Urban,Tripura,Crime Against Women,Molestation,Female,0-12,7924,2047,5877,3996,3928
2002,Rural,Jammu & Kashmir,Crime Against Men,Robbery,Female,0-12,5198,4054,1144,4167,1031
2001,Rural,Manipur,Crime Against Children,Trafficking,Male,60+,7674,3351,4323,7360,314
2009,Urban,Goa,Crime Against Women,Rape,Female,31-45,6444,2977,3467,4975,1469
2007,Urban,Maharashtra,Other Crimes,Drug Offense,Male,13-17,6059,3525,2534,4495,1564
2005,Urban,Punjab,Other Crimes,Drug Offense,Female,46-60,4687,599,4088,3549,1138
2002,Urban,Tamil Nadu,Other Crimes,Fraud,Male,13-17,1184,334,850,802,382
2003,Rural,Nagaland,Crime Against Men,Extortion,Male,46-60,7654,3071,4583,3638,4016
2009,Urban,Nagaland,Property Crime,Theft,Male,31-45,3327,2930,397,3187,140
2004,Rural,Nagaland,Crime Against Children,Child Labor,Male,46-60,540,315,225,506,34
2003,Rural,Telangana,Property Crime,Theft,Male,18-30,6163,3112,3051,5569,594
2006,Urban,Manipur,Crime Against Men,Robbery,Male,18-30,4308,1427,2881,4280,28
2005,Urban,Punjab,Property Crime,Arson,Male,18-30,66,41,25,60,6
2010,Urban,West Bengal,Crime Against Children,Child Abuse,Female,13-17,427,205,222,320,107
2003,Urban,Goa,Crime Against Men,Murder,Female,60+,4368,2877,1491,3988,380
2001,Urban,Uttar Pradesh,Other Crimes,Fraud,Male,13-17,128,93,35,109,19
2008,Rural,Karnataka,Crime Against Men,Murder,Female,13-17,8246,6762,1484,7495,751
2007,Urban,Manipur,Other Crimes,Cyber Crime,Female,60+,9081,794,8287,5300,3781
2006,Rural,Punjab,Property Crime,Burglary,Female,31-45,8648,8639,9,8648,0
2004,Urban,Tamil Nadu,Crime Against Men,Murder,Female,60+,6893,1396,5497,5442,1451
2006,Urban,Arunachal Pradesh,Crime Against Men,Robbery,Female,60+,8297,6931,1366,7909,388
2003,Rural,Sikkim,Crime Against Men,Assault,Female,0-12,6860,3509,3351,5267,1593
2008,Rural,Tripura,Crime Against Men,Assault,Female,46-60,2184,1499,685,1514,670
2003,Rural,Chhattisgarh,Property Crime,Theft,Female,13-17,2128,962,1166,1468,660
2007,Rural,Assam,Crime Against Children,Child Labor,Female,0-12,4067,291,3776,784,3283
2001,Urban,Rajasthan,Crime Against Children,Child Abuse,Female,13-17,9885,8537,1348,9767,118
2003,Rural,Himachal Pradesh,Crime Against Children,Child Labor,Female,31-45,623,210,413,279,344
2002,Rural,Chhattisgarh,Other Crimes,Cyber Crime,Female,31-45,1913,289,1624,687,1226
2008,Urban,Gujarat,Other Crimes,Drug Offense,Female,46-60,4500,2739,1761,4446,54
2010,Rural,Mizoram,Crime Against Women,Dowry Deaths,Female,60+,9820,3988,5832,6800,3020
2002,Rural,Arunachal Pradesh,Property Crime,Burglary,Female,60+,4179,2232,1947,3617,562
2001,Urban,Goa,Crime Against Men,Assault,Female,13-17,1912,1102,810,1420,492
2009,Urban,Gujarat,Other Crimes,Drug Offense,Female,31-45,688,148,540,312,376
2008,Rural,Odisha,Crime Against Children,Child Labor,Male,31-45,872,793,79,850,22
2002,Urban,Assam,Crime Against Children,Child Abuse,Female,31-45,3833,498,3335,832,3001
2009,Urban,Karnataka,Property Crime,Vandalism,Male,18-30,8825,6085,2740,8048,777
2001,Rural,Chhattisgarh,Property Crime,Burglary,Female,18-30,5409,382,5027,1912,3497
2006,Rural,Gujarat,Property Crime,Arson,Female,18-30,1277,13,1264,850,427
2007,Urban,Mizoram,Crime Against Children,Child Labor,Male,13-17,9745,1985,7760,6026,3719
2003,Urban,Rajasthan,Property Crime,Arson,Male,18-30,7406,6894,512,7233,173
2006,Rural,Uttarakhand,Other Crimes,Fraud,Male,0-12,1075,643,432,885,190
2002,Urban,Himachal Pradesh,Crime Against Children,Trafficking,Male,13-17,2110,1315,795,2014,96
2005,Urban,Punjab,Property Crime,Burglary,Male,0-12,1914,269,1645,744,1170
2003,Urban,Delhi,Crime Against Women,Rape,Female,18-30,2025,1275,750,1884,141
2006,Urban,Delhi,Crime Against Men,Assault,Male,46-60,2797,84,2713,2369,428
2003,Urban,Arunachal Pradesh,Crime Against Men,Murder,Female,0-12,6409,1905,4504,5830,579
2005,Rural,Uttarakhand,Crime Against Children,Kidnapping,Female,0-12,3243,1096,2147,2275,968
2001,Rural,Rajasthan,Crime Against Men,Robbery,Female,31-45,7735,4361,3374,4963,2772
2008,Urban,Jammu & Kashmir,Property Crime,Burglary,Male,46-60,8609,1728,6881,8333,276
2001,Rural,Meghalaya,Crime Against Children,Child Labor,Female,0-12,4745,1008,3737,1308,3437
2001,Urban,Andhra Pradesh,Crime Against Children,Trafficking,Female,18-30,1287,654,633,918,369
2007,Rural,Kerala,Crime Against Men,Assault,Female,18-30,9634,6053,3581,8026,1608
2008,Rural,Andhra Pradesh,Crime Against Children,Trafficking,Female,31-45,5081,1823,3258,2880,2201
2006,Rural,Madhya Pradesh,Crime Against Children,Child Abuse,Female,18-30,4412,1785,2627,4152,260
2008,Rural,Chhattisgarh,Property Crime,Burglary,Female,60+,4808,3437,1371,3536,1272
2007,Urban,Maharashtra,Other Crimes,Fraud,Male,46-60,8143,4597,3546,4800,3343
2010,Urban,Meghalaya,Other Crimes,Cyber Crime,Male,31-45,429,9,420,46,383
2006,Urban,Assam,Crime Against Men,Murder,Female,46-60,2436,1005,1431,1783,653
2002,Urban,Gujarat,Other Crimes,Cyber Crime,Male,18-30,3115,2498,617,2898,217
2007,Urban,Tripura,Crime Against Men,Robbery,Male,31-45,3842,2389,1453,2907,935
2008,Urban,Mizoram,Crime Against Men,Robbery,Female,31-45,8444,5991,2453,7463,981
2005,Rural,Uttar Pradesh,Property Crime,Arson,Male,60+,7784,2468,5316,2816,4968
2009,Rural,Odisha,Crime Against Men,Extortion,Male,60+,2502,2020,482,2188,314
2001,Rural,Haryana,Property Crime,Burglary,Male,13-17,8778,7779,999,8606,172
2010,Rural,Meghalaya,Crime Against Men,Extortion,Male,31-45,7669,560,7109,770,6899
2006,Urban,Goa,Crime Against Women,Dowry Deaths,Female,13-17,2228,290,1938,1793,435
2006,Urban,Chhattisgarh,Crime Against Children,Child Abuse,Male,0-12,8534,3507,5027,7604,930
2001,Urban,Odisha,Other Crimes,Drug Offense,Male,46-60,9614,5413,4201,9559,55
2007,Urban,Goa,Property Crime,Burglary,Female,13-17,5600,1971,3629,4990,610
2010,Urban,Meghalaya,Property Crime,Burglary,Male,31-45,6741,4113,2628,6308,433
2003,Urban,Sikkim,Other Crimes,Drug Offense,Female,31-45,4760,2044,2716,4615,145
2007,Urban,Haryana,Crime Against Women,Molestation,Female,0-12,5700,4486,1214,5601,99
2005,Urban,Nagaland,Crime Against Women,Molestation,Female,60+,2068,1227,841,1269,799
2001,Urban,Sikkim,Property Crime,Theft,Female,13-17,2322,241,2081,2161,161
2003,Urban,Jharkhand,Crime Against Children,Kidnapping,Male,18-30,3513,377,3136,1735,1778
2003,Urban,Andhra Pradesh,Other Crimes,Cyber Crime,Male,0-12,6475,3107,3368,5539,936
2002,Rural,Tripura,Crime Against Women,Rape,Female,0-12,4513,3382,1131,3654,859
2004,Urban,Delhi,Other Crimes,Drug Offense,Female,46-60,2318,33,2285,1043,1275
2005,Urban,Tamil Nadu,Crime Against Children,Child Labor,Male,60+,4559,334,4225,4265,294
2002,Rural,Rajasthan,Crime Against Men,Murder,Female,18-30,2504,2237,267,2441,63
2006,Rural,Uttarakhand,Crime Against Men,Extortion,Female,31-45,4447,4405,42,4435,12
2007,Rural,Arunachal Pradesh,Crime Against Women,Dowry Deaths,Male,13-17,1357,925,432,934,423
2002,Rural,Tamil Nadu,Crime Against Children,Child Abuse,Male,13-17,3958,820,3138,3106,852
2008,Rural,Punjab,Crime Against Children,Child Labor,Male,13-17,5446,1940,3506,4279,1167
2005,Urban,Chhattisgarh,Crime Against Men,Robbery,Male,46-60,8961,2730,6231,6412,2549
2007,Rural,Karnataka,Other Crimes,Corruption,Female,31-45,510,255,255,457,53
2009,Rural,Nagaland,Crime Against Children,Child Abuse,Female,18-30,116,62,54,74,42
2004,Rural,Bihar,Other Crimes,Fraud,Female,13-17,6001,955,5046,1620,4381
2003,Urban,Maharashtra,Crime Against Children,Child Labor,Male,0-12,7066,5609,1457,5838,1228
2001,Rural,Tamil Nadu,Other Crimes,Corruption,Male,46-60,2615,894,1721,1320,1295
2006,Rural,Maharashtra,Crime Against Men,Extortion,Female,31-45,384,364,20,372,12
2005,Rural,Mizoram,Crime Against Men,Extortion,Female,46-60,4452,790,3662,1902,2550
2001,Urban,Rajasthan,Property Crime,Arson,Female,18-30,7496,4287,3209,4375,3121
2001,Urban,Delhi,Property Crime,Theft,Male,0-12,1836,1249,587,1566,270
2004,Rural,Haryana,Crime Against Women,Domestic Violence,Female,60+,4358,2674,1684,3455,903
2005,Urban,Punjab,Property Crime,Theft,Male,18-30,2967,2241,726,2288,679
2010,Rural,Telangana,Other Crimes,Drug Offense,Male,13-17,5879,5154,725,5555,324
2010,Urban,Jammu & Kashmir,Property Crime,Theft,Female,31-45,3577,172,3405,2812,765
2009,Urban,Jharkhand,Crime Against Children,Kidnapping,Female,0-12,5038,4827,211,4827,211
2006,Rural,Uttar Pradesh,Crime Against Men,Assault,Female,18-30,6694,256,6438,4727,1967
2010,Urban,Arunachal Pradesh,Property Crime,Arson,Male,60+,8936,1992,6944,3112,5824
2007,Urban,Assam,Property Crime,Theft,Female,18-30,6589,4050,2539,6363,226
2004,Rural,Bihar,Crime Against Men,Robbery,Female,60+,6443,3272,3171,4632,1811
2006,Urban,Goa,Crime Against Children,Child Abuse,Female,13-17,1631,286,1345,752,879
2007,Urban,Madhya Pradesh,Crime Against Women,Molestation,Male,0-12,2994,2519,475,2633,361
2006,Urban,Madhya Pradesh,Other Crimes,Cyber Crime,Male,18-30,8899,2241,6658,4030,4869
2003,Urban,Mizoram,Other Crimes,Drug Offense,Male,31-45,2907,1153,1754,2886,21
2007,Urban,Gujarat,Crime Against Women,Molestation,Female,31-45,827,331,496,615,212
2006,Rural,Manipur,Crime Against Women,Dowry Deaths,Male,46-60,5793,4447,1346,5492,301
2008,Rural,Nagaland,Property Crime,Burglary,Male,46-60,6792,2174,4618,3538,3254
2007,Urban,Chhattisgarh,Crime Against Men,Extortion,Male,46-60,8930,2168,6762,2294,6636
2006,Rural,Himachal Pradesh,Crime Against Women,Dowry Deaths,Male,0-12,439,128,311,301,138
2009,Rural,Tripura,Other Crimes,Corruption,Male,31-45,829,648,181,730,99
2005,Rural,Karnataka,Crime Against Women,Dowry Deaths,Female,0-12,5906,1238,4668,2341,3565
2006,Rural,Manipur,Other Crimes,Fraud,Female,31-45,1924,72,1852,444,1480
2008,Urban,Himachal Pradesh,Crime Against Women,Molestation,Male,0-12,6747,4753,1994,5636,1111
2010,Urban,Odisha,Crime Against Children,Child Abuse,Female,31-45,6573,2479,4094,5687,886
2003,Rural,Maharashtra,Crime Against Children,Trafficking,Female,18-30,8825,5735,3090,6089,2736
2005,Rural,Odisha,Crime Against Men,Murder,Female,13-17,8008,6436,1572,7185,823
2007,Urban,West Bengal,Other Crimes,Corruption,Male,31-45,8794,3623,5171,8060,734
2004,Rural,Tripura,Crime Against Women,Dowry Deaths,Female,0-12,6655,294,6361,3788,2867
2005,Rural,Gujarat,Property Crime,Vandalism,Female,0-12,9731,7818,1913,8983,748
2003,Rural,Maharashtra,Crime Against Women,Dowry Deaths,Female,0-12,77,34,43,45,32
2010,Rural,Maharashtra,Crime Against Children,Kidnapping,Male,0-12,8759,7135,1624,8149,610
2007,Urban,Telangana,Property Crime,Theft,Female,46-60,5847,744,5103,3935,1912
2005,Urban,Meghalaya,Other Crimes,Fraud,Female,18-30,2373,843,1530,1251,1122
2005,Rural,Nagaland,Crime Against Men,Robbery,Female,31-45,6343,5346,997,5427,916
2008,Rural,Nagaland,Crime Against Children,Kidnapping,Female,31-45,7400,3298,4102,3556,3844
2009,Urban,Manipur,Crime Against Men,Robbery,Female,18-30,5512,1111,4401,5489,23
2001,Urban,Tamil Nadu,Other Crimes,Corruption,Male,18-30,6578,1648,4930,4055,2523
2008,Urban,Jammu & Kashmir,Crime Against Children,Kidnapping,Female,13-17,8120,874,7246,1794,6326
2007,Rural,Punjab,Crime Against Men,Assault,Female,60+,7056,2568,4488,6758,298
2006,Rural,Jammu & Kashmir,Crime Against Women,Molestation,Female,31-45,8408,2747,5661,5398,3010
2007,Urban,Uttarakhand,Crime Against Women,Domestic Violence,Male,31-45,2420,1746,674,2050,370
2010,Urban,Uttarakhand,Crime Against Women,Molestation,Female,18-30,7846,6350,1496,7472,374
2008,Rural,Meghalaya,Crime Against Women,Molestation,Female,13-17,7012,3585,3427,6242,770
2008,Rural,Jharkhand,Property Crime,Vandalism,Male,60+,2082,902,1180,1400,682
2010,Rural,Goa,Other Crimes,Corruption,Female,31-45,6418,3116,3302,3323,3095
2010,Urban,Arunachal Pradesh,Crime Against Children,Kidnapping,Female,60+,3103,1821,1282,2536,567
2004,Urban,Madhya Pradesh,Crime Against Women,Dowry Deaths,Female,18-30,4554,1213,3341,4314,240
2004,Urban,Karnataka,Crime Against Men,Assault,Female,60+,8619,4259,4360,7230,1389
2001,Rural,Delhi,Crime Against Men,Assault,Male,13-17,7137,4853,2284,6610,527
2008,Rural,Haryana,Crime Against Women,Domestic Violence,Male,0-12,3395,1416,1979,3246,149
2009,Rural,Karnataka,Crime Against Women,Rape,Male,0-12,7216,5458,1758,6957,259
2007,Urban,Tripura,Crime Against Men,Murder,Male,60+,2359,800,1559,1139,1220
2006,Urban,Mizoram,Crime Against Men,Murder,Male,46-60,8288,4761,3527,7701,587
2010,Rural,Himachal Pradesh,Crime Against Men,Extortion,Male,0-12,1384,641,743,982,402
2001,Rural,Rajasthan,Crime Against Men,Murder,Male,60+,2608,434,2174,1805,803
2001,Rural,Tripura,Other Crimes,Corruption,Male,0-12,5756,4130,1626,5744,12
2007,Urban,Tripura,Crime Against Men,Extortion,Male,60+,2500,532,1968,1270,1230
2006,Rural,Arunachal Pradesh,Property Crime,Arson,Female,13-17,5065,957,4108,4826,239
2003,Rural,Gujarat,Crime Against Children,Child Abuse,Female,60+,7447,1482,5965,2493,4954
2004,Urban,West Bengal,Other Crimes,Drug Offense,Male,13-17,2324,1013,1311,2137,187
2005,Urban,Manipur,Crime Against Children,Child Abuse,Female,13-17,2864,611,2253,2750,114
2001,Rural,Madhya Pradesh,Crime Against Children,Child Abuse,Male,60+,575,525,50,536,39
2008,Rural,Haryana,Property Crime,Burglary,Female,46-60,2970,1613,1357,2966,4
2007,Urban,Karnataka,Property Crime,Arson,Male,18-30,5580,1514,4066,1822,3758
2008,Rural,Haryana,Crime Against Children,Child Abuse,Female,0-12,3745,1785,1960,2584,1161
2009,Rural,Nagaland,Crime Against Men,Robbery,Male,60+,5997,2096,3901,4450,1547
2010,Urban,Uttarakhand,Property Crime,Vandalism,Male,18-30,9877,6366,3511,7413,2464
2005,Rural,Jammu & Kashmir,Crime Against Women,Dowry Deaths,Male,60+,1202,345,857,562,640
2009,Urban,Jharkhand,Property Crime,Theft,Female,31-45,9371,4207,5164,5760,3611
2009,Rural,Assam,Property Crime,Theft,Female,60+,7892,6267,1625,6891,1001
2002,Urban,Punjab,Crime Against Men,Extortion,Male,0-12,9194,8170,1024,8487,707
2002,Rural,Jammu & Kashmir,Other Crimes,Fraud,Male,0-12,6278,2539,3739,2843,3435
2004,Urban,Mizoram,Property Crime,Vandalism,Female,13-17,3975,1567,2408,1993,1982
2008,Urban,Tripura,Crime Against Children,Kidnapping,Female,0-12,3202,721,2481,1010,2192
2006,Rural,Mizoram,Crime Against Women,Rape,Male,18-30,7991,1907,6084,2847,5144
2004,Rural,Assam,Property Crime,Burglary,Male,60+,7358,758,6600,4099,3259
2007,Rural,Delhi,Crime Against Women,Domestic Violence,Male,0-12,2258,577,1681,1091,1167
2002,Rural,Delhi,Crime Against Men,Robbery,Female,18-30,3315,1288,2027,2971,344
2008,Urban,Goa,Property Crime,Theft,Female,31-45,9782,1497,8285,2210,7572
2007,Urban,Tamil Nadu,Crime Against Women,Dowry Deaths,Male,60+,7376,3626,3750,7035,341
2003,Rural,Bihar,Crime Against Men,Assault,Female,31-45,715,671,44,698,17
2001,Rural,Goa,Crime Against Women,Dowry Deaths,Male,0-12,4404,2032,2372,2876,1528
2009,Urban,Arunachal Pradesh,Property Crime,Burglary,Male,0-12,1753,405,1348,928,825
2010,Urban,Haryana,Other Crimes,Cyber Crime,Male,60+,6511,4162,2349,5842,669
2005,Urban,Mizoram,Crime Against Men,Robbery,Female,31-45,5335,533,4802,4741,594
2004,Rural,Punjab,Crime Against Men,Murder,Female,18-30,486,294,192,318,168
2004,Urban,Kerala,Property Crime,Burglary,Female,46-60,365,363,2,364,1
2002,Rural,West Bengal,Property Crime,Vandalism,Female,13-17,8614,8283,331,8453,161
2004,Urban,Gujarat,Crime Against Men,Extortion,Female,46-60,645,173,472,535,110
2006,Rural,Bihar,Crime Against Children,Child Labor,Male,46-60,2197,554,1643,1494,703
2009,Urban,Maharashtra,Crime Against Men,Extortion,Male,0-12,4346,3512,834,3652,694
2007,Rural,Karnataka,Crime Against Women,Dowry Deaths,Female,46-60,3701,1475,2226,3609,92
2002,Urban,Andhra Pradesh,Other Crimes,Drug Offense,Female,60+,9037,8079,958,8243,794
2001,Urban,Himachal Pradesh,Other Crimes,Drug Offense,Male,46-60,6851,5813,1038,6492,359
2004,Urban,Uttar Pradesh,Crime Against Men,Assault,Female,18-30,7366,7162,204,7282,84
2004,Urban,Haryana,Crime Against Men,Assault,Male,18-30,8395,895,7500,5794,2601
2010,Urban,Bihar,Property Crime,Arson,Male,46-60,7140,4423,2717,6368,772
2006,Rural,West Bengal,Other Crimes,Corruption,Male,31-45,4999,4068,931,4921,78
2010,Rural,Uttarakhand,Crime Against Women,Rape,Female,18-30,6513,4951,1562,5077,1436
2001,Urban,Madhya Pradesh,Property Crime,Theft,Female,18-30,7448,6126,1322,6525,923
2007,Urban,Nagaland,Property Crime,Vandalism,Female,18-30,6263,2861,3402,3635,2628
2004,Rural,Himachal Pradesh,Crime Against Women,Rape,Male,18-30,9260,5533,3727,7148,2112
2002,Rural,Sikkim,Crime Against Children,Child Abuse,Male,31-45,9372,9325,47,9335,37
2007,Rural,Delhi,Crime Against Children,Child Abuse,Female,0-12,3763,337,3426,3475,288
2003,Urban,Haryana,Other Crimes,Cyber Crime,Male,60+,1712,33,1679,360,1352
2006,Urban,Madhya Pradesh,Other Crimes,Cyber Crime,Female,31-45,6717,5771,946,6152,565
2010,Urban,Assam,Crime Against Children,Kidnapping,Male,18-30,511,469,42,475,36
2009,Rural,Maharashtra,Crime Against Children,Kidnapping,Male,60+,4594,3114,1480,3875,719
2007,Urban,West Bengal,Crime Against Children,Trafficking,Male,18-30,2298,1984,314,2126,172
2009,Rural,Meghalaya,Property Crime,Arson,Male,18-30,7446,495,6951,2029,5417
2005,Urban,Punjab,Crime Against Women,Rape,Male,31-45,8439,7578,861,7741,698
2006,Rural,Bihar,Crime Against Men,Murder,Female,60+,532,445,87,524,8
2001,Urban,Punjab,Property Crime,Burglary,Female,13-17,9925,6924,3001,7048,2877
2005,Urban,Kerala,Other Crimes,Cyber Crime,Male,18-30,9844,8871,973,9201,643
2008,Rural,Assam,Property Crime,Vandalism,Female,60+,8136,7482,654,7934,202
2008,Rural,Madhya Pradesh,Property Crime,Vandalism,Female,18-30,3332,2451,881,2959,373
2002,Rural,Delhi,Property Crime,Vandalism,Male,31-45,7949,1637,6312,5128,2821
2003,Urban,Jammu & Kashmir,Property Crime,Burglary,Male,46-60,9512,2992,6520,7831,1681
2002,Rural,Goa,Crime Against Men,Assault,Female,18-30,4662,3514,1148,4652,10
2006,Rural,Arunachal Pradesh,Crime Against Men,Robbery,Female,60+,5091,4321,770,4754,337
2006,Rural,Uttar Pradesh,Other Crimes,Fraud,Male,13-17,7115,3224,3891,3499,3616
2001,Rural,West Bengal,Crime Against Men,Assault,Female,13-17,1404,734,670,1053,351
2003,Rural,Rajasthan,Crime Against Women,Domestic Violence,Female,13-17,3903,125,3778,2795,1108
2004,Rural,Chhattisgarh,Crime Against Children,Child Labor,Male,31-45,4762,885,3877,1718,3044
2001,Urban,Meghalaya,Other Crimes,Fraud,Female,60+,8448,2456,5992,3621,4827
2003,Urban,Madhya Pradesh,Property Crime,Vandalism,Male,60+,3054,2457,597,2529,525
2003,Rural,Goa,Property Crime,Theft,Female,13-17,3546,3170,376,3263,283
2006,Urban,Nagaland,Crime Against Women,Molestation,Male,31-45,1154,819,335,1021,133
2004,Urban,Punjab,Crime Against Men,Assault,Female,60+,1334,871,463,1042,292
2008,Rural,Uttarakhand,Property Crime,Theft,Female,0-12,1769,324,1445,649,1120
2002,Urban,Gujarat,Property Crime,Arson,Female,46-60,2623,1776,847,2192,431
2010,Rural,Uttar Pradesh,Crime Against Children,Kidnapping,Male,0-12,5803,5477,326,5605,198
2008,Rural,Tripura,Crime Against Women,Molestation,Male,31-45,7475,4875,2600,7175,300
2007,Urban,Rajasthan,Crime Against Men,Assault,Male,46-60,9887,3443,6444,7748,2139
2001,Urban,Assam,Property Crime,Arson,Male,0-12,9164,3561,5603,6402,2762
2001,Rural,Assam,Other Crimes,Drug Offense,Female,31-45,277,192,85,248,29
2008,Urban,Jammu & Kashmir,Crime Against Children,Child Abuse,Male,60+,4455,2285,2170,2897,1558
2003,Rural,Karnataka,Other Crimes,Drug Offense,Female,46-60,2813,1434,1379,1646,1167
2006,Rural,Telangana,Crime Against Women,Dowry Deaths,Female,13-17,1401,685,716,884,517
2010,Urban,Delhi,Crime Against Women,Rape,Male,13-17,4729,829,3900,2125,2604
2008,Rural,Goa,Crime Against Women,Dowry Deaths,Male,46-60,310,287,23,299,11
2008,Urban,Andhra Pradesh,Other Crimes,Corruption,Female,60+,9747,909,8838,2335,7412
2005,Urban,Nagaland,Crime Against Men,Assault,Female,46-60,796,527,269,568,228
2004,Rural,Rajasthan,Crime Against Children,Child Labor,Female,18-30,7964,5939,2025,7583,381
2010,Rural,Jharkhand,Other Crimes,Drug Offense,Female,18-30,1363,584,779,594,769
2008,Urban,Karnataka,Crime Against Men,Extortion,Female,46-60,8124,5836,2288,6641,1483
2010,Urban,Mizoram,Crime Against Men,Extortion,Female,13-17,2483,2067,416,2294,189
2007,Rural,Himachal Pradesh,Property Crime,Theft,Male,13-17,3767,2894,873,3713,54
2008,Rural,West Bengal,Crime Against Women,Domestic Violence,Female,46-60,9370,970,8400,5661,3709
2008,Rural,Kerala,Property Crime,Vandalism,Male,18-30,5897,937,4960,1384,4513
2001,Urban,Haryana,Property Crime,Arson,Female,31-45,688,284,404,491,197
2006,Rural,Jharkhand,Property Crime,Burglary,Female,0-12,3906,917,2989,2024,1882
2004,Rural,Tamil Nadu,Crime Against Children,Child Abuse,Female,13-17,4180,1162,3018,3573,607
2001,Rural,Telangana,Crime Against Children,Child Labor,Female,0-12,8701,7330,1371,8131,570
2005,Urban,Maharashtra,Other Crimes,Cyber Crime,Female,13-17,2930,2890,40,2924,6
2010,Urban,Kerala,Crime Against Men,Robbery,Female,13-17,8468,2715,5753,4824,3644
2006,Rural,Himachal Pradesh,Crime Against Children,Trafficking,Female,0-12,315,3,312,53,262
2003,Rural,Andhra Pradesh,Crime Against Men,Extortion,Female,0-12,7048,5508,1540,6979,69
2009,Rural,Uttarakhand,Property Crime,Vandalism,Male,60+,6402,5711,691,6111,291
2003,Urban,Jharkhand,Crime Against Men,Assault,Female,60+,882,274,608,569,313
2008,Urban,Meghalaya,Property Crime,Arson,Male,13-17,7805,4035,3770,4881,2924
2007,Rural,Uttar Pradesh,Other Crimes,Corruption,Male,60+,3351,2171,1180,3205,146
2001,Rural,Delhi,Crime Against Men,Extortion,Male,46-60,9765,2800,6965,5549,4216
2009,Rural,Andhra Pradesh,Crime Against Women,Dowry Deaths,Male,0-12,4658,2156,2502,4194,464
2010,Rural,Delhi,Other Crimes,Fraud,Male,18-30,1249,559,690,887,362
2006,Rural,Maharashtra,Crime Against Children,Trafficking,Male,60+,6282,1356,4926,6086,196
2009,Rural,Mizoram,Crime Against Women,Domestic Violence,Male,0-12,4639,832,3807,3684,955
2009,Urban,Karnataka,Crime Against Women,Rape,Male,46-60,2797,596,2201,2346,451
2008,Urban,Tripura,Crime Against Men,Assault,Male,18-30,7307,5155,2152,5805,1502
2002,Urban,Delhi,Crime Against Women,Rape,Male,60+,4219,2133,2086,3325,894
2001,Urban,Nagaland,Crime Against Children,Child Abuse,Female,60+,7786,2273,5513,6596,1190
2007,Urban,Haryana,Property Crime,Vandalism,Male,31-45,3796,3153,643,3447,349
2006,Rural,Mizoram,Property Crime,Burglary,Female,18-30,2657,2556,101,2585,72
2002,Rural,Meghalaya,Crime Against Children,Kidnapping,Female,0-12,3201,1711,1490,1894,1307
2007,Rural,Manipur,Crime Against Men,Extortion,Male,46-60,1234,215,1019,962,272
2006,Urban,Bihar,Property Crime,Theft,Male,46-60,4776,3056,1720,4143,633
2001,Urban,Nagaland,Crime Against Children,Child Labor,Male,31-45,2997,210,2787,697,2300
2010,Rural,Goa,Crime Against Women,Molestation,Male,60+,9293,2367,6926,7306,1987
2008,Urban,Sikkim,Crime Against Women,Dowry Deaths,Male,0-12,5670,589,5081,5301,369
2003,Urban,Maharashtra,Other Crimes,Corruption,Female,31-45,4542,2294,2248,3574,968
2010,Rural,Sikkim,Property Crime,Arson,Male,31-45,1551,334,1217,756,795
2002,Rural,Goa,Crime Against Children,Child Abuse,Female,18-30,7113,5387,1726,5467,1646
2001,Urban,Uttar Pradesh,Crime Against Children,Child Labor,Male,31-45,8246,1587,6659,2657,5589
2006,Urban,Kerala,Crime Against Women,Dowry Deaths,Male,31-45,7784,1578,6206,2978,4806
2002,Urban,Kerala,Crime Against Men,Extortion,Male,60+,8779,5077,3702,6975,1804
2002,Urban,Goa,Crime Against Children,Kidnapping,Male,0-12,85,1,84,36,49
2009,Urban,Jammu & Kashmir,Crime Against Women,Molestation,Female,31-45,4653,1696,2957,3826,827
2010,Urban,Assam,Crime Against Children,Trafficking,Male,18-30,3498,2949,549,3301,197
2006,Rural,Telangana,Crime Against Women,Domestic Violence,Female,46-60,9030,5511,3519,5965,3065
2004,Urban,Odisha,Crime Against Women,Rape,Male,31-45,224,216,8,217,7
2009,Urban,Goa,Property Crime,Arson,Female,0-12,267,160,107,188,79
2006,Urban,Uttar Pradesh,Property Crime,Burglary,Female,13-17,4618,24,4594,4461,157
2010,Rural,Odisha,Crime Against Men,Robbery,Female,0-12,5192,1537,3655,2186,3006
2004,Rural,Andhra Pradesh,Crime Against Men,Assault,Male,18-30,3546,2663,883,3105,441
2006,Urban,Sikkim,Crime Against Men,Murder,Male,18-30,9247,7924,1323,8424,823
2007,Urban,Assam,Crime Against Women,Dowry Deaths,Male,46-60,7369,4997,2372,6267,1102
2001,Urban,Haryana,Other Crimes,Cyber Crime,Female,46-60,6021,1735,4286,3498,2523
2007,Rural,Himachal Pradesh,Property Crime,Vandalism,Female,18-30,6254,3741,2513,4177,2077
2007,Urban,Jharkhand,Crime Against Children,Kidnapping,Female,18-30,3524,2481,1043,3318,206
2006,Rural,Punjab,Other Crimes,Cyber Crime,Female,18-30,4714,3773,941,4578,136
2002,Rural,Jharkhand,Crime Against Children,Child Labor,Female,31-45,7117,4580,2537,6877,240
2006,Rural,Uttarakhand,Crime Against Women,Rape,Male,18-30,6063,5437,626,5541,522
2003,Urban,Tripura,Crime Against Women,Domestic Violence,Male,18-30,1590,769,821,1403,187
2001,Rural,Jammu & Kashmir,Other Crimes,Drug Offense,Male,18-30,2202,35,2167,2056,146
2001,Rural,Madhya Pradesh,Other Crimes,Drug Offense,Female,18-30,3467,2711,756,3403,64
2006,Urban,Gujarat,Property Crime,Vandalism,Male,18-30,6291,3134,3157,4398,1893
2006,Urban,Tripura,Crime Against Children,Trafficking,Male,31-45,6659,1727,4932,6352,307
2004,Urban,Himachal Pradesh,Other Crimes,Drug Offense,Female,18-30,1243,595,648,1047,196
2001,Urban,Maharashtra,Crime Against Children,Kidnapping,Female,31-45,4644,21,4623,4454,190
2002,Urban,Haryana,Crime Against Women,Domestic Violence,Female,60+,4506,3945,561,4283,223
2008,Urban,Jharkhand,Other Crimes,Cyber Crime,Male,31-45,4806,3882,924,4663,143
2010,Urban,Jharkhand,Crime Against Women,Domestic Violence,Male,13-17,68,20,48,43,25
2004,Urban,Chhattisgarh,Crime Against Women,Dowry Deaths,Female,46-60,3846,2132,1714,2547,1299
2003,Rural,Kerala,Other Crimes,Fraud,Male,60+,6217,5896,321,5908,309
2005,Urban,Maharashtra,Crime Against Women,Dowry Deaths,Female,0-12,121,96,25,116,5
2006,Rural,Delhi,Crime Against Women,Rape,Female,0-12,4020,957,3063,2909,1111
2003,Rural,Kerala,Crime Against Women,Dowry Deaths,Male,31-45,6621,4669,1952,5311,1310
2007,Rural,Karnataka,Other Crimes,Fraud,Female,60+,9519,315,9204,654,8865
2009,Rural,Uttar Pradesh,Other Crimes,Fraud,Female,18-30,8853,2717,6136,3961,4892
2002,Rural,Madhya Pradesh,Crime Against Women,Domestic Violence,Female,60+,9902,6004,3898,6282,3620
2005,Rural,Chhattisgarh,Crime Against Women,Rape,Female,31-45,8793,2162,6631,7428,1365
2005,Urban,Telangana,Crime Against Men,Murder,Male,0-12,6798,910,5888,2379,4419
2005,Urban,Arunachal Pradesh,Crime Against Men,Extortion,Female,18-30,7527,4333,3194,4875,2652
2010,Rural,Maharashtra,Property Crime,Vandalism,Male,46-60,4515,1582,2933,3759,756
2005,Urban,Odisha,Crime Against Children,Child Abuse,Female,31-45,4991,1731,3260,3622,1369
2009,Urban,Sikkim,Crime Against Men,Robbery,Male,60+,1179,442,737,533,646
2005,Rural,Nagaland,Crime Against Women,Molestation,Female,18-30,881,213,668,526,355
2004,Urban,Sikkim,Crime Against Women,Rape,Male,31-45,3309,1416,1893,1685,1624
2008,Rural,Haryana,Property Crime,Vandalism,Male,31-45,580,267,313,439,141
2003,Urban,Tamil Nadu,Crime Against Women,Molestation,Female,13-17,5901,3813,2088,4250,1651
2009,Urban,Jharkhand,Crime Against Women,Molestation,Female,0-12,5229,2791,2438,4297,932
2005,Urban,Punjab,Crime Against Women,Rape,Female,18-30,525,295,230,500,25
2010,Rural,Karnataka,Other Crimes,Corruption,Female,18-30,2117,1529,588,1871,246
2009,Urban,Maharashtra,Other Crimes,Drug Offense,Male,31-45,5435,1894,3541,2545,2890
2007,Rural,Arunachal Pradesh,Property Crime,Burglary,Male,31-45,192,99,93,168,24
2001,Urban,Bihar,Crime Against Women,Rape,Male,0-12,1183,389,794,871,312
2001,Urban,Uttar Pradesh,Property Crime,Vandalism,Male,46-60,6249,1010,5239,4095,2154
2003,Rural,Himachal Pradesh,Crime Against Men,Murder,Female,46-60,4054,2342,1712,2776,1278
2008,Rural,Gujarat,Other Crimes,Corruption,Male,13-17,7854,2713,5141,4898,2956
2009,Urban,Arunachal Pradesh,Other Crimes,Fraud,Female,13-17,1044,979,65,989,55
2002,Urban,Mizoram,Crime Against Men,Murder,Female,31-45,4806,2725,2081,3670,1136
2001,Rural,Delhi,Crime Against Children,Child Abuse,Female,60+,8701,4132,4569,5485,3216
2006,Rural,Telangana,Property Crime,Theft,Male,13-17,4463,1033,3430,1366,3097
2006,Rural,Sikkim,Property Crime,Arson,Male,31-45,277,204,73,215,62
2005,Urban,West Bengal,Crime Against Women,Rape,Male,0-12,3082,2180,902,2393,689
2003,Rural,Maharashtra,Property Crime,Theft,Male,46-60,6161,5668,493,5747,414
2003,Rural,Nagaland,Crime Against Children,Child Abuse,Male,46-60,4823,3648,1175,4406,417
2001,Rural,Meghalaya,Property Crime,Vandalism,Female,60+,8949,6466,2483,6903,2046
2004,Rural,Maharashtra,Crime Against Men,Assault,Female,46-60,6336,3686,2650,5308,1028
2004,Urban,Arunachal Pradesh,Property Crime,Vandalism,Female,0-12,4363,2249,2114,3248,1115
2006,Rural,Arunachal Pradesh,Crime Against Men,Murder,Male,60+,4373,3880,493,4317,56
2003,Rural,Haryana,Property Crime,Vandalism,Male,18-30,5456,2855,2601,4449,1007
2010,Rural,Rajasthan,Crime Against Women,Rape,Male,31-45,2377,2223,154,2291,86
2007,Urban,Kerala,Crime Against Children,Kidnapping,Male,46-60,6948,5112,1836,6454,494
2007,Rural,Maharashtra,Crime Against Men,Assault,Female,18-30,8593,923,7670,1965,6628
2006,Rural,Gujarat,Crime Against Children,Child Labor,Female,18-30,1624,1057,567,1162,462
2010,Rural,Haryana,Other Crimes,Corruption,Female,60+,155,80,75,97,58
2005,Rural,Chhattisgarh,Crime Against Women,Dowry Deaths,Female,0-12,8521,7616,905,7792,729
2008,Urban,Maharashtra,Other Crimes,Fraud,Male,31-45,9552,4443,5109,4941,4611
2009,Rural,Manipur,Crime Against Children,Trafficking,Female,46-60,2753,781,1972,1897,856
2002,Urban,Jammu & Kashmir,Crime Against Men,Murder,Male,31-45,6516,4456,2060,4933,1583
2002,Urban,West Bengal,Other Crimes,Corruption,Female,0-12,9235,594,8641,6722,2513
2007,Rural,Arunachal Pradesh,Crime Against Men,Murder,Male,18-30,256,159,97,203,53
2003,Rural,Kerala,Crime Against Men,Murder,Male,60+,1203,23,1180,87,1116
2003,Urban,Uttar Pradesh,Crime Against Women,Rape,Female,18-30,6181,1512,4669,5186,995
2002,Urban,Arunachal Pradesh,Property Crime,Arson,Female,0-12,130,82,48,94,36
2002,Urban,Goa,Property Crime,Arson,Male,18-30,5242,1602,3640,2043,3199
2003,Rural,Madhya Pradesh,Other Crimes,Corruption,Female,18-30,2670,1621,1049,1904,766
2008,Rural,Delhi,Crime Against Men,Murder,Female,46-60,7240,5234,2006,6801,439
2005,Rural,Delhi,Crime Against Children,Kidnapping,Male,60+,6940,5710,1230,6508,432
2009,Urban,West Bengal,Other Crimes,Fraud,Female,60+,5012,4207,805,4966,46
2002,Urban,Arunachal Pradesh,Other Crimes,Fraud,Male,0-12,4512,3841,671,4375,137
2003,Urban,Arunachal Pradesh,Crime Against Women,Dowry Deaths,Male,31-45,8207,6177,2030,7074,1133
2009,Rural,Gujarat,Crime Against Children,Child Labor,Female,13-17,8748,5424,3324,7934,814
2008,Rural,Bihar,Crime Against Women,Rape,Female,0-12,7149,4352,2797,5938,1211
2002,Urban,Karnataka,Crime Against Women,Dowry Deaths,Male,13-17,939,516,423,645,294
2003,Rural,Kerala,Crime Against Children,Child Labor,Female,31-45,998,222,776,311,687
2002,Rural,Andhra Pradesh,Crime Against Men,Robbery,Female,0-12,1202,543,659,956,246
2004,Urban,Manipur,Property Crime,Vandalism,Male,31-45,5471,2680,2791,3351,2120
2008,Rural,Telangana,Crime Against Children,Kidnapping,Male,18-30,8889,8053,836,8758,131
2009,Urban,Gujarat,Other Crimes,Corruption,Female,60+,4350,826,3524,3032,1318
2006,Rural,Kerala,Crime Against Children,Child Abuse,Male,60+,5426,1949,3477,2153,3273
2003,Rural,Delhi,Property Crime,Arson,Female,46-60,7526,3197,4329,5727,1799
2009,Urban,Tamil Nadu,Other Crimes,Cyber Crime,Male,0-12,2801,2243,558,2764,37
2009,Urban,Goa,Crime Against Children,Kidnapping,Male,31-45,620,277,343,357,263
2007,Rural,Goa,Property Crime,Arson,Male,18-30,1033,889,144,1009,24
2008,Urban,Uttar Pradesh,Property Crime,Vandalism,Female,31-45,9096,8110,986,8463,633
2001,Rural,Bihar,Property Crime,Arson,Male,60+,3479,2207,1272,2534,945
2008,Rural,Uttarakhand,Other Crimes,Cyber Crime,Male,31-45,583,184,399,340,243
2006,Rural,Arunachal Pradesh,Crime Against Children,Child Labor,Male,46-60,5343,3717,1626,4773,570
2008,Urban,West Bengal,Other Crimes,Corruption,Male,0-12,1601,1584,17,1584,17
2008,Urban,Sikkim,Crime Against Children,Trafficking,Female,46-60,1872,1179,693,1767,105
2009,Urban,Maharashtra,Crime Against Children,Child Abuse,Male,13-17,3295,290,3005,1077,2218
2006,Urban,Bihar,Crime Against Children,Child Abuse,Male,13-17,584,185,399,481,103
2003,Urban,Chhattisgarh,Other Crimes,Fraud,Male,0-12,5656,2427,3229,3753,1903
2003,Urban,Goa,Property Crime,Vandalism,Male,18-30,1883,780,1103,1479,404
2009,Rural,Arunachal Pradesh,Crime Against Children,Child Abuse,Female,18-30,8665,4886,3779,5782,2883
2003,Urban,West Bengal,Other Crimes,Drug Offense,Male,18-30,5227,1385,3842,2464,2763
2010,Rural,West Bengal,Other Crimes,Corruption,Male,46-60,6397,1161,5236,2820,3577
2002,Rural,Bihar,Crime Against Men,Extortion,Female,46-60,2289,1340,949,1635,654
2008,Urban,Andhra Pradesh,Crime Against Men,Assault,Female,0-12,4737,323,4414,1158,3579
2002,Urban,Punjab,Crime Against Women,Domestic Violence,Male,60+,3965,2627,1338,3846,119
2010,Urban,Jammu & Kashmir,Crime Against Men,Extortion,Female,31-45,8515,2808,5707,7716,799
2004,Rural,Mizoram,Crime Against Men,Murder,Male,31-45,9027,6845,2182,7093,1934
2002,Rural,Goa,Property Crime,Burglary,Female,0-12,7994,6317,1677,7768,226
2009,Urban,Uttar Pradesh,Other Crimes,Fraud,Male,46-60,1010,358,652,604,406
2006,Urban,Tamil Nadu,Other Crimes,Corruption,Male,60+,5147,3208,1939,3689,1458
2008,Rural,Odisha,Crime Against Children,Kidnapping,Male,0-12,9199,2908,6291,3988,5211
2002,Rural,Uttar Pradesh,Crime Against Women,Rape,Female,18-30,2127,1075,1052,1882,245
2004,Rural,Madhya Pradesh,Crime Against Women,Molestation,Female,0-12,2930,89,2841,2254,676
2006,Rural,Assam,Property Crime,Vandalism,Male,46-60,6981,4717,2264,5290,1691
2003,Rural,Bihar,Crime Against Men,Extortion,Female,13-17,1392,955,437,1137,255
2004,Urban,Mizoram,Crime Against Children,Trafficking,Female,13-17,1395,1392,3,1392,3
2005,Rural,Maharashtra,Crime Against Men,Robbery,Male,60+,3744,934,2810,2741,1003
2002,Urban,Maharashtra,Crime Against Women,Dowry Deaths,Male,31-45,6507,2565,3942,5472,1035
2009,Rural,Odisha,Other Crimes,Cyber Crime,Female,18-30,5259,599,4660,5170,89
2010,Urban,Gujarat,Crime Against Children,Trafficking,Female,18-30,5120,2090,3030,5005,115
2002,Urban,Punjab,Other Crimes,Fraud,Female,31-45,8876,1821,7055,4029,4847
2009,Urban,Tamil Nadu,Property Crime,Arson,Female,46-60,2290,2085,205,2101,189
2005,Rural,Arunachal Pradesh,Crime Against Men,Robbery,Female,60+,9925,8105,1820,8219,1706
2009,Rural,Tripura,Crime Against Women,Rape,Female,60+,981,784,197,875,106
2009,Urban,Meghalaya,Other Crimes,Drug Offense,Female,46-60,5073,3378,1695,3655,1418
2007,Urban,Bihar,Crime Against Women,Molestation,Male,60+,569,349,220,389,180
2008,Urban,West Bengal,Crime Against Men,Murder,Female,13-17,4773,119,4654,527,4246
2003,Urban,Manipur,Crime Against Men,Assault,Female,18-30,1377,343,1034,1174,203
2004,Rural,Bihar,Other Crimes,Corruption,Male,13-17,1085,910,175,1009,76
2009,Rural,Telangana,Other Crimes,Cyber Crime,Male,0-12,7638,2433,5205,3489,4149
2005,Urban,West Bengal,Crime Against Men,Murder,Female,18-30,1313,1293,20,1309,4
2005,Urban,Andhra Pradesh,Crime Against Men,Assault,Male,46-60,7345,1131,6214,5235,2110
2001,Urban,Jammu & Kashmir,Crime Against Men,Extortion,Male,46-60,1072,537,535,722,350
2007,Rural,Maharashtra,Property Crime,Vandalism,Female,31-45,7596,4781,2815,6510,1086
2010,Urban,Uttar Pradesh,Crime Against Men,Murder,Male,18-30,571,394,177,447,124
2010,Urban,Chhattisgarh,Property Crime,Burglary,Male,31-45,2371,866,1505,1094,1277
2008,Urban,Chhattisgarh,Other Crimes,Fraud,Male,13-17,550,369,181,464,86
2003,Rural,Karnataka,Property Crime,Arson,Male,0-12,5844,3518,2326,3661,2183
2002,Urban,Madhya Pradesh,Property Crime,Arson,Female,60+,6038,3244,2794,4290,1748
2006,Rural,Bihar,Crime Against Men,Murder,Female,46-60,5608,1259,4349,1398,4210
2002,Urban,Haryana,Crime Against Children,Kidnapping,Female,0-12,9739,3112,6627,5950,3789
2001,Rural,Odisha,Property Crime,Vandalism,Female,13-17,5721,208,5513,5332,389
2003,Urban,Gujarat,Crime Against Women,Domestic Violence,Male,46-60,5362,890,4472,4737,625
2005,Urban,Punjab,Other Crimes,Corruption,Male,46-60,1580,1381,199,1544,36
2010,Urban,Meghalaya,Crime Against Men,Extortion,Female,18-30,1630,816,814,1067,563
2010,Urban,Tripura,Other Crimes,Cyber Crime,Female,46-60,466,263,203,384,82
2003,Urban,Jharkhand,Crime Against Men,Murder,Male,13-17,3479,545,2934,2700,779
2008,Rural,Bihar,Crime Against Women,Molestation,Male,46-60,6019,4483,1536,5617,402
2004,Urban,Karnataka,Crime Against Children,Trafficking,Female,31-45,7551,4791,2760,5728,1823
2009,Urban,Tamil Nadu,Crime Against Men,Assault,Female,31-45,1758,523,1235,1142,616
2003,Urban,Madhya Pradesh,Crime Against Men,Robbery,Male,31-45,4596,4023,573,4270,326
2004,Urban,Kerala,Other Crimes,Corruption,Male,0-12,177,89,88,129,48
2009,Rural,Andhra Pradesh,Crime Against Women,Dowry Deaths,Male,46-60,5550,802,4748,3561,1989
2008,Rural,Himachal Pradesh,Crime Against Children,Kidnapping,Male,60+,6652,3722,2930,5225,1427
2008,Rural,Himachal Pradesh,Crime Against Men,Extortion,Female,60+,8541,8124,417,8462,79
2010,Rural,Uttar Pradesh,Crime Against Men,Assault,Male,13-17,4226,3023,1203,3956,270
2004,Rural,Karnataka,Crime Against Children,Trafficking,Female,18-30,9514,748,8766,7705,1809
2001,Rural,Haryana,Property Crime,Burglary,Male,0-12,939,661,278,801,138
2003,Rural,Bihar,Property Crime,Theft,Male,18-30,3112,2829,283,3107,5
2001,Urban,Tripura,Crime Against Women,Molestation,Male,0-12,5043,3711,1332,4097,946
2005,Rural,Karnataka,Crime Against Children,Child Abuse,Male,18-30,9538,4031,5507,6736,2802
2005,Rural,Uttar Pradesh,Crime Against Children,Child Labor,Male,31-45,7309,4830,2479,4843,2466
2002,Rural,Madhya Pradesh,Property Crime,Arson,Female,18-30,4670,4430,240,4669,1
2003,Urban,Himachal Pradesh,Crime Against Women,Domestic Violence,Female,13-17,5182,4192,990,4868,314
2002,Rural,Telangana,Crime Against Women,Dowry Deaths,Male,60+,194,34,160,140,54
2001,Urban,Punjab,Crime Against Children,Trafficking,Female,13-17,2817,831,1986,1497,1320
2006,Urban,Delhi,Crime Against Men,Murder,Male,46-60,3002,214,2788,905,2097
2001,Rural,Manipur,Crime Against Women,Domestic Violence,Female,60+,4340,1511,2829,2211,2129
2001,Rural,Kerala,Property Crime,Vandalism,Male,18-30,6345,3836,2509,3840,2505
2006,Urban,Tamil Nadu,Property Crime,Burglary,Male,46-60,2714,570,2144,584,2130
2007,Rural,Jharkhand,Crime Against Children,Kidnapping,Female,0-12,6842,4805,2037,6237,605
2010,Urban,Delhi,Crime Against Men,Assault,Female,46-60,1176,1007,169,1096,80
2007,Urban,Manipur,Crime Against Children,Child Labor,Female,18-30,8486,6954,1532,7939,547
2003,Rural,Chhattisgarh,Crime Against Women,Domestic Violence,Male,13-17,775,38,737,481,294
2007,Rural,Haryana,Crime Against Children,Child Labor,Female,18-30,4766,1346,3420,4128,638
2009,Rural,Haryana,Crime Against Men,Extortion,Male,46-60,2602,393,2209,2132,470
2005,Rural,West Bengal,Property Crime,Arson,Female,60+,805,546,259,627,178
2007,Urban,Nagaland,Property Crime,Burglary,Male,31-45,8630,1371,7259,7142,1488
2008,Rural,Goa,Other Crimes,Corruption,Male,60+,8869,712,8157,3073,5796
2005,Rural,Goa,Property Crime,Theft,Male,60+,3812,267,3545,1904,1908
2009,Urban,Uttarakhand,Crime Against Men,Murder,Female,60+,9870,111,9759,294,9576
2010,Rural,Haryana,Crime Against Men,Extortion,Female,0-12,1791,896,895,1658,133
2006,Rural,Meghalaya,Other Crimes,Corruption,Male,46-60,2323,2187,136,2267,56
2006,Rural,Chhattisgarh,Crime Against Women,Rape,Male,18-30,5442,3820,1622,3954,1488
2009,Rural,Tamil Nadu,Property Crime,Vandalism,Female,60+,2716,636,2080,800,1916
2003,Urban,Meghalaya,Crime Against Men,Robbery,Female,18-30,7605,6055,1550,7345,260
2010,Rural,Delhi,Crime Against Women,Molestation,Female,18-30,4859,3359,1500,4691,168
2004,Urban,Uttarakhand,Other Crimes,Drug Offense,Male,31-45,9607,6437,3170,8343,1264
2007,Rural,Meghalaya,Property Crime,Arson,Male,13-17,3099,1673,1426,2055,1044
2008,Rural,Delhi,Property Crime,Arson,Male,31-45,4855,4610,245,4725,130
2002,Rural,Telangana,Crime Against Women,Molestation,Male,60+,2194,200,1994,1329,865
2005,Rural,Tamil Nadu,Property Crime,Burglary,Female,46-60,6319,5916,403,6042,277
2005,Rural,Assam,Crime Against Men,Assault,Male,60+,8667,8552,115,8629,38
2008,Urban,Telangana,Crime Against Men,Murder,Male,46-60,6742,1713,5029,5428,1314
2007,Rural,Rajasthan,Crime Against Children,Kidnapping,Male,0-12,6048,4147,1901,4396,1652
2003,Rural,Maharashtra,Crime Against Women,Molestation,Male,31-45,7937,2391,5546,6940,997
2004,Rural,Tamil Nadu,Crime Against Women,Molestation,Female,60+,9312,7290,2022,9013,299
2009,Urban,Kerala,Crime Against Men,Extortion,Male,0-12,4867,1651,3216,4250,617
2007,Urban,Gujarat,Crime Against Men,Extortion,Female,18-30,1235,455,780,506,729
2008,Urban,Uttar Pradesh,Crime Against Women,Domestic Violence,Male,18-30,9833,8858,975,9590,243
2004,Urban,Gujarat,Other Crimes,Cyber Crime,Female,0-12,4935,3928,1007,4780,155
2004,Rural,Andhra Pradesh,Other Crimes,Cyber Crime,Female,31-45,404,289,115,364,40
2001,Rural,Kerala,Property Crime,Vandalism,Female,18-30,7186,1377,5809,4974,2212
2006,Urban,Himachal Pradesh,Crime Against Children,Child Abuse,Male,46-60,5010,3654,1356,4982,28
2003,Urban,Nagaland,Crime Against Men,Murder,Male,13-17,5315,178,5137,4457,858
2004,Urban,Goa,Crime Against Men,Murder,Male,13-17,5063,607,4456,1947,3116
2009,Urban,Rajasthan,Crime Against Men,Extortion,Female,13-17,5441,2275,3166,3914,1527
2007,Urban,Manipur,Crime Against Children,Trafficking,Female,31-45,4169,82,4087,2168,2001
2006,Urban,Bihar,Crime Against Men,Robbery,Female,46-60,4361,672,3689,2274,2087
2007,Rural,Gujarat,Crime Against Children,Trafficking,Male,46-60,3094,1239,1855,2493,601
2006,Urban,Jammu & Kashmir,Crime Against Women,Molestation,Male,46-60,9200,6699,2501,8130,1070
2009,Rural,Odisha,Property Crime,Theft,Male,31-45,8942,2007,6935,7860,1082
2002,Urban,Odisha,Property Crime,Burglary,Male,31-45,5240,1857,3383,4232,1008
2005,Rural,Himachal Pradesh,Other Crimes,Corruption,Female,18-30,8756,6819,1937,7231,1525
2004,Urban,Mizoram,Property Crime,Theft,Male,0-12,8442,4713,3729,6142,2300
2002,Urban,Sikkim,Property Crime,Vandalism,Female,60+,2368,822,1546,2107,261
2004,Rural,Chhattisgarh,Crime Against Children,Trafficking,Male,13-17,6991,2145,4846,2400,4591
2005,Urban,Sikkim,Property Crime,Vandalism,Female,0-12,5752,5713,39,5729,23
2004,Rural,Uttar Pradesh,Property Crime,Theft,Male,31-45,6731,4120,2611,6597,134
2001,Urban,Andhra Pradesh,Crime Against Women,Dowry Deaths,Male,0-12,2115,1207,908,1374,741
2002,Rural,Rajasthan,Property Crime,Arson,Male,0-12,6698,5737,961,5910,788
2009,Urban,Madhya Pradesh,Crime Against Women,Dowry Deaths,Female,18-30,777,608,169,612,165
2008,Urban,Nagaland,Crime Against Children,Kidnapping,Female,0-12,9433,1011,8422,6279,3154
2009,Rural,Manipur,Crime Against Men,Assault,Male,0-12,1581,1262,319,1377,204
2010,Rural,Nagaland,Other Crimes,Cyber Crime,Female,46-60,503,55,448,429,74
2007,Urban,Goa,Crime Against Women,Dowry Deaths,Male,13-17,676,451,225,652,24
2001,Rural,Telangana,Other Crimes,Drug Offense,Male,31-45,1110,332,778,670,440
2004,Urban,Bihar,Other Crimes,Cyber Crime,Male,60+,199,143,56,186,13
2001,Urban,Odisha,Other Crimes,Corruption,Male,46-60,1905,291,1614,412,1493
2010,Urban,Himachal Pradesh,Crime Against Women,Rape,Male,13-17,821,745,76,784,37
2008,Rural,Haryana,Crime Against Men,Robbery,Male,18-30,4940,931,4009,2111,2829
2010,Rural,Jammu & Kashmir,Crime Against Men,Extortion,Male,18-30,3843,314,3529,2041,1802
2010,Urban,Himachal Pradesh,Crime Against Women,Dowry Deaths,Male,46-60,1456,468,988,605,851
2001,Rural,Tripura,Crime Against Children,Kidnapping,Female,18-30,6950,6337,613,6451,499
2003,Urban,Punjab,Property Crime,Theft,Male,46-60,1961,1250,711,1332,629
2009,Rural,Tripura,Property Crime,Arson,Male,13-17,888,391,497,589,299
2007,Urban,Odisha,Crime Against Children,Kidnapping,Female,18-30,654,351,303,456,198
2010,Rural,Andhra Pradesh,Crime Against Women,Molestation,Female,60+,2711,207,2504,2008,703
2008,Urban,Chhattisgarh,Crime Against Men,Assault,Male,60+,4615,3867,748,4011,604
2006,Rural,Uttarakhand,Crime Against Men,Extortion,Female,31-45,8228,6051,2177,6902,1326
2007,Rural,Rajasthan,Crime Against Men,Assault,Male,18-30,1058,130,928,480,578
2010,Rural,Telangana,Crime Against Children,Kidnapping,Male,18-30,1481,1015,466,1374,107
2007,Urban,Uttar Pradesh,Property Crime,Theft,Female,13-17,4004,2434,1570,3853,151
2008,Urban,Himachal Pradesh,Crime Against Children,Trafficking,Male,31-45,8644,7088,1556,7142,1502
2006,Urban,Karnataka,Other Crimes,Drug Offense,Female,60+,4449,907,3542,1120,3329
2004,Urban,Uttarakhand,Crime Against Men,Robbery,Male,0-12,2236,580,1656,2206,30
2008,Rural,Goa,Crime Against Women,Domestic Violence,Female,13-17,5640,2670,2970,2903,2737
2003,Urban,Goa,Crime Against Men,Extortion,Female,60+,6561,6030,531,6356,205
2005,Rural,Madhya Pradesh,Property Crime,Arson,Female,31-45,499,470,29,493,6
2003,Urban,Rajasthan,Property Crime,Burglary,Male,46-60,7297,1321,5976,5870,1427
2010,Urban,Madhya Pradesh,Crime Against Children,Child Abuse,Female,31-45,2920,542,2378,1457,1463
2003,Urban,Nagaland,Crime Against Women,Molestation,Female,46-60,8952,1954,6998,5602,3350
2006,Rural,West Bengal,Crime Against Women,Rape,Male,60+,3811,2700,1111,3314,497
2006,Rural,Telangana,Property Crime,Theft,Female,13-17,9822,6657,3165,7285,2537
2001,Urban,Assam,Other Crimes,Corruption,Male,60+,9963,6186,3777,6979,2984
2010,Urban,Bihar,Crime Against Men,Extortion,Female,0-12,5076,1613,3463,3586,1490
2003,Urban,Nagaland,Property Crime,Burglary,Male,31-45,3879,3368,511,3395,484
2001,Rural,Maharashtra,Crime Against Children,Child Abuse,Female,0-12,8810,423,8387,1301,7509
2002,Rural,Madhya Pradesh,Property Crime,Burglary,Male,0-12,2035,1506,529,1769,266
2004,Urban,Chhattisgarh,Crime Against Men,Assault,Male,31-45,6107,2354,3753,5736,371
2001,Rural,Rajasthan,Crime Against Men,Assault,Male,0-12,3881,3247,634,3814,67
2002,Urban,Nagaland,Property Crime,Theft,Male,60+,9484,1244,8240,3863,5621
2006,Rural,Gujarat,Crime Against Men,Extortion,Male,46-60,6193,2958,3235,5023,1170
2008,Urban,Jharkhand,Crime Against Women,Domestic Violence,Female,60+,7064,5401,1663,6315,749
2004,Rural,Himachal Pradesh,Property Crime,Burglary,Male,18-30,9494,146,9348,3843,5651
2005,Urban,Karnataka,Property Crime,Burglary,Male,46-60,6118,5496,622,5792,326
2001,Urban,Manipur,Crime Against Women,Domestic Violence,Female,46-60,4909,2386,2523,3976,933
2008,Urban,Punjab,Crime Against Women,Rape,Female,46-60,4105,2784,1321,2830,1275
2009,Rural,Odisha,Other Crimes,Corruption,Female,0-12,3527,1660,1867,3304,223
2007,Urban,Madhya Pradesh,Crime Against Men,Assault,Female,60+,8489,291,8198,7421,1068
2010,Rural,Tamil Nadu,Crime Against Children,Child Abuse,Male,31-45,2668,1841,827,2166,502
2005,Rural,Rajasthan,Crime Against Women,Domestic Violence,Female,60+,144,81,63,131,13
2008,Rural,Jammu & Kashmir,Crime Against Women,Rape,Female,13-17,52,15,37,45,7
2005,Rural,Andhra Pradesh,Other Crimes,Cyber Crime,Male,31-45,987,308,679,804,183
2001,Rural,Manipur,Crime Against Women,Molestation,Female,13-17,7282,2246,5036,2765,4517
2009,Urban,Karnataka,Other Crimes,Corruption,Female,31-45,9525,6487,3038,6551,2974
2007,Urban,Odisha,Other Crimes,Corruption,Female,46-60,2455,331,2124,1257,1198
2010,Rural,Punjab,Property Crime,Vandalism,Female,46-60,674,459,215,488,186
2007,Rural,Uttar Pradesh,Property Crime,Vandalism,Male,18-30,3465,1090,2375,2290,1175
2008,Urban,Telangana,Other Crimes,Corruption,Male,18-30,1088,1037,51,1053,35
2003,Urban,Delhi,Crime Against Women,Dowry Deaths,Male,31-45,8838,3734,5104,8452,386
2001,Rural,Arunachal Pradesh,Crime Against Women,Rape,Male,18-30,6050,2859,3191,3969,2081
2007,Urban,Sikkim,Other Crimes,Cyber Crime,Female,0-12,2217,1325,892,2089,128
2004,Urban,Karnataka,Crime Against Children,Trafficking,Female,60+,931,643,288,808,123
2002,Rural,Arunachal Pradesh,Other Crimes,Fraud,Male,13-17,2105,1731,374,1869,236
2006,Rural,Arunachal Pradesh,Crime Against Children,Trafficking,Female,13-17,8282,1254,7028,7209,1073
2001,Urban,Madhya Pradesh,Crime Against Men,Assault,Male,46-60,7351,3739,3612,4330,3021
2009,Rural,Odisha,Crime Against Men,Robbery,Male,13-17,187,27,160,65,122
2001,Rural,Manipur,Crime Against Men,Extortion,Female,46-60,3536,2985,551,3224,312
2004,Rural,Gujarat,Crime Against Women,Domestic Violence,Female,60+,4558,1077,3481,2816,1742
2006,Urban,Manipur,Crime Against Men,Robbery,Female,46-60,9876,3469,6407,3825,6051
2009,Rural,West Bengal,Crime Against Women,Rape,Male,13-17,8086,4436,3650,7249,837
2007,Rural,Gujarat,Crime Against Children,Child Labor,Female,46-60,8468,8259,209,8292,176
2004,Rural,Rajasthan,Crime Against Men,Assault,Female,18-30,8702,2777,5925,7445,1257
2010,Urban,Telangana,Crime Against Men,Robbery,Male,31-45,3579,286,3293,2303,1276
2003,Urban,Tripura,Other Crimes,Cyber Crime,Male,46-60,8392,7042,1350,7275,1117
2009,Rural,Maharashtra,Crime Against Women,Domestic Violence,Male,46-60,4119,2751,1368,3137,982
2009,Rural,Rajasthan,Other Crimes,Corruption,Female,46-60,1644,1477,167,1552,92
2002,Urban,Manipur,Crime Against Children,Child Abuse,Male,60+,9930,5331,4599,7565,2365
2006,Rural,Telangana,Property Crime,Arson,Male,31-45,4960,2162,2798,3875,1085
2005,Rural,Meghalaya,Crime Against Children,Trafficking,Male,60+,3904,131,3773,1721,2183
2006,Urban,Assam,Crime Against Men,Murder,Male,60+,516,49,467,72,444
2006,Rural,Manipur,Other Crimes,Corruption,Male,13-17,4396,1297,3099,4265,131
2001,Rural,Haryana,Crime Against Men,Extortion,Male,18-30,5917,1052,4865,1137,4780
2005,Urban,Delhi,Crime Against Men,Assault,Male,18-30,6668,2187,4481,3879,2789
2005,Urban,Sikkim,Other Crimes,Cyber Crime,Male,13-17,6054,4834,1220,4872,1182
2005,Rural,Tamil Nadu,Crime Against Men,Murder,Female,60+,5323,666,4657,5091,232
2009,Urban,Madhya Pradesh,Crime Against Men,Robbery,Male,0-12,5958,5481,477,5554,404
2010,Urban,Sikkim,Other Crimes,Fraud,Female,13-17,1281,197,1084,879,402
2001,Urban,Bihar,Crime Against Men,Assault,Male,60+,8362,4074,4288,7496,866
2002,Rural,Jammu & Kashmir,Property Crime,Arson,Male,31-45,8778,5111,3667,7657,1121
2005,Rural,Assam,Property Crime,Burglary,Female,31-45,5685,234,5451,4929,756
2006,Rural,Sikkim,Property Crime,Arson,Female,18-30,3473,2973,500,3179,294
2004,Urban,Haryana,Property Crime,Theft,Female,60+,1280,511,769,592,688
2001,Rural,Goa,Crime Against Men,Extortion,Male,0-12,965,929,36,952,13
2003,Urban,Gujarat,Crime Against Men,Murder,Female,13-17,9555,7008,2547,9145,410
2003,Rural,Andhra Pradesh,Crime Against Men,Robbery,Female,18-30,1053,424,629,1016,37
2005,Urban,Uttar Pradesh,Crime Against Men,Assault,Male,13-17,5259,2979,2280,4866,393
2010,Rural,Jammu & Kashmir,Other Crimes,Corruption,Male,31-45,7736,750,6986,818,6918
2004,Rural,West Bengal,Other Crimes,Fraud,Female,46-60,4008,2417,1591,2879,1129
2003,Rural,Gujarat,Crime Against Children,Trafficking,Male,31-45,8633,6922,1711,8589,44
2007,Urban,Odisha,Other Crimes,Cyber Crime,Female,46-60,7758,7593,165,7658,100
2002,Rural,Maharashtra,Property Crime,Arson,Male,13-17,2966,2470,496,2587,379
2009,Urban,Rajasthan,Property Crime,Burglary,Female,60+,8260,1568,6692,6701,1559
2009,Urban,Tripura,Crime Against Women,Molestation,Female,0-12,7354,181,7173,2195,5159
2001,Urban,Bihar,Crime Against Children,Trafficking,Male,31-45,6877,6283,594,6678,199
2003,Rural,Assam,Crime Against Men,Extortion,Male,18-30,5362,4256,1106,4610,752
2002,Urban,Odisha,Other Crimes,Fraud,Male,18-30,574,441,133,442,132
2002,Urban,Punjab,Other Crimes,Cyber Crime,Female,0-12,8155,3741,4414,5711,2444
2003,Rural,Goa,Other Crimes,Corruption,Female,60+,7013,1364,5649,4217,2796
2003,Rural,Telangana,Crime Against Men,Extortion,Female,0-12,8915,2034,6881,7436,1479
2001,Rural,Jammu & Kashmir,Other Crimes,Cyber Crime,Male,31-45,4946,2257,2689,4436,510
2008,Urban,Uttar Pradesh,Crime Against Women,Dowry Deaths,Female,0-12,4424,3370,1054,3528,896
2002,Urban,Manipur,Property Crime,Vandalism,Female,13-17,3387,2522,865,2861,526
2002,Rural,Arunachal Pradesh,Property Crime,Vandalism,Male,13-17,6633,4329,2304,6111,522
2004,Rural,Nagaland,Other Crimes,Corruption,Male,0-12,3082,481,2601,1888,1194
2002,Rural,Goa,Crime Against Women,Domestic Violence,Male,60+,2962,355,2607,633,2329
2005,Urban,Jammu & Kashmir,Property Crime,Theft,Male,60+,1291,356,935,733,558
2002,Rural,Goa,Other Crimes,Cyber Crime,Male,60+,3636,3488,148,3607,29
2008,Rural,Mizoram,Property Crime,Arson,Male,18-30,6801,5570,1231,6181,620
2007,Urban,Rajasthan,Crime Against Women,Rape,Female,18-30,8011,1257,6754,4704,3307
2001,Rural,Meghalaya,Crime Against Children,Trafficking,Male,18-30,6832,1024,5808,2016,4816
2004,Rural,Jharkhand,Crime Against Children,Child Labor,Male,31-45,9937,7832,2105,8548,1389
2006,Urban,West Bengal,Crime Against Children,Trafficking,Female,46-60,2246,931,1315,1128,1118
2010,Rural,Meghalaya,Property Crime,Theft,Male,31-45,4179,3697,482,3698,481
2004,Urban,Chhattisgarh,Crime Against Children,Child Labor,Male,46-60,3007,2833,174,2989,18
2010,Rural,Arunachal Pradesh,Crime Against Women,Domestic Violence,Male,0-12,7209,1937,5272,5114,2095
2006,Rural,Mizoram,Property Crime,Vandalism,Female,0-12,8028,293,7735,5689,2339
2010,Rural,Bihar,Crime Against Women,Molestation,Female,60+,8511,2447,6064,7017,1494
2008,Urban,Himachal Pradesh,Other Crimes,Fraud,Male,60+,8640,7230,1410,8146,494
2005,Rural,Andhra Pradesh,Crime Against Children,Child Labor,Female,46-60,5453,1689,3764,3501,1952
2002,Rural,Assam,Crime Against Women,Rape,Female,0-12,7962,2773,5189,6236,1726
2005,Urban,Andhra Pradesh,Property Crime,Arson,Female,31-45,1460,24,1436,270,1190
2004,Rural,Arunachal Pradesh,Property Crime,Burglary,Female,0-12,5320,4625,695,5079,241
2005,Urban,Gujarat,Other Crimes,Drug Offense,Female,60+,8116,6904,1212,7514,602
2001,Urban,Madhya Pradesh,Crime Against Children,Trafficking,Female,31-45,8631,2756,5875,7621,1010
2010,Urban,Jharkhand,Property Crime,Arson,Female,31-45,9455,1160,8295,2422,7033
2002,Urban,Kerala,Crime Against Men,Robbery,Male,31-45,7172,3231,3941,4261,2911
2005,Urban,Bihar,Crime Against Children,Kidnapping,Male,31-45,2271,607,1664,1337,934
2001,Urban,Bihar,Crime Against Children,Child Labor,Male,18-30,8244,1544,6700,7866,378
2004,Rural,Uttar Pradesh,Property Crime,Vandalism,Male,13-17,2692,2267,425,2509,183
2002,Rural,Bihar,Property Crime,Arson,Male,31-45,4176,3754,422,3843,333
2003,Rural,Jammu & Kashmir,Other Crimes,Fraud,Male,31-45,7939,969,6970,5600,2339
2008,Urban,Gujarat,Other Crimes,Drug Offense,Female,60+,443,51,392,56,387
2008,Rural,Jharkhand,Property Crime,Vandalism,Female,60+,6414,1973,4441,4251,2163
2002,Urban,Meghalaya,Crime Against Children,Kidnapping,Male,60+,7752,681,7071,5985,1767
2002,Rural,Meghalaya,Crime Against Children,Child Labor,Female,0-12,3319,1949,1370,2874,445
2005,Urban,Bihar,Crime Against Men,Assault,Female,13-17,1353,164,1189,177,1176
2007,Urban,West Bengal,Crime Against Men,Robbery,Female,46-60,3447,749,2698,2639,808
2003,Rural,Uttarakhand,Crime Against Children,Kidnapping,Male,46-60,520,200,320,334,186
2003,Rural,Delhi,Other Crimes,Cyber Crime,Male,46-60,8117,443,7674,3966,4151
2010,Rural,Meghalaya,Property Crime,Burglary,Female,13-17,2472,1166,1306,2265,207
2005,Rural,Karnataka,Other Crimes,Corruption,Male,46-60,6703,3031,3672,5910,793
2003,Urban,Meghalaya,Property Crime,Vandalism,Male,18-30,7141,1436,5705,5265,1876
2009,Rural,Kerala,Property Crime,Arson,Female,60+,9209,5455,3754,8910,299
2002,Rural,Maharashtra,Crime Against Children,Trafficking,Male,13-17,609,176,433,590,19
2009,Rural,Jammu & Kashmir,Other Crimes,Cyber Crime,Female,60+,6588,5436,1152,6379,209
2008,Urban,Goa,Crime Against Children,Child Abuse,Male,60+,642,509,133,529,113
2006,Rural,Mizoram,Other Crimes,Fraud,Female,0-12,5997,1490,4507,3378,2619
2010,Rural,Odisha,Other Crimes,Fraud,Female,13-17,2717,920,1797,2431,286
2001,Urban,Andhra Pradesh,Other Crimes,Corruption,Male,18-30,1757,1191,566,1404,353
2003,Urban,Andhra Pradesh,Other Crimes,Cyber Crime,Male,13-17,5192,1440,3752,3879,1313
2005,Rural,Punjab,Property Crime,Vandalism,Female,18-30,2965,308,2657,2469,496
2007,Urban,Goa,Property Crime,Vandalism,Female,46-60,5789,4934,855,5108,681
2010,Rural,Assam,Crime Against Children,Child Labor,Female,46-60,8396,4947,3449,5179,3217
2004,Urban,Kerala,Other Crimes,Cyber Crime,Male,31-45,6165,5877,288,5932,233
2004,Urban,Bihar,Property Crime,Theft,Female,0-12,7798,3634,4164,6957,841
2001,Urban,Andhra Pradesh,Crime Against Children,Child Abuse,Female,60+,592,303,289,398,194
2004,Rural,Telangana,Crime Against Women,Dowry Deaths,Male,18-30,6507,3751,2756,5351,1156
2008,Rural,Tripura,Crime Against Children,Kidnapping,Male,60+,9332,2624,6708,8452,880
2002,Rural,Bihar,Property Crime,Vandalism,Male,31-45,2286,1053,1233,1498,788
2010,Rural,Jharkhand,Crime Against Men,Murder,Male,13-17,9574,4689,4885,5588,3986
2010,Rural,Nagaland,Crime Against Men,Murder,Female,0-12,6556,4470,2086,6131,425
2003,Rural,Mizoram,Crime Against Children,Child Abuse,Female,60+,9703,363,9340,7498,2205
2007,Urban,Meghalaya,Other Crimes,Fraud,Male,31-45,5268,2019,3249,3227,2041
2002,Rural,Bihar,Crime Against Men,Extortion,Female,60+,7362,1107,6255,4761,2601
2006,Rural,Uttarakhand,Crime Against Children,Child Abuse,Female,31-45,7747,4152,3595,6244,1503
2003,Rural,West Bengal,Crime Against Women,Molestation,Female,31-45,1403,1067,336,1113,290
2008,Urban,Meghalaya,Property Crime,Vandalism,Female,18-30,6419,859,5560,5306,1113
2002,Urban,Andhra Pradesh,Crime Against Men,Assault,Male,18-30,3670,693,2977,950,2720
2008,Rural,Assam,Crime Against Men,Robbery,Female,60+,6518,1242,5276,6509,9
2010,Urban,Mizoram,Crime Against Children,Kidnapping,Male,0-12,4400,1197,3203,3408,992
2008,Urban,Assam,Property Crime,Theft,Male,18-30,709,121,588,577,132
2006,Urban,Himachal Pradesh,Other Crimes,Drug Offense,Female,60+,5659,5631,28,5634,25
2007,Rural,Nagaland,Crime Against Children,Child Labor,Female,46-60,711,127,584,414,297
2009,Rural,Uttarakhand,Crime Against Men,Assault,Female,60+,8488,1277,7211,2492,5996
2008,Rural,Sikkim,Crime Against Children,Trafficking,Male,46-60,8035,5307,2728,7513,522
2003,Urban,Tamil Nadu,Crime Against Women,Molestation,Male,60+,3072,2115,957,2455,617
2002,Urban,Bihar,Other Crimes,Cyber Crime,Female,18-30,7057,1256,5801,5793,1264
2005,Rural,Kerala,Crime Against Men,Murder,Male,60+,3921,2417,1504,3699,222
2009,Rural,Himachal Pradesh,Other Crimes,Drug Offense,Male,0-12,4008,2042,1966,2295,1713
2007,Urban,Himachal Pradesh,Property Crime,Vandalism,Female,13-17,1566,1500,66,1554,12
2009,Rural,Manipur,Other Crimes,Cyber Crime,Female,0-12,4966,877,4089,2044,2922
2003,Urban,Gujarat,Crime Against Women,Dowry Deaths,Male,46-60,8108,1308,6800,2324,5784
2001,Rural,Nagaland,Crime Against Children,Kidnapping,Female,0-12,8673,2224,6449,3075,5598
2002,Rural,Nagaland,Other Crimes,Fraud,Male,13-17,6878,5166,1712,5241,1637
2004,Rural,Madhya Pradesh,Property Crime,Arson,Female,0-12,7099,2359,4740,6776,323
2010,Urban,Jammu & Kashmir,Property Crime,Arson,Male,18-30,3270,420,2850,2508,762
2005,Urban,Punjab,Other Crimes,Corruption,Male,13-17,672,501,171,626,46
2010,Urban,Rajasthan,Crime Against Men,Murder,Female,60+,7731,948,6783,7229,502
2005,Urban,Himachal Pradesh,Other Crimes,Cyber Crime,Male,46-60,282,68,214,169,113
2008,Rural,Andhra Pradesh,Crime Against Women,Domestic Violence,Male,0-12,8209,3400,4809,6107,2102
2002,Rural,Odisha,Crime Against Men,Extortion,Male,13-17,4134,3666,468,3877,257
2003,Rural,Odisha,Crime Against Children,Kidnapping,Male,13-17,177,165,12,172,5
2009,Rural,Uttar Pradesh,Crime Against Women,Dowry Deaths,Female,60+,6444,3976,2468,4847,1597
2003,Urban,Goa,Crime Against Men,Assault,Male,31-45,7249,5481,1768,7236,13
2008,Rural,Manipur,Other Crimes,Drug Offense,Male,31-45,9794,4528,5266,5457,4337
2010,Rural,Assam,Crime Against Women,Rape,Male,60+,6079,4596,1483,4773,1306
2008,Rural,Himachal Pradesh,Property Crime,Burglary,Female,46-60,1697,929,768,1569,128
2006,Rural,Gujarat,Property Crime,Vandalism,Male,18-30,9039,2453,6586,8898,141
2002,Urban,Punjab,Other Crimes,Drug Offense,Male,60+,4085,2933,1152,3609,476
2002,Rural,Chhattisgarh,Other Crimes,Drug Offense,Female,0-12,7172,3580,3592,6404,768
2003,Rural,Himachal Pradesh,Other Crimes,Drug Offense,Male,60+,3214,2971,243,2996,218
2006,Urban,Haryana,Other Crimes,Corruption,Female,31-45,8861,607,8254,7380,1481
2010,Urban,Andhra Pradesh,Crime Against Women,Rape,Male,60+,1145,620,525,956,189
2010,Rural,Karnataka,Crime Against Children,Child Abuse,Female,18-30,5382,1528,3854,3257,2125
2007,Urban,Jammu & Kashmir,Crime Against Women,Dowry Deaths,Female,18-30,1830,1019,811,1380,450
2009,Urban,Bihar,Crime Against Men,Robbery,Male,13-17,5677,2460,3217,4836,841
2006,Rural,Arunachal Pradesh,Property Crime,Burglary,Female,60+,5794,5381,413,5504,290
2006,Rural,Telangana,Crime Against Children,Child Labor,Male,0-12,7771,550,7221,5128,2643
2007,Urban,West Bengal,Other Crimes,Fraud,Male,13-17,6153,1348,4805,3371,2782
2001,Rural,Telangana,Crime Against Children,Child Labor,Female,31-45,6541,3018,3523,3156,3385
2003,Rural,Gujarat,Crime Against Women,Rape,Male,31-45,8691,4068,4623,5688,3003
2005,Urban,West Bengal,Crime Against Women,Molestation,Male,60+,7486,2258,5228,6572,914
2010,Urban,Goa,Other Crimes,Drug Offense,Female,46-60,7863,487,7376,4838,3025
2005,Rural,Jammu & Kashmir,Crime Against Men,Murder,Male,31-45,3205,2020,1185,2510,695
2006,Urban,Rajasthan,Crime Against Women,Molestation,Male,46-60,1068,966,102,1017,51
2008,Urban,Maharashtra,Other Crimes,Drug Offense,Male,0-12,8059,3980,4079,7754,305
2004,Urban,Punjab,Other Crimes,Cyber Crime,Female,18-30,8980,8554,426,8796,184
2007,Rural,Arunachal Pradesh,Other Crimes,Fraud,Female,60+,7493,7152,341,7275,218
2004,Rural,Assam,Property Crime,Vandalism,Female,31-45,3325,3002,323,3313,12
2002,Urban,Sikkim,Crime Against Men,Robbery,Male,31-45,6113,4599,1514,4793,1320
2002,Urban,Karnataka,Crime Against Children,Child Labor,Male,18-30,4695,536,4159,572,4123
2010,Urban,Haryana,Crime Against Children,Kidnapping,Male,13-17,9585,8910,675,9266,319
2004,Rural,Jharkhand,Property Crime,Theft,Male,31-45,9723,5647,4076,8447,1276
2002,Urban,Meghalaya,Crime Against Men,Robbery,Female,60+,301,67,234,80,221
2004,Urban,Jharkhand,Property Crime,Theft,Female,0-12,9445,6742,2703,8487,958
2008,Rural,Punjab,Crime Against Men,Robbery,Female,31-45,8005,3980,4025,6346,1659
2010,Rural,Jammu & Kashmir,Crime Against Women,Molestation,Male,46-60,4864,1535,3329,3262,1602
2003,Rural,Gujarat,Crime Against Women,Molestation,Female,31-45,2971,1404,1567,1569,1402
2001,Urban,Sikkim,Crime Against Men,Assault,Male,0-12,5365,656,4709,1472,3893
2002,Urban,Sikkim,Crime Against Men,Assault,Male,0-12,1807,869,938,1389,418
2009,Urban,Kerala,Crime Against Children,Kidnapping,Female,60+,6697,1647,5050,4572,2125
2004,Urban,Manipur,Property Crime,Burglary,Male,13-17,1830,369,1461,1729,101
2005,Urban,Meghalaya,Crime Against Men,Assault,Male,46-60,9420,2616,6804,5786,3634
2009,Urban,Gujarat,Crime Against Men,Murder,Female,13-17,731,554,177,683,48
2009,Rural,Tripura,Crime Against Women,Domestic Violence,Female,18-30,7608,1028,6580,2790,4818
2005,Urban,Himachal Pradesh,Crime Against Women,Domestic Violence,Female,31-45,9850,30,9820,4333,5517
2005,Rural,Madhya Pradesh,Other Crimes,Fraud,Female,13-17,6525,44,6481,4834,1691
2003,Urban,Sikkim,Property Crime,Burglary,Male,18-30,9789,3697,6092,6797,2992
2007,Urban,Maharashtra,Crime Against Men,Robbery,Male,60+,5409,143,5266,832,4577
2010,Rural,Karnataka,Crime Against Men,Extortion,Female,60+,5765,3023,2742,3961,1804
2009,Urban,Jammu & Kashmir,Crime Against Women,Dowry Deaths,Male,18-30,4560,2848,1712,2986,1574
2002,Urban,Rajasthan,Other Crimes,Fraud,Female,46-60,193,66,127,84,109
2008,Rural,Jammu & Kashmir,Property Crime,Vandalism,Female,0-12,4083,1989,2094,2299,1784
2006,Rural,Assam,Other Crimes,Drug Offense,Female,13-17,1640,1321,319,1514,126
2006,Rural,Arunachal Pradesh,Crime Against Children,Kidnapping,Female,46-60,4168,1120,3048,3865,303
2004,Rural,Chhattisgarh,Crime Against Women,Dowry Deaths,Male,31-45,3183,1945,1238,2233,950
2008,Rural,Jammu & Kashmir,Crime Against Men,Murder,Male,46-60,9521,8940,581,9109,412
2002,Urban,Meghalaya,Crime Against Men,Murder,Female,13-17,5276,1974,3302,3456,1820
2005,Rural,Telangana,Crime Against Children,Child Labor,Male,31-45,8481,6895,1586,7342,1139
2006,Urban,Chhattisgarh,Crime Against Children,Kidnapping,Male,0-12,664,71,593,464,200
2002,Urban,Tripura,Crime Against Children,Trafficking,Male,18-30,9798,9324,474,9798,0
2009,Urban,Karnataka,Property Crime,Burglary,Male,13-17,2306,66,2240,210,2096
2001,Rural,Delhi,Crime Against Men,Assault,Male,0-12,1464,35,1429,41,1423
2007,Rural,West Bengal,Crime Against Men,Extortion,Male,18-30,8581,658,7923,6943,1638
2001,Urban,Uttarakhand,Crime Against Children,Trafficking,Female,60+,8967,416,8551,1279,7688
2009,Urban,Karnataka,Crime Against Children,Child Labor,Male,46-60,3176,2074,1102,2210,966
2009,Rural,Bihar,Property Crime,Burglary,Male,60+,5763,807,4956,2547,3216
2001,Rural,Bihar,Property Crime,Burglary,Female,46-60,9457,1712,7745,2918,6539
2002,Urban,Kerala,Other Crimes,Drug Offense,Male,13-17,9691,9633,58,9665,26
2007,Rural,Karnataka,Property Crime,Arson,Male,18-30,8151,4032,4119,7121,1030
2009,Rural,West Bengal,Other Crimes,Cyber Crime,Female,13-17,8364,4672,3692,8069,295
2010,Urban,Bihar,Crime Against Children,Trafficking,Male,60+,1820,750,1070,1617,203
2001,Urban,Kerala,Crime Against Children,Child Labor,Male,31-45,8379,2527,5852,4105,4274
2007,Urban,Himachal Pradesh,Property Crime,Vandalism,Male,13-17,1797,592,1205,1790,7
2005,Urban,Haryana,Other Crimes,Corruption,Male,0-12,9410,3594,5816,4042,5368
2008,Urban,Gujarat,Other Crimes,Corruption,Female,18-30,4886,2517,2369,2633,2253
2008,Urban,Uttarakhand,Crime Against Children,Child Abuse,Male,46-60,5680,808,4872,5376,304
2008,Urban,Kerala,Crime Against Women,Rape,Female,31-45,7782,3987,3795,5558,2224
2009,Rural,Tamil Nadu,Other Crimes,Drug Offense,Male,60+,2738,2646,92,2675,63
2008,Urban,Gujarat,Crime Against Children,Child Abuse,Female,0-12,9695,4565,5130,9250,445
2006,Urban,Madhya Pradesh,Crime Against Men,Assault,Female,31-45,4586,2087,2499,3354,1232
2005,Rural,Haryana,Property Crime,Arson,Male,46-60,1742,357,1385,1133,609
2003,Rural,Tamil Nadu,Other Crimes,Corruption,Male,18-30,4653,894,3759,4228,425
2001,Rural,Manipur,Other Crimes,Cyber Crime,Female,31-45,539,487,52,519,20
2006,Urban,Manipur,Property Crime,Burglary,Female,31-45,6975,4407,2568,6944,31
2009,Urban,Goa,Crime Against Women,Molestation,Male,46-60,6199,5740,459,6097,102
2009,Urban,Rajasthan,Property Crime,Arson,Male,18-30,9033,8614,419,8945,88
2005,Rural,Maharashtra,Other Crimes,Drug Offense,Female,18-30,8480,6118,2362,7188,1292
2002,Urban,Madhya Pradesh,Crime Against Women,Dowry Deaths,Male,0-12,1127,617,510,885,242
2004,Rural,Himachal Pradesh,Crime Against Men,Extortion,Male,13-17,8860,3027,5833,3624,5236
2009,Rural,Odisha,Crime Against Men,Extortion,Male,0-12,932,574,358,903,29
2010,Rural,Uttar Pradesh,Other Crimes,Cyber Crime,Male,46-60,8175,303,7872,523,7652
2007,Rural,Rajasthan,Crime Against Children,Child Abuse,Male,60+,9041,4172,4869,4237,4804
2003,Urban,Punjab,Crime Against Children,Kidnapping,Male,46-60,911,840,71,899,12
2003,Rural,Manipur,Crime Against Men,Extortion,Male,18-30,9490,1449,8041,4175,5315
2008,Urban,Bihar,Other Crimes,Drug Offense,Male,18-30,6926,2988,3938,4938,1988
2003,Rural,Uttarakhand,Property Crime,Burglary,Female,0-12,4735,2281,2454,4292,443
2006,Urban,Gujarat,Crime Against Children,Trafficking,Female,0-12,900,481,419,624,276
2006,Urban,Telangana,Crime Against Women,Domestic Violence,Male,13-17,6875,414,6461,2352,4523
2005,Rural,Assam,Crime Against Children,Child Abuse,Female,31-45,6782,2853,3929,5686,1096
2009,Urban,Haryana,Crime Against Children,Child Abuse,Male,18-30,619,115,504,262,357
2004,Urban,Arunachal Pradesh,Crime Against Women,Rape,Female,0-12,228,66,162,181,47
2006,Urban,Tripura,Property Crime,Burglary,Female,13-17,9953,120,9833,4652,5301
2005,Rural,Himachal Pradesh,Crime Against Women,Domestic Violence,Female,13-17,6841,1474,5367,2130,4711
2002,Urban,Himachal Pradesh,Crime Against Women,Rape,Female,60+,5334,1100,4234,4388,946
2001,Urban,Meghalaya,Other Crimes,Cyber Crime,Female,60+,8945,7231,1714,8757,188
2003,Rural,Rajasthan,Property Crime,Arson,Female,0-12,1320,610,710,865,455
2002,Urban,Assam,Crime Against Children,Child Abuse,Female,13-17,3308,3027,281,3289,19
2003,Rural,Tamil Nadu,Other Crimes,Drug Offense,Male,0-12,2443,1208,1235,1956,487
2007,Rural,Uttar Pradesh,Other Crimes,Drug Offense,Male,18-30,7403,365,7038,7092,311
2005,Urban,Manipur,Other Crimes,Drug Offense,Female,13-17,1867,1263,604,1471,396
2002,Rural,Chhattisgarh,Crime Against Men,Extortion,Male,18-30,8546,5759,2787,8537,9
2005,Rural,Madhya Pradesh,Crime Against Men,Murder,Male,60+,5495,1823,3672,4468,1027
2010,Urban,Kerala,Other Crimes,Cyber Crime,Female,31-45,93,3,90,31,62
2004,Urban,Madhya Pradesh,Crime Against Men,Murder,Female,60+,3400,996,2404,2981,419
2005,Urban,Assam,Crime Against Women,Molestation,Male,31-45,6459,2532,3927,3712,2747
2006,Rural,Karnataka,Crime Against Men,Assault,Male,13-17,5613,5289,324,5372,241
2004,Rural,Kerala,Crime Against Men,Robbery,Female,13-17,6003,3012,2991,3157,2846
2005,Rural,Goa,Property Crime,Arson,Male,18-30,5575,4234,1341,5156,419
2002,Rural,Jammu & Kashmir,Crime Against Children,Trafficking,Female,46-60,6790,5881,909,6664,126
2005,Rural,West Bengal,Crime Against Women,Rape,Female,0-12,1048,387,661,599,449
2002,Urban,Maharashtra,Crime Against Women,Molestation,Male,18-30,4931,265,4666,656,4275
2010,Urban,Sikkim,Crime Against Children,Child Labor,Male,46-60,5745,2156,3589,2909,2836
2006,Urban,Gujarat,Crime Against Women,Domestic Violence,Male,18-30,5187,1082,4105,4147,1040
2003,Rural,Uttarakhand,Crime Against Women,Domestic Violence,Female,46-60,7426,1854,5572,3114,4312
2010,Rural,Karnataka,Other Crimes,Corruption,Male,31-45,4690,2610,2080,3436,1254
2001,Rural,Delhi,Other Crimes,Drug Offense,Male,60+,8863,392,8471,7896,967
2007,Rural,Maharashtra,Property Crime,Theft,Male,13-17,1988,948,1040,1263,725
2010,Rural,Goa,Crime Against Women,Domestic Violence,Female,0-12,2069,891,1178,1346,723
2003,Rural,Jharkhand,Other Crimes,Fraud,Female,31-45,373,185,188,247,126
2008,Rural,Arunachal Pradesh,Crime Against Men,Robbery,Female,13-17,2260,469,1791,1159,1101
2010,Urban,Madhya Pradesh,Crime Against Women,Domestic Violence,Male,0-12,1854,388,1466,624,1230
2002,Rural,Manipur,Property Crime,Burglary,Female,0-12,3183,276,2907,1972,1211
2003,Rural,Goa,Crime Against Men,Murder,Female,18-30,5717,48,5669,1905,3812
2008,Rural,Gujarat,Crime Against Children,Child Labor,Male,13-17,5116,592,4524,3306,1810
2001,Urban,Andhra Pradesh,Crime Against Women,Domestic Violence,Male,13-17,2685,2133,552,2223,462
2002,Urban,Chhattisgarh,Crime Against Children,Child Labor,Male,13-17,8661,2693,5968,6513,2148
2005,Urban,Chhattisgarh,Other Crimes,Corruption,Female,0-12,2877,1200,1677,2593,284
2008,Rural,Delhi,Crime Against Children,Kidnapping,Male,46-60,4530,1151,3379,1399,3131
2003,Urban,West Bengal,Other Crimes,Cyber Crime,Male,13-17,8393,4721,3672,6264,2129
2005,Rural,Maharashtra,Crime Against Men,Murder,Female,13-17,1711,825,886,1543,168
2001,Urban,Assam,Crime Against Men,Extortion,Male,13-17,1336,175,1161,1232,104
2008,Rural,Karnataka,Other Crimes,Cyber Crime,Female,18-30,3913,642,3271,769,3144
2002,Urban,Sikkim,Crime Against Children,Kidnapping,Male,13-17,6889,1046,5843,3496,3393
2008,Urban,Arunachal Pradesh,Crime Against Women,Domestic Violence,Female,18-30,8067,3004,5063,7094,973
2001,Rural,Tripura,Crime Against Children,Trafficking,Female,18-30,334,1,333,70,264
2006,Urban,Goa,Crime Against Men,Murder,Male,18-30,8083,3869,4214,7570,513
2005,Rural,Delhi,Crime Against Children,Trafficking,Female,0-12,1294,625,669,792,502
2010,Rural,Uttarakhand,Property Crime,Burglary,Male,18-30,7062,6192,870,6757,305
2004,Rural,Maharashtra,Crime Against Men,Extortion,Female,18-30,7397,1811,5586,3340,4057
2006,Urban,Uttarakhand,Other Crimes,Corruption,Male,46-60,3833,654,3179,3151,682
2010,Rural,Rajasthan,Crime Against Women,Rape,Female,31-45,1740,168,1572,1396,344
2006,Rural,Goa,Crime Against Men,Extortion,Female,13-17,1476,1057,419,1262,214
2008,Rural,Delhi,Crime Against Women,Domestic Violence,Male,13-17,96,26,70,50,46
2004,Urban,Nagaland,Crime Against Men,Assault,Male,0-12,9076,743,8333,1099,7977
2010,Urban,Jharkhand,Other Crimes,Corruption,Male,46-60,1032,685,347,1008,24
2001,Rural,Telangana,Crime Against Women,Dowry Deaths,Female,31-45,5789,141,5648,3118,2671
2005,Urban,Kerala,Other Crimes,Fraud,Female,31-45,6179,2827,3352,4206,1973
2006,Urban,Andhra Pradesh,Crime Against Women,Molestation,Female,18-30,2281,1015,1266,2106,175
2008,Rural,Rajasthan,Crime Against Children,Child Abuse,Male,60+,5857,5129,728,5785,72
2007,Rural,Kerala,Crime Against Men,Robbery,Female,60+,8260,6474,1786,7566,694
2003,Rural,Manipur,Property Crime,Burglary,Male,0-12,3828,2131,1697,2339,1489
2005,Rural,Arunachal Pradesh,Property Crime,Vandalism,Female,13-17,5651,401,5250,3962,1689
2009,Rural,Nagaland,Crime Against Women,Dowry Deaths,Male,31-45,4462,4439,23,4460,2
2006,Urban,Delhi,Crime Against Men,Robbery,Male,31-45,3016,3004,12,3013,3
2004,Urban,Odisha,Other Crimes,Drug Offense,Female,31-45,4710,4237,473,4473,237
2010,Rural,Karnataka,Other Crimes,Drug Offense,Female,46-60,6313,3947,2366,4437,1876
2001,Rural,Punjab,Crime Against Women,Domestic Violence,Female,18-30,1698,20,1678,1237,461
2003,Rural,Madhya Pradesh,Crime Against Men,Murder,Male,18-30,5350,5269,81,5282,68
2006,Rural,Delhi,Crime Against Men,Robbery,Female,13-17,7446,430,7016,6044,1402
2010,Rural,Rajasthan,Crime Against Men,Murder,Male,46-60,7605,5984,1621,6799,806
2003,Urban,Sikkim,Other Crimes,Drug Offense,Male,13-17,2048,536,1512,1964,84
2006,Urban,Himachal Pradesh,Crime Against Women,Domestic Violence,Female,31-45,939,349,590,778,161
2009,Urban,Haryana,Property Crime,Arson,Male,31-45,63,49,14,53,10
2009,Urban,Bihar,Property Crime,Theft,Female,46-60,4098,675,3423,2740,1358
2003,Rural,Haryana,Other Crimes,Cyber Crime,Male,60+,1266,1250,16,1253,13
2002,Urban,Himachal Pradesh,Crime Against Children,Kidnapping,Female,13-17,8041,1515,6526,2819,5222
2006,Urban,Himachal Pradesh,Crime Against Men,Extortion,Female,46-60,7112,434,6678,1218,5894
2010,Urban,West Bengal,Crime Against Men,Extortion,Male,13-17,4481,210,4271,1374,3107
2005,Rural,Tripura,Crime Against Men,Murder,Female,60+,2985,8,2977,1723,1262
2003,Urban,Tamil Nadu,Other Crimes,Fraud,Female,18-30,9125,2384,6741,2570,6555
2004,Rural,Gujarat,Crime Against Children,Trafficking,Male,0-12,8314,3626,4688,6035,2279
2010,Rural,Karnataka,Crime Against Children,Child Labor,Female,46-60,6986,1262,5724,4930,2056
2009,Rural,Gujarat,Property Crime,Theft,Male,46-60,123,37,86,74,49
2010,Rural,Delhi,Other Crimes,Corruption,Female,18-30,8291,6914,1377,8140,151
2005,Urban,Meghalaya,Crime Against Men,Murder,Female,18-30,5872,332,5540,3958,1914
2008,Urban,Madhya Pradesh,Other Crimes,Cyber Crime,Female,0-12,2709,1805,904,2047,662
2003,Urban,Andhra Pradesh,Crime Against Men,Robbery,Female,0-12,4970,2870,2100,3477,1493
2010,Urban,Assam,Crime Against Children,Child Abuse,Female,18-30,8480,3303,5177,5079,3401
2004,Rural,Karnataka,Property Crime,Theft,Female,13-17,3672,2783,889,3242,430
2007,Rural,Kerala,Other Crimes,Fraud,Male,13-17,5838,1391,4447,3956,1882
2005,Rural,Manipur,Other Crimes,Fraud,Male,46-60,6023,4673,1350,4838,1185
2003,Urban,Odisha,Crime Against Children,Kidnapping,Male,31-45,5128,1106,4022,2803,2325
2008,Rural,Tamil Nadu,Property Crime,Burglary,Female,13-17,3470,336,3134,3347,123
2009,Urban,Assam,Crime Against Women,Domestic Violence,Female,31-45,3472,2273,1199,2443,1029
2008,Urban,Sikkim,Crime Against Children,Child Labor,Female,46-60,4603,1161,3442,2847,1756
2010,Rural,Sikkim,Other Crimes,Corruption,Male,13-17,5183,553,4630,4055,1128
2009,Rural,West Bengal,Property Crime,Burglary,Female,13-17,1466,1243,223,1364,102
2008,Urban,Jammu & Kashmir,Crime Against Men,Assault,Male,13-17,7504,189,7315,1578,5926
2005,Rural,Goa,Property Crime,Vandalism,Male,46-60,4757,2576,2181,3781,976
2005,Rural,Madhya Pradesh,Property Crime,Theft,Female,18-30,6480,2051,4429,5006,1474
2006,Rural,Madhya Pradesh,Crime Against Children,Trafficking,Male,13-17,2392,792,1600,868,1524
2004,Rural,Jharkhand,Crime Against Women,Rape,Female,18-30,6292,1727,4565,4483,1809
2008,Rural,Karnataka,Crime Against Men,Murder,Male,46-60,1240,1193,47,1222,18
2004,Rural,Tamil Nadu,Crime Against Children,Child Abuse,Male,13-17,5134,3799,1335,4716,418
2004,Rural,Goa,Crime Against Men,Extortion,Male,31-45,1752,762,990,1062,690
2008,Rural,Andhra Pradesh,Other Crimes,Cyber Crime,Female,13-17,9010,4165,4845,6346,2664
2003,Rural,Andhra Pradesh,Crime Against Children,Child Abuse,Female,60+,9297,1185,8112,8231,1066
2008,Rural,Uttar Pradesh,Property Crime,Burglary,Female,13-17,6014,3489,2525,4584,1430
2001,Rural,Odisha,Crime Against Women,Molestation,Female,60+,9011,5254,3757,7087,1924
2003,Rural,Andhra Pradesh,Crime Against Men,Robbery,Female,46-60,4887,3790,1097,4774,113
2009,Rural,Gujarat,Property Crime,Arson,Female,60+,7701,861,6840,4798,2903
2010,Urban,Meghalaya,Crime Against Men,Extortion,Female,18-30,1178,1071,107,1172,6
2007,Rural,Tamil Nadu,Other Crimes,Drug Offense,Male,0-12,4579,2747,1832,3752,827
2005,Urban,Meghalaya,Crime Against Women,Dowry Deaths,Male,46-60,3337,2125,1212,3299,38
2001,Rural,Gujarat,Other Crimes,Fraud,Male,46-60,1827,1029,798,1568,259
2005,Urban,Sikkim,Property Crime,Arson,Male,60+,1241,845,396,993,248
2007,Rural,Gujarat,Crime Against Men,Murder,Male,0-12,5454,1627,3827,3135,2319
2005,Urban,Arunachal Pradesh,Crime Against Children,Trafficking,Male,60+,9679,6985,2694,9339,340
2006,Rural,Tamil Nadu,Property Crime,Burglary,Female,0-12,6942,6602,340,6618,324
2004,Rural,Kerala,Crime Against Men,Assault,Male,31-45,1091,812,279,1084,7
2001,Rural,Assam,Crime Against Men,Murder,Male,31-45,581,65,516,96,485
2003,Rural,Maharashtra,Crime Against Women,Domestic Violence,Female,46-60,6312,170,6142,4592,1720
2002,Urban,West Bengal,Property Crime,Arson,Female,13-17,4422,1295,3127,2771,1651
2002,Urban,Meghalaya,Crime Against Men,Assault,Male,0-12,8883,1976,6907,5356,3527
2003,Urban,Odisha,Other Crimes,Corruption,Female,13-17,3909,2503,1406,3510,399
2010,Rural,Chhattisgarh,Crime Against Men,Assault,Female,13-17,5222,3379,1843,4061,1161
2002,Urban,Nagaland,Crime Against Men,Assault,Male,0-12,6727,1851,4876,5215,1512
2010,Rural,Assam,Crime Against Women,Molestation,Female,46-60,2092,488,1604,1917,175
2006,Urban,Haryana,Crime Against Men,Extortion,Female,60+,1314,918,396,1304,10
2003,Rural,Mizoram,Property Crime,Burglary,Female,46-60,1894,463,1431,927,967
2007,Urban,Nagaland,Property Crime,Vandalism,Female,13-17,3469,3319,150,3375,94
2007,Urban,Andhra Pradesh,Crime Against Men,Robbery,Female,13-17,5302,4146,1156,5119,183
2005,Urban,Nagaland,Crime Against Women,Domestic Violence,Female,18-30,7874,1481,6393,6398,1476
2009,Rural,Jharkhand,Crime Against Men,Robbery,Female,13-17,5809,3850,1959,4849,960
2001,Rural,Nagaland,Other Crimes,Drug Offense,Male,31-45,2921,1078,1843,2089,832
2009,Rural,Maharashtra,Crime Against Children,Child Abuse,Male,31-45,8738,4690,4048,6205,2533
2004,Urban,Kerala,Property Crime,Burglary,Female,13-17,1187,708,479,737,450
2006,Rural,Karnataka,Crime Against Men,Assault,Female,13-17,4149,1814,2335,1955,2194
2002,Urban,Andhra Pradesh,Crime Against Women,Domestic Violence,Male,31-45,5180,2386,2794,4367,813
2005,Rural,Manipur,Other Crimes,Corruption,Male,46-60,7945,7165,780,7617,328
2005,Rural,Jammu & Kashmir,Property Crime,Arson,Female,60+,1117,59,1058,1064,53
2004,Rural,Delhi,Other Crimes,Fraud,Female,31-45,8126,3404,4722,7779,347
2003,Urban,Kerala,Property Crime,Theft,Female,60+,8870,3836,5034,6017,2853
2005,Rural,Madhya Pradesh,Crime Against Women,Dowry Deaths,Female,18-30,9625,2719,6906,3750,5875
2001,Urban,Haryana,Crime Against Men,Assault,Male,46-60,7705,4793,2912,6052,1653
2005,Rural,Maharashtra,Other Crimes,Fraud,Male,13-17,7450,5285,2165,6743,707
2010,Rural,West Bengal,Crime Against Men,Assault,Male,18-30,6251,1420,4831,2160,4091
2003,Rural,Uttar Pradesh,Crime Against Children,Kidnapping,Male,31-45,5428,2053,3375,4398,1030
2001,Urban,Jharkhand,Crime Against Children,Child Abuse,Female,18-30,2474,176,2298,2387,87
2002,Urban,Odisha,Other Crimes,Corruption,Female,18-30,206,113,93,189,17
2008,Urban,Haryana,Crime Against Children,Trafficking,Male,60+,8159,3475,4684,7391,768
2010,Urban,Chhattisgarh,Crime Against Women,Dowry Deaths,Female,0-12,4035,3037,998,3323,712
2005,Rural,Kerala,Crime Against Children,Trafficking,Female,46-60,9629,7235,2394,8623,1006
2007,Urban,Rajasthan,Crime Against Children,Trafficking,Male,0-12,772,96,676,418,354
2002,Rural,Meghalaya,Crime Against Women,Domestic Violence,Female,18-30,7942,1298,6644,2213,5729
2008,Urban,Uttarakhand,Crime Against Women,Dowry Deaths,Female,46-60,1404,647,757,955,449
2010,Rural,Rajasthan,Crime Against Women,Domestic Violence,Female,31-45,7860,5272,2588,6465,1395
2009,Urban,Jharkhand,Property Crime,Burglary,Female,60+,3456,3198,258,3310,146
2002,Urban,Jammu & Kashmir,Property Crime,Vandalism,Female,31-45,2202,961,1241,1396,806
2002,Rural,Mizoram,Property Crime,Theft,Male,31-45,4851,2667,2184,2756,2095
2010,Rural,Tripura,Other Crimes,Corruption,Female,60+,9085,6401,2684,6420,2665
2007,Urban,Kerala,Crime Against Men,Robbery,Male,60+,5698,62,5636,4694,1004
2010,Urban,Nagaland,Property Crime,Arson,Male,46-60,363,45,318,209,154
2005,Urban,Haryana,Crime Against Children,Kidnapping,Female,31-45,6702,1002,5700,6387,315
2010,Urban,Sikkim,Crime Against Women,Molestation,Female,46-60,5132,1355,3777,1837,3295
2009,Urban,Sikkim,Other Crimes,Cyber Crime,Male,18-30,1642,105,1537,1264,378
2005,Rural,Manipur,Crime Against Women,Rape,Male,18-30,9979,1454,8525,5394,4585
2001,Rural,Andhra Pradesh,Crime Against Men,Assault,Female,13-17,8087,5463,2624,7530,557
2001,Urban,Madhya Pradesh,Other Crimes,Corruption,Male,31-45,776,173,603,571,205
2001,Rural,Punjab,Crime Against Women,Dowry Deaths,Male,31-45,5411,1712,3699,4875,536
2005,Rural,Goa,Other Crimes,Corruption,Male,31-45,3123,167,2956,2413,710
2003,Urban,Jharkhand,Property Crime,Theft,Female,18-30,2687,1203,1484,2192,495
2001,Rural,Assam,Property Crime,Arson,Female,18-30,1917,508,1409,992,925
2004,Rural,Andhra Pradesh,Property Crime,Vandalism,Female,0-12,6116,135,5981,772,5344
2003,Urban,Jharkhand,Crime Against Men,Assault,Male,46-60,5991,919,5072,2187,3804
2003,Rural,Madhya Pradesh,Other Crimes,Fraud,Female,18-30,8819,8699,120,8796,23
2006,Urban,Tripura,Other Crimes,Drug Offense,Male,18-30,6144,2838,3306,3376,2768
2008,Rural,Arunachal Pradesh,Other Crimes,Fraud,Female,60+,9852,9752,100,9822,30
2003,Rural,Delhi,Crime Against Women,Molestation,Male,60+,2264,1996,268,2114,150
2007,Urban,Manipur,Crime Against Women,Dowry Deaths,Female,18-30,2513,2436,77,2512,1
2003,Urban,Gujarat,Crime Against Children,Child Abuse,Male,18-30,9674,399,9275,7737,1937
2007,Rural,Chhattisgarh,Other Crimes,Corruption,Female,13-17,5326,4083,1243,5306,20
2008,Rural,Kerala,Other Crimes,Corruption,Male,46-60,9995,7292,2703,7795,2200
2002,Urban,Delhi,Other Crimes,Corruption,Female,18-30,7871,4032,3839,6532,1339
2003,Rural,Uttarakhand,Crime Against Children,Child Labor,Female,46-60,4598,3589,1009,4492,106
2004,Rural,Rajasthan,Other Crimes,Drug Offense,Male,18-30,8221,7104,1117,7889,332
2007,Rural,Nagaland,Crime Against Children,Kidnapping,Female,13-17,9284,2895,6389,7416,1868
2004,Rural,Jharkhand,Crime Against Men,Robbery,Female,46-60,6922,1527,5395,4772,2150
2005,Rural,Maharashtra,Other Crimes,Corruption,Male,60+,758,308,450,332,426
2005,Urban,Rajasthan,Crime Against Women,Dowry Deaths,Female,0-12,1730,355,1375,1635,95
2009,Rural,Rajasthan,Other Crimes,Corruption,Male,13-17,3001,1996,1005,2222,779
2009,Rural,Jharkhand,Crime Against Men,Assault,Female,31-45,9448,7504,1944,9289,159
2007,Rural,Assam,Crime Against Children,Child Labor,Male,0-12,4221,3929,292,3946,275
2008,Urban,Sikkim,Crime Against Men,Robbery,Female,0-12,3717,3436,281,3479,238
2002,Urban,Sikkim,Crime Against Children,Trafficking,Female,13-17,4072,247,3825,707,3365
2010,Rural,Chhattisgarh,Crime Against Women,Molestation,Female,18-30,9033,1690,7343,5803,3230
2001,Urban,Telangana,Property Crime,Theft,Male,0-12,3997,3694,303,3872,125
2001,Rural,Punjab,Other Crimes,Drug Offense,Male,46-60,8387,4879,3508,7662,725
2004,Rural,Rajasthan,Crime Against Women,Domestic Violence,Female,46-60,1360,420,940,973,387
2009,Rural,Telangana,Crime Against Children,Child Abuse,Male,31-45,5022,1175,3847,1959,3063
2005,Urban,Uttar Pradesh,Property Crime,Theft,Female,46-60,9753,6731,3022,9569,184
2004,Rural,Manipur,Property Crime,Theft,Male,18-30,3285,1137,2148,1574,1711
2005,Urban,Uttarakhand,Crime Against Children,Child Labor,Female,13-17,54,26,28,27,27
2002,Urban,Meghalaya,Crime Against Men,Assault,Female,31-45,2445,1294,1151,1307,1138
2005,Urban,Kerala,Property Crime,Arson,Male,46-60,5880,3209,2671,3734,2146
2001,Rural,Mizoram,Crime Against Women,Molestation,Male,13-17,9488,2011,7477,7860,1628
2005,Urban,Maharashtra,Crime Against Women,Dowry Deaths,Male,13-17,9372,6779,2593,8215,1157
2008,Rural,Arunachal Pradesh,Crime Against Women,Molestation,Female,46-60,7865,3831,4034,4988,2877
2002,Rural,Karnataka,Other Crimes,Cyber Crime,Male,18-30,1379,538,841,563,816
2005,Urban,Bihar,Crime Against Men,Assault,Female,0-12,8531,7448,1083,7841,690
2002,Urban,Jammu & Kashmir,Crime Against Women,Dowry Deaths,Female,46-60,3285,404,2881,2986,299
2008,Urban,Karnataka,Property Crime,Theft,Male,18-30,6356,5456,900,5706,650
2005,Rural,West Bengal,Other Crimes,Fraud,Male,60+,8869,7134,1735,7419,1450
2009,Urban,Punjab,Crime Against Women,Dowry Deaths,Female,18-30,6955,4555,2400,5569,1386
2006,Urban,Kerala,Crime Against Men,Murder,Male,31-45,8527,4411,4116,5672,2855
2006,Urban,Uttarakhand,Other Crimes,Fraud,Male,18-30,9918,1359,8559,2398,7520
2007,Rural,West Bengal,Crime Against Children,Kidnapping,Female,60+,6526,4221,2305,5913,613
2004,Rural,Bihar,Crime Against Children,Trafficking,Male,0-12,1994,348,1646,1862,132
2005,Urban,Jharkhand,Other Crimes,Fraud,Male,18-30,1772,1335,437,1388,384
2003,Rural,Tamil Nadu,Crime Against Women,Dowry Deaths,Female,13-17,3423,3076,347,3269,154
2004,Urban,Chhattisgarh,Crime Against Men,Assault,Female,46-60,5657,3003,2654,5316,341
2005,Rural,Bihar,Property Crime,Arson,Female,60+,6579,4459,2120,5368,1211
2009,Urban,Delhi,Other Crimes,Drug Offense,Female,13-17,8523,870,7653,7837,686
2010,Rural,Nagaland,Crime Against Men,Extortion,Male,18-30,668,160,508,535,133
2001,Rural,Punjab,Crime Against Women,Molestation,Male,46-60,9302,337,8965,8458,844
2003,Rural,Rajasthan,Crime Against Women,Dowry Deaths,Female,13-17,8887,4259,4628,8167,720
2009,Urban,Sikkim,Other Crimes,Cyber Crime,Female,60+,3000,1925,1075,2701,299
2009,Urban,Jammu & Kashmir,Property Crime,Vandalism,Male,46-60,9399,7565,1834,8906,493
2006,Rural,Haryana,Crime Against Children,Child Abuse,Female,0-12,5637,4311,1326,4467,1170
2004,Rural,Sikkim,Crime Against Men,Assault,Male,13-17,6743,3569,3174,5943,800
2008,Rural,Meghalaya,Crime Against Children,Child Labor,Female,31-45,7975,5347,2628,6782,1193
2010,Rural,Jammu & Kashmir,Crime Against Women,Domestic Violence,Female,0-12,4393,3080,1313,3518,875
2007,Rural,Meghalaya,Crime Against Men,Murder,Female,60+,6786,1815,4971,2231,4555
2002,Urban,Nagaland,Crime Against Children,Trafficking,Male,18-30,7117,6946,171,6985,132
2007,Rural,Madhya Pradesh,Other Crimes,Drug Offense,Male,0-12,4837,2466,2371,3743,1094
2003,Rural,Maharashtra,Other Crimes,Fraud,Female,18-30,4395,2446,1949,2746,1649
2002,Rural,Odisha,Property Crime,Vandalism,Male,60+,741,392,349,461,280
2002,Urban,Tripura,Crime Against Women,Rape,Female,31-45,1455,1344,111,1372,83
2006,Rural,Delhi,Property Crime,Arson,Female,60+,89,31,58,79,10
2001,Rural,Himachal Pradesh,Other Crimes,Drug Offense,Female,31-45,7703,0,7703,6651,1052
2009,Rural,Chhattisgarh,Crime Against Women,Rape,Female,31-45,4338,1745,2593,2607,1731
2009,Urban,Uttarakhand,Property Crime,Theft,Female,60+,6046,3474,2572,5281,765
2001,Rural,Odisha,Other Crimes,Cyber Crime,Female,31-45,3980,3264,716,3597,383
2001,Rural,Rajasthan,Crime Against Men,Assault,Female,31-45,5540,5420,120,5538,2
2002,Rural,Delhi,Crime Against Children,Child Labor,Female,46-60,7823,1568,6255,6336,1487
2009,Urban,Chhattisgarh,Crime Against Women,Molestation,Male,31-45,4688,53,4635,2391,2297
2008,Urban,Telangana,Crime Against Men,Extortion,Female,18-30,9073,3568,5505,5155,3918
2004,Rural,Gujarat,Property Crime,Arson,Female,60+,3059,1534,1525,1684,1375
2006,Rural,Uttar Pradesh,Crime Against Men,Murder,Female,13-17,8020,7081,939,7165,855
2005,Urban,Bihar,Other Crimes,Cyber Crime,Male,13-17,1425,861,564,1009,416
2008,Rural,Telangana,Crime Against Men,Extortion,Male,18-30,3210,3060,150,3077,133
2002,Urban,Sikkim,Crime Against Men,Robbery,Male,13-17,57,3,54,51,6
2006,Urban,West Bengal,Crime Against Women,Molestation,Male,18-30,339,55,284,231,108
2006,Urban,Uttarakhand,Property Crime,Burglary,Male,0-12,5002,742,4260,4293,709
2003,Urban,Jharkhand,Crime Against Men,Assault,Male,18-30,6426,4878,1548,5937,489
2001,Rural,Karnataka,Crime Against Children,Kidnapping,Female,60+,3569,202,3367,2315,1254
2002,Urban,Delhi,Property Crime,Theft,Female,13-17,9513,4282,5231,6995,2518
2003,Rural,Meghalaya,Crime Against Children,Kidnapping,Male,0-12,7845,7735,110,7766,79
2003,Urban,Maharashtra,Crime Against Children,Child Labor,Male,60+,1084,308,776,429,655
2008,Rural,Manipur,Crime Against Children,Child Labor,Female,0-12,2132,319,1813,1937,195
2002,Urban,Gujarat,Crime Against Children,Trafficking,Male,60+,7430,6755,675,6823,607
2003,Urban,Uttar Pradesh,Property Crime,Vandalism,Female,31-45,6380,6118,262,6291,89
2010,Urban,Haryana,Crime Against Women,Molestation,Male,31-45,9001,4385,4616,6954,2047
2007,Urban,Madhya Pradesh,Property Crime,Theft,Female,18-30,4406,2361,2045,2769,1637
2010,Urban,Bihar,Crime Against Women,Molestation,Female,46-60,7908,5523,2385,5732,2176
2007,Rural,Karnataka,Property Crime,Arson,Female,60+,3020,303,2717,1468,1552
2003,Rural,Goa,Crime Against Men,Extortion,Male,31-45,7882,1975,5907,7087,795
2003,Urban,Tripura,Other Crimes,Cyber Crime,Female,31-45,8010,5220,2790,7539,471
2008,Urban,Himachal Pradesh,Crime Against Women,Molestation,Female,0-12,1215,804,411,944,271
2010,Urban,Maharashtra,Crime Against Children,Trafficking,Male,0-12,9793,7955,1838,9700,93
2005,Urban,Himachal Pradesh,Crime Against Women,Molestation,Female,0-12,1629,1001,628,1475,154
2008,Rural,Jammu & Kashmir,Crime Against Women,Rape,Female,13-17,8839,5955,2884,8592,247
2006,Rural,Delhi,Property Crime,Theft,Male,13-17,5750,3808,1942,5444,306
2008,Urban,Chhattisgarh,Crime Against Children,Child Labor,Male,18-30,4561,1881,2680,1888,2673
2007,Rural,Himachal Pradesh,Property Crime,Arson,Female,46-60,7340,4948,2392,6173,1167
2003,Urban,Mizoram,Crime Against Women,Molestation,Male,60+,2479,1876,603,2131,348
2006,Rural,Karnataka,Property Crime,Vandalism,Male,46-60,7183,2254,4929,6140,1043
2004,Urban,Arunachal Pradesh,Property Crime,Arson,Male,18-30,6841,1464,5377,5533,1308
2010,Rural,Meghalaya,Crime Against Women,Molestation,Female,18-30,9510,3273,6237,7845,1665
2005,Urban,Maharashtra,Crime Against Women,Domestic Violence,Male,60+,4070,212,3858,3055,1015
2004,Urban,Punjab,Other Crimes,Drug Offense,Female,46-60,6327,401,5926,1346,4981
2003,Rural,Karnataka,Property Crime,Theft,Male,60+,3312,2480,832,2806,506
2009,Rural,West Bengal,Property Crime,Vandalism,Female,46-60,2850,945,1905,1052,1798
2005,Rural,Uttar Pradesh,Crime Against Children,Trafficking,Male,18-30,8874,7776,1098,8598,276
2006,Urban,Manipur,Property Crime,Arson,Male,13-17,8357,3234,5123,6910,1447
2006,Rural,Maharashtra,Crime Against Women,Rape,Female,46-60,4311,2491,1820,3389,922
2001,Urban,Gujarat,Property Crime,Vandalism,Male,18-30,3492,1282,2210,1684,1808
2004,Urban,Kerala,Other Crimes,Corruption,Female,13-17,4446,1303,3143,2079,2367
2006,Rural,Meghalaya,Crime Against Men,Assault,Male,60+,5397,4553,844,4756,641
2003,Urban,Tamil Nadu,Crime Against Children,Kidnapping,Female,18-30,8005,5241,2764,6907,1098
2004,Urban,Tripura,Crime Against Men,Robbery,Male,60+,5324,4645,679,5125,199
2003,Rural,Gujarat,Crime Against Children,Child Abuse,Female,13-17,7196,5525,1671,5737,1459
2007,Rural,Odisha,Crime Against Women,Rape,Male,31-45,5746,578,5168,5264,482
2010,Urban,Tamil Nadu,Crime Against Men,Assault,Male,46-60,8047,7630,417,7796,251
2001,Rural,Uttarakhand,Crime Against Men,Robbery,Male,46-60,2615,1058,1557,1624,991
2007,Rural,Madhya Pradesh,Property Crime,Theft,Male,60+,8175,3624,4551,4286,3889
2005,Urban,Uttarakhand,Crime Against Men,Murder,Female,18-30,6014,491,5523,5293,721
2004,Rural,Tripura,Other Crimes,Cyber Crime,Female,0-12,8208,1651,6557,3210,4998
2002,Urban,Tripura,Crime Against Women,Domestic Violence,Female,18-30,4239,2418,1821,4151,88
2001,Rural,Tripura,Crime Against Women,Dowry Deaths,Female,31-45,5773,4321,1452,5655,118
2001,Urban,Nagaland,Crime Against Women,Dowry Deaths,Female,60+,9375,5083,4292,7228,2147
2005,Rural,Karnataka,Crime Against Women,Molestation,Male,0-12,5794,346,5448,5764,30
2009,Rural,Jammu & Kashmir,Property Crime,Burglary,Female,31-45,4462,3720,742,4192,270
2010,Rural,Punjab,Property Crime,Arson,Female,31-45,3397,2621,776,2654,743
2007,Urban,Telangana,Crime Against Women,Domestic Violence,Male,31-45,3955,2095,1860,2438,1517
2003,Rural,Odisha,Crime Against Women,Molestation,Male,60+,5832,4220,1612,5467,365
2002,Urban,Madhya Pradesh,Other Crimes,Fraud,Male,46-60,7210,1171,6039,2641,4569
2009,Urban,Kerala,Crime Against Men,Murder,Female,46-60,8539,148,8391,2611,5928
2008,Urban,Goa,Crime Against Men,Robbery,Male,60+,50,42,8,48,2
2002,Urban,Jammu & Kashmir,Crime Against Children,Trafficking,Female,13-17,9144,5530,3614,6191,2953
2010,Urban,Arunachal Pradesh,Crime Against Children,Child Labor,Male,31-45,6778,2412,4366,6195,583
2010,Urban,Goa,Crime Against Children,Child Abuse,Male,31-45,2550,586,1964,1110,1440
2006,Urban,West Bengal,Other Crimes,Fraud,Male,0-12,1807,181,1626,529,1278
2010,Rural,Uttar Pradesh,Crime Against Children,Child Abuse,Male,18-30,7607,4159,3448,5913,1694
2004,Urban,Maharashtra,Property Crime,Arson,Female,46-60,4690,3481,1209,3566,1124
2003,Rural,Bihar,Other Crimes,Corruption,Male,13-17,8616,2293,6323,5535,3081
2002,Urban,Haryana,Property Crime,Vandalism,Male,13-17,6191,4559,1632,5435,756
2009,Rural,Goa,Crime Against Men,Robbery,Male,18-30,9048,4067,4981,8686,362
2008,Rural,Meghalaya,Crime Against Women,Dowry Deaths,Female,13-17,6588,902,5686,3328,3260
2009,Urban,Uttar Pradesh,Crime Against Women,Molestation,Female,0-12,5999,2065,3934,3541,2458
2002,Urban,Delhi,Crime Against Children,Kidnapping,Male,60+,7496,3695,3801,6128,1368
2008,Urban,Jharkhand,Crime Against Children,Child Labor,Female,13-17,7515,6264,1251,6494,1021
2003,Rural,Tamil Nadu,Other Crimes,Corruption,Male,31-45,2674,1030,1644,1693,981
2003,Rural,Rajasthan,Property Crime,Vandalism,Female,31-45,1233,999,234,1022,211
2009,Rural,Sikkim,Crime Against Women,Molestation,Female,60+,6448,5775,673,6251,197
2007,Urban,Bihar,Crime Against Women,Domestic Violence,Male,60+,7885,7668,217,7749,136
2004,Urban,Haryana,Other Crimes,Cyber Crime,Male,0-12,7936,1172,6764,6574,1362
2001,Rural,Punjab,Crime Against Men,Extortion,Male,60+,9724,4488,5236,4539,5185
2007,Rural,Tamil Nadu,Other Crimes,Corruption,Female,60+,2121,282,1839,1172,949
2004,Rural,Bihar,Crime Against Men,Assault,Female,0-12,381,170,211,301,80
2008,Urban,Meghalaya,Crime Against Women,Rape,Male,46-60,2080,1057,1023,1264,816
2009,Urban,Kerala,Crime Against Men,Extortion,Female,60+,3671,180,3491,1053,2618
2003,Rural,Mizoram,Crime Against Children,Child Labor,Female,31-45,247,26,221,153,94
2004,Urban,Gujarat,Crime Against Women,Domestic Violence,Female,13-17,6966,2070,4896,3227,3739
2003,Rural,West Bengal,Crime Against Men,Robbery,Female,46-60,4255,3927,328,4228,27
2008,Rural,Delhi,Property Crime,Arson,Female,60+,2536,822,1714,1554,982
2007,Urban,Uttar Pradesh,Property Crime,Theft,Female,18-30,3691,1180,2511,3289,402
2001,Urban,Jharkhand,Property Crime,Vandalism,Male,13-17,7551,4876,2675,5979,1572
2003,Rural,Uttar Pradesh,Other Crimes,Cyber Crime,Male,18-30,574,22,552,340,234
2009,Rural,Kerala,Other Crimes,Corruption,Female,18-30,1471,397,1074,1249,222
2009,Urban,Uttarakhand,Crime Against Women,Domestic Violence,Male,0-12,9586,1307,8279,5588,3998
2004,Urban,Jammu & Kashmir,Property Crime,Vandalism,Male,46-60,4120,644,3476,2362,1758
2002,Rural,Tamil Nadu,Crime Against Women,Molestation,Female,18-30,8190,3377,4813,4343,3847
2001,Urban,Uttar Pradesh,Crime Against Children,Child Abuse,Female,0-12,2640,2233,407,2383,257
2001,Urban,Odisha,Crime Against Children,Trafficking,Female,46-60,9935,8910,1025,9757,178
2005,Rural,Jammu & Kashmir,Crime Against Men,Murder,Male,46-60,6853,4375,2478,5595,1258
2008,Urban,Madhya Pradesh,Other Crimes,Fraud,Male,0-12,2417,1859,558,2031,386
2006,Rural,Meghalaya,Property Crime,Arson,Male,60+,1960,1403,557,1602,358
2006,Urban,Meghalaya,Other Crimes,Cyber Crime,Female,31-45,8502,3365,5137,4605,3897
2009,Urban,Gujarat,Crime Against Women,Dowry Deaths,Male,60+,9403,2393,7010,4957,4446
2002,Urban,Maharashtra,Property Crime,Vandalism,Female,0-12,6960,5103,1857,5794,1166
2005,Rural,Uttar Pradesh,Property Crime,Vandalism,Female,18-30,5088,592,4496,4201,887
2005,Rural,Andhra Pradesh,Property Crime,Vandalism,Female,18-30,7338,2834,4504,5688,1650
2007,Rural,Jammu & Kashmir,Property Crime,Arson,Female,18-30,9067,6512,2555,8506,561
2005,Rural,Jharkhand,Other Crimes,Fraud,Male,46-60,3792,2011,1781,3321,471
2003,Rural,Chhattisgarh,Property Crime,Theft,Male,46-60,9652,4491,5161,5515,4137
2002,Urban,Mizoram,Crime Against Men,Extortion,Female,13-17,177,17,160,136,41
2002,Rural,Assam,Crime Against Children,Child Labor,Female,0-12,6992,5771,1221,6314,678
2003,Rural,Odisha,Property Crime,Burglary,Female,18-30,9439,1859,7580,5143,4296
2007,Rural,Goa,Crime Against Women,Rape,Female,0-12,2501,2469,32,2490,11
2010,Rural,Haryana,Crime Against Children,Child Abuse,Male,13-17,4946,27,4919,1282,3664
2002,Rural,Mizoram,Other Crimes,Fraud,Male,60+,2091,1816,275,2081,10
2004,Rural,Sikkim,Crime Against Women,Domestic Violence,Male,31-45,4741,4086,655,4616,125
2010,Rural,Manipur,Crime Against Children,Trafficking,Male,0-12,1515,691,824,951,564
2003,Rural,Tamil Nadu,Crime Against Women,Domestic Violence,Female,13-17,329,284,45,311,18
2006,Rural,Sikkim,Crime Against Children,Child Labor,Male,31-45,622,472,150,618,4
2001,Rural,Odisha,Crime Against Women,Molestation,Male,18-30,6826,5505,1321,6063,763
2009,Urban,Telangana,Other Crimes,Drug Offense,Male,46-60,3274,2012,1262,2097,1177
2009,Rural,Telangana,Other Crimes,Cyber Crime,Male,46-60,624,304,320,562,62
2005,Urban,Bihar,Property Crime,Burglary,Male,46-60,6279,3897,2382,4819,1460
2006,Urban,Kerala,Crime Against Women,Molestation,Female,18-30,4963,95,4868,1894,3069
2004,Rural,Arunachal Pradesh,Crime Against Men,Robbery,Male,60+,4049,2417,1632,2823,1226
2001,Urban,Jharkhand,Property Crime,Theft,Male,13-17,1866,1447,419,1586,280
2002,Rural,Andhra Pradesh,Other Crimes,Cyber Crime,Female,13-17,4840,3567,1273,3588,1252
2007,Urban,Delhi,Crime Against Men,Murder,Female,60+,4821,1509,3312,2041,2780
2001,Rural,Odisha,Property Crime,Arson,Female,18-30,7137,1989,5148,5222,1915
2006,Rural,Goa,Other Crimes,Cyber Crime,Female,60+,5625,2236,3389,5054,571
2004,Urban,Meghalaya,Other Crimes,Corruption,Female,18-30,4300,1813,2487,4282,18
2004,Rural,Jharkhand,Crime Against Men,Murder,Male,31-45,4605,1008,3597,2129,2476
2009,Urban,Manipur,Crime Against Children,Trafficking,Male,60+,2692,2297,395,2333,359
2009,Rural,Chhattisgarh,Other Crimes,Drug Offense,Male,0-12,2687,2027,660,2610,77
2003,Urban,Tripura,Crime Against Women,Dowry Deaths,Female,18-30,995,932,63,960,35
2003,Urban,Telangana,Other Crimes,Corruption,Female,60+,7565,1803,5762,3673,3892
2004,Rural,Himachal Pradesh,Property Crime,Arson,Male,46-60,7329,1301,6028,3909,3420
2008,Rural,Mizoram,Crime Against Children,Child Labor,Female,46-60,9472,44,9428,5447,4025
2001,Rural,Delhi,Other Crimes,Corruption,Female,46-60,4292,1259,3033,3265,1027
2008,Urban,Tamil Nadu,Crime Against Women,Rape,Female,0-12,3796,1366,2430,2175,1621
2002,Urban,Karnataka,Crime Against Women,Dowry Deaths,Female,60+,8656,3454,5202,6792,1864
2010,Rural,Madhya Pradesh,Property Crime,Theft,Male,46-60,6488,6102,386,6156,332
2001,Urban,Odisha,Other Crimes,Corruption,Male,13-17,7028,3219,3809,3278,3750
2003,Urban,Odisha,Other Crimes,Corruption,Female,46-60,3593,2429,1164,3330,263
2005,Urban,Nagaland,Other Crimes,Corruption,Male,31-45,6168,4625,1543,5129,1039
2007,Rural,Jammu & Kashmir,Property Crime,Theft,Female,31-45,5877,5871,6,5871,6
2008,Urban,Mizoram,Crime Against Women,Molestation,Male,0-12,7595,3391,4204,4205,3390
2009,Rural,Kerala,Other Crimes,Drug Offense,Male,60+,2209,802,1407,1806,403
2008,Rural,Karnataka,Crime Against Women,Rape,Female,46-60,5412,2619,2793,3801,1611
2010,Urban,Meghalaya,Property Crime,Theft,Male,31-45,4539,751,3788,2426,2113
2010,Rural,Sikkim,Crime Against Children,Kidnapping,Female,60+,2779,1507,1272,1662,1117
2004,Rural,Tripura,Other Crimes,Cyber Crime,Female,13-17,2856,2273,583,2803,53
2006,Rural,Mizoram,Crime Against Women,Rape,Male,31-45,2561,2051,510,2223,338
2004,Urban,Kerala,Property Crime,Arson,Female,46-60,9716,8497,1219,9163,553
2007,Rural,Bihar,Crime Against Women,Dowry Deaths,Male,13-17,2393,406,1987,443,1950
2006,Urban,Maharashtra,Crime Against Children,Kidnapping,Male,18-30,1518,30,1488,1458,60
2001,Urban,Punjab,Crime Against Women,Domestic Violence,Female,46-60,5854,4402,1452,4994,860
2002,Rural,Karnataka,Property Crime,Arson,Male,13-17,966,452,514,700,266
2002,Urban,Goa,Crime Against Men,Robbery,Female,60+,3636,2815,821,3561,75
2001,Rural,Maharashtra,Crime Against Children,Kidnapping,Male,31-45,6123,1127,4996,2059,4064
2002,Rural,Meghalaya,Other Crimes,Cyber Crime,Female,60+,9490,1472,8018,2518,6972
2009,Rural,Odisha,Crime Against Women,Molestation,Female,46-60,5201,3563,1638,4008,1193
2009,Urban,Uttar Pradesh,Other Crimes,Corruption,Male,18-30,2627,11,2616,1902,725
2005,Urban,Bihar,Other Crimes,Cyber Crime,Female,13-17,3615,1219,2396,2127,1488
2010,Rural,Mizoram,Crime Against Children,Kidnapping,Female,18-30,4130,1460,2670,4084,46
2002,Urban,Mizoram,Crime Against Women,Rape,Male,46-60,4644,3661,983,3845,799
2006,Urban,Chhattisgarh,Crime Against Men,Assault,Female,0-12,4166,830,3336,957,3209
2007,Rural,Tripura,Crime Against Men,Murder,Male,18-30,6272,4093,2179,5922,350
2009,Urban,Himachal Pradesh,Crime Against Men,Robbery,Male,18-30,4818,242,4576,2705,2113
2003,Urban,Manipur,Crime Against Women,Domestic Violence,Female,31-45,7390,6299,1091,7303,87
2007,Rural,Tamil Nadu,Crime Against Women,Molestation,Female,13-17,6311,2522,3789,5032,1279
2005,Urban,Goa,Crime Against Men,Robbery,Male,0-12,6451,3918,2533,5518,933
2002,Rural,Kerala,Property Crime,Theft,Male,13-17,629,467,162,590,39
2004,Rural,Haryana,Other Crimes,Fraud,Female,18-30,2521,2299,222,2318,203
2001,Urban,Arunachal Pradesh,Property Crime,Arson,Male,0-12,2249,1444,805,1829,420
2009,Rural,Bihar,Crime Against Children,Kidnapping,Female,60+,1396,212,1184,1376,20
2005,Urban,Sikkim,Crime Against Men,Murder,Male,60+,7647,4924,2723,7273,374
2002,Rural,Sikkim,Crime Against Children,Kidnapping,Male,31-45,9107,3233,5874,6000,3107
2001,Urban,Goa,Property Crime,Burglary,Female,31-45,4635,1549,3086,2995,1640
2010,Urban,Haryana,Crime Against Men,Extortion,Male,18-30,596,308,288,484,112
2001,Urban,Gujarat,Crime Against Children,Child Abuse,Female,13-17,4459,4293,166,4316,143
2007,Urban,Tamil Nadu,Crime Against Women,Domestic Violence,Female,13-17,6215,1390,4825,5081,1134
2006,Urban,Kerala,Other Crimes,Fraud,Male,46-60,8036,7014,1022,7877,159
2006,Rural,Uttarakhand,Crime Against Men,Murder,Female,60+,6883,5948,935,6677,206
2009,Urban,Himachal Pradesh,Crime Against Women,Molestation,Male,13-17,6226,2294,3932,4212,2014
2010,Rural,Karnataka,Crime Against Children,Trafficking,Male,31-45,9804,6860,2944,7286,2518
2003,Urban,Telangana,Crime Against Men,Murder,Male,31-45,9783,6075,3708,7806,1977
2009,Urban,Goa,Crime Against Women,Molestation,Male,18-30,6731,1606,5125,4600,2131
2009,Rural,Mizoram,Crime Against Women,Rape,Male,31-45,6050,1997,4053,5295,755
2010,Rural,Sikkim,Property Crime,Arson,Female,31-45,1863,196,1667,1257,606
2008,Urban,Arunachal Pradesh,Crime Against Men,Robbery,Female,13-17,1116,764,352,840,276
2010,Rural,Kerala,Crime Against Women,Dowry Deaths,Female,46-60,3381,473,2908,1429,1952
2007,Urban,Maharashtra,Other Crimes,Drug Offense,Male,18-30,4977,1678,3299,4192,785
2001,Rural,Haryana,Crime Against Children,Child Abuse,Female,31-45,7326,625,6701,3623,3703
2002,Urban,Himachal Pradesh,Crime Against Children,Child Labor,Female,60+,4113,1932,2181,2403,1710
2010,Rural,Assam,Crime Against Children,Kidnapping,Female,13-17,5240,4377,863,5073,167
2001,Urban,Himachal Pradesh,Other Crimes,Fraud,Female,13-17,1201,1118,83,1146,55
2005,Rural,Tamil Nadu,Property Crime,Vandalism,Male,60+,3635,2131,1504,3376,259
2009,Urban,Odisha,Crime Against Men,Robbery,Male,46-60,590,183,407,316,274
2006,Rural,Kerala,Crime Against Children,Child Abuse,Female,31-45,7289,7259,30,7274,15
2008,Urban,Uttar Pradesh,Crime Against Children,Kidnapping,Female,31-45,9163,8179,984,8184,979
2004,Urban,Telangana,Crime Against Women,Dowry Deaths,Female,0-12,515,284,231,498,17
2005,Urban,Tamil Nadu,Property Crime,Arson,Male,13-17,679,141,538,643,36
2001,Urban,Madhya Pradesh,Crime Against Women,Molestation,Female,31-45,1303,19,1284,712,591
2008,Rural,Haryana,Property Crime,Arson,Female,18-30,3599,270,3329,730,2869
2002,Rural,Tripura,Other Crimes,Corruption,Male,18-30,7659,2865,4794,4246,3413
2009,Urban,Kerala,Other Crimes,Fraud,Male,18-30,3201,2707,494,2728,473
2008,Rural,Mizoram,Other Crimes,Corruption,Male,18-30,5089,1493,3596,2171,2918
2010,Urban,Manipur,Other Crimes,Drug Offense,Male,18-30,8353,4469,3884,7970,383
2001,Rural,Arunachal Pradesh,Crime Against Women,Dowry Deaths,Female,31-45,9377,2065,7312,5597,3780
2008,Rural,Kerala,Other Crimes,Fraud,Male,13-17,9533,5866,3667,6179,3354
2001,Urban,Meghalaya,Crime Against Men,Robbery,Female,31-45,1696,160,1536,1322,374
2010,Urban,Madhya Pradesh,Crime Against Women,Molestation,Female,13-17,3947,2528,1419,3290,657
2003,Rural,Haryana,Crime Against Women,Rape,Female,0-12,2063,1422,641,1542,521
2006,Rural,Assam,Other Crimes,Corruption,Female,18-30,8278,102,8176,3512,4766
2009,Rural,Karnataka,Other Crimes,Corruption,Female,31-45,2201,1598,603,1975,226
2007,Rural,Maharashtra,Crime Against Women,Rape,Female,18-30,6504,1695,4809,2747,3757
2004,Urban,Punjab,Crime Against Women,Molestation,Female,46-60,3404,1884,1520,2290,1114
2006,Rural,Chhattisgarh,Other Crimes,Fraud,Female,60+,9733,6755,2978,7081,2652
2006,Rural,Uttar Pradesh,Property Crime,Arson,Male,31-45,4061,2817,1244,3160,901
2002,Urban,Tamil Nadu,Other Crimes,Corruption,Female,31-45,9151,8968,183,9025,126
2002,Rural,Uttarakhand,Crime Against Women,Dowry Deaths,Male,31-45,3470,2745,725,2824,646
2007,Urban,Maharashtra,Property Crime,Vandalism,Male,18-30,2968,863,2105,2871,97
2010,Urban,Kerala,Crime Against Children,Kidnapping,Female,0-12,1515,667,848,1155,360
2001,Rural,Arunachal Pradesh,Other Crimes,Drug Offense,Female,60+,4122,3447,675,3661,461
2004,Rural,Tamil Nadu,Property Crime,Theft,Male,31-45,7822,5142,2680,5673,2149
2003,Rural,Andhra Pradesh,Crime Against Women,Domestic Violence,Female,31-45,6814,1606,5208,1980,4834
2002,Urban,Mizoram,Crime Against Women,Dowry Deaths,Male,46-60,3595,2625,970,3320,275
2005,Rural,Sikkim,Crime Against Men,Murder,Female,18-30,3075,2300,775,2612,463
2002,Urban,Bihar,Crime Against Men,Robbery,Female,31-45,6012,3656,2356,5058,954
2004,Urban,Meghalaya,Crime Against Women,Rape,Male,0-12,8042,3420,4622,7371,671
2003,Urban,Nagaland,Property Crime,Vandalism,Female,18-30,2090,1721,369,1886,204
2003,Rural,Rajasthan,Crime Against Children,Child Labor,Female,0-12,2804,2434,370,2451,353
2009,Urban,Bihar,Crime Against Women,Domestic Violence,Male,31-45,979,496,483,781,198
2010,Rural,Madhya Pradesh,Crime Against Children,Child Labor,Male,60+,9053,8687,366,8919,134
2009,Rural,Haryana,Crime Against Women,Domestic Violence,Male,0-12,1277,442,835,1071,206
2009,Urban,Meghalaya,Crime Against Women,Domestic Violence,Male,0-12,637,346,291,575,62
2010,Rural,Rajasthan,Other Crimes,Drug Offense,Male,31-45,8204,1173,7031,7165,1039
2006,Urban,Delhi,Other Crimes,Corruption,Male,46-60,2581,1186,1395,2537,44
2005,Rural,Manipur,Crime Against Women,Dowry Deaths,Female,13-17,5662,1597,4065,5268,394
2010,Urban,Mizoram,Crime Against Children,Trafficking,Female,0-12,6194,2342,3852,5229,965
2008,Rural,Jharkhand,Other Crimes,Cyber Crime,Male,18-30,9264,3190,6074,4569,4695
2005,Urban,Manipur,Other Crimes,Cyber Crime,Female,46-60,3857,821,3036,3192,665
2004,Urban,Meghalaya,Property Crime,Arson,Male,13-17,9337,2455,6882,3323,6014
2004,Rural,Gujarat,Property Crime,Arson,Female,18-30,3817,615,3202,1540,2277
2007,Rural,Jharkhand,Crime Against Children,Child Abuse,Female,60+,2217,466,1751,1177,1040
2002,Rural,Madhya Pradesh,Crime Against Women,Rape,Male,31-45,1200,1056,144,1117,83
2004,Rural,Meghalaya,Other Crimes,Corruption,Female,0-12,9436,8580,856,9312,124
2008,Urban,Meghalaya,Property Crime,Arson,Male,31-45,6138,1958,4180,5986,152
2005,Rural,West Bengal,Crime Against Men,Assault,Female,0-12,2486,583,1903,950,1536
2002,Urban,Punjab,Crime Against Children,Child Abuse,Male,0-12,3773,1487,2286,1495,2278
2007,Urban,Sikkim,Crime Against Children,Child Labor,Female,60+,1667,1626,41,1641,26
2005,Urban,Uttarakhand,Other Crimes,Drug Offense,Male,18-30,9110,6617,2493,7633,1477
2007,Rural,Jammu & Kashmir,Crime Against Men,Assault,Male,60+,2510,1342,1168,1496,1014
2008,Rural,Telangana,Crime Against Women,Domestic Violence,Female,18-30,8070,4636,3434,5929,2141
2002,Urban,Himachal Pradesh,Crime Against Children,Trafficking,Female,31-45,1154,195,959,976,178
2007,Rural,West Bengal,Crime Against Women,Dowry Deaths,Female,18-30,1752,1408,344,1558,194
2003,Rural,Nagaland,Crime Against Women,Domestic Violence,Male,0-12,5532,2312,3220,4560,972
2001,Rural,Manipur,Crime Against Women,Domestic Violence,Male,46-60,3968,3661,307,3775,193
2002,Rural,Gujarat,Crime Against Men,Murder,Male,0-12,5996,818,5178,3118,2878
2005,Urban,Uttarakhand,Crime Against Men,Murder,Female,13-17,1392,1028,364,1083,309
2003,Rural,Uttarakhand,Other Crimes,Cyber Crime,Male,0-12,3987,3953,34,3961,26
2001,Urban,Delhi,Other Crimes,Fraud,Female,13-17,2963,519,2444,1154,1809
2009,Rural,Uttarakhand,Crime Against Men,Extortion,Male,31-45,4108,1546,2562,3527,581
2007,Rural,Mizoram,Crime Against Women,Molestation,Female,60+,1638,624,1014,1047,591
2006,Urban,Tamil Nadu,Crime Against Men,Robbery,Male,31-45,9218,6635,2583,7941,1277
2010,Rural,Sikkim,Crime Against Men,Robbery,Male,13-17,5981,2490,3491,5444,537
2001,Rural,Arunachal Pradesh,Other Crimes,Corruption,Male,31-45,7227,6779,448,7119,108
2004,Urban,Nagaland,Crime Against Men,Extortion,Male,31-45,7500,2655,4845,7010,490
2008,Rural,Chhattisgarh,Property Crime,Vandalism,Male,18-30,189,45,144,78,111
2002,Urban,Rajasthan,Crime Against Women,Domestic Violence,Female,18-30,8877,2976,5901,8459,418
2003,Urban,Uttar Pradesh,Crime Against Children,Trafficking,Male,13-17,8623,5449,3174,7435,1188
2003,Rural,Arunachal Pradesh,Other Crimes,Cyber Crime,Female,13-17,7017,6433,584,6765,252
2010,Urban,Jammu & Kashmir,Crime Against Children,Kidnapping,Male,13-17,5934,4801,1133,5085,849
2006,Urban,Tripura,Crime Against Men,Murder,Male,31-45,2504,625,1879,728,1776
2008,Urban,Bihar,Other Crimes,Corruption,Female,31-45,2135,119,2016,442,1693
2008,Urban,Bihar,Crime Against Children,Child Abuse,Male,60+,5367,75,5292,4629,738
2006,Urban,Uttarakhand,Crime Against Children,Child Labor,Female,31-45,7106,5846,1260,6708,398
2008,Rural,West Bengal,Crime Against Children,Child Labor,Female,13-17,5888,1473,4415,2043,3845
2009,Rural,Jharkhand,Crime Against Children,Child Labor,Male,46-60,6697,2398,4299,4787,1910
2008,Rural,Gujarat,Crime Against Men,Murder,Female,13-17,5083,79,5004,1678,3405
2004,Urban,Haryana,Crime Against Men,Assault,Female,31-45,7828,6978,850,7055,773
2005,Rural,Jharkhand,Crime Against Women,Dowry Deaths,Female,46-60,2430,1510,920,1598,832
2007,Urban,Bihar,Other Crimes,Corruption,Male,46-60,9577,8341,1236,9104,473
2001,Rural,West Bengal,Other Crimes,Cyber Crime,Female,31-45,1992,222,1770,439,1553
2008,Rural,Madhya Pradesh,Crime Against Women,Molestation,Female,0-12,8960,3664,5296,3881,5079
2006,Rural,Kerala,Crime Against Men,Extortion,Female,0-12,786,175,611,534,252
2009,Rural,Sikkim,Other Crimes,Cyber Crime,Female,46-60,4985,4963,22,4970,15
2006,Rural,Nagaland,Property Crime,Burglary,Female,13-17,8516,6709,1807,7581,935
2010,Rural,Manipur,Property Crime,Arson,Female,13-17,4240,3628,612,4015,225
2007,Urban,Uttar Pradesh,Property Crime,Arson,Male,60+,8201,5800,2401,6638,1563
2008,Rural,Kerala,Crime Against Children,Child Abuse,Female,46-60,7148,3356,3792,4299,2849
2003,Rural,Arunachal Pradesh,Crime Against Men,Robbery,Female,13-17,288,242,46,263,25
2006,Urban,West Bengal,Property Crime,Theft,Female,18-30,7512,3727,3785,5052,2460
2006,Rural,Tripura,Crime Against Women,Molestation,Male,18-30,7067,1530,5537,3534,3533
2010,Rural,Tamil Nadu,Property Crime,Vandalism,Female,31-45,1926,1085,841,1772,154
2009,Urban,Andhra Pradesh,Crime Against Men,Extortion,Male,46-60,288,213,75,227,61
2004,Rural,Manipur,Property Crime,Vandalism,Male,0-12,5074,3880,1194,4590,484
2005,Urban,Kerala,Crime Against Women,Domestic Violence,Male,0-12,5629,34,5595,5485,144
2010,Rural,Telangana,Property Crime,Theft,Female,46-60,1280,1173,107,1239,41
2002,Urban,Punjab,Property Crime,Vandalism,Male,18-30,4042,2259,1783,3167,875
2005,Urban,Maharashtra,Property Crime,Burglary,Female,31-45,4076,129,3947,2509,1567
2001,Urban,Himachal Pradesh,Other Crimes,Corruption,Male,31-45,7445,5270,2175,7107,338
2010,Rural,Rajasthan,Crime Against Men,Robbery,Female,31-45,161,143,18,159,2
2005,Rural,Karnataka,Crime Against Women,Dowry Deaths,Male,13-17,3087,2885,202,2983,104
2010,Urban,Goa,Crime Against Men,Assault,Male,13-17,6193,287,5906,4627,1566
2007,Rural,Punjab,Crime Against Children,Trafficking,Male,18-30,5452,3433,2019,4756,696
2010,Urban,Mizoram,Other Crimes,Drug Offense,Female,13-17,5201,1086,4115,3793,1408
2007,Rural,Bihar,Crime Against Children,Kidnapping,Female,18-30,7286,3694,3592,6106,1180
2004,Urban,Arunachal Pradesh,Property Crime,Burglary,Female,13-17,1578,27,1551,808,770
2006,Rural,Haryana,Crime Against Children,Child Labor,Male,31-45,4645,3910,735,4326,319
2003,Urban,Meghalaya,Property Crime,Arson,Male,31-45,9806,4208,5598,4230,5576
2005,Rural,Jammu & Kashmir,Crime Against Women,Molestation,Male,13-17,8336,6764,1572,7357,979
2009,Rural,Nagaland,Property Crime,Arson,Female,0-12,68,40,28,66,2
2006,Rural,Mizoram,Other Crimes,Drug Offense,Male,46-60,4059,1593,2466,3906,153
2009,Urban,Telangana,Other Crimes,Corruption,Female,31-45,3618,2930,688,3080,538
2002,Urban,Telangana,Crime Against Children,Child Abuse,Female,46-60,7895,7613,282,7864,31
2005,Urban,Uttarakhand,Crime Against Children,Kidnapping,Female,46-60,5710,4870,840,5136,574
2007,Urban,Madhya Pradesh,Property Crime,Vandalism,Male,46-60,5574,4749,825,5373,201
2003,Rural,Odisha,Crime Against Men,Murder,Male,0-12,3021,2584,437,2979,42
2005,Rural,Punjab,Property Crime,Burglary,Male,13-17,1476,107,1369,799,677
2001,Rural,Mizoram,Property Crime,Vandalism,Male,0-12,1723,21,1702,1546,177
2010,Urban,Jammu & Kashmir,Crime Against Women,Rape,Male,0-12,5724,4153,1571,5572,152
2009,Urban,Himachal Pradesh,Crime Against Women,Rape,Female,31-45,3260,1553,1707,2006,1254
2007,Rural,Haryana,Other Crimes,Fraud,Female,60+,9139,7364,1775,8683,456
2007,Urban,Punjab,Crime Against Men,Extortion,Female,31-45,5144,1792,3352,4602,542
2009,Rural,Punjab,Crime Against Children,Trafficking,Female,31-45,3526,2714,812,3111,415
2008,Rural,Nagaland,Crime Against Children,Trafficking,Female,18-30,7688,7170,518,7360,328
2006,Urban,Meghalaya,Crime Against Children,Child Abuse,Female,18-30,9187,5035,4152,8250,937
2009,Rural,Gujarat,Other Crimes,Cyber Crime,Female,18-30,4021,202,3819,3326,695
2001,Urban,Karnataka,Crime Against Women,Rape,Male,0-12,2259,220,2039,1671,588
2007,Rural,Gujarat,Property Crime,Arson,Male,60+,8131,7703,428,7791,340
2008,Rural,Punjab,Crime Against Children,Child Abuse,Male,18-30,4271,2831,1440,3774,497
2004,Rural,Arunachal Pradesh,Property Crime,Burglary,Male,18-30,3524,2611,913,2699,825
2002,Urban,Telangana,Crime Against Children,Child Abuse,Male,18-30,2042,475,1567,1732,310
2004,Rural,Goa,Crime Against Men,Assault,Female,0-12,7918,3875,4043,5685,2233
2009,Rural,Mizoram,Crime Against Children,Kidnapping,Male,31-45,5965,399,5566,5103,862
2003,Rural,Manipur,Crime Against Children,Trafficking,Male,13-17,6924,3872,3052,4804,2120
2007,Urban,Mizoram,Crime Against Men,Extortion,Male,0-12,1877,129,1748,839,1038
2003,Urban,Chhattisgarh,Property Crime,Burglary,Male,18-30,4275,1166,3109,1456,2819
2006,Urban,Assam,Crime Against Men,Robbery,Male,0-12,8705,254,8451,1686,7019
2004,Urban,Sikkim,Crime Against Men,Assault,Female,46-60,4542,3341,1201,3938,604
2007,Rural,Maharashtra,Crime Against Men,Murder,Male,60+,1775,541,1234,1201,574
2006,Rural,Himachal Pradesh,Property Crime,Vandalism,Male,60+,938,624,314,890,48
2006,Rural,Karnataka,Property Crime,Vandalism,Male,46-60,4834,2693,2141,3172,1662
2005,Urban,Jammu & Kashmir,Other Crimes,Corruption,Male,31-45,3197,1234,1963,1577,1620
2007,Urban,Tripura,Crime Against Women,Domestic Violence,Female,0-12,1922,1302,620,1770,152
2007,Rural,Punjab,Crime Against Children,Kidnapping,Male,0-12,8831,1743,7088,2315,6516
2002,Rural,Goa,Property Crime,Vandalism,Male,13-17,1318,295,1023,967,351
2002,Rural,Uttarakhand,Crime Against Women,Dowry Deaths,Male,60+,2264,1777,487,2045,219
2008,Rural,Mizoram,Crime Against Children,Child Abuse,Male,18-30,9565,3449,6116,7854,1711
2005,Urban,Karnataka,Other Crimes,Fraud,Female,60+,825,427,398,825,0
2009,Urban,Maharashtra,Crime Against Women,Dowry Deaths,Female,60+,8063,3324,4739,6235,1828
2001,Urban,Tamil Nadu,Crime Against Children,Child Labor,Male,0-12,7561,2155,5406,5933,1628
2002,Rural,Himachal Pradesh,Property Crime,Vandalism,Female,0-12,8561,6481,2080,7710,851
2007,Rural,Jammu & Kashmir,Property Crime,Theft,Male,60+,7199,919,6280,7070,129
2010,Urban,Mizoram,Other Crimes,Cyber Crime,Male,13-17,4197,2007,2190,3368,829
2009,Urban,West Bengal,Crime Against Children,Trafficking,Male,60+,7768,1796,5972,3862,3906
2007,Urban,Rajasthan,Other Crimes,Fraud,Male,13-17,3933,495,3438,510,3423
2002,Rural,Tamil Nadu,Property Crime,Theft,Male,18-30,7893,1651,6242,3135,4758
2006,Urban,Rajasthan,Crime Against Children,Trafficking,Male,60+,1844,1810,34,1842,2
2010,Urban,Jharkhand,Other Crimes,Corruption,Male,60+,7673,5306,2367,6245,1428
2009,Urban,Himachal Pradesh,Crime Against Women,Dowry Deaths,Female,18-30,1294,885,409,1218,76
2008,Rural,Nagaland,Crime Against Children,Child Labor,Female,46-60,7373,6689,684,7051,322
2007,Urban,Madhya Pradesh,Other Crimes,Cyber Crime,Male,46-60,9717,9382,335,9520,197
2005,Urban,West Bengal,Other Crimes,Cyber Crime,Female,13-17,6811,1393,5418,1712,5099
2002,Urban,Odisha,Crime Against Men,Extortion,Male,13-17,9949,9180,769,9304,645
2001,Rural,Telangana,Crime Against Men,Murder,Female,0-12,5399,4593,806,4942,457
2004,Urban,Uttar Pradesh,Property Crime,Vandalism,Female,60+,2817,1775,1042,1793,1024
2003,Urban,West Bengal,Crime Against Children,Child Abuse,Male,18-30,7934,2533,5401,5896,2038
2001,Rural,Punjab,Crime Against Men,Murder,Female,60+,1074,214,860,734,340
2003,Urban,Tripura,Property Crime,Burglary,Male,0-12,4862,2071,2791,3089,1773
2009,Rural,Uttarakhand,Other Crimes,Cyber Crime,Female,13-17,1896,1870,26,1870,26
2009,Urban,Nagaland,Crime Against Women,Rape,Male,18-30,1542,560,982,750,792
2007,Urban,Delhi,Crime Against Men,Murder,Female,46-60,4114,915,3199,4108,6
2004,Urban,Tripura,Crime Against Children,Child Labor,Male,31-45,9275,2680,6595,5114,4161
2006,Rural,Tamil Nadu,Crime Against Men,Robbery,Female,0-12,8646,7419,1227,7501,1145
2004,Rural,Uttarakhand,Crime Against Women,Molestation,Female,31-45,6692,417,6275,6301,391
2002,Urban,Meghalaya,Property Crime,Theft,Male,31-45,4049,1153,2896,3714,335
2007,Rural,Gujarat,Crime Against Men,Extortion,Male,46-60,1584,217,1367,442,1142
2007,Rural,Karnataka,Crime Against Women,Molestation,Male,60+,5859,5444,415,5818,41
2006,Rural,Mizoram,Crime Against Men,Robbery,Female,46-60,2885,1065,1820,1550,1335
2002,Urban,Gujarat,Crime Against Women,Rape,Male,0-12,9100,6172,2928,8018,1082
2007,Rural,Karnataka,Other Crimes,Fraud,Male,13-17,2279,1183,1096,1739,540
2001,Rural,Telangana,Property Crime,Burglary,Female,0-12,1136,602,534,843,293
2005,Rural,Telangana,Crime Against Women,Dowry Deaths,Female,46-60,5352,3663,1689,5221,131
2003,Rural,Meghalaya,Crime Against Children,Child Abuse,Female,18-30,6832,660,6172,893,5939
2008,Rural,Sikkim,Crime Against Men,Murder,Male,60+,6836,4177,2659,4455,2381
2009,Urban,Andhra Pradesh,Crime Against Children,Trafficking,Female,31-45,5209,1112,4097,3066,2143
2004,Urban,Uttar Pradesh,Crime Against Women,Dowry Deaths,Male,46-60,8676,3530,5146,8064,612
2004,Urban,Chhattisgarh,Crime Against Children,Kidnapping,Female,13-17,3973,1890,2083,3506,467
2010,Urban,Uttarakhand,Property Crime,Vandalism,Female,46-60,4430,2733,1697,3791,639
2006,Rural,Goa,Crime Against Children,Trafficking,Female,18-30,9588,3248,6340,7523,2065
2008,Rural,Odisha,Other Crimes,Corruption,Female,60+,7948,4334,3614,4984,2964
2010,Rural,Tripura,Other Crimes,Cyber Crime,Male,31-45,2369,662,1707,1083,1286
2009,Urban,Uttar Pradesh,Property Crime,Vandalism,Female,13-17,2488,1357,1131,1520,968
2003,Rural,Sikkim,Crime Against Children,Child Labor,Male,60+,3345,2337,1008,3166,179
2009,Urban,Jharkhand,Crime Against Men,Assault,Female,46-60,1772,814,958,880,892
2002,Rural,Bihar,Other Crimes,Drug Offense,Female,31-45,1759,1614,145,1638,121
2005,Urban,Mizoram,Crime Against Men,Extortion,Male,31-45,3414,1244,2170,1244,2170
2008,Rural,Gujarat,Crime Against Men,Assault,Female,46-60,9838,373,9465,2152,7686
2008,Rural,Andhra Pradesh,Crime Against Children,Child Labor,Female,0-12,1330,1303,27,1303,27
2010,Urban,Manipur,Crime Against Men,Assault,Female,0-12,6710,6026,684,6176,534
2010,Urban,Andhra Pradesh,Crime Against Men,Assault,Male,18-30,4172,1567,2605,2597,1575
2007,Rural,Gujarat,Property Crime,Arson,Female,31-45,6744,4333,2411,6633,111
2004,Urban,Himachal Pradesh,Other Crimes,Corruption,Female,0-12,3260,323,2937,3240,20
2009,Rural,Tripura,Crime Against Men,Extortion,Male,31-45,1921,1715,206,1786,135
2007,Rural,Arunachal Pradesh,Crime Against Men,Robbery,Female,13-17,9175,3827,5348,7546,1629
2009,Urban,Karnataka,Property Crime,Arson,Male,13-17,667,607,60,646,21
2006,Rural,Maharashtra,Crime Against Children,Kidnapping,Male,18-30,6104,758,5346,4555,1549
2002,Rural,Jharkhand,Crime Against Men,Assault,Female,0-12,987,752,235,921,66
2010,Urban,Kerala,Other Crimes,Corruption,Male,60+,6205,2563,3642,3793,2412
2007,Rural,Sikkim,Crime Against Men,Robbery,Female,31-45,2606,123,2483,1608,998
2002,Rural,Jammu & Kashmir,Crime Against Children,Kidnapping,Female,0-12,6151,1372,4779,4577,1574
2007,Urban,Mizoram,Property Crime,Vandalism,Male,13-17,8432,7481,951,8319,113
2002,Rural,Bihar,Crime Against Children,Child Labor,Male,60+,3241,1151,2090,2364,877
2010,Rural,Haryana,Property Crime,Arson,Female,31-45,861,800,61,843,18
2007,Urban,Sikkim,Crime Against Children,Trafficking,Female,60+,4254,2507,1747,2959,1295
2003,Urban,Jharkhand,Crime Against Children,Kidnapping,Female,13-17,4016,3886,130,3956,60
2003,Urban,Uttar Pradesh,Other Crimes,Cyber Crime,Male,46-60,9670,9620,50,9635,35
2001,Rural,Mizoram,Crime Against Men,Murder,Female,18-30,6400,2871,3529,3366,3034
2006,Urban,Madhya Pradesh,Property Crime,Burglary,Female,46-60,7797,3074,4723,6933,864
2002,Rural,Madhya Pradesh,Crime Against Women,Rape,Male,0-12,4608,2504,2104,2800,1808
2005,Rural,Karnataka,Crime Against Children,Child Labor,Male,0-12,7986,4237,3749,7005,981
2001,Urban,Meghalaya,Property Crime,Arson,Male,31-45,2103,1438,665,1576,527
2010,Urban,Karnataka,Crime Against Women,Rape,Male,46-60,3728,362,3366,2649,1079
2003,Rural,Assam,Property Crime,Theft,Male,0-12,7699,2779,4920,6133,1566
2008,Urban,Telangana,Crime Against Women,Domestic Violence,Female,60+,1154,635,519,715,439
2010,Urban,Haryana,Other Crimes,Drug Offense,Male,0-12,9835,9617,218,9634,201
2005,Rural,Arunachal Pradesh,Crime Against Children,Trafficking,Male,18-30,9537,9252,285,9301,236
2006,Urban,Bihar,Crime Against Women,Dowry Deaths,Female,18-30,257,66,191,151,106
2001,Rural,Madhya Pradesh,Property Crime,Theft,Female,18-30,6555,5414,1141,5739,816
2004,Urban,Rajasthan,Crime Against Women,Domestic Violence,Male,0-12,600,109,491,494,106
2003,Urban,Haryana,Property Crime,Vandalism,Female,0-12,5842,547,5295,4873,969
2006,Rural,Uttarakhand,Property Crime,Burglary,Female,31-45,3360,1202,2158,3143,217
2009,Urban,Arunachal Pradesh,Crime Against Women,Molestation,Female,31-45,2033,137,1896,524,1509
2002,Rural,Telangana,Crime Against Men,Extortion,Female,60+,5755,1410,4345,3537,2218
2001,Urban,Assam,Crime Against Men,Extortion,Female,18-30,4499,3268,1231,4426,73
2004,Rural,Tamil Nadu,Property Crime,Theft,Female,13-17,1181,331,850,1157,24
2007,Urban,Bihar,Property Crime,Arson,Male,18-30,3550,2135,1415,2268,1282
2006,Rural,Mizoram,Crime Against Men,Murder,Male,13-17,7684,3377,4307,6466,1218
2009,Rural,Jammu & Kashmir,Crime Against Children,Kidnapping,Female,18-30,7668,123,7545,4805,2863
2004,Rural,West Bengal,Crime Against Children,Kidnapping,Male,0-12,3493,1709,1784,1985,1508
2008,Rural,Madhya Pradesh,Crime Against Children,Child Labor,Female,18-30,7963,3853,4110,4056,3907
2006,Rural,Himachal Pradesh,Property Crime,Burglary,Female,31-45,6606,444,6162,5567,1039
2002,Urban,Nagaland,Crime Against Men,Assault,Male,0-12,4371,3539,832,4161,210
2009,Rural,Delhi,Crime Against Children,Trafficking,Male,31-45,7754,5418,2336,7068,686
2007,Urban,Manipur,Other Crimes,Drug Offense,Female,0-12,1670,362,1308,707,963
2010,Urban,Odisha,Crime Against Women,Domestic Violence,Female,13-17,6763,262,6501,6043,720
2006,Urban,Bihar,Crime Against Children,Child Abuse,Female,31-45,784,609,175,716,68
2004,Urban,Karnataka,Crime Against Women,Molestation,Male,60+,3814,299,3515,682,3132
2010,Urban,Chhattisgarh,Crime Against Men,Murder,Female,60+,7206,6996,210,7062,144
2006,Urban,Manipur,Crime Against Men,Murder,Male,60+,3370,135,3235,389,2981
2004,Urban,Assam,Crime Against Men,Robbery,Male,31-45,3148,88,3060,1395,1753
2009,Rural,Odisha,Crime Against Men,Extortion,Male,13-17,6257,144,6113,3675,2582
2008,Urban,Goa,Crime Against Women,Dowry Deaths,Female,46-60,8228,6231,1997,6934,1294
2006,Urban,Bihar,Crime Against Women,Rape,Male,46-60,4736,3847,889,3921,815
2003,Rural,Gujarat,Crime Against Men,Assault,Female,46-60,674,207,467,331,343
2002,Urban,Nagaland,Crime Against Children,Child Abuse,Female,13-17,1174,1026,148,1117,57
2009,Rural,Goa,Crime Against Men,Assault,Male,0-12,3237,1054,2183,2528,709
2006,Urban,Jharkhand,Crime Against Men,Robbery,Female,46-60,4473,637,3836,2573,1900
2002,Urban,Delhi,Crime Against Women,Molestation,Male,18-30,3501,257,3244,2190,1311
2007,Urban,Assam,Crime Against Children,Kidnapping,Male,31-45,4250,670,3580,1102,3148
2005,Urban,Kerala,Crime Against Women,Rape,Female,0-12,9477,6799,2678,7329,2148
2005,Rural,Arunachal Pradesh,Property Crime,Arson,Female,60+,3915,2059,1856,3795,120
2008,Rural,Meghalaya,Property Crime,Vandalism,Female,60+,9497,1804,7693,4355,5142
2004,Rural,Manipur,Crime Against Men,Murder,Male,31-45,7310,4966,2344,6883,427
2008,Rural,Assam,Crime Against Men,Extortion,Male,18-30,5097,168,4929,4383,714
2001,Rural,Karnataka,Crime Against Children,Trafficking,Male,13-17,6928,2842,4086,6173,755
2001,Rural,Nagaland,Crime Against Men,Robbery,Female,46-60,2830,2163,667,2818,12
2007,Urban,Madhya Pradesh,Crime Against Women,Molestation,Female,46-60,3440,934,2506,2686,754
2008,Urban,Mizoram,Property Crime,Arson,Female,13-17,9108,5963,3145,7242,1866
2005,Rural,Madhya Pradesh,Property Crime,Theft,Male,13-17,5091,3122,1969,4072,1019
2003,Rural,Assam,Crime Against Women,Domestic Violence,Female,60+,8318,2883,5435,4235,4083
2005,Rural,Goa,Property Crime,Vandalism,Male,13-17,9304,4946,4358,7402,1902
2008,Rural,Gujarat,Property Crime,Arson,Female,31-45,1557,1387,170,1427,130
2002,Urban,Manipur,Property Crime,Theft,Male,60+,252,237,15,248,4
2004,Rural,Sikkim,Crime Against Men,Extortion,Female,46-60,4636,4505,131,4585,51
2005,Urban,Assam,Crime Against Children,Trafficking,Male,0-12,6818,750,6068,3435,3383
2005,Rural,Delhi,Crime Against Children,Kidnapping,Male,13-17,648,276,372,510,138
2009,Rural,Telangana,Crime Against Children,Trafficking,Female,46-60,5168,5124,44,5128,40
2009,Urban,Gujarat,Crime Against Children,Child Abuse,Female,0-12,9370,7009,2361,8161,1209
2002,Urban,Kerala,Crime Against Children,Child Abuse,Male,18-30,1105,1008,97,1030,75
2003,Urban,Sikkim,Other Crimes,Corruption,Female,46-60,9830,1251,8579,4340,5490
2002,Rural,Jammu & Kashmir,Other Crimes,Cyber Crime,Male,13-17,5467,4201,1266,4915,552
2004,Rural,Rajasthan,Crime Against Men,Assault,Female,60+,6593,1962,4631,5386,1207
2001,Urban,West Bengal,Crime Against Children,Child Labor,Female,13-17,4787,2314,2473,2763,2024
2003,Rural,Punjab,Crime Against Men,Assault,Male,46-60,6391,3202,3189,3238,3153
2005,Rural,Haryana,Property Crime,Burglary,Male,31-45,7040,6959,81,6995,45
2005,Urban,Andhra Pradesh,Other Crimes,Drug Offense,Male,18-30,7253,1306,5947,3154,4099
2007,Urban,Mizoram,Crime Against Children,Kidnapping,Male,46-60,1069,908,161,1033,36
2010,Urban,Manipur,Crime Against Men,Robbery,Male,13-17,4897,3572,1325,4077,820
2009,Rural,Meghalaya,Other Crimes,Drug Offense,Female,31-45,9986,2521,7465,7356,2630
2010,Rural,Andhra Pradesh,Crime Against Women,Dowry Deaths,Male,60+,233,217,16,222,11
2002,Urban,Nagaland,Crime Against Men,Assault,Female,31-45,5373,1377,3996,2331,3042
2008,Rural,Himachal Pradesh,Other Crimes,Fraud,Female,46-60,4484,4344,140,4382,102
2007,Urban,Himachal Pradesh,Other Crimes,Drug Offense,Female,46-60,9785,6930,2855,7524,2261
2003,Rural,Goa,Property Crime,Burglary,Male,31-45,3235,465,2770,887,2348
2009,Rural,Chhattisgarh,Property Crime,Theft,Male,46-60,872,44,828,813,59
2005,Urban,Maharashtra,Property Crime,Vandalism,Female,31-45,8544,3243,5301,5225,3319
2005,Rural,Chhattisgarh,Crime Against Women,Rape,Male,60+,7452,6908,544,7267,185
2001,Rural,Karnataka,Other Crimes,Cyber Crime,Male,60+,5919,3480,2439,3493,2426
2001,Rural,Kerala,Crime Against Men,Murder,Male,46-60,1486,1484,2,1486,0
2008,Urban,Telangana,Crime Against Women,Rape,Female,46-60,6778,5953,825,6440,338
2010,Urban,Andhra Pradesh,Property Crime,Burglary,Male,46-60,6526,2915,3611,3467,3059
2005,Urban,Jharkhand,Property Crime,Burglary,Male,31-45,8176,1840,6336,2072,6104
2005,Urban,Madhya Pradesh,Other Crimes,Corruption,Male,0-12,6931,3384,3547,6537,394
2003,Urban,Karnataka,Other Crimes,Cyber Crime,Female,31-45,9326,4301,5025,6966,2360
2010,Urban,Punjab,Crime Against Children,Child Labor,Male,18-30,8380,5467,2913,7757,623
2006,Urban,Madhya Pradesh,Crime Against Children,Trafficking,Female,13-17,8790,7390,1400,8209,581
2003,Urban,Jharkhand,Property Crime,Burglary,Male,0-12,8420,3730,4690,7368,1052
2001,Urban,Punjab,Other Crimes,Corruption,Female,18-30,2538,2061,477,2444,94
2005,Rural,Goa,Other Crimes,Cyber Crime,Female,0-12,5390,1153,4237,3673,1717
2006,Rural,Madhya Pradesh,Crime Against Women,Dowry Deaths,Male,0-12,1365,350,1015,698,667
2001,Urban,West Bengal,Property Crime,Arson,Female,46-60,8426,3511,4915,6828,1598
2010,Urban,Delhi,Crime Against Women,Domestic Violence,Female,60+,7599,355,7244,1969,5630
2008,Urban,Rajasthan,Property Crime,Vandalism,Female,13-17,757,122,635,126,631
2005,Urban,Odisha,Other Crimes,Drug Offense,Female,31-45,9184,691,8493,9096,88
2008,Urban,Meghalaya,Crime Against Women,Molestation,Female,60+,4710,3865,845,3873,837
2007,Rural,Rajasthan,Crime Against Children,Child Labor,Female,0-12,4688,1448,3240,3261,1427
2002,Rural,Maharashtra,Other Crimes,Corruption,Male,60+,6432,2368,4064,3662,2770
2002,Rural,Punjab,Crime Against Women,Domestic Violence,Male,31-45,1267,906,361,1261,6
2008,Rural,Gujarat,Property Crime,Vandalism,Female,31-45,7890,1272,6618,4988,2902
2009,Rural,Uttarakhand,Crime Against Children,Child Abuse,Female,31-45,5430,2464,2966,3815,1615
2002,Rural,Jharkhand,Other Crimes,Corruption,Female,0-12,7546,5191,2355,5371,2175
2006,Urban,Andhra Pradesh,Other Crimes,Drug Offense,Female,0-12,768,9,759,347,421
2008,Rural,Nagaland,Crime Against Children,Kidnapping,Male,18-30,2878,2871,7,2871,7
2002,Urban,Maharashtra,Crime Against Women,Dowry Deaths,Female,0-12,110,29,81,30,80
2004,Rural,Odisha,Property Crime,Arson,Female,31-45,8014,1062,6952,7131,883
2003,Urban,Uttarakhand,Crime Against Children,Child Abuse,Female,31-45,8929,7922,1007,8907,22
2008,Urban,Jammu & Kashmir,Crime Against Men,Assault,Male,60+,3638,2848,790,2935,703
2002,Urban,Karnataka,Property Crime,Vandalism,Female,13-17,607,554,53,575,32
2004,Rural,Punjab,Crime Against Men,Murder,Female,13-17,6373,357,6016,5708,665
2003,Urban,Arunachal Pradesh,Crime Against Children,Child Labor,Female,46-60,8206,3783,4423,4146,4060
2006,Urban,Telangana,Other Crimes,Cyber Crime,Female,18-30,1101,1087,14,1088,13
2003,Rural,Tamil Nadu,Other Crimes,Cyber Crime,Male,18-30,1030,31,999,699,331
2008,Urban,Maharashtra,Crime Against Women,Domestic Violence,Male,13-17,8217,606,7611,6392,1825
2002,Urban,Maharashtra,Crime Against Men,Extortion,Male,46-60,5293,5068,225,5138,155
2009,Rural,Bihar,Property Crime,Vandalism,Male,18-30,6910,5945,965,6199,711
2008,Urban,Meghalaya,Other Crimes,Fraud,Male,46-60,651,264,387,472,179
2001,Urban,Uttarakhand,Other Crimes,Corruption,Female,13-17,6241,1723,4518,3820,2421
2003,Urban,Karnataka,Crime Against Children,Child Labor,Male,46-60,3781,1298,2483,2925,856
2002,Rural,Andhra Pradesh,Crime Against Children,Kidnapping,Male,31-45,9819,1328,8491,5639,4180
2001,Rural,Chhattisgarh,Crime Against Children,Child Labor,Male,13-17,2284,1610,674,2051,233
2007,Rural,Assam,Crime Against Men,Assault,Female,31-45,1293,1056,237,1214,79
2008,Rural,Himachal Pradesh,Crime Against Children,Child Abuse,Female,13-17,9175,493,8682,4523,4652
2010,Urban,Tamil Nadu,Crime Against Men,Robbery,Female,46-60,8212,5186,3026,8182,30
2007,Rural,Punjab,Other Crimes,Cyber Crime,Female,31-45,6179,1548,4631,5728,451
2006,Rural,Uttar Pradesh,Other Crimes,Drug Offense,Male,60+,1642,762,880,1642,0
2002,Urban,Telangana,Crime Against Men,Robbery,Female,46-60,4635,1020,3615,3714,921
2007,Rural,Sikkim,Crime Against Children,Trafficking,Female,46-60,5424,1534,3890,4053,1371
2002,Urban,Tripura,Other Crimes,Drug Offense,Female,0-12,5420,4367,1053,5126,294
2008,Rural,Telangana,Crime Against Women,Domestic Violence,Female,31-45,9418,2334,7084,5572,3846
2010,Urban,Andhra Pradesh,Crime Against Women,Dowry Deaths,Female,46-60,5128,4555,573,5006,122
2009,Rural,Uttar Pradesh,Property Crime,Arson,Male,13-17,5125,1060,4065,3064,2061
2006,Urban,Uttar Pradesh,Crime Against Men,Robbery,Female,31-45,8545,1881,6664,7295,1250
2001,Rural,Tamil Nadu,Property Crime,Arson,Male,13-17,9378,3650,5728,6913,2465
2009,Rural,Delhi,Crime Against Children,Trafficking,Male,0-12,873,448,425,594,279
2007,Rural,Arunachal Pradesh,Other Crimes,Fraud,Male,31-45,7047,3904,3143,6707,340
2010,Urban,Tripura,Crime Against Women,Dowry Deaths,Female,13-17,3297,1242,2055,1551,1746
2009,Urban,Tripura,Crime Against Children,Child Abuse,Male,18-30,2958,2898,60,2904,54
2008,Rural,Karnataka,Crime Against Women,Molestation,Male,46-60,5067,2069,2998,2737,2330
2010,Rural,Himachal Pradesh,Other Crimes,Fraud,Female,0-12,1610,1216,394,1579,31
2005,Urban,Telangana,Crime Against Children,Child Labor,Male,0-12,725,604,121,630,95
2006,Rural,Jammu & Kashmir,Other Crimes,Cyber Crime,Female,31-45,8777,531,8246,6204,2573
2003,Urban,Arunachal Pradesh,Property Crime,Theft,Female,46-60,2781,2260,521,2664,117
2004,Rural,Assam,Property Crime,Theft,Male,46-60,9391,7367,2024,7928,1463
2007,Urban,Gujarat,Other Crimes,Cyber Crime,Female,13-17,2269,820,1449,1136,1133
2009,Urban,Maharashtra,Crime Against Men,Murder,Male,31-45,6435,1803,4632,2521,3914
2008,Rural,Delhi,Crime Against Children,Trafficking,Male,0-12,8029,6746,1283,7037,992
2002,Rural,Nagaland,Other Crimes,Fraud,Male,13-17,520,477,43,483,37
2009,Urban,Manipur,Crime Against Women,Molestation,Male,46-60,2065,834,1231,1804,261
2010,Urban,Gujarat,Other Crimes,Fraud,Male,60+,3535,1335,2200,1469,2066
2006,Urban,Jharkhand,Property Crime,Vandalism,Female,31-45,3717,2219,1498,2894,823
2003,Urban,Manipur,Crime Against Men,Murder,Female,31-45,1721,773,948,1394,327
2001,Rural,Rajasthan,Property Crime,Theft,Female,0-12,1658,755,903,1561,97
2002,Rural,Maharashtra,Other Crimes,Drug Offense,Male,31-45,5090,1380,3710,2784,2306
2001,Rural,Karnataka,Property Crime,Vandalism,Female,18-30,8489,1549,6940,2979,5510
2010,Urban,Meghalaya,Other Crimes,Cyber Crime,Female,18-30,96,26,70,73,23
2006,Urban,Chhattisgarh,Crime Against Men,Murder,Female,60+,1873,664,1209,1475,398
2005,Rural,Jammu & Kashmir,Crime Against Men,Extortion,Female,46-60,9179,5785,3394,8102,1077
2006,Urban,Arunachal Pradesh,Crime Against Children,Trafficking,Female,46-60,8217,6526,1691,7888,329
2007,Urban,Tripura,Crime Against Women,Dowry Deaths,Female,13-17,9626,6733,2893,8876,750
2009,Urban,Goa,Crime Against Women,Dowry Deaths,Male,31-45,5540,3635,1905,5536,4
2010,Urban,Telangana,Crime Against Women,Domestic Violence,Male,13-17,5202,4166,1036,4993,209
2001,Urban,Uttar Pradesh,Crime Against Children,Kidnapping,Male,0-12,1780,454,1326,789,991
2003,Urban,Jharkhand,Crime Against Men,Robbery,Male,60+,8160,3016,5144,4205,3955
2010,Rural,Meghalaya,Crime Against Women,Molestation,Male,13-17,2960,1459,1501,2239,721
2010,Urban,Maharashtra,Property Crime,Theft,Male,0-12,7833,815,7018,3346,4487
2003,Rural,Punjab,Crime Against Women,Rape,Female,13-17,696,83,613,262,434
2008,Rural,Tripura,Property Crime,Theft,Female,60+,7456,459,6997,1857,5599
2001,Rural,Punjab,Property Crime,Arson,Female,18-30,7466,1054,6412,7441,25
2002,Urban,Karnataka,Crime Against Children,Trafficking,Female,31-45,2488,2177,311,2468,20
2010,Urban,Jammu & Kashmir,Property Crime,Vandalism,Male,18-30,6354,1614,4740,1787,4567
2010,Rural,Bihar,Crime Against Men,Extortion,Female,0-12,1336,39,1297,306,1030
2007,Rural,Manipur,Property Crime,Theft,Male,18-30,9215,5018,4197,7139,2076
2008,Rural,Arunachal Pradesh,Crime Against Women,Molestation,Female,46-60,5583,467,5116,1145,4438
2010,Rural,Maharashtra,Other Crimes,Cyber Crime,Female,31-45,5588,3567,2021,5424,164
2010,Urban,Madhya Pradesh,Crime Against Women,Domestic Violence,Male,60+,7305,3412,3893,5317,1988
2002,Rural,Gujarat,Crime Against Children,Child Labor,Male,46-60,2224,850,1374,1946,278
2010,Rural,Goa,Crime Against Children,Child Abuse,Female,46-60,5751,5177,574,5416,335
2002,Urban,West Bengal,Crime Against Women,Domestic Violence,Male,31-45,5424,2315,3109,4813,611
2004,Rural,Himachal Pradesh,Crime Against Women,Molestation,Male,0-12,7064,2530,4534,6463,601
2007,Rural,Madhya Pradesh,Property Crime,Arson,Female,31-45,5637,2744,2893,3173,2464
2002,Urban,Arunachal Pradesh,Other Crimes,Fraud,Female,60+,824,528,296,561,263
2003,Rural,Uttar Pradesh,Crime Against Children,Child Abuse,Female,13-17,5896,264,5632,1348,4548
2005,Rural,Himachal Pradesh,Crime Against Children,Child Abuse,Male,31-45,4785,4478,307,4701,84
2009,Rural,Telangana,Property Crime,Burglary,Male,13-17,4375,908,3467,3116,1259
2002,Urban,Arunachal Pradesh,Property Crime,Burglary,Female,31-45,9050,338,8712,8890,160
2006,Urban,Bihar,Property Crime,Vandalism,Male,60+,1027,888,139,1014,13
2001,Urban,Madhya Pradesh,Property Crime,Burglary,Male,13-17,4526,489,4037,4323,203
2008,Urban,Maharashtra,Crime Against Women,Molestation,Male,18-30,7337,1263,6074,4918,2419
2004,Urban,Odisha,Crime Against Women,Dowry Deaths,Female,13-17,8957,3322,5635,6214,2743
2010,Urban,Meghalaya,Crime Against Men,Assault,Female,46-60,7821,3497,4324,4069,3752
2003,Rural,Delhi,Crime Against Women,Dowry Deaths,Male,13-17,4855,1259,3596,1538,3317
2001,Urban,Goa,Crime Against Women,Dowry Deaths,Female,0-12,2925,934,1991,1956,969
2005,Rural,Jammu & Kashmir,Property Crime,Burglary,Female,46-60,5896,3085,2811,5068,828
2001,Urban,Meghalaya,Property Crime,Burglary,Female,0-12,6812,1481,5331,6280,532
2003,Urban,Jammu & Kashmir,Other Crimes,Corruption,Female,18-30,2592,352,2240,2172,420
2002,Rural,Haryana,Crime Against Men,Robbery,Female,13-17,2401,1861,540,1895,506
2007,Urban,Telangana,Crime Against Men,Assault,Female,13-17,3881,2658,1223,3497,384
2006,Urban,Jammu & Kashmir,Crime Against Men,Extortion,Female,0-12,2723,1972,751,2629,94
2002,Rural,Jammu & Kashmir,Other Crimes,Drug Offense,Female,13-17,3018,1283,1735,2682,336
2001,Rural,Manipur,Crime Against Children,Kidnapping,Female,0-12,2134,648,1486,1997,137
2004,Rural,West Bengal,Crime Against Men,Assault,Female,18-30,185,174,11,174,11
2002,Rural,Nagaland,Crime Against Women,Dowry Deaths,Male,13-17,879,170,709,205,674
2006,Rural,Tripura,Crime Against Men,Murder,Female,13-17,6765,6585,180,6717,48
2006,Urban,Chhattisgarh,Crime Against Children,Trafficking,Female,13-17,7896,7361,535,7618,278
2008,Rural,Tamil Nadu,Crime Against Men,Robbery,Male,60+,3223,302,2921,681,2542
2001,Rural,Odisha,Property Crime,Theft,Male,13-17,2551,1412,1139,2085,466
2009,Urban,Nagaland,Crime Against Men,Murder,Male,18-30,3247,1332,1915,1783,1464
2008,Urban,Arunachal Pradesh,Other Crimes,Cyber Crime,Male,13-17,1077,181,896,765,312
2001,Urban,Goa,Crime Against Men,Robbery,Male,46-60,7967,3372,4595,6153,1814
2009,Rural,Tripura,Crime Against Children,Child Labor,Male,0-12,856,82,774,286,570
2001,Rural,Bihar,Crime Against Men,Murder,Female,31-45,2696,152,2544,943,1753
2010,Rural,Himachal Pradesh,Property Crime,Theft,Female,46-60,5652,4640,1012,5346,306
2005,Rural,Andhra Pradesh,Other Crimes,Corruption,Female,31-45,4390,2831,1559,3453,937
2002,Rural,Jharkhand,Crime Against Women,Molestation,Female,0-12,8193,5008,3185,6196,1997
2002,Urban,Tripura,Other Crimes,Fraud,Male,0-12,8267,1313,6954,7637,630
2006,Urban,Assam,Other Crimes,Fraud,Female,0-12,2284,1573,711,2113,171
2002,Urban,Tripura,Crime Against Women,Molestation,Male,18-30,2079,1118,961,1993,86
2002,Urban,Nagaland,Crime Against Men,Assault,Female,13-17,9802,5074,4728,6804,2998
2004,Urban,Haryana,Crime Against Men,Murder,Female,0-12,383,9,374,113,270
2002,Rural,Chhattisgarh,Crime Against Children,Child Abuse,Female,18-30,1116,583,533,1067,49
2004,Urban,Punjab,Other Crimes,Drug Offense,Male,60+,6286,151,6135,5512,774
2002,Urban,Gujarat,Other Crimes,Corruption,Female,60+,9733,2906,6827,5232,4501
2002,Rural,Andhra Pradesh,Crime Against Children,Child Labor,Male,0-12,5281,1642,3639,5074,207
2005,Urban,Kerala,Crime Against Women,Dowry Deaths,Female,18-30,9755,5056,4699,8424,1331
2003,Rural,Delhi,Property Crime,Vandalism,Male,31-45,3089,2424,665,2545,544
2002,Urban,Meghalaya,Crime Against Men,Murder,Female,13-17,2644,1006,1638,1692,952
2010,Rural,Telangana,Crime Against Children,Trafficking,Female,0-12,992,519,473,702,290
2003,Urban,Bihar,Other Crimes,Fraud,Male,46-60,4134,3025,1109,3462,672
2005,Urban,Delhi,Crime Against Children,Child Labor,Male,0-12,6959,4105,2854,5323,1636
2009,Urban,West Bengal,Crime Against Women,Molestation,Male,0-12,3652,386,3266,1491,2161
2006,Urban,Manipur,Crime Against Women,Rape,Male,31-45,648,534,114,610,38
2004,Rural,Assam,Crime Against Children,Kidnapping,Male,18-30,711,269,442,691,20
2002,Urban,Jammu & Kashmir,Crime Against Women,Dowry Deaths,Male,46-60,129,48,81,95,34
2002,Rural,Tamil Nadu,Property Crime,Vandalism,Male,31-45,1878,1025,853,1822,56
2008,Rural,Madhya Pradesh,Property Crime,Burglary,Female,13-17,4691,1295,3396,1681,3010
2002,Urban,Telangana,Crime Against Men,Robbery,Male,46-60,362,71,291,229,133
2003,Rural,Rajasthan,Other Crimes,Fraud,Male,46-60,1977,120,1857,1219,758
2004,Urban,Karnataka,Crime Against Men,Murder,Male,46-60,7480,1559,5921,6486,994
2004,Urban,Telangana,Crime Against Children,Child Abuse,Male,13-17,3162,652,2510,3060,102
2004,Rural,Tripura,Crime Against Women,Rape,Female,13-17,1997,1626,371,1784,213
2002,Rural,Kerala,Other Crimes,Drug Offense,Female,0-12,330,310,20,312,18
2004,Rural,Delhi,Crime Against Children,Kidnapping,Female,31-45,2514,1770,744,1788,726
2002,Urban,Uttarakhand,Other Crimes,Drug Offense,Male,31-45,2193,2154,39,2171,22
2004,Rural,Meghalaya,Crime Against Men,Murder,Female,13-17,8594,4358,4236,4812,3782
2008,Rural,Himachal Pradesh,Crime Against Men,Extortion,Male,46-60,3460,3429,31,3443,17
2008,Rural,Jammu & Kashmir,Other Crimes,Corruption,Male,46-60,4087,3885,202,3960,127
2009,Rural,Manipur,Other Crimes,Drug Offense,Male,0-12,8034,6078,1956,6951,1083
2010,Rural,Kerala,Crime Against Children,Kidnapping,Female,60+,5047,1356,3691,2478,2569
2008,Rural,Tripura,Crime Against Men,Murder,Male,0-12,4028,2664,1364,3729,299
2007,Urban,Tripura,Crime Against Men,Murder,Male,0-12,9084,5548,3536,5721,3363
2007,Urban,Tamil Nadu,Other Crimes,Corruption,Female,18-30,9545,506,9039,5817,3728
2009,Rural,Kerala,Crime Against Men,Extortion,Female,46-60,6750,4769,1981,6257,493
2004,Urban,Nagaland,Other Crimes,Cyber Crime,Male,60+,1895,1446,449,1824,71
2007,Urban,Bihar,Other Crimes,Cyber Crime,Male,0-12,1910,1150,760,1483,427
2001,Rural,Manipur,Crime Against Children,Child Abuse,Female,46-60,9196,2337,6859,7175,2021
2008,Urban,Rajasthan,Other Crimes,Corruption,Male,60+,2883,269,2614,1424,1459
2010,Urban,Haryana,Crime Against Children,Kidnapping,Male,18-30,7662,1081,6581,5106,2556
2007,Rural,Madhya Pradesh,Crime Against Women,Domestic Violence,Male,13-17,8886,7357,1529,8797,89
2006,Rural,Manipur,Crime Against Men,Extortion,Male,46-60,8074,4010,4064,6358,1716
2004,Rural,Andhra Pradesh,Other Crimes,Fraud,Male,60+,7837,7819,18,7829,8
2001,Rural,Telangana,Other Crimes,Corruption,Male,46-60,6805,3040,3765,4598,2207
2003,Rural,Sikkim,Crime Against Children,Trafficking,Female,13-17,1375,439,936,877,498
2009,Rural,Gujarat,Crime Against Women,Molestation,Female,18-30,7518,2097,5421,2404,5114
2004,Rural,Himachal Pradesh,Property Crime,Burglary,Female,13-17,2144,1418,726,1942,202
2010,Urban,Arunachal Pradesh,Property Crime,Vandalism,Female,0-12,2803,314,2489,1649,1154
2002,Rural,Andhra Pradesh,Crime Against Women,Domestic Violence,Female,60+,3908,1324,2584,1725,2183
2002,Urban,Goa,Crime Against Women,Molestation,Male,0-12,4131,230,3901,1404,2727
2006,Rural,Sikkim,Crime Against Women,Dowry Deaths,Female,46-60,8799,7925,874,8206,593
2007,Rural,Mizoram,Other Crimes,Cyber Crime,Female,46-60,8541,8064,477,8112,429
2006,Rural,Assam,Crime Against Women,Rape,Female,18-30,2258,1406,852,1773,485
2008,Rural,Mizoram,Crime Against Children,Child Abuse,Male,0-12,1162,955,207,1041,121
2002,Rural,Arunachal Pradesh,Crime Against Children,Child Abuse,Female,31-45,6690,2125,4565,3736,2954
2007,Rural,Mizoram,Crime Against Children,Child Labor,Female,13-17,5975,5286,689,5938,37
2001,Urban,Arunachal Pradesh,Crime Against Children,Kidnapping,Male,0-12,3142,2989,153,3019,123
2008,Urban,Manipur,Crime Against Men,Murder,Male,46-60,7500,6959,541,7382,118
2009,Rural,Mizoram,Crime Against Men,Murder,Female,18-30,3575,428,3147,1164,2411
2008,Urban,Jharkhand,Crime Against Women,Dowry Deaths,Female,0-12,1767,840,927,1480,287
2010,Rural,Jharkhand,Property Crime,Vandalism,Female,13-17,9706,6480,3226,8742,964
2007,Rural,Delhi,Other Crimes,Fraud,Male,31-45,3662,815,2847,3090,572
2005,Rural,Delhi,Property Crime,Arson,Male,31-45,2614,2277,337,2397,217
2004,Rural,Karnataka,Property Crime,Burglary,Female,0-12,5975,3041,2934,5855,120
2007,Urban,Haryana,Crime Against Men,Assault,Male,13-17,2021,905,1116,1321,700
2002,Rural,Gujarat,Crime Against Children,Child Labor,Male,31-45,9812,3067,6745,6098,3714
2010,Rural,Arunachal Pradesh,Crime Against Men,Murder,Male,60+,6251,3107,3144,3481,2770
2004,Rural,Bihar,Crime Against Men,Robbery,Male,0-12,3126,36,3090,864,2262
2007,Rural,Tamil Nadu,Crime Against Men,Assault,Male,60+,7715,552,7163,2164,5551
2008,Urban,Karnataka,Crime Against Children,Kidnapping,Female,0-12,688,378,310,682,6
2004,Urban,Meghalaya,Crime Against Men,Assault,Female,31-45,7239,3247,3992,4829,2410
2003,Rural,Tamil Nadu,Other Crimes,Fraud,Female,31-45,3977,1540,2437,1842,2135
2004,Urban,Punjab,Crime Against Children,Child Abuse,Male,18-30,3495,3209,286,3345,150
2004,Rural,Mizoram,Crime Against Children,Trafficking,Male,31-45,8513,7861,652,7907,606
2007,Rural,Gujarat,Crime Against Children,Child Abuse,Male,18-30,9945,3932,6013,7789,2156
2007,Urban,Chhattisgarh,Property Crime,Vandalism,Male,13-17,4305,3124,1181,4121,184
2010,Rural,Jammu & Kashmir,Crime Against Women,Molestation,Male,0-12,4450,2251,2199,3596,854
2004,Urban,Manipur,Property Crime,Arson,Male,60+,3647,503,3144,1582,2065
2002,Urban,West Bengal,Crime Against Women,Dowry Deaths,Female,13-17,844,273,571,371,473
2002,Rural,Tamil Nadu,Crime Against Children,Child Labor,Male,46-60,8889,7442,1447,8884,5
2005,Rural,Assam,Other Crimes,Drug Offense,Female,13-17,4882,105,4777,2004,2878
2006,Urban,Odisha,Crime Against Men,Assault,Female,60+,8230,6325,1905,7019,1211
2010,Rural,Jammu & Kashmir,Crime Against Children,Child Labor,Male,60+,8200,1762,6438,2847,5353
2005,Urban,Goa,Property Crime,Burglary,Female,13-17,4584,3641,943,4209,375
2005,Urban,Haryana,Crime Against Women,Molestation,Female,60+,718,616,102,661,57
2003,Urban,Sikkim,Property Crime,Vandalism,Female,0-12,742,261,481,491,251
2005,Urban,Jharkhand,Crime Against Men,Robbery,Female,13-17,1569,684,885,991,578
2009,Urban,Odisha,Crime Against Men,Extortion,Male,60+,8239,1287,6952,4903,3336
2005,Rural,Mizoram,Crime Against Men,Extortion,Female,46-60,4592,3930,662,4471,121
2006,Urban,Uttar Pradesh,Crime Against Women,Rape,Male,46-60,8365,11,8354,7056,1309
2005,Urban,Meghalaya,Crime Against Men,Murder,Male,18-30,4311,2904,1407,3695,616
2007,Urban,Meghalaya,Property Crime,Burglary,Male,60+,4513,492,4021,3103,1410
2001,Urban,Gujarat,Crime Against Children,Child Abuse,Male,13-17,3836,3354,482,3810,26
2009,Urban,Madhya Pradesh,Crime Against Women,Rape,Female,18-30,2254,368,1886,1271,983
2002,Urban,Uttarakhand,Property Crime,Arson,Female,46-60,8129,1578,6551,4891,3238
2002,Rural,Maharashtra,Crime Against Men,Assault,Male,60+,3702,3029,673,3189,513
2001,Urban,Assam,Crime Against Children,Kidnapping,Female,13-17,4960,1177,3783,4089,871
2009,Rural,Arunachal Pradesh,Crime Against Women,Rape,Female,60+,6117,3956,2161,4381,1736
2010,Urban,Jammu & Kashmir,Other Crimes,Fraud,Female,31-45,8161,3511,4650,3737,4424
2002,Urban,Andhra Pradesh,Crime Against Children,Trafficking,Male,0-12,1363,242,1121,718,645
2001,Rural,Delhi,Crime Against Children,Child Labor,Male,0-12,725,433,292,705,20
2009,Rural,Meghalaya,Crime Against Women,Rape,Female,0-12,8273,4830,3443,7797,476
2007,Rural,Rajasthan,Crime Against Children,Child Labor,Male,13-17,2157,1546,611,1721,436
2010,Urban,Uttarakhand,Crime Against Women,Molestation,Male,18-30,314,179,135,297,17
2006,Rural,Chhattisgarh,Crime Against Women,Dowry Deaths,Male,31-45,6545,3249,3296,3359,3186
2007,Urban,Uttar Pradesh,Crime Against Children,Kidnapping,Male,13-17,4332,1234,3098,2490,1842
2003,Rural,Jharkhand,Crime Against Women,Molestation,Female,46-60,4826,2583,2243,4072,754
2004,Urban,West Bengal,Crime Against Women,Rape,Male,60+,4089,2625,1464,3740,349
2009,Urban,Maharashtra,Crime Against Children,Child Abuse,Male,46-60,4590,2709,1881,3970,620
2004,Urban,Arunachal Pradesh,Other Crimes,Cyber Crime,Male,46-60,9614,5233,4381,8829,785
2003,Urban,Himachal Pradesh,Crime Against Children,Child Labor,Female,13-17,2812,2579,233,2760,52
2010,Urban,Gujarat,Other Crimes,Drug Offense,Male,18-30,2487,1521,966,2314,173
2007,Urban,Sikkim,Property Crime,Burglary,Male,13-17,8612,5433,3179,8387,225
2007,Urban,Uttarakhand,Crime Against Men,Murder,Male,46-60,3470,2047,1423,2157,1313
2004,Rural,Delhi,Crime Against Men,Assault,Male,31-45,81,46,35,77,4
2003,Rural,Delhi,Crime Against Men,Robbery,Male,13-17,203,22,181,172,31
2005,Urban,Jammu & Kashmir,Crime Against Women,Rape,Male,18-30,5474,112,5362,4494,980
2010,Urban,Delhi,Other Crimes,Cyber Crime,Male,60+,7174,6873,301,7060,114
2002,Urban,Punjab,Crime Against Women,Domestic Violence,Female,18-30,2669,2174,495,2430,239
2010,Urban,Bihar,Other Crimes,Fraud,Male,13-17,1034,46,988,992,42
2007,Urban,Arunachal Pradesh,Other Crimes,Drug Offense,Female,31-45,4247,2299,1948,3081,1166
2009,Urban,Madhya Pradesh,Other Crimes,Fraud,Male,0-12,6080,5332,748,5672,408
2007,Rural,Jammu & Kashmir,Other Crimes,Corruption,Female,31-45,246,153,93,204,42
2004,Urban,Delhi,Crime Against Children,Trafficking,Male,0-12,6492,4149,2343,5242,1250
2008,Rural,Bihar,Crime Against Children,Trafficking,Male,46-60,7456,3280,4176,5490,1966
2007,Rural,Kerala,Crime Against Men,Murder,Male,0-12,4882,771,4111,4464,418
2002,Urban,Tamil Nadu,Crime Against Men,Murder,Female,13-17,1964,1539,425,1649,315
2001,Rural,Goa,Property Crime,Theft,Male,60+,9603,441,9162,2599,7004
2003,Rural,Bihar,Crime Against Women,Domestic Violence,Male,0-12,7693,6233,1460,7584,109
2010,Urban,Kerala,Other Crimes,Cyber Crime,Male,13-17,2601,343,2258,364,2237
2009,Rural,Madhya Pradesh,Crime Against Men,Robbery,Male,0-12,4718,4189,529,4370,348
2006,Rural,Jharkhand,Crime Against Children,Kidnapping,Male,31-45,3711,53,3658,1707,2004
2005,Rural,Rajasthan,Property Crime,Arson,Female,60+,1582,509,1073,1426,156
2004,Rural,Maharashtra,Crime Against Men,Robbery,Male,31-45,8264,2716,5548,7823,441
2001,Urban,Andhra Pradesh,Property Crime,Theft,Male,31-45,8418,5624,2794,6513,1905
2003,Urban,Uttar Pradesh,Crime Against Children,Child Abuse,Female,60+,1863,190,1673,847,1016
2001,Urban,Delhi,Crime Against Women,Rape,Male,18-30,8227,263,7964,4688,3539
2002,Rural,Telangana,Property Crime,Theft,Male,18-30,5020,4343,677,4504,516
2001,Urban,Kerala,Other Crimes,Corruption,Male,31-45,2625,1755,870,2275,350
2008,Rural,Karnataka,Crime Against Children,Child Labor,Female,13-17,2329,1469,860,2124,205
2009,Rural,Meghalaya,Crime Against Children,Kidnapping,Male,31-45,3493,2591,902,2635,858
2009,Rural,Tripura,Crime Against Women,Rape,Female,46-60,3480,2059,1421,3392,88
2006,Rural,Haryana,Other Crimes,Fraud,Female,60+,3595,674,2921,789,2806
2010,Rural,Bihar,Crime Against Children,Trafficking,Male,0-12,7344,5912,1432,6669,675
2008,Rural,Odisha,Crime Against Children,Child Labor,Male,60+,2836,1098,1738,2641,195
2005,Urban,Sikkim,Other Crimes,Corruption,Female,46-60,8924,7916,1008,8411,513
2005,Rural,Jharkhand,Property Crime,Theft,Female,0-12,3493,3082,411,3276,217
2008,Rural,Arunachal Pradesh,Crime Against Women,Molestation,Female,60+,9408,3434,5974,5685,3723
2006,Urban,Goa,Crime Against Men,Assault,Female,18-30,9466,4069,5397,4097,5369
2007,Urban,Odisha,Other Crimes,Drug Offense,Male,60+,7512,2585,4927,3355,4157
2003,Urban,Mizoram,Property Crime,Vandalism,Male,46-60,6166,1235,4931,2486,3680
2007,Urban,West Bengal,Crime Against Children,Kidnapping,Female,46-60,8857,7473,1384,8055,802
2007,Rural,Punjab,Crime Against Children,Trafficking,Female,13-17,5061,3038,2023,4536,525
2010,Urban,Arunachal Pradesh,Crime Against Children,Child Labor,Female,46-60,3324,2161,1163,2609,715
2001,Urban,Gujarat,Property Crime,Arson,Female,46-60,7003,4021,2982,5211,1792
2007,Rural,Andhra Pradesh,Crime Against Women,Rape,Female,46-60,6950,5963,987,6668,282
2009,Urban,Meghalaya,Other Crimes,Cyber Crime,Male,13-17,7849,6887,962,7752,97
2009,Urban,Rajasthan,Crime Against Children,Kidnapping,Female,13-17,8792,4565,4227,6028,2764
2008,Rural,Bihar,Crime Against Women,Molestation,Male,60+,3174,1557,1617,2715,459
2003,Urban,Tripura,Other Crimes,Cyber Crime,Female,46-60,5897,3809,2088,5721,176
2009,Rural,Meghalaya,Crime Against Children,Kidnapping,Female,18-30,2891,2718,173,2890,1
2003,Urban,Odisha,Crime Against Women,Rape,Female,31-45,1049,773,276,946,103
2001,Urban,Arunachal Pradesh,Crime Against Men,Murder,Male,46-60,8386,2894,5492,5066,3320
2002,Rural,Kerala,Property Crime,Theft,Male,31-45,280,5,275,227,53
2008,Urban,Jammu & Kashmir,Crime Against Men,Robbery,Male,0-12,5609,3620,1989,5232,377
2003,Rural,Andhra Pradesh,Crime Against Children,Child Abuse,Male,0-12,2994,1035,1959,1505,1489
2010,Urban,Madhya Pradesh,Crime Against Children,Child Abuse,Female,0-12,8955,4674,4281,7232,1723
2001,Urban,Kerala,Crime Against Women,Domestic Violence,Female,18-30,9924,5067,4857,6086,3838
2008,Urban,Karnataka,Property Crime,Vandalism,Male,60+,8699,3591,5108,3955,4744
2009,Urban,Kerala,Property Crime,Burglary,Female,46-60,2671,325,2346,1770,901
2009,Rural,Delhi,Other Crimes,Fraud,Male,18-30,7448,4,7444,991,6457
2006,Rural,Uttar Pradesh,Property Crime,Theft,Female,18-30,3223,366,2857,432,2791
2010,Urban,Maharashtra,Crime Against Men,Robbery,Female,46-60,1338,648,690,1084,254
2002,Urban,Sikkim,Crime Against Men,Assault,Male,0-12,2486,1465,1021,2071,415
2009,Rural,Uttarakhand,Other Crimes,Corruption,Male,13-17,7197,5188,2009,5248,1949
2004,Rural,Gujarat,Crime Against Children,Child Labor,Female,18-30,3629,3120,509,3571,58
2006,Rural,Gujarat,Crime Against Men,Robbery,Female,60+,9441,6294,3147,7809,1632
2009,Rural,Uttar Pradesh,Property Crime,Vandalism,Male,18-30,6191,1138,5053,3019,3172
2001,Rural,Andhra Pradesh,Other Crimes,Corruption,Male,60+,6739,4706,2033,4711,2028
2002,Rural,Uttar Pradesh,Other Crimes,Drug Offense,Female,46-60,6080,5131,949,5331,749
2001,Rural,Goa,Other Crimes,Cyber Crime,Female,18-30,5567,4261,1306,4444,1123
2006,Rural,Kerala,Property Crime,Arson,Male,13-17,6136,952,5184,1572,4564
2008,Rural,Nagaland,Other Crimes,Cyber Crime,Female,13-17,7440,2186,5254,3841,3599
2001,Urban,Bihar,Property Crime,Burglary,Male,46-60,8880,3519,5361,5230,3650
2001,Urban,Assam,Other Crimes,Fraud,Female,46-60,1044,957,87,980,64
2001,Rural,Rajasthan,Property Crime,Theft,Male,46-60,1231,70,1161,1080,151
2006,Urban,Arunachal Pradesh,Other Crimes,Drug Offense,Male,46-60,3806,617,3189,847,2959
2002,Urban,Tamil Nadu,Crime Against Children,Kidnapping,Female,46-60,9718,8814,904,9043,675
2004,Rural,West Bengal,Crime Against Children,Child Labor,Female,46-60,6731,3859,2872,6403,328
2010,Urban,Bihar,Other Crimes,Fraud,Female,13-17,3279,515,2764,3056,223
2007,Rural,Maharashtra,Crime Against Men,Robbery,Female,18-30,7918,5623,2295,6280,1638
2008,Urban,Tamil Nadu,Crime Against Women,Rape,Female,0-12,8354,1080,7274,2175,6179
2001,Urban,Tripura,Crime Against Men,Extortion,Male,60+,528,417,111,517,11
2008,Urban,Uttarakhand,Crime Against Women,Domestic Violence,Male,31-45,5988,2993,2995,4142,1846
2002,Rural,Rajasthan,Crime Against Children,Kidnapping,Female,0-12,1705,1057,648,1559,146
2004,Rural,Andhra Pradesh,Property Crime,Burglary,Female,46-60,8774,8746,28,8751,23
2004,Urban,Delhi,Crime Against Men,Assault,Male,0-12,7275,1272,6003,1824,5451
2001,Rural,Manipur,Other Crimes,Fraud,Male,60+,7391,2687,4704,5358,2033
2010,Rural,Andhra Pradesh,Crime Against Men,Murder,Male,18-30,5035,877,4158,2361,2674
2007,Urban,Bihar,Crime Against Men,Extortion,Male,31-45,5913,3456,2457,4891,1022
2003,Rural,Karnataka,Crime Against Children,Trafficking,Male,0-12,1903,426,1477,548,1355
2007,Rural,Arunachal Pradesh,Crime Against Children,Kidnapping,Male,31-45,6003,868,5135,1925,4078
2007,Urban,Telangana,Crime Against Children,Child Labor,Male,18-30,5193,4272,921,4602,591
2005,Urban,Manipur,Property Crime,Theft,Male,31-45,7951,6184,1767,6546,1405
2005,Urban,Tamil Nadu,Crime Against Women,Molestation,Male,0-12,7705,7039,666,7335,370
2003,Rural,Maharashtra,Crime Against Men,Assault,Male,60+,6199,5125,1074,5677,522
2004,Urban,Himachal Pradesh,Property Crime,Theft,Female,60+,6312,393,5919,1657,4655
2004,Urban,Bihar,Crime Against Men,Assault,Male,18-30,1956,1135,821,1267,689
2004,Urban,Arunachal Pradesh,Other Crimes,Drug Offense,Female,31-45,9904,6109,3795,8693,1211
2003,Urban,Telangana,Other Crimes,Fraud,Male,60+,2237,37,2200,274,1963
2008,Urban,Kerala,Crime Against Men,Assault,Female,0-12,4225,1580,2645,3556,669
2002,Rural,Arunachal Pradesh,Crime Against Children,Child Labor,Male,31-45,8327,3836,4491,7590,737
2004,Urban,Arunachal Pradesh,Crime Against Women,Domestic Violence,Female,13-17,4997,4119,878,4380,617
2001,Rural,Delhi,Crime Against Men,Murder,Female,18-30,3535,2881,654,2991,544
2007,Urban,Karnataka,Property Crime,Theft,Female,31-45,6182,6092,90,6106,76
2001,Urban,Nagaland,Crime Against Men,Extortion,Female,46-60,5715,1796,3919,5206,509
2010,Urban,Andhra Pradesh,Other Crimes,Fraud,Female,60+,260,94,166,118,142
2004,Urban,Punjab,Property Crime,Arson,Male,46-60,962,87,875,461,501
2002,Urban,Andhra Pradesh,Property Crime,Vandalism,Female,46-60,7931,2061,5870,5491,2440
2005,Rural,Rajasthan,Other Crimes,Fraud,Male,60+,8345,5113,3232,6206,2139
2010,Urban,Sikkim,Crime Against Children,Child Abuse,Female,13-17,4423,3998,425,4221,202
2005,Rural,Odisha,Crime Against Women,Rape,Female,46-60,1680,1109,571,1295,385
2002,Urban,Andhra Pradesh,Other Crimes,Cyber Crime,Male,46-60,2491,1936,555,2154,337
2009,Urban,Punjab,Other Crimes,Drug Offense,Male,31-45,4992,3231,1761,3798,1194
2005,Urban,Andhra Pradesh,Other Crimes,Cyber Crime,Female,46-60,707,375,332,614,93
2002,Rural,Arunachal Pradesh,Other Crimes,Corruption,Female,31-45,5084,1692,3392,2181,2903
2008,Rural,Punjab,Crime Against Children,Kidnapping,Female,60+,4003,3870,133,3988,15
2008,Rural,Meghalaya,Property Crime,Burglary,Male,0-12,4254,1987,2267,3621,633
2009,Urban,Tripura,Other Crimes,Fraud,Female,31-45,7770,3739,4031,5961,1809
2005,Urban,Chhattisgarh,Property Crime,Burglary,Female,18-30,2308,1986,322,2076,232
2009,Urban,Maharashtra,Crime Against Children,Kidnapping,Female,60+,629,466,163,562,67
2010,Rural,Mizoram,Other Crimes,Corruption,Female,60+,1615,1113,502,1320,295
2008,Urban,Jharkhand,Crime Against Men,Murder,Male,18-30,7035,1154,5881,6985,50
2002,Urban,Jammu & Kashmir,Crime Against Women,Dowry Deaths,Female,13-17,868,496,372,522,346
2001,Rural,Chhattisgarh,Property Crime,Burglary,Female,60+,8722,2907,5815,8005,717
2004,Rural,Mizoram,Crime Against Women,Rape,Male,46-60,308,92,216,259,49
2009,Urban,Karnataka,Other Crimes,Corruption,Female,60+,1329,782,547,1175,154
2008,Rural,Bihar,Property Crime,Arson,Female,18-30,4600,4425,175,4539,61
2005,Rural,Kerala,Crime Against Men,Assault,Male,31-45,9786,2436,7350,5909,3877
2002,Rural,Sikkim,Property Crime,Burglary,Female,46-60,3660,471,3189,2487,1173
2001,Rural,Sikkim,Property Crime,Burglary,Female,13-17,8911,4604,4307,7580,1331
2001,Rural,Uttarakhand,Other Crimes,Corruption,Male,31-45,5586,1079,4507,4036,1550
2008,Urban,West Bengal,Crime Against Women,Dowry Deaths,Female,31-45,1949,1885,64,1916,33
2006,Rural,Arunachal Pradesh,Crime Against Men,Extortion,Male,13-17,2233,496,1737,2059,174
2009,Urban,Bihar,Crime Against Women,Molestation,Female,18-30,3308,597,2711,700,2608
2007,Rural,Tamil Nadu,Other Crimes,Drug Offense,Male,0-12,4262,2146,2116,3173,1089
2006,Urban,Delhi,Property Crime,Vandalism,Male,60+,8720,6505,2215,7511,1209
2003,Rural,Goa,Crime Against Children,Kidnapping,Male,0-12,4634,512,4122,2768,1866
2002,Urban,Rajasthan,Property Crime,Burglary,Male,31-45,6658,6484,174,6617,41
2008,Rural,Jharkhand,Other Crimes,Corruption,Female,31-45,6067,750,5317,2844,3223
2010,Urban,Maharashtra,Crime Against Women,Domestic Violence,Male,18-30,6228,361,5867,2545,3683
2003,Urban,Punjab,Other Crimes,Drug Offense,Female,60+,833,589,244,795,38
2003,Rural,Madhya Pradesh,Crime Against Men,Extortion,Male,13-17,500,349,151,408,92
2008,Rural,Himachal Pradesh,Other Crimes,Drug Offense,Male,46-60,2424,1551,873,2059,365
2001,Urban,Nagaland,Other Crimes,Corruption,Female,0-12,5657,2102,3555,2310,3347
2008,Urban,Telangana,Other Crimes,Drug Offense,Female,60+,7905,7629,276,7901,4
2006,Urban,Haryana,Crime Against Children,Kidnapping,Male,18-30,9673,7130,2543,9224,449
2009,Rural,Himachal Pradesh,Crime Against Men,Assault,Female,18-30,7660,6095,1565,6700,960
2007,Rural,Sikkim,Crime Against Women,Dowry Deaths,Male,18-30,1023,890,133,1005,18
2001,Urban,Chhattisgarh,Property Crime,Vandalism,Male,46-60,8235,6643,1592,6999,1236
2009,Rural,Jammu & Kashmir,Other Crimes,Drug Offense,Female,60+,5481,5452,29,5473,8
2007,Urban,Karnataka,Other Crimes,Drug Offense,Female,0-12,6492,2908,3584,3796,2696
2001,Urban,Uttar Pradesh,Crime Against Men,Murder,Female,13-17,7876,4281,3595,5011,2865
2004,Urban,Andhra Pradesh,Other Crimes,Drug Offense,Male,0-12,8694,803,7891,5933,2761
2001,Rural,Jammu & Kashmir,Crime Against Women,Domestic Violence,Female,18-30,670,120,550,252,418
2009,Urban,Tamil Nadu,Crime Against Men,Murder,Male,31-45,8539,3531,5008,4544,3995
2002,Urban,Madhya Pradesh,Property Crime,Burglary,Female,13-17,1111,1041,70,1089,22
2008,Urban,Goa,Other Crimes,Fraud,Female,18-30,4733,1212,3521,2178,2555
2009,Rural,Goa,Crime Against Children,Kidnapping,Male,31-45,2085,1505,580,1745,340
2007,Urban,Gujarat,Crime Against Women,Molestation,Female,18-30,2272,1359,913,2114,158
2002,Urban,Chhattisgarh,Property Crime,Burglary,Male,46-60,6671,5204,1467,6544,127
2010,Urban,Telangana,Other Crimes,Cyber Crime,Female,13-17,2463,1290,1173,1335,1128
2003,Urban,Assam,Crime Against Women,Domestic Violence,Female,60+,3313,1305,2008,1625,1688
2003,Rural,Meghalaya,Crime Against Men,Assault,Female,46-60,2157,864,1293,1614,543
2001,Urban,Bihar,Property Crime,Burglary,Female,60+,233,22,211,199,34
2007,Rural,Andhra Pradesh,Other Crimes,Fraud,Male,18-30,5658,3538,2120,4883,775
2009,Urban,Delhi,Crime Against Children,Kidnapping,Male,46-60,7459,3756,3703,7025,434
2001,Urban,Assam,Crime Against Men,Robbery,Female,31-45,3690,2093,1597,2568,1122
2007,Rural,Haryana,Crime Against Women,Dowry Deaths,Male,18-30,9270,7270,2000,7963,1307
2003,Urban,Punjab,Property Crime,Theft,Female,13-17,3886,2136,1750,2688,1198
2002,Rural,Jammu & Kashmir,Property Crime,Theft,Male,13-17,875,288,587,679,196
2007,Urban,Madhya Pradesh,Crime Against Children,Child Abuse,Male,13-17,5417,2990,2427,5120,297
2007,Urban,Madhya Pradesh,Other Crimes,Fraud,Male,31-45,1579,1185,394,1444,135
2002,Rural,Bihar,Crime Against Children,Child Abuse,Male,13-17,6058,1600,4458,5547,511
2008,Rural,Meghalaya,Crime Against Children,Child Labor,Female,18-30,3489,1010,2479,2045,1444
2002,Urban,Madhya Pradesh,Property Crime,Burglary,Male,0-12,8201,1617,6584,5200,3001
2007,Urban,Andhra Pradesh,Property Crime,Vandalism,Male,13-17,8049,6034,2015,7761,288
2006,Rural,West Bengal,Crime Against Men,Robbery,Male,60+,2750,1484,1266,1760,990
2008,Rural,Delhi,Crime Against Men,Robbery,Female,46-60,1032,411,621,970,62
2008,Urban,Jammu & Kashmir,Property Crime,Theft,Male,13-17,9520,8976,544,9276,244
2002,Rural,Chhattisgarh,Property Crime,Theft,Female,13-17,3977,1082,2895,1594,2383
2004,Rural,Maharashtra,Property Crime,Arson,Female,13-17,606,550,56,575,31
2001,Urban,Jammu & Kashmir,Other Crimes,Corruption,Female,18-30,2092,388,1704,930,1162
2003,Rural,Goa,Crime Against Men,Assault,Male,46-60,9870,1028,8842,4762,5108
2007,Rural,Tripura,Crime Against Children,Trafficking,Female,60+,3022,2123,899,2329,693
2007,Rural,Rajasthan,Other Crimes,Drug Offense,Female,46-60,5510,5491,19,5494,16
2005,Rural,Rajasthan,Property Crime,Arson,Male,46-60,1346,629,717,1256,90
2008,Rural,Sikkim,Crime Against Children,Trafficking,Male,31-45,8295,4635,3660,5980,2315
2001,Urban,Madhya Pradesh,Crime Against Children,Child Labor,Male,31-45,1172,971,201,1116,56
2001,Urban,Jharkhand,Crime Against Men,Assault,Male,13-17,9144,2680,6464,3149,5995
2009,Rural,Delhi,Other Crimes,Corruption,Female,13-17,4943,4425,518,4715,228
2005,Urban,Jammu & Kashmir,Crime Against Children,Child Abuse,Male,13-17,6810,5432,1378,6411,399
2006,Urban,Andhra Pradesh,Other Crimes,Fraud,Male,0-12,801,694,107,701,100
2007,Rural,Himachal Pradesh,Crime Against Men,Murder,Male,18-30,9415,6724,2691,8115,1300
2002,Rural,Tripura,Crime Against Women,Molestation,Male,46-60,2590,1164,1426,1700,890
2001,Rural,Haryana,Crime Against Men,Robbery,Female,0-12,871,773,98,857,14
2003,Urban,Tripura,Other Crimes,Cyber Crime,Male,0-12,6975,604,6371,4338,2637
2008,Rural,Jammu & Kashmir,Crime Against Women,Domestic Violence,Male,31-45,103,33,70,37,66
2003,Urban,Bihar,Other Crimes,Drug Offense,Female,31-45,4917,445,4472,2067,2850
2004,Urban,Andhra Pradesh,Other Crimes,Fraud,Male,60+,8442,1100,7342,7344,1098
2001,Urban,Uttarakhand,Crime Against Children,Child Labor,Male,60+,3520,2507,1013,2664,856
2005,Rural,Chhattisgarh,Crime Against Women,Molestation,Male,13-17,4894,3883,1011,3963,931
2003,Urban,Sikkim,Crime Against Children,Child Abuse,Male,0-12,7200,2158,5042,4453,2747
2010,Urban,Kerala,Crime Against Women,Domestic Violence,Female,13-17,735,235,500,399,336
2006,Rural,Assam,Other Crimes,Fraud,Female,60+,1863,1474,389,1795,68
2001,Rural,Uttarakhand,Crime Against Women,Dowry Deaths,Female,31-45,5846,2365,3481,3560,2286
2005,Rural,Manipur,Crime Against Women,Molestation,Male,13-17,6321,2922,3399,4655,1666
2001,Urban,Maharashtra,Crime Against Children,Child Abuse,Male,18-30,5555,4868,687,5488,67
2004,Urban,Mizoram,Property Crime,Vandalism,Male,60+,7594,4235,3359,6021,1573
2004,Rural,Delhi,Other Crimes,Corruption,Male,60+,3290,3284,6,3285,5
2001,Urban,Punjab,Crime Against Men,Extortion,Female,46-60,2699,2505,194,2526,173
2009,Urban,Goa,Property Crime,Arson,Male,18-30,7065,4714,2351,6160,905
2005,Rural,Tamil Nadu,Crime Against Men,Robbery,Female,18-30,3339,20,3319,1613,1726
2001,Urban,Manipur,Property Crime,Theft,Female,0-12,7047,822,6225,2533,4514
2009,Urban,Manipur,Crime Against Women,Domestic Violence,Female,60+,201,176,25,177,24
2007,Urban,Telangana,Crime Against Women,Dowry Deaths,Female,31-45,9358,5483,3875,8596,762
2007,Urban,Himachal Pradesh,Crime Against Children,Child Labor,Male,31-45,6161,614,5547,2530,3631
2008,Urban,Chhattisgarh,Crime Against Men,Robbery,Male,60+,8083,7443,640,7932,151
2002,Urban,Assam,Other Crimes,Fraud,Female,13-17,992,929,63,942,50
2003,Urban,Uttar Pradesh,Other Crimes,Corruption,Male,60+,5798,582,5216,1942,3856
2008,Rural,Jammu & Kashmir,Crime Against Men,Robbery,Male,31-45,5633,4688,945,5485,148
2008,Urban,Manipur,Crime Against Children,Child Labor,Male,60+,1747,541,1206,953,794
2002,Rural,Jammu & Kashmir,Crime Against Women,Domestic Violence,Male,60+,8440,1415,7025,1829,6611
2001,Rural,Delhi,Property Crime,Burglary,Female,0-12,3068,1825,1243,2365,703
2004,Rural,Nagaland,Crime Against Women,Domestic Violence,Female,13-17,7728,7131,597,7375,353
2008,Rural,Mizoram,Property Crime,Vandalism,Female,0-12,1931,135,1796,521,1410
2008,Urban,Haryana,Crime Against Women,Domestic Violence,Male,0-12,5055,1167,3888,2273,2782
2003,Rural,Maharashtra,Crime Against Men,Assault,Male,0-12,8657,4551,4106,7974,683
2003,Rural,Delhi,Crime Against Children,Kidnapping,Male,13-17,6054,4546,1508,5232,822
2004,Rural,Andhra Pradesh,Crime Against Women,Rape,Male,0-12,5716,3824,1892,4687,1029
2001,Rural,Andhra Pradesh,Crime Against Men,Robbery,Female,0-12,6850,4471,2379,6128,722
2007,Urban,Punjab,Crime Against Women,Domestic Violence,Male,46-60,1960,1066,894,1508,452
2008,Urban,Uttar Pradesh,Crime Against Children,Child Labor,Female,0-12,1667,1159,508,1530,137
2006,Rural,Himachal Pradesh,Other Crimes,Fraud,Female,46-60,4298,1120,3178,3738,560
2002,Urban,Goa,Crime Against Women,Rape,Female,31-45,5200,1922,3278,4203,997
2010,Rural,Nagaland,Crime Against Women,Molestation,Female,46-60,7172,4016,3156,6114,1058
2008,Rural,Himachal Pradesh,Crime Against Women,Molestation,Female,46-60,1892,1320,572,1575,317
2006,Rural,Uttar Pradesh,Property Crime,Theft,Female,18-30,4834,278,4556,1258,3576
2006,Urban,Haryana,Crime Against Children,Trafficking,Female,60+,3499,1090,2409,2844,655
2009,Urban,Haryana,Other Crimes,Cyber Crime,Male,31-45,3250,863,2387,1990,1260
2008,Rural,Karnataka,Crime Against Children,Child Abuse,Male,0-12,4369,315,4054,4060,309
2002,Rural,Tamil Nadu,Crime Against Men,Murder,Female,13-17,869,740,129,801,68
2007,Urban,Tripura,Other Crimes,Corruption,Female,13-17,6091,5325,766,5878,213
2001,Rural,Manipur,Crime Against Men,Extortion,Male,60+,9600,211,9389,7471,2129
2001,Rural,Tamil Nadu,Crime Against Children,Kidnapping,Female,0-12,8703,5923,2780,8226,477
2001,Rural,Uttarakhand,Crime Against Children,Trafficking,Male,0-12,3966,3153,813,3544,422
2003,Rural,Odisha,Other Crimes,Cyber Crime,Female,0-12,5170,3510,1660,4918,252
2001,Urban,Uttar Pradesh,Crime Against Women,Dowry Deaths,Female,60+,4554,1621,2933,2266,2288
2008,Urban,Chhattisgarh,Crime Against Women,Domestic Violence,Female,31-45,9869,7613,2256,7989,1880
2008,Urban,Telangana,Other Crimes,Corruption,Male,31-45,8212,6206,2006,6706,1506
2006,Urban,Meghalaya,Crime Against Women,Rape,Female,0-12,1299,1052,247,1070,229
2002,Urban,Manipur,Crime Against Children,Trafficking,Female,13-17,3721,658,3063,2450,1271
2008,Rural,Andhra Pradesh,Crime Against Men,Assault,Female,31-45,4902,3418,1484,4685,217
2004,Urban,Meghalaya,Property Crime,Burglary,Female,0-12,5052,2492,2560,2677,2375
2010,Urban,Tripura,Property Crime,Burglary,Female,0-12,9687,6955,2732,7241,2446
2010,Urban,Telangana,Crime Against Children,Kidnapping,Female,13-17,280,149,131,280,0
2007,Urban,Delhi,Crime Against Children,Trafficking,Female,18-30,2898,1110,1788,2787,111
2009,Urban,Nagaland,Other Crimes,Cyber Crime,Male,0-12,8438,3150,5288,4156,4282
2001,Rural,Karnataka,Crime Against Men,Extortion,Female,60+,152,105,47,138,14
2007,Urban,Gujarat,Crime Against Men,Murder,Male,13-17,7725,2692,5033,7226,499
2009,Rural,Tamil Nadu,Other Crimes,Fraud,Male,13-17,5975,1156,4819,1624,4351
2002,Urban,Manipur,Crime Against Women,Molestation,Male,60+,1775,505,1270,906,869
2001,Rural,Tamil Nadu,Property Crime,Vandalism,Female,18-30,530,294,236,309,221
2001,Urban,Gujarat,Crime Against Women,Domestic Violence,Female,31-45,6434,3310,3124,5326,1108
2006,Rural,Odisha,Property Crime,Theft,Male,46-60,3745,1828,1917,2762,983
2007,Rural,Punjab,Crime Against Children,Trafficking,Male,31-45,6008,1999,4009,3189,2819
2003,Urban,Sikkim,Crime Against Children,Child Labor,Female,31-45,958,3,955,848,110
2001,Urban,Manipur,Other Crimes,Drug Offense,Male,0-12,6869,6171,698,6486,383
2007,Urban,Bihar,Crime Against Women,Rape,Female,60+,6286,2409,3877,3950,2336
2001,Rural,Karnataka,Crime Against Men,Extortion,Female,46-60,8633,2221,6412,4631,4002
2006,Rural,Uttar Pradesh,Other Crimes,Corruption,Male,46-60,5407,4832,575,5143,264
2009,Rural,Goa,Other Crimes,Corruption,Female,60+,7587,5549,2038,7258,329
2005,Rural,Haryana,Other Crimes,Corruption,Female,0-12,9367,8975,392,9359,8
2001,Urban,Telangana,Crime Against Men,Extortion,Male,46-60,1348,816,532,1282,66
2001,Urban,Chhattisgarh,Property Crime,Arson,Male,0-12,9749,4259,5490,8671,1078
2005,Rural,Nagaland,Property Crime,Vandalism,Female,31-45,6329,2152,4177,2160,4169
2008,Rural,Tamil Nadu,Crime Against Men,Murder,Male,31-45,7990,3159,4831,4073,3917
2007,Urban,Maharashtra,Other Crimes,Corruption,Female,31-45,7298,5820,1478,6116,1182
2006,Urban,Nagaland,Crime Against Men,Assault,Female,31-45,8230,5640,2590,8008,222
2006,Urban,Andhra Pradesh,Crime Against Women,Domestic Violence,Male,13-17,505,450,55,464,41
2008,Urban,Haryana,Other Crimes,Corruption,Female,46-60,2043,582,1461,839,1204
2003,Urban,Delhi,Crime Against Women,Dowry Deaths,Female,46-60,5626,4694,932,5050,576
2004,Rural,Punjab,Crime Against Children,Kidnapping,Male,60+,2260,951,1309,2076,184
2008,Rural,West Bengal,Crime Against Men,Murder,Female,0-12,4960,2752,2208,4652,308
2010,Urban,Gujarat,Property Crime,Burglary,Female,0-12,3250,3004,246,3121,129
2002,Urban,Rajasthan,Crime Against Children,Child Labor,Female,46-60,7536,2071,5465,3657,3879
2010,Rural,Tamil Nadu,Property Crime,Burglary,Male,0-12,5254,1533,3721,3191,2063
2003,Urban,Jharkhand,Crime Against Women,Domestic Violence,Male,0-12,6727,4644,2083,5511,1216
2004,Rural,Haryana,Other Crimes,Drug Offense,Male,31-45,772,466,306,611,161
2001,Rural,Assam,Other Crimes,Corruption,Female,46-60,9936,5751,4185,8556,1380
2003,Rural,Telangana,Crime Against Children,Child Abuse,Female,13-17,5580,1678,3902,3717,1863
2006,Urban,Assam,Other Crimes,Cyber Crime,Female,13-17,7672,143,7529,1820,5852
2009,Urban,Maharashtra,Property Crime,Vandalism,Female,18-30,6492,790,5702,2848,3644
2005,Rural,Karnataka,Crime Against Women,Molestation,Male,31-45,6068,5006,1062,5377,691
2010,Urban,Karnataka,Crime Against Women,Dowry Deaths,Male,46-60,573,363,210,488,85
2004,Urban,Himachal Pradesh,Crime Against Children,Child Abuse,Male,46-60,4822,1643,3179,2344,2478
2006,Urban,Assam,Other Crimes,Corruption,Male,46-60,1115,89,1026,696,419
2004,Rural,Meghalaya,Crime Against Children,Trafficking,Female,46-60,1173,318,855,985,188
2003,Urban,Uttarakhand,Crime Against Women,Dowry Deaths,Female,46-60,8047,6415,1632,6975,1072
2002,Urban,Mizoram,Crime Against Men,Robbery,Male,60+,7133,6183,950,6555,578
2008,Rural,Assam,Property Crime,Arson,Female,18-30,8552,432,8120,1849,6703
2009,Urban,Tripura,Other Crimes,Corruption,Male,18-30,9309,6102,3207,8014,1295
2003,Rural,Odisha,Crime Against Women,Dowry Deaths,Male,13-17,2749,2632,117,2742,7
2010,Urban,Rajasthan,Crime Against Children,Trafficking,Female,13-17,7509,5904,1605,6680,829
2006,Rural,Delhi,Property Crime,Arson,Male,60+,4439,1001,3438,2882,1557
2004,Rural,Telangana,Crime Against Children,Trafficking,Female,46-60,8708,3036,5672,4539,4169
2005,Rural,Odisha,Crime Against Women,Rape,Female,46-60,4508,3589,919,4113,395
2005,Urban,Arunachal Pradesh,Crime Against Children,Child Abuse,Male,46-60,211,202,9,202,9
2002,Urban,Arunachal Pradesh,Crime Against Children,Kidnapping,Male,46-60,9226,5914,3312,9041,185
2008,Rural,West Bengal,Property Crime,Burglary,Male,0-12,3707,960,2747,3182,525
2004,Rural,Goa,Other Crimes,Cyber Crime,Female,46-60,5309,3905,1404,4983,326
2007,Rural,Karnataka,Crime Against Women,Domestic Violence,Male,31-45,8175,579,7596,2678,5497
2001,Rural,Uttar Pradesh,Crime Against Children,Kidnapping,Male,46-60,8647,3576,5071,5269,3378
2004,Rural,Kerala,Crime Against Women,Rape,Female,13-17,8345,6865,1480,7582,763
2002,Rural,Uttarakhand,Crime Against Men,Robbery,Male,0-12,9802,7136,2666,8403,1399
2001,Urban,Andhra Pradesh,Other Crimes,Cyber Crime,Female,18-30,8296,2152,6144,3276,5020
2002,Rural,Himachal Pradesh,Other Crimes,Cyber Crime,Female,18-30,9211,4727,4484,8427,784
2009,Rural,Punjab,Property Crime,Vandalism,Male,46-60,980,82,898,286,694
2003,Urban,Rajasthan,Property Crime,Theft,Female,60+,8501,188,8313,6461,2040
2005,Rural,Punjab,Property Crime,Arson,Male,0-12,2428,836,1592,1236,1192
2004,Urban,Kerala,Property Crime,Theft,Female,31-45,3545,512,3033,2654,891
2004,Rural,Odisha,Crime Against Men,Extortion,Female,31-45,5580,2923,2657,4284,1296
2004,Rural,Jharkhand,Crime Against Women,Molestation,Female,46-60,5762,3885,1877,4184,1578
2006,Rural,Jammu & Kashmir,Other Crimes,Drug Offense,Female,46-60,5381,3460,1921,5108,273
2009,Urban,Mizoram,Crime Against Children,Trafficking,Female,13-17,8740,2044,6696,4029,4711
2010,Rural,Manipur,Crime Against Men,Extortion,Male,18-30,1404,868,536,998,406
2004,Rural,Meghalaya,Crime Against Women,Rape,Male,13-17,989,121,868,834,155
2004,Rural,Uttar Pradesh,Property Crime,Theft,Male,13-17,2000,1861,139,1906,94
2001,Urban,Mizoram,Property Crime,Theft,Male,31-45,5284,4569,715,4591,693
2008,Rural,Karnataka,Other Crimes,Corruption,Female,46-60,8174,1861,6313,2438,5736
2002,Rural,Bihar,Property Crime,Burglary,Male,46-60,8949,4904,4045,6206,2743
2002,Rural,Maharashtra,Other Crimes,Drug Offense,Male,0-12,3545,455,3090,2855,690
2006,Rural,Andhra Pradesh,Crime Against Women,Domestic Violence,Male,18-30,274,226,48,271,3
2007,Rural,Manipur,Crime Against Women,Molestation,Male,0-12,6374,982,5392,5929,445
2003,Rural,Andhra Pradesh,Other Crimes,Drug Offense,Male,13-17,7385,6375,1010,6708,677
2001,Rural,Delhi,Crime Against Men,Murder,Female,13-17,7898,6034,1864,7536,362
2005,Urban,Madhya Pradesh,Crime Against Men,Robbery,Male,18-30,8264,2919,5345,3966,4298
2003,Rural,Andhra Pradesh,Property Crime,Arson,Male,46-60,4193,2862,1331,3074,1119
2001,Urban,Jharkhand,Property Crime,Vandalism,Male,60+,5107,4313,794,4491,616
2001,Rural,Manipur,Crime Against Women,Molestation,Male,0-12,7828,6800,1028,7136,692
2006,Rural,Punjab,Crime Against Women,Domestic Violence,Female,0-12,8435,1399,7036,5990,2445
2009,Urban,Chhattisgarh,Crime Against Men,Extortion,Male,46-60,2201,766,1435,1109,1092
2010,Urban,Tripura,Crime Against Men,Murder,Female,0-12,7041,5558,1483,5937,1104
2008,Urban,Kerala,Property Crime,Theft,Female,13-17,7398,5146,2252,6469,929
2002,Urban,Chhattisgarh,Property Crime,Theft,Female,18-30,3779,2192,1587,2472,1307
2009,Urban,Kerala,Crime Against Men,Murder,Female,13-17,8662,5212,3450,7226,1436
2004,Urban,Meghalaya,Crime Against Women,Domestic Violence,Female,0-12,3294,1074,2220,1330,1964
2005,Urban,Meghalaya,Crime Against Women,Domestic Violence,Male,60+,7094,4660,2434,5791,1303
2008,Rural,Tripura,Crime Against Children,Trafficking,Male,60+,4723,1926,2797,2661,2062
2004,Urban,Tripura,Crime Against Children,Kidnapping,Male,0-12,7079,2398,4681,5406,1673
2008,Rural,Odisha,Other Crimes,Cyber Crime,Male,18-30,9453,6968,2485,8393,1060
2006,Rural,Goa,Crime Against Women,Molestation,Male,60+,4732,3157,1575,4326,406
2006,Rural,Goa,Property Crime,Arson,Female,31-45,8147,3100,5047,7912,235
2002,Rural,West Bengal,Other Crimes,Cyber Crime,Male,18-30,9512,6189,3323,6835,2677
2009,Rural,Nagaland,Crime Against Children,Child Labor,Female,0-12,5452,1824,3628,3433,2019
2007,Urban,Haryana,Crime Against Children,Kidnapping,Female,18-30,8034,5756,2278,6518,1516
2010,Rural,Jharkhand,Other Crimes,Corruption,Female,60+,3943,3456,487,3740,203
2004,Urban,Rajasthan,Property Crime,Arson,Male,31-45,5307,2158,3149,3428,1879
2009,Rural,Rajasthan,Crime Against Men,Assault,Male,31-45,3127,1049,2078,2038,1089
2002,Urban,Punjab,Property Crime,Burglary,Male,0-12,6582,5221,1361,6017,565
2008,Rural,West Bengal,Other Crimes,Corruption,Female,31-45,5558,4249,1309,5403,155
2009,Urban,Jharkhand,Crime Against Children,Kidnapping,Male,13-17,9464,52,9412,5490,3974
2002,Rural,Andhra Pradesh,Crime Against Women,Rape,Female,0-12,5155,3148,2007,3206,1949
2001,Urban,Tripura,Crime Against Men,Assault,Female,31-45,8847,2490,6357,3683,5164
2004,Urban,Karnataka,Crime Against Children,Child Abuse,Male,13-17,9230,8904,326,8937,293
2004,Rural,Bihar,Crime Against Women,Rape,Male,60+,7535,3581,3954,6770,765
2005,Rural,Odisha,Crime Against Children,Child Labor,Female,46-60,7090,5932,1158,6986,104
2005,Urban,Uttarakhand,Other Crimes,Drug Offense,Male,18-30,2799,2099,700,2151,648
2010,Rural,Jharkhand,Crime Against Men,Extortion,Male,18-30,6533,448,6085,2522,4011
2008,Urban,West Bengal,Crime Against Women,Rape,Male,31-45,3119,2195,924,2428,691
2007,Rural,Tamil Nadu,Other Crimes,Drug Offense,Male,60+,1745,581,1164,916,829
2007,Rural,Haryana,Crime Against Children,Child Abuse,Female,31-45,2032,946,1086,1890,142
2003,Rural,Odisha,Crime Against Children,Child Labor,Male,0-12,821,502,319,726,95
2007,Rural,Andhra Pradesh,Property Crime,Burglary,Male,18-30,6903,5875,1028,6763,140
2005,Urban,Chhattisgarh,Other Crimes,Corruption,Female,60+,5286,2252,3034,4383,903
2007,Urban,Rajasthan,Crime Against Women,Molestation,Male,18-30,1674,571,1103,1311,363
2001,Urban,Mizoram,Other Crimes,Drug Offense,Female,13-17,9623,6688,2935,9142,481
2009,Urban,Jammu & Kashmir,Other Crimes,Fraud,Female,60+,9409,6523,2886,6985,2424
2007,Urban,Arunachal Pradesh,Property Crime,Theft,Female,13-17,154,71,83,139,15
2007,Rural,Kerala,Property Crime,Vandalism,Male,46-60,4258,1431,2827,2511,1747
2006,Rural,Tripura,Crime Against Men,Robbery,Female,60+,6455,5072,1383,6038,417
2003,Urban,Odisha,Property Crime,Theft,Female,13-17,7532,1531,6001,1532,6000
2003,Urban,Maharashtra,Crime Against Children,Trafficking,Female,60+,2981,614,2367,2787,194
2004,Rural,Maharashtra,Crime Against Women,Rape,Male,46-60,757,242,515,736,21
2002,Rural,Delhi,Crime Against Children,Child Abuse,Male,0-12,3731,2235,1496,3071,660
2002,Rural,Kerala,Property Crime,Arson,Male,46-60,5229,4624,605,4818,411
2008,Urban,Karnataka,Other Crimes,Drug Offense,Male,13-17,6391,3497,2894,4669,1722
2007,Rural,Rajasthan,Crime Against Children,Child Abuse,Female,31-45,1289,721,568,833,456
2008,Rural,Assam,Crime Against Children,Kidnapping,Female,0-12,4844,1822,3022,2896,1948
2009,Rural,Chhattisgarh,Crime Against Men,Extortion,Female,60+,2382,2195,187,2264,118
2001,Rural,Gujarat,Crime Against Women,Dowry Deaths,Female,18-30,7088,6699,389,6927,161
2002,Urban,Telangana,Crime Against Children,Trafficking,Female,60+,5342,4605,737,4937,405
2010,Rural,Madhya Pradesh,Property Crime,Vandalism,Male,60+,8693,8360,333,8462,231
2003,Rural,Chhattisgarh,Crime Against Women,Dowry Deaths,Male,13-17,5106,1756,3350,4026,1080
2005,Urban,Madhya Pradesh,Crime Against Women,Domestic Violence,Male,18-30,4211,3145,1066,3588,623
2001,Urban,Nagaland,Property Crime,Arson,Male,18-30,9036,1487,7549,5892,3144
2001,Rural,Goa,Crime Against Men,Extortion,Male,13-17,3210,108,3102,2209,1001
2003,Urban,Andhra Pradesh,Other Crimes,Corruption,Male,13-17,6573,1967,4606,5877,696
2007,Urban,Odisha,Crime Against Children,Kidnapping,Female,60+,4334,1503,2831,3133,1201
2006,Urban,Assam,Crime Against Women,Dowry Deaths,Male,60+,9380,2482,6898,4229,5151
2002,Urban,Tripura,Other Crimes,Drug Offense,Male,60+,7311,4556,2755,4870,2441
2005,Rural,Uttar Pradesh,Crime Against Women,Rape,Male,46-60,2466,661,1805,1535,931
2010,Urban,Himachal Pradesh,Crime Against Women,Rape,Male,60+,2040,1696,344,1792,248
2005,Rural,West Bengal,Crime Against Men,Robbery,Male,60+,9049,7387,1662,7772,1277
2005,Urban,Andhra Pradesh,Crime Against Women,Domestic Violence,Male,46-60,2905,1254,1651,2224,681
2005,Urban,Sikkim,Crime Against Children,Kidnapping,Male,18-30,578,352,226,446,132
2010,Rural,Chhattisgarh,Crime Against Women,Rape,Male,0-12,2909,233,2676,2734,175
2003,Urban,Odisha,Crime Against Men,Murder,Female,13-17,5035,2008,3027,3289,1746
2005,Rural,Kerala,Crime Against Men,Assault,Female,18-30,4747,1665,3082,4494,253
2007,Urban,Tamil Nadu,Crime Against Women,Rape,Female,46-60,7782,7528,254,7733,49
2002,Rural,Chhattisgarh,Crime Against Children,Kidnapping,Female,0-12,9663,1035,8628,7812,1851
2001,Rural,Meghalaya,Property Crime,Burglary,Female,31-45,516,124,392,337,179
2008,Rural,Jammu & Kashmir,Property Crime,Theft,Female,13-17,5109,1037,4072,3231,1878
2001,Rural,Tamil Nadu,Crime Against Men,Assault,Male,0-12,3991,2005,1986,2936,1055
2008,Rural,Kerala,Crime Against Children,Child Abuse,Female,0-12,7289,6026,1263,6941,348
2003,Rural,Telangana,Crime Against Children,Child Labor,Male,13-17,9985,7068,2917,7980,2005
2003,Rural,Arunachal Pradesh,Crime Against Children,Child Labor,Male,13-17,5141,2621,2520,3305,1836
2003,Urban,Sikkim,Other Crimes,Cyber Crime,Male,18-30,4305,3677,628,3893,412
2005,Urban,Sikkim,Crime Against Children,Kidnapping,Female,60+,4067,1253,2814,1596,2471
2006,Urban,Maharashtra,Other Crimes,Fraud,Male,13-17,4987,4500,487,4693,294
2004,Urban,Goa,Crime Against Children,Kidnapping,Male,31-45,7835,1489,6346,5361,2474
2005,Rural,Odisha,Other Crimes,Fraud,Male,18-30,3123,837,2286,2069,1054
2003,Urban,Mizoram,Other Crimes,Drug Offense,Male,46-60,5190,4268,922,4419,771
2004,Rural,Delhi,Property Crime,Arson,Female,31-45,1660,54,1606,448,1212
2009,Urban,Punjab,Crime Against Men,Assault,Male,46-60,3231,500,2731,1667,1564
2004,Rural,Tripura,Other Crimes,Corruption,Female,0-12,7271,6745,526,6781,490
2001,Rural,Rajasthan,Property Crime,Arson,Male,46-60,5497,783,4714,4427,1070
2002,Rural,Sikkim,Other Crimes,Cyber Crime,Female,46-60,4132,2143,1989,3195,937
2001,Rural,Uttar Pradesh,Other Crimes,Cyber Crime,Male,18-30,3515,2925,590,2969,546
2010,Urban,Telangana,Crime Against Men,Assault,Male,0-12,1005,345,660,402,603
2006,Rural,Uttar Pradesh,Other Crimes,Drug Offense,Male,60+,8732,7785,947,7952,780
2007,Urban,Jammu & Kashmir,Crime Against Children,Child Abuse,Male,46-60,6604,3664,2940,5537,1067
2010,Urban,Delhi,Property Crime,Arson,Female,18-30,9141,8953,188,9048,93
2004,Urban,Haryana,Crime Against Women,Molestation,Female,46-60,6208,3555,2653,3792,2416
2002,Urban,Tamil Nadu,Crime Against Children,Kidnapping,Female,18-30,3329,3180,149,3219,110
2003,Urban,Tripura,Crime Against Children,Kidnapping,Male,0-12,6935,5409,1526,5916,1019
2005,Urban,Odisha,Crime Against Women,Rape,Female,13-17,1271,634,637,805,466
2009,Rural,West Bengal,Other Crimes,Fraud,Female,13-17,4977,4035,942,4765,212
2010,Urban,Himachal Pradesh,Crime Against Children,Kidnapping,Male,46-60,2824,1578,1246,2367,457
2008,Urban,Jammu & Kashmir,Crime Against Women,Dowry Deaths,Male,18-30,489,155,334,177,312
2003,Rural,Delhi,Crime Against Women,Dowry Deaths,Female,31-45,8542,2007,6535,7593,949
2009,Rural,Assam,Crime Against Men,Assault,Female,18-30,5057,4636,421,4668,389
2006,Urban,Tripura,Crime Against Women,Dowry Deaths,Male,0-12,5556,2404,3152,5055,501
2001,Rural,Gujarat,Crime Against Men,Robbery,Female,18-30,4768,935,3833,1276,3492
2003,Urban,Rajasthan,Property Crime,Theft,Male,18-30,5823,5679,144,5748,75
2006,Urban,Uttar Pradesh,Property Crime,Vandalism,Male,60+,9693,6989,2704,7827,1866
2010,Urban,Himachal Pradesh,Crime Against Children,Child Labor,Male,60+,1589,1025,564,1549,40
2009,Urban,Odisha,Crime Against Women,Dowry Deaths,Female,18-30,7726,2111,5615,4627,3099
2008,Rural,Maharashtra,Crime Against Children,Child Labor,Female,46-60,7167,1910,5257,3089,4078
2002,Urban,Tripura,Crime Against Men,Assault,Female,0-12,5510,4818,692,4985,525
2001,Rural,Rajasthan,Crime Against Men,Murder,Female,60+,6996,1242,5754,5184,1812
2004,Rural,Sikkim,Crime Against Men,Assault,Male,60+,8604,3839,4765,6367,2237
2009,Rural,Uttarakhand,Crime Against Men,Extortion,Female,46-60,1302,143,1159,360,942
2008,Urban,Haryana,Crime Against Children,Child Labor,Male,60+,763,686,77,698,65
2004,Rural,Punjab,Crime Against Women,Domestic Violence,Female,0-12,90,12,78,83,7
2007,Urban,Jharkhand,Crime Against Men,Assault,Female,31-45,862,212,650,777,85
2002,Rural,Arunachal Pradesh,Property Crime,Arson,Male,18-30,7629,3900,3729,5627,2002
2001,Urban,Madhya Pradesh,Crime Against Women,Dowry Deaths,Male,18-30,1144,1136,8,1144,0
2006,Rural,Jammu & Kashmir,Crime Against Women,Domestic Violence,Male,0-12,2874,1154,1720,1606,1268
2003,Urban,Arunachal Pradesh,Crime Against Children,Child Labor,Male,46-60,4433,2422,2011,3459,974
2006,Rural,Maharashtra,Other Crimes,Corruption,Female,31-45,3274,919,2355,1943,1331
2010,Urban,Odisha,Crime Against Women,Molestation,Female,0-12,8228,6150,2078,8063,165
2007,Urban,Chhattisgarh,Crime Against Men,Assault,Female,0-12,677,208,469,543,134
2005,Rural,Uttar Pradesh,Crime Against Men,Assault,Female,31-45,7251,4760,2491,5067,2184
2003,Urban,Bihar,Crime Against Men,Extortion,Male,0-12,683,374,309,504,179
2005,Rural,Arunachal Pradesh,Property Crime,Vandalism,Male,13-17,486,7,479,447,39
2001,Rural,Chhattisgarh,Crime Against Women,Molestation,Male,0-12,9042,6012,3030,8650,392
2005,Urban,Jharkhand,Crime Against Children,Trafficking,Female,46-60,5103,75,5028,2420,2683
2002,Rural,Assam,Crime Against Women,Domestic Violence,Female,0-12,7500,3496,4004,4940,2560
2001,Rural,Karnataka,Property Crime,Vandalism,Female,31-45,2357,163,2194,847,1510
2002,Rural,Jammu & Kashmir,Property Crime,Burglary,Male,18-30,5801,2893,2908,5401,400
2008,Rural,Uttarakhand,Crime Against Men,Robbery,Female,46-60,2579,1502,1077,1644,935
2003,Rural,Bihar,Crime Against Children,Trafficking,Female,18-30,6740,183,6557,1897,4843
2007,Rural,Bihar,Other Crimes,Corruption,Female,13-17,436,367,69,387,49
2001,Urban,Punjab,Crime Against Children,Child Abuse,Male,13-17,6106,4481,1625,4652,1454
2002,Urban,West Bengal,Crime Against Men,Murder,Female,0-12,9903,8734,1169,8770,1133
2009,Urban,Delhi,Other Crimes,Drug Offense,Female,31-45,7011,6325,686,6949,62
2009,Rural,Chhattisgarh,Other Crimes,Corruption,Female,46-60,6282,4208,2074,4654,1628
2004,Rural,Tripura,Crime Against Women,Domestic Violence,Male,31-45,9181,4506,4675,6818,2363
2010,Rural,Jharkhand,Other Crimes,Cyber Crime,Male,31-45,6945,604,6341,1539,5406
2010,Rural,Nagaland,Crime Against Children,Kidnapping,Male,60+,8016,3320,4696,5149,2867
2004,Urban,Andhra Pradesh,Crime Against Women,Rape,Male,31-45,5064,3348,1716,5058,6
2009,Urban,Sikkim,Crime Against Children,Child Abuse,Male,60+,5031,608,4423,4273,758
2008,Urban,Goa,Crime Against Men,Extortion,Male,0-12,7874,1314,6560,5589,2285
2005,Urban,Uttarakhand,Other Crimes,Corruption,Male,13-17,4833,2170,2663,3865,968
2004,Urban,Manipur,Crime Against Children,Kidnapping,Female,60+,7310,6124,1186,7126,184
2002,Rural,Nagaland,Crime Against Children,Trafficking,Female,13-17,3704,2867,837,2904,800
2004,Rural,Tripura,Crime Against Women,Molestation,Male,31-45,8642,1785,6857,3184,5458
2010,Urban,Arunachal Pradesh,Property Crime,Arson,Female,31-45,6022,3966,2056,4691,1331
2007,Rural,Himachal Pradesh,Crime Against Men,Extortion,Male,18-30,9574,3692,5882,7042,2532
2007,Urban,Uttarakhand,Other Crimes,Cyber Crime,Male,31-45,7888,4956,2932,7590,298
2006,Rural,Jharkhand,Other Crimes,Drug Offense,Male,18-30,8898,5484,3414,6395,2503
2006,Rural,Karnataka,Crime Against Women,Domestic Violence,Male,46-60,2662,166,2496,747,1915
2003,Rural,Chhattisgarh,Property Crime,Vandalism,Female,0-12,9581,4540,5041,7436,2145
2009,Rural,Bihar,Property Crime,Burglary,Male,18-30,3550,507,3043,3406,144
2005,Urban,Jammu & Kashmir,Crime Against Children,Child Labor,Male,31-45,7443,841,6602,7118,325
2007,Rural,Manipur,Property Crime,Burglary,Male,46-60,353,85,268,254,99
2004,Rural,West Bengal,Crime Against Children,Child Abuse,Male,31-45,6573,493,6080,3877,2696
2009,Urban,Tamil Nadu,Crime Against Children,Child Abuse,Male,0-12,3784,329,3455,2434,1350
2008,Urban,Himachal Pradesh,Other Crimes,Drug Offense,Male,46-60,5686,2317,3369,3329,2357
2005,Rural,Chhattisgarh,Other Crimes,Cyber Crime,Male,13-17,3517,3417,100,3473,44
2008,Urban,Karnataka,Crime Against Men,Murder,Male,60+,7623,593,7030,6964,659
2003,Urban,Madhya Pradesh,Crime Against Men,Murder,Male,46-60,8533,8357,176,8368,165
2007,Urban,West Bengal,Crime Against Men,Murder,Male,31-45,1175,548,627,1086,89
2005,Urban,Jharkhand,Crime Against Children,Child Abuse,Female,0-12,7562,7531,31,7553,9
2002,Urban,Arunachal Pradesh,Crime Against Children,Child Labor,Male,0-12,7987,2155,5832,4960,3027
2008,Urban,Arunachal Pradesh,Other Crimes,Corruption,Male,60+,733,436,297,492,241
2008,Rural,Delhi,Property Crime,Vandalism,Female,31-45,1464,162,1302,661,803
2010,Rural,Odisha,Crime Against Men,Murder,Male,18-30,3067,2844,223,2928,139
2003,Urban,Mizoram,Other Crimes,Corruption,Female,60+,8670,1232,7438,5127,3543
2010,Urban,Manipur,Property Crime,Vandalism,Female,0-12,6554,6439,115,6512,42
2003,Rural,Tamil Nadu,Property Crime,Burglary,Male,0-12,9184,215,8969,7259,1925
2005,Rural,Jharkhand,Property Crime,Vandalism,Male,18-30,6724,815,5909,3926,2798
2010,Urban,Uttarakhand,Crime Against Children,Kidnapping,Female,60+,6238,4658,1580,5830,408
2004,Rural,Odisha,Crime Against Men,Assault,Female,13-17,7012,3463,3549,6664,348
2007,Urban,Karnataka,Other Crimes,Drug Offense,Female,0-12,9593,6853,2740,8031,1562
2005,Urban,Punjab,Crime Against Women,Dowry Deaths,Male,60+,4478,1145,3333,3589,889
2005,Rural,Tripura,Crime Against Men,Murder,Female,60+,4925,2831,2094,3941,984
2002,Urban,Manipur,Other Crimes,Fraud,Male,46-60,3188,1580,1608,2096,1092
2006,Urban,Haryana,Other Crimes,Cyber Crime,Male,60+,332,228,104,292,40
2010,Rural,Bihar,Crime Against Children,Child Abuse,Female,13-17,8196,5247,2949,7077,1119
2010,Rural,Bihar,Crime Against Children,Trafficking,Male,18-30,2455,630,1825,784,1671
2005,Urban,Manipur,Crime Against Men,Assault,Male,60+,5558,3219,2339,4263,1295
2001,Urban,Jammu & Kashmir,Crime Against Women,Dowry Deaths,Female,60+,748,267,481,398,350
2009,Urban,Gujarat,Crime Against Men,Robbery,Female,13-17,1396,340,1056,1137,259
2001,Urban,Karnataka,Property Crime,Burglary,Female,0-12,7188,2885,4303,3799,3389
2009,Rural,Jammu & Kashmir,Crime Against Children,Kidnapping,Male,60+,4574,460,4114,501,4073
2010,Urban,Uttar Pradesh,Crime Against Children,Child Labor,Male,31-45,7566,3261,4305,6613,953
2009,Urban,Telangana,Property Crime,Theft,Female,13-17,9665,6571,3094,9372,293
2006,Rural,Tripura,Property Crime,Arson,Male,18-30,4226,2544,1682,2563,1663
2008,Rural,Madhya Pradesh,Crime Against Men,Robbery,Female,60+,5383,4035,1348,4911,472
2003,Urban,Jharkhand,Property Crime,Theft,Male,46-60,408,160,248,203,205
2007,Urban,Nagaland,Other Crimes,Drug Offense,Female,18-30,1490,166,1324,1204,286
2005,Urban,Jharkhand,Property Crime,Arson,Female,46-60,5221,3516,1705,4811,410
2006,Urban,West Bengal,Crime Against Women,Rape,Female,13-17,3139,2741,398,2960,179
2007,Urban,Nagaland,Crime Against Children,Child Labor,Female,46-60,7411,2177,5234,7234,177
2007,Urban,Uttarakhand,Crime Against Children,Child Abuse,Male,31-45,9600,4514,5086,9330,270
2008,Rural,Karnataka,Property Crime,Burglary,Male,60+,7340,4661,2679,4718,2622
2003,Rural,Tripura,Crime Against Children,Child Labor,Female,13-17,2613,2521,92,2549,64
2002,Rural,Goa,Other Crimes,Drug Offense,Female,18-30,9966,6517,3449,7122,2844
2001,Rural,Meghalaya,Crime Against Children,Child Labor,Male,0-12,9948,572,9376,6866,3082
2005,Urban,Tamil Nadu,Crime Against Women,Domestic Violence,Female,31-45,8947,8926,21,8929,18
2002,Rural,Mizoram,Property Crime,Theft,Female,13-17,1612,734,878,1181,431
2006,Urban,Gujarat,Crime Against Men,Assault,Male,46-60,2053,986,1067,1200,853
2004,Rural,Rajasthan,Crime Against Men,Robbery,Male,46-60,3459,1803,1656,1949,1510
2010,Rural,Karnataka,Crime Against Women,Dowry Deaths,Male,31-45,4532,4099,433,4415,117
2002,Rural,Nagaland,Crime Against Women,Domestic Violence,Male,31-45,132,100,32,112,20
2007,Urban,Nagaland,Crime Against Women,Molestation,Male,46-60,9435,4100,5335,8583,852
2007,Urban,Arunachal Pradesh,Crime Against Children,Child Labor,Male,46-60,2573,2367,206,2500,73
2005,Rural,Meghalaya,Crime Against Women,Molestation,Female,0-12,8060,1555,6505,3066,4994
2010,Urban,Goa,Property Crime,Vandalism,Female,18-30,5692,1720,3972,2882,2810
2004,Rural,Gujarat,Crime Against Women,Rape,Female,46-60,6983,5357,1626,6654,329
2007,Rural,Tripura,Other Crimes,Drug Offense,Female,13-17,9483,9454,29,9479,4
2009,Rural,Jharkhand,Crime Against Men,Assault,Female,46-60,2971,2234,737,2479,492
2003,Urban,Nagaland,Crime Against Men,Assault,Male,13-17,6707,6169,538,6379,328
2001,Rural,Andhra Pradesh,Property Crime,Theft,Male,31-45,5857,4347,1510,5617,240
2005,Rural,Tamil Nadu,Crime Against Women,Dowry Deaths,Female,46-60,8322,2824,5498,7127,1195
2008,Urban,Manipur,Crime Against Children,Trafficking,Female,60+,4961,754,4207,1932,3029
2001,Urban,Kerala,Property Crime,Vandalism,Female,0-12,7709,2904,4805,5322,2387
2004,Urban,Bihar,Crime Against Children,Kidnapping,Male,0-12,4900,2586,2314,3075,1825
2006,Rural,Arunachal Pradesh,Crime Against Children,Child Abuse,Female,60+,3170,331,2839,2423,747
2010,Rural,Delhi,Crime Against Women,Dowry Deaths,Male,60+,1998,1881,117,1957,41
2003,Rural,West Bengal,Property Crime,Arson,Male,46-60,7455,891,6564,5940,1515
2009,Rural,Delhi,Crime Against Men,Extortion,Female,18-30,5096,1403,3693,2338,2758
2005,Urban,Manipur,Crime Against Children,Trafficking,Male,0-12,7134,1957,5177,3951,3183
2004,Urban,Rajasthan,Property Crime,Burglary,Female,13-17,5808,3137,2671,5765,43
2005,Rural,Gujarat,Crime Against Women,Molestation,Female,13-17,3596,1814,1782,1815,1781
2001,Rural,Tamil Nadu,Property Crime,Vandalism,Male,46-60,6703,146,6557,3266,3437
2004,Rural,Uttar Pradesh,Property Crime,Arson,Male,60+,1056,863,193,951,105
2005,Rural,Uttarakhand,Crime Against Men,Murder,Female,46-60,4240,3711,529,4032,208
2008,Rural,Karnataka,Other Crimes,Fraud,Male,13-17,5028,1983,3045,4712,316
2001,Urban,Andhra Pradesh,Property Crime,Arson,Male,0-12,9901,1323,8578,8136,1765
2001,Urban,Sikkim,Property Crime,Arson,Female,13-17,964,763,201,905,59
2010,Rural,Punjab,Property Crime,Vandalism,Female,18-30,1594,814,780,1516,78
2005,Rural,Jammu & Kashmir,Crime Against Men,Assault,Male,0-12,7812,5975,1837,7808,4
2006,Rural,Himachal Pradesh,Crime Against Children,Child Abuse,Male,18-30,8776,5380,3396,6602,2174
2005,Urban,Odisha,Other Crimes,Corruption,Female,31-45,8752,5452,3300,6464,2288
2005,Rural,Punjab,Crime Against Women,Dowry Deaths,Female,18-30,9692,8995,697,9116,576
2009,Rural,Assam,Crime Against Children,Kidnapping,Female,60+,5879,3950,1929,4512,1367
2009,Urban,Rajasthan,Property Crime,Burglary,Male,60+,3256,2299,957,2629,627
2010,Urban,Mizoram,Other Crimes,Cyber Crime,Male,0-12,9989,9642,347,9989,0
2009,Rural,Odisha,Crime Against Women,Molestation,Male,13-17,2260,1534,726,1909,351
2007,Urban,Rajasthan,Crime Against Children,Child Abuse,Female,31-45,8809,8376,433,8441,368
2008,Rural,Uttar Pradesh,Crime Against Children,Child Abuse,Male,18-30,2223,509,1714,1596,627
2007,Rural,Karnataka,Crime Against Men,Extortion,Female,46-60,6509,3677,2832,6034,475
2001,Rural,Nagaland,Property Crime,Theft,Male,18-30,6704,656,6048,1906,4798
2005,Urban,Odisha,Crime Against Women,Dowry Deaths,Male,60+,293,233,60,236,57
2007,Rural,Himachal Pradesh,Other Crimes,Corruption,Male,46-60,4215,1601,2614,1666,2549
2005,Urban,Haryana,Crime Against Children,Kidnapping,Female,60+,2597,1820,777,2056,541
2010,Rural,Tamil Nadu,Crime Against Children,Kidnapping,Female,31-45,7246,901,6345,4016,3230
2008,Rural,West Bengal,Other Crimes,Drug Offense,Female,18-30,354,277,77,317,37
2010,Rural,Odisha,Crime Against Women,Molestation,Male,13-17,9049,5255,3794,8119,930
2008,Rural,Punjab,Other Crimes,Corruption,Male,60+,6996,4658,2338,6160,836
2008,Rural,Tamil Nadu,Crime Against Men,Extortion,Male,60+,2573,1542,1031,2078,495
2009,Rural,Odisha,Crime Against Women,Domestic Violence,Male,13-17,1423,1305,118,1404,19
2005,Rural,Maharashtra,Crime Against Men,Assault,Female,31-45,9605,165,9440,8525,1080
2004,Rural,Madhya Pradesh,Property Crime,Theft,Male,13-17,1784,747,1037,1141,643
2008,Rural,Manipur,Other Crimes,Cyber Crime,Male,0-12,4453,3310,1143,3491,962
2009,Rural,Mizoram,Crime Against Women,Dowry Deaths,Female,46-60,5552,194,5358,3558,1994
2001,Rural,Goa,Crime Against Women,Rape,Female,60+,7943,1963,5980,3792,4151
2005,Rural,Bihar,Property Crime,Theft,Female,13-17,1469,1392,77,1406,63
2003,Rural,Delhi,Crime Against Women,Molestation,Female,0-12,5437,4464,973,4541,896
2002,Rural,Tripura,Other Crimes,Drug Offense,Female,31-45,2092,1744,348,1954,138
2010,Rural,Goa,Crime Against Women,Dowry Deaths,Female,46-60,7632,1049,6583,2130,5502
2004,Rural,Karnataka,Crime Against Women,Domestic Violence,Male,18-30,693,363,330,381,312
2005,Rural,Bihar,Crime Against Women,Rape,Male,13-17,822,319,503,612,210
2006,Urban,Madhya Pradesh,Crime Against Men,Assault,Male,60+,2307,1696,611,2130,177
2007,Rural,Punjab,Crime Against Men,Murder,Male,18-30,4640,2521,2119,4208,432
2001,Rural,Manipur,Crime Against Women,Dowry Deaths,Female,13-17,6402,1293,5109,1753,4649
2001,Rural,Mizoram,Property Crime,Theft,Female,31-45,4614,810,3804,3537,1077
2008,Urban,Rajasthan,Crime Against Men,Assault,Male,31-45,7561,5848,1713,5938,1623
2007,Rural,Assam,Crime Against Children,Trafficking,Male,46-60,4414,2341,2073,3425,989
2004,Rural,Telangana,Property Crime,Burglary,Male,13-17,250,145,105,226,24
2010,Urban,Madhya Pradesh,Other Crimes,Cyber Crime,Female,13-17,1091,159,932,546,545
2010,Rural,Bihar,Crime Against Women,Domestic Violence,Female,60+,8748,6683,2065,8582,166
2001,Urban,Delhi,Crime Against Men,Robbery,Female,18-30,423,56,367,201,222
2003,Urban,Mizoram,Property Crime,Burglary,Male,31-45,7595,2585,5010,2941,4654
2001,Rural,Delhi,Other Crimes,Corruption,Male,13-17,4307,2183,2124,2905,1402
2002,Rural,Nagaland,Other Crimes,Fraud,Female,18-30,3811,1255,2556,3559,252
2005,Rural,Goa,Property Crime,Theft,Female,46-60,5392,918,4474,3301,2091
2009,Urban,Tripura,Crime Against Men,Murder,Female,0-12,7713,756,6957,2919,4794
2007,Urban,Kerala,Crime Against Children,Child Abuse,Male,13-17,2963,2909,54,2960,3
2003,Rural,Maharashtra,Crime Against Women,Rape,Male,60+,2337,712,1625,1367,970
2010,Urban,Manipur,Crime Against Men,Assault,Female,13-17,9992,6108,3884,7941,2051
2009,Rural,Sikkim,Crime Against Children,Kidnapping,Female,0-12,2588,575,2013,891,1697
2005,Rural,Odisha,Other Crimes,Corruption,Male,0-12,5626,2681,2945,4471,1155
2001,Urban,Uttarakhand,Property Crime,Vandalism,Male,46-60,7485,6317,1168,6735,750
2007,Rural,Kerala,Property Crime,Theft,Female,0-12,7467,1439,6028,1919,5548
2005,Urban,Delhi,Other Crimes,Cyber Crime,Male,0-12,3313,3087,226,3274,39
2004,Urban,Rajasthan,Other Crimes,Fraud,Male,18-30,6979,3770,3209,6525,454
2007,Urban,Himachal Pradesh,Crime Against Men,Extortion,Male,60+,2555,2533,22,2536,19
2006,Urban,Manipur,Other Crimes,Drug Offense,Female,60+,2889,2697,192,2782,107
2009,Rural,Kerala,Crime Against Men,Murder,Female,18-30,7127,4646,2481,4888,2239
2005,Rural,Meghalaya,Crime Against Women,Dowry Deaths,Male,31-45,8065,4734,3331,5746,2319
2010,Urban,Uttar Pradesh,Property Crime,Vandalism,Female,18-30,9450,3745,5705,5447,4003
2003,Rural,Gujarat,Crime Against Men,Assault,Male,46-60,9180,2552,6628,8453,727
2009,Rural,Meghalaya,Crime Against Children,Child Labor,Female,31-45,8044,461,7583,6898,1146
2006,Rural,Meghalaya,Crime Against Men,Assault,Male,46-60,7490,4102,3388,7459,31
2006,Urban,Maharashtra,Crime Against Men,Assault,Male,46-60,3484,834,2650,1630,1854
2006,Urban,Rajasthan,Crime Against Men,Murder,Female,60+,659,560,99,640,19
2004,Urban,Maharashtra,Other Crimes,Corruption,Female,13-17,7443,1427,6016,6301,1142
2007,Urban,Rajasthan,Other Crimes,Drug Offense,Male,60+,5101,879,4222,2403,2698
2001,Rural,Punjab,Property Crime,Vandalism,Female,46-60,8856,4841,4015,5703,3153
2003,Urban,Meghalaya,Crime Against Children,Kidnapping,Female,31-45,3152,369,2783,437,2715
2004,Rural,West Bengal,Property Crime,Burglary,Male,18-30,3556,2783,773,3299,257
2005,Rural,Rajasthan,Crime Against Men,Extortion,Female,46-60,3671,3425,246,3456,215
2003,Urban,Tamil Nadu,Crime Against Women,Molestation,Male,18-30,5589,1795,3794,2104,3485
2003,Urban,Kerala,Property Crime,Arson,Male,0-12,2796,1323,1473,2151,645
2006,Urban,Kerala,Crime Against Men,Robbery,Female,31-45,2491,1637,854,1793,698
2010,Urban,Odisha,Property Crime,Arson,Female,13-17,7687,2141,5546,7606,81
2010,Rural,Gujarat,Crime Against Men,Robbery,Male,46-60,4949,3048,1901,4195,754
2006,Urban,Himachal Pradesh,Property Crime,Burglary,Female,31-45,1440,667,773,1322,118
2008,Rural,Arunachal Pradesh,Crime Against Women,Molestation,Male,0-12,7622,1201,6421,5471,2151
2003,Rural,Assam,Crime Against Women,Domestic Violence,Female,46-60,6419,2213,4206,5992,427
2006,Urban,Manipur,Crime Against Men,Robbery,Female,18-30,1849,571,1278,882,967
2003,Urban,Andhra Pradesh,Crime Against Women,Rape,Male,60+,9434,1480,7954,9369,65
2006,Urban,Mizoram,Crime Against Women,Rape,Female,13-17,5949,1547,4402,5553,396
2005,Urban,Gujarat,Property Crime,Theft,Male,18-30,8167,804,7363,7951,216
2008,Urban,Mizoram,Crime Against Children,Trafficking,Male,13-17,4521,1274,3247,4447,74
2007,Urban,Jammu & Kashmir,Other Crimes,Cyber Crime,Male,46-60,3851,1339,2512,2220,1631
2004,Urban,Kerala,Crime Against Men,Murder,Male,60+,5928,4125,1803,5018,910
2006,Rural,Maharashtra,Other Crimes,Drug Offense,Male,13-17,9053,2962,6091,7365,1688
2003,Urban,Delhi,Crime Against Women,Molestation,Female,60+,2287,1197,1090,2040,247
2002,Urban,Tamil Nadu,Crime Against Children,Trafficking,Female,0-12,1685,1192,493,1409,276
2004,Rural,Goa,Property Crime,Vandalism,Female,18-30,4236,3086,1150,4199,37
2007,Rural,Punjab,Crime Against Men,Extortion,Male,0-12,7934,2036,5898,4187,3747
2003,Rural,Haryana,Other Crimes,Drug Offense,Male,31-45,7770,2005,5765,3513,4257
2002,Rural,Meghalaya,Crime Against Children,Kidnapping,Female,31-45,7644,7561,83,7592,52
2001,Urban,West Bengal,Other Crimes,Fraud,Female,18-30,9311,7367,1944,8372,939
2005,Rural,Delhi,Crime Against Men,Robbery,Female,31-45,7444,6350,1094,7332,112
2007,Rural,Assam,Crime Against Men,Murder,Male,0-12,4336,204,4132,2217,2119
2005,Rural,Punjab,Other Crimes,Corruption,Male,31-45,3520,837,2683,1426,2094
2002,Rural,Haryana,Other Crimes,Fraud,Female,18-30,8647,6658,1989,6750,1897
2008,Rural,Assam,Crime Against Women,Molestation,Female,13-17,793,568,225,649,144
2003,Rural,Karnataka,Crime Against Women,Molestation,Female,0-12,7239,4050,3189,5221,2018
2010,Rural,Uttarakhand,Crime Against Children,Kidnapping,Male,13-17,2180,226,1954,1587,593
2005,Urban,Himachal Pradesh,Crime Against Women,Dowry Deaths,Female,18-30,3693,325,3368,568,3125
2010,Urban,Karnataka,Property Crime,Theft,Male,13-17,215,214,1,214,1
2006,Rural,Himachal Pradesh,Property Crime,Theft,Female,13-17,1872,1753,119,1847,25
2002,Rural,Himachal Pradesh,Other Crimes,Corruption,Male,0-12,6450,5841,609,5962,488
2003,Rural,Jammu & Kashmir,Crime Against Women,Dowry Deaths,Female,0-12,596,244,352,256,340
2004,Urban,Tripura,Crime Against Children,Trafficking,Male,60+,3194,2616,578,2930,264
2002,Rural,Sikkim,Crime Against Women,Rape,Female,31-45,8183,7767,416,7950,233
2005,Rural,Punjab,Crime Against Women,Molestation,Male,18-30,3697,3607,90,3677,20
2008,Rural,Goa,Crime Against Women,Rape,Female,0-12,1854,1421,433,1439,415
2001,Rural,Gujarat,Crime Against Children,Kidnapping,Male,18-30,9152,3847,5305,5274,3878
2009,Urban,Karnataka,Crime Against Women,Molestation,Female,60+,3820,192,3628,303,3517
2009,Rural,Jammu & Kashmir,Crime Against Children,Child Labor,Female,0-12,3257,2576,681,3093,164
2007,Urban,Kerala,Crime Against Children,Kidnapping,Female,31-45,2877,1241,1636,2135,742
2001,Rural,Kerala,Crime Against Children,Child Labor,Female,31-45,9017,2155,6862,3723,5294
2007,Urban,Tripura,Property Crime,Vandalism,Female,13-17,2640,1040,1600,1583,1057
2008,Rural,Madhya Pradesh,Crime Against Men,Robbery,Male,0-12,1797,960,837,1375,422
2001,Urban,Arunachal Pradesh,Crime Against Women,Molestation,Male,46-60,7156,6965,191,7069,87
2001,Rural,Chhattisgarh,Crime Against Women,Rape,Male,60+,3294,1218,2076,1782,1512
2006,Urban,Goa,Crime Against Children,Child Abuse,Female,31-45,8685,2367,6318,6708,1977
2007,Rural,Jharkhand,Crime Against Men,Assault,Male,31-45,5790,1756,4034,5738,52
2003,Urban,Jammu & Kashmir,Crime Against Children,Child Labor,Male,13-17,5881,4819,1062,5556,325
2010,Urban,Kerala,Crime Against Children,Child Labor,Male,46-60,5765,4207,1558,4926,839
2004,Urban,Punjab,Crime Against Women,Rape,Male,60+,8399,4739,3660,7262,1137
2001,Rural,Haryana,Crime Against Children,Child Abuse,Female,46-60,852,457,395,725,127
2010,Rural,Kerala,Crime Against Men,Murder,Male,60+,5655,5475,180,5587,68
2005,Urban,Delhi,Crime Against Men,Assault,Female,18-30,8554,3102,5452,6542,2012
2003,Rural,Bihar,Crime Against Women,Molestation,Female,13-17,9223,2181,7042,9049,174
2009,Rural,Maharashtra,Crime Against Women,Molestation,Female,18-30,6750,1522,5228,4448,2302
2004,Rural,West Bengal,Crime Against Women,Dowry Deaths,Male,13-17,8344,4809,3535,7760,584
2002,Rural,Bihar,Other Crimes,Drug Offense,Male,0-12,5083,48,5035,3504,1579
2004,Urban,Chhattisgarh,Crime Against Women,Domestic Violence,Female,18-30,8362,7333,1029,7637,725
2002,Rural,Chhattisgarh,Crime Against Men,Extortion,Male,18-30,5042,1420,3622,2527,2515
2006,Rural,Tamil Nadu,Crime Against Women,Dowry Deaths,Female,46-60,1618,282,1336,688,930
2010,Rural,Telangana,Other Crimes,Cyber Crime,Male,0-12,8001,5098,2903,6004,1997
2008,Urban,Tamil Nadu,Crime Against Women,Molestation,Female,18-30,5639,3343,2296,3593,2046
2009,Urban,Maharashtra,Crime Against Women,Rape,Male,0-12,9441,7137,2304,8670,771
2003,Urban,Mizoram,Crime Against Children,Child Labor,Male,13-17,7863,2455,5408,2830,5033
2001,Rural,Delhi,Property Crime,Vandalism,Male,31-45,2586,380,2206,1663,923
2001,Urban,Sikkim,Other Crimes,Cyber Crime,Male,18-30,1712,371,1341,738,974
2010,Rural,Jammu & Kashmir,Crime Against Men,Robbery,Male,46-60,7592,2460,5132,4492,3100
2002,Urban,Uttarakhand,Property Crime,Theft,Female,31-45,4543,2538,2005,3515,1028
2006,Rural,Kerala,Other Crimes,Corruption,Male,60+,4787,3739,1048,4739,48
2001,Rural,Bihar,Crime Against Men,Robbery,Female,60+,8845,128,8717,743,8102
2002,Urban,Telangana,Crime Against Men,Murder,Female,60+,9839,9678,161,9766,73
2010,Urban,Delhi,Crime Against Men,Extortion,Female,60+,6814,3659,3155,4522,2292
2002,Urban,Haryana,Crime Against Women,Molestation,Male,60+,4778,2314,2464,3240,1538
2001,Urban,Bihar,Crime Against Women,Domestic Violence,Female,18-30,149,26,123,72,77
2007,Rural,Assam,Other Crimes,Drug Offense,Male,31-45,9287,472,8815,8312,975
2006,Urban,Punjab,Other Crimes,Fraud,Female,0-12,3710,1400,2310,3410,300
2002,Rural,Bihar,Crime Against Children,Child Labor,Female,18-30,4742,51,4691,1913,2829
2006,Rural,Delhi,Other Crimes,Cyber Crime,Female,13-17,8375,3287,5088,4997,3378
2006,Rural,Tripura,Property Crime,Vandalism,Female,60+,7820,1921,5899,2847,4973
2008,Urban,Haryana,Other Crimes,Fraud,Male,13-17,6272,915,5357,4418,1854
2003,Urban,Chhattisgarh,Other Crimes,Cyber Crime,Female,31-45,5546,4059,1487,5477,69
2002,Rural,Manipur,Crime Against Children,Trafficking,Male,18-30,2320,2282,38,2320,0
2001,Urban,Sikkim,Other Crimes,Drug Offense,Female,31-45,2877,630,2247,2442,435
2008,Urban,Andhra Pradesh,Property Crime,Vandalism,Female,13-17,1187,644,543,977,210
2003,Urban,Madhya Pradesh,Crime Against Children,Child Abuse,Female,13-17,7808,3534,4274,4094,3714
2003,Rural,Tripura,Property Crime,Theft,Female,18-30,3545,2319,1226,2947,598
2003,Urban,Himachal Pradesh,Crime Against Women,Dowry Deaths,Male,46-60,9395,4104,5291,5741,3654
2005,Urban,Uttar Pradesh,Other Crimes,Cyber Crime,Male,31-45,2093,1131,962,1140,953
2004,Urban,Himachal Pradesh,Crime Against Women,Dowry Deaths,Female,18-30,710,679,31,699,11
2002,Urban,Gujarat,Other Crimes,Corruption,Female,46-60,8666,6133,2533,8319,347
2008,Urban,Rajasthan,Property Crime,Arson,Male,18-30,9211,6851,2360,6955,2256
2001,Rural,Tamil Nadu,Crime Against Men,Extortion,Female,13-17,4364,3131,1233,4051,313
2008,Rural,Jammu & Kashmir,Crime Against Women,Molestation,Female,60+,913,660,253,830,83
2010,Urban,Mizoram,Crime Against Children,Child Labor,Male,60+,2044,1126,918,1593,451
2008,Urban,Telangana,Crime Against Children,Child Abuse,Female,60+,2401,2382,19,2399,2
2007,Urban,Gujarat,Property Crime,Vandalism,Female,0-12,6829,5418,1411,5676,1153
2002,Urban,Tamil Nadu,Other Crimes,Drug Offense,Female,31-45,2251,2041,210,2055,196
2009,Urban,Odisha,Crime Against Men,Assault,Male,0-12,588,584,4,584,4
2004,Rural,Meghalaya,Crime Against Children,Child Labor,Female,13-17,5350,748,4602,4435,915
2003,Urban,Kerala,Property Crime,Vandalism,Female,0-12,3413,62,3351,270,3143
2006,Rural,Punjab,Crime Against Women,Rape,Female,60+,9474,9205,269,9322,152
2004,Rural,Andhra Pradesh,Crime Against Women,Dowry Deaths,Male,13-17,2812,98,2714,1611,1201
2006,Rural,Kerala,Property Crime,Arson,Male,0-12,8182,4920,3262,7267,915
2009,Urban,Tamil Nadu,Crime Against Women,Rape,Female,18-30,7245,6537,708,6981,264
2002,Rural,Punjab,Crime Against Men,Assault,Male,18-30,2989,433,2556,2322,667
2006,Rural,Bihar,Other Crimes,Drug Offense,Female,18-30,9673,3918,5755,4634,5039
2004,Urban,Uttar Pradesh,Crime Against Men,Assault,Female,31-45,5685,2847,2838,3367,2318
2001,Rural,Mizoram,Crime Against Children,Kidnapping,Male,0-12,4336,2032,2304,2362,1974
2001,Rural,Tamil Nadu,Property Crime,Vandalism,Male,46-60,9138,556,8582,5654,3484
2001,Urban,Punjab,Crime Against Children,Child Labor,Male,18-30,3615,2982,633,3529,86
2007,Urban,Manipur,Crime Against Women,Domestic Violence,Female,31-45,7046,6266,780,6405,641
2008,Urban,Assam,Crime Against Women,Molestation,Male,18-30,3133,2173,960,2816,317
2001,Rural,Tamil Nadu,Other Crimes,Drug Offense,Male,0-12,5076,2521,2555,3709,1367
2010,Urban,Bihar,Crime Against Women,Domestic Violence,Female,31-45,3362,1024,2338,2818,544
2010,Rural,Punjab,Crime Against Women,Domestic Violence,Male,60+,7050,1227,5823,4352,2698
2010,Urban,Haryana,Crime Against Women,Rape,Male,13-17,3750,3559,191,3673,77
2006,Rural,Maharashtra,Other Crimes,Drug Offense,Male,60+,4329,3166,1163,3403,926
2004,Urban,Jammu & Kashmir,Property Crime,Vandalism,Male,31-45,395,287,108,301,94
2006,Urban,Telangana,Crime Against Men,Murder,Male,13-17,472,17,455,68,404
2005,Urban,Mizoram,Crime Against Women,Domestic Violence,Female,0-12,8638,7326,1312,7729,909
2005,Rural,Meghalaya,Crime Against Men,Extortion,Male,13-17,3933,1124,2809,3434,499
2008,Urban,Madhya Pradesh,Crime Against Men,Assault,Male,18-30,4706,3935,771,4138,568
2002,Urban,Jammu & Kashmir,Property Crime,Theft,Male,18-30,6751,6081,670,6713,38
2008,Rural,Arunachal Pradesh,Crime Against Men,Assault,Male,13-17,1968,1380,588,1427,541
2005,Rural,Manipur,Property Crime,Theft,Female,46-60,7476,3411,4065,3519,3957
2009,Urban,Manipur,Other Crimes,Cyber Crime,Female,0-12,4161,2835,1326,3073,1088
2006,Urban,Kerala,Crime Against Children,Kidnapping,Female,31-45,620,595,25,598,22
2009,Urban,West Bengal,Property Crime,Vandalism,Female,18-30,4406,1834,2572,1980,2426
2007,Rural,Tamil Nadu,Crime Against Women,Dowry Deaths,Female,0-12,1152,477,675,682,470
2007,Rural,Punjab,Crime Against Women,Domestic Violence,Male,0-12,2154,1239,915,2055,99
2010,Rural,Maharashtra,Crime Against Children,Kidnapping,Male,31-45,8346,138,8208,6432,1914
2010,Urban,West Bengal,Crime Against Children,Kidnapping,Male,18-30,8644,3894,4750,6295,2349
2005,Rural,Madhya Pradesh,Property Crime,Arson,Male,18-30,5148,1179,3969,4515,633
2008,Urban,Chhattisgarh,Crime Against Women,Domestic Violence,Female,13-17,6652,2921,3731,3732,2920
2008,Urban,Karnataka,Crime Against Children,Kidnapping,Male,18-30,8552,3098,5454,4470,4082
2010,Rural,Odisha,Other Crimes,Cyber Crime,Male,13-17,7146,2454,4692,5436,1710
2008,Rural,Himachal Pradesh,Crime Against Women,Dowry Deaths,Female,46-60,8525,5324,3201,5570,2955
2007,Urban,Nagaland,Crime Against Children,Kidnapping,Male,18-30,2465,283,2182,2017,448
2003,Rural,Mizoram,Other Crimes,Drug Offense,Female,31-45,7633,4291,3342,7163,470
2004,Rural,Punjab,Crime Against Women,Molestation,Female,18-30,1696,252,1444,1268,428
2009,Urban,Himachal Pradesh,Other Crimes,Drug Offense,Female,18-30,395,221,174,298,97
2008,Urban,Tripura,Crime Against Women,Domestic Violence,Male,18-30,3768,3665,103,3706,62
2007,Urban,Tripura,Crime Against Men,Murder,Male,46-60,1190,1082,108,1097,93
2004,Rural,Goa,Property Crime,Arson,Male,60+,9019,7740,1279,8185,834
2004,Rural,Maharashtra,Crime Against Women,Molestation,Female,18-30,5264,1845,3419,3780,1484
2009,Urban,Madhya Pradesh,Property Crime,Arson,Male,18-30,4516,3770,746,4209,307
2005,Urban,Odisha,Crime Against Women,Molestation,Male,60+,882,90,792,450,432
2008,Rural,Nagaland,Crime Against Men,Assault,Female,31-45,4367,1603,2764,3495,872
2004,Rural,Haryana,Property Crime,Vandalism,Male,60+,2057,1021,1036,1314,743
2001,Urban,Haryana,Property Crime,Vandalism,Male,60+,6766,1037,5729,4977,1789
2010,Rural,Sikkim,Crime Against Children,Child Labor,Female,13-17,2258,299,1959,2184,74
2004,Urban,Bihar,Property Crime,Burglary,Male,18-30,747,448,299,618,129
2004,Rural,Gujarat,Property Crime,Arson,Female,0-12,1436,1401,35,1427,9
2003,Rural,Maharashtra,Crime Against Women,Domestic Violence,Female,31-45,816,709,107,761,55
2007,Rural,Tripura,Other Crimes,Fraud,Male,31-45,9513,4836,4677,5985,3528
2010,Urban,Punjab,Crime Against Children,Child Labor,Male,60+,1085,57,1028,1008,77
2005,Rural,Arunachal Pradesh,Property Crime,Burglary,Male,0-12,2621,405,2216,1733,888
2001,Rural,West Bengal,Other Crimes,Corruption,Female,0-12,1237,512,725,1114,123
2009,Rural,Madhya Pradesh,Property Crime,Vandalism,Male,13-17,6800,6609,191,6630,170
2002,Rural,Mizoram,Other Crimes,Fraud,Female,0-12,3658,1681,1977,1984,1674
2002,Rural,Jammu & Kashmir,Property Crime,Theft,Female,0-12,4044,2631,1413,2802,1242
2010,Urban,Mizoram,Crime Against Children,Child Abuse,Female,0-12,6180,4685,1495,5365,815
2006,Rural,Karnataka,Crime Against Children,Child Abuse,Male,13-17,3725,265,3460,2305,1420
2002,Urban,Sikkim,Other Crimes,Corruption,Female,13-17,9260,2030,7230,5481,3779
2009,Rural,Goa,Crime Against Children,Trafficking,Female,0-12,4276,1816,2460,1956,2320
2009,Urban,Tripura,Crime Against Children,Child Labor,Male,31-45,6826,3230,3596,6169,657
2005,Rural,Himachal Pradesh,Other Crimes,Drug Offense,Male,18-30,1363,566,797,1270,93
2006,Urban,Haryana,Crime Against Women,Domestic Violence,Male,46-60,1094,881,213,1071,23
2005,Rural,Maharashtra,Crime Against Children,Child Abuse,Male,31-45,9413,4982,4431,7424,1989
2008,Rural,Assam,Crime Against Women,Rape,Female,13-17,8833,7392,1441,8212,621
2007,Rural,Maharashtra,Property Crime,Theft,Male,46-60,9240,2070,7170,7518,1722
2010,Rural,Gujarat,Crime Against Men,Murder,Male,31-45,8194,6809,1385,6809,1385
2001,Rural,Assam,Crime Against Men,Assault,Male,60+,1171,963,208,977,194
2003,Rural,Mizoram,Property Crime,Theft,Male,60+,8496,3852,4644,8248,248
2009,Urban,Delhi,Crime Against Women,Molestation,Male,0-12,3920,1425,2495,2864,1056
2007,Urban,Madhya Pradesh,Crime Against Men,Assault,Female,46-60,2096,959,1137,1509,587
2002,Urban,Uttar Pradesh,Property Crime,Vandalism,Male,60+,3516,161,3355,570,2946
2009,Rural,Andhra Pradesh,Crime Against Children,Child Abuse,Male,60+,1645,270,1375,1098,547
2004,Rural,Nagaland,Property Crime,Vandalism,Female,0-12,7002,2971,4031,6365,637
2005,Urban,Jammu & Kashmir,Crime Against Men,Robbery,Female,13-17,3864,1811,2053,2565,1299
2004,Urban,Sikkim,Crime Against Children,Trafficking,Female,60+,6898,1938,4960,5669,1229
2006,Urban,Bihar,Crime Against Children,Trafficking,Male,0-12,2828,1037,1791,2057,771
2001,Urban,Punjab,Crime Against Children,Trafficking,Male,13-17,4676,2995,1681,4243,433
2009,Urban,Jharkhand,Crime Against Women,Domestic Violence,Female,60+,6206,1883,4323,2653,3553
2008,Rural,Sikkim,Crime Against Children,Trafficking,Male,46-60,9576,8536,1040,8968,608
2008,Rural,Maharashtra,Crime Against Children,Child Abuse,Male,13-17,4936,580,4356,901,4035
2001,Rural,Chhattisgarh,Crime Against Women,Rape,Male,0-12,8971,6484,2487,7407,1564
2003,Rural,Chhattisgarh,Other Crimes,Fraud,Female,0-12,6541,4411,2130,4764,1777
2004,Urban,Maharashtra,Crime Against Children,Trafficking,Male,31-45,4095,1580,2515,1605,2490
2010,Urban,Kerala,Crime Against Men,Extortion,Female,31-45,7663,2563,5100,5898,1765
2006,Urban,Andhra Pradesh,Crime Against Children,Child Labor,Male,46-60,4311,990,3321,3639,672
2006,Rural,Delhi,Crime Against Women,Domestic Violence,Male,18-30,7991,5635,2356,6267,1724
2006,Rural,Himachal Pradesh,Crime Against Women,Rape,Male,60+,1770,804,966,1043,727
2005,Rural,Uttarakhand,Property Crime,Burglary,Male,18-30,6104,4512,1592,5008,1096
2004,Urban,Goa,Crime Against Children,Trafficking,Male,18-30,7777,3931,3846,5754,2023
2008,Rural,Assam,Other Crimes,Fraud,Male,31-45,3644,2998,646,3488,156
2006,Rural,Tamil Nadu,Other Crimes,Corruption,Female,60+,344,269,75,294,50
2003,Rural,Haryana,Crime Against Children,Child Labor,Male,60+,7472,336,7136,2355,5117
2009,Urban,Jharkhand,Other Crimes,Cyber Crime,Male,31-45,756,93,663,688,68
2001,Rural,Karnataka,Other Crimes,Corruption,Female,18-30,3897,3135,762,3243,654
2001,Urban,Kerala,Crime Against Children,Kidnapping,Male,60+,5025,965,4060,2568,2457
2004,Rural,Sikkim,Crime Against Men,Murder,Male,13-17,327,214,113,216,111
2009,Rural,Arunachal Pradesh,Crime Against Children,Child Abuse,Female,0-12,8660,1080,7580,2974,5686
2007,Rural,Meghalaya,Crime Against Children,Trafficking,Female,46-60,8131,5600,2531,6558,1573
2001,Urban,Meghalaya,Crime Against Children,Child Labor,Male,60+,8752,7308,1444,8192,560
2004,Urban,Uttarakhand,Crime Against Children,Child Labor,Male,13-17,9207,8236,971,8523,684
2003,Rural,Bihar,Crime Against Children,Kidnapping,Female,18-30,6159,3440,2719,3664,2495
2009,Rural,Haryana,Property Crime,Vandalism,Male,0-12,6762,4641,2121,6447,315
2007,Rural,Gujarat,Crime Against Women,Molestation,Male,60+,2247,1455,792,2122,125
2008,Rural,Assam,Crime Against Children,Child Abuse,Female,46-60,8728,2469,6259,6971,1757
2008,Urban,Chhattisgarh,Crime Against Children,Trafficking,Male,13-17,9016,1723,7293,6306,2710
2004,Rural,Uttarakhand,Crime Against Children,Child Abuse,Male,0-12,6718,3439,3279,4039,2679
2007,Rural,Himachal Pradesh,Crime Against Women,Rape,Female,18-30,6816,3465,3351,5622,1194
2002,Rural,Rajasthan,Crime Against Children,Kidnapping,Female,31-45,4856,3121,1735,3345,1511
2009,Rural,Sikkim,Crime Against Men,Murder,Male,18-30,4615,151,4464,312,4303
2008,Urban,Maharashtra,Other Crimes,Corruption,Male,0-12,3166,2308,858,2853,313
2003,Rural,Punjab,Property Crime,Burglary,Male,0-12,9357,5445,3912,9101,256
2007,Rural,Tamil Nadu,Other Crimes,Cyber Crime,Female,46-60,5372,3205,2167,3748,1624
2001,Urban,Meghalaya,Crime Against Men,Robbery,Male,0-12,4718,438,4280,872,3846
2010,Urban,Uttarakhand,Property Crime,Arson,Female,13-17,7697,232,7465,4760,2937
2005,Rural,Nagaland,Crime Against Men,Extortion,Male,31-45,6027,5780,247,6003,24
2009,Urban,Manipur,Property Crime,Vandalism,Female,60+,9251,4569,4682,6004,3247
2003,Urban,Jharkhand,Crime Against Children,Child Labor,Male,18-30,8797,2785,6012,4333,4464
2008,Rural,Uttarakhand,Crime Against Children,Kidnapping,Male,46-60,5303,4292,1011,4749,554
2004,Urban,Goa,Property Crime,Theft,Female,60+,5499,3607,1892,4176,1323
2004,Urban,Assam,Crime Against Men,Assault,Male,18-30,4708,280,4428,4594,114
2010,Urban,Nagaland,Property Crime,Vandalism,Female,18-30,9039,808,8231,7355,1684
2005,Rural,Karnataka,Other Crimes,Fraud,Female,60+,6494,3177,3317,3549,2945
2006,Rural,Andhra Pradesh,Property Crime,Vandalism,Female,18-30,3357,3105,252,3339,18
2006,Rural,Haryana,Property Crime,Arson,Female,31-45,8972,8481,491,8667,305
2003,Rural,Maharashtra,Other Crimes,Drug Offense,Female,31-45,4877,2139,2738,3922,955
2001,Urban,Madhya Pradesh,Property Crime,Vandalism,Female,13-17,4116,4111,5,4114,2
2005,Rural,Arunachal Pradesh,Crime Against Children,Trafficking,Female,46-60,723,87,636,511,212
2007,Rural,Tamil Nadu,Crime Against Children,Child Abuse,Female,0-12,805,779,26,793,12
2003,Urban,Manipur,Other Crimes,Fraud,Male,18-30,3369,2361,1008,3245,124
2008,Urban,Jammu & Kashmir,Other Crimes,Corruption,Male,60+,9185,809,8376,4175,5010
2010,Urban,Jharkhand,Crime Against Children,Trafficking,Female,60+,233,23,210,52,181
2010,Urban,Uttar Pradesh,Crime Against Children,Child Labor,Male,18-30,1306,1087,219,1167,139
2004,Rural,Himachal Pradesh,Other Crimes,Cyber Crime,Male,60+,2631,1944,687,2100,531
2009,Rural,Jammu & Kashmir,Other Crimes,Drug Offense,Male,46-60,3852,600,3252,2516,1336
2005,Rural,Meghalaya,Crime Against Men,Assault,Female,60+,8480,4773,3707,7055,1425
2010,Urban,Assam,Other Crimes,Fraud,Male,60+,1100,816,284,834,266
2010,Rural,Sikkim,Other Crimes,Cyber Crime,Female,0-12,2751,1455,1296,2134,617
2002,Rural,West Bengal,Crime Against Men,Robbery,Female,13-17,7082,2029,5053,6867,215
2001,Rural,Sikkim,Property Crime,Theft,Male,13-17,2881,670,2211,1106,1775
2003,Rural,Mizoram,Crime Against Men,Extortion,Female,46-60,4020,2676,1344,3535,485
2008,Urban,Jammu & Kashmir,Crime Against Women,Rape,Female,31-45,932,471,461,838,94
2003,Urban,Tripura,Crime Against Women,Molestation,Male,18-30,1018,328,690,384,634
2005,Rural,Jharkhand,Property Crime,Arson,Male,13-17,9334,4149,5185,6027,3307
2008,Urban,Jharkhand,Other Crimes,Cyber Crime,Male,31-45,3271,3019,252,3087,184
2001,Urban,Jammu & Kashmir,Crime Against Women,Domestic Violence,Male,13-17,7679,6008,1671,6629,1050
2010,Rural,Chhattisgarh,Crime Against Men,Robbery,Male,60+,8143,5841,2302,6162,1981
2009,Urban,Chhattisgarh,Crime Against Men,Murder,Female,0-12,8407,4561,3846,8217,190
2009,Rural,Punjab,Property Crime,Arson,Female,0-12,4470,225,4245,3249,1221
2005,Rural,Bihar,Property Crime,Theft,Male,31-45,1872,751,1121,1858,14
2007,Rural,Jharkhand,Property Crime,Theft,Female,0-12,1687,202,1485,536,1151
2010,Urban,Assam,Crime Against Men,Extortion,Male,60+,5813,2548,3265,4581,1232
2005,Rural,Assam,Crime Against Children,Kidnapping,Male,18-30,4937,3813,1124,4540,397
2007,Rural,Uttar Pradesh,Other Crimes,Corruption,Male,31-45,1508,352,1156,1143,365
2007,Rural,West Bengal,Other Crimes,Cyber Crime,Male,13-17,8986,2495,6491,7989,997
2002,Rural,Sikkim,Crime Against Men,Assault,Male,60+,1318,300,1018,1056,262
2009,Urban,Uttar Pradesh,Property Crime,Arson,Male,18-30,733,38,695,468,265
2003,Urban,Andhra Pradesh,Crime Against Children,Trafficking,Female,60+,9121,6511,2610,8598,523
2003,Rural,Manipur,Property Crime,Burglary,Male,60+,1343,270,1073,367,976
2005,Urban,Goa,Crime Against Men,Murder,Female,18-30,2666,2022,644,2619,47
2006,Urban,Chhattisgarh,Crime Against Women,Rape,Female,31-45,2335,2163,172,2173,162
2003,Rural,Gujarat,Crime Against Women,Dowry Deaths,Female,31-45,8280,189,8091,3741,4539
2008,Urban,Punjab,Property Crime,Theft,Female,0-12,140,22,118,46,94
2005,Rural,Chhattisgarh,Crime Against Women,Rape,Female,46-60,116,10,106,95,21
2002,Urban,Meghalaya,Crime Against Men,Extortion,Male,18-30,3796,1505,2291,2757,1039
2001,Urban,Meghalaya,Crime Against Children,Child Abuse,Female,13-17,7967,6824,1143,7239,728
2002,Urban,Delhi,Property Crime,Burglary,Male,0-12,4944,3238,1706,4370,574
2005,Rural,Haryana,Crime Against Women,Dowry Deaths,Male,13-17,5320,5164,156,5308,12
2005,Urban,Uttar Pradesh,Crime Against Men,Murder,Male,46-60,7892,7685,207,7772,120
2001,Rural,Manipur,Property Crime,Theft,Male,60+,2153,43,2110,1100,1053
2010,Urban,Jharkhand,Crime Against Men,Murder,Female,60+,8508,7678,830,7909,599
2008,Rural,Uttar Pradesh,Crime Against Women,Domestic Violence,Male,18-30,1552,444,1108,1023,529
2007,Rural,Sikkim,Crime Against Women,Rape,Female,60+,728,564,164,594,134
2005,Rural,Karnataka,Property Crime,Burglary,Female,60+,4206,2288,1918,2747,1459
2001,Rural,Rajasthan,Crime Against Children,Trafficking,Male,31-45,4809,2803,2006,3254,1555
2001,Urban,Maharashtra,Other Crimes,Cyber Crime,Male,46-60,5020,3194,1826,4143,877
2007,Urban,Bihar,Crime Against Men,Murder,Female,13-17,8530,6991,1539,7223,1307
2008,Urban,Uttarakhand,Property Crime,Burglary,Female,13-17,791,344,447,744,47
2001,Rural,Mizoram,Crime Against Children,Trafficking,Male,18-30,1318,404,914,890,428
2002,Rural,Maharashtra,Property Crime,Vandalism,Male,13-17,4728,157,4571,540,4188
2006,Rural,Nagaland,Other Crimes,Corruption,Male,46-60,5541,1575,3966,3527,2014
2006,Urban,Jharkhand,Other Crimes,Corruption,Female,60+,5370,4024,1346,4514,856
2007,Rural,Kerala,Crime Against Children,Kidnapping,Female,31-45,6950,4462,2488,5188,1762
2003,Urban,Tripura,Property Crime,Burglary,Male,60+,7628,7091,537,7490,138
2010,Rural,Jammu & Kashmir,Crime Against Children,Trafficking,Female,13-17,5626,3656,1970,4095,1531
2007,Rural,Chhattisgarh,Crime Against Women,Dowry Deaths,Female,46-60,3012,2386,626,2869,143
2007,Urban,Himachal Pradesh,Property Crime,Theft,Male,18-30,4630,95,4535,2616,2014
2009,Urban,Rajasthan,Crime Against Children,Child Abuse,Male,13-17,5959,3940,2019,3998,1961
2005,Rural,Maharashtra,Property Crime,Burglary,Male,13-17,8078,6219,1859,6867,1211
2004,Urban,Chhattisgarh,Crime Against Men,Robbery,Male,0-12,9682,4056,5626,5954,3728
2008,Urban,Mizoram,Crime Against Men,Murder,Female,60+,5958,4234,1724,4318,1640
2009,Rural,Nagaland,Other Crimes,Drug Offense,Female,0-12,3630,1327,2303,2799,831
2003,Rural,Maharashtra,Crime Against Women,Domestic Violence,Female,18-30,7460,5910,1550,6104,1356
2001,Urban,Sikkim,Crime Against Children,Child Labor,Male,18-30,9152,7508,1644,8693,459
2004,Rural,Rajasthan,Other Crimes,Corruption,Female,0-12,1093,1001,92,1066,27
2009,Rural,Chhattisgarh,Other Crimes,Fraud,Female,46-60,7902,5531,2371,6016,1886
2002,Urban,Meghalaya,Property Crime,Vandalism,Female,18-30,5883,2386,3497,5345,538
2009,Urban,Telangana,Property Crime,Theft,Female,60+,3810,2900,910,3180,630
2007,Urban,Uttarakhand,Property Crime,Burglary,Male,13-17,2645,1680,965,2459,186
2004,Rural,Delhi,Crime Against Women,Dowry Deaths,Male,46-60,1730,1291,439,1668,62
2005,Rural,Manipur,Property Crime,Theft,Female,13-17,481,220,261,374,107
2008,Urban,Karnataka,Crime Against Men,Murder,Male,60+,2912,2134,778,2291,621
2003,Rural,Mizoram,Crime Against Women,Rape,Male,46-60,7000,1254,5746,5914,1086
2002,Rural,Kerala,Other Crimes,Corruption,Female,31-45,8630,7436,1194,8085,545
2008,Urban,Himachal Pradesh,Property Crime,Arson,Female,46-60,3645,26,3619,2525,1120
2010,Rural,Manipur,Crime Against Men,Murder,Male,13-17,4674,4061,613,4407,267
2009,Rural,Andhra Pradesh,Other Crimes,Fraud,Male,31-45,5367,2558,2809,3967,1400
2004,Urban,Gujarat,Crime Against Men,Robbery,Male,18-30,5818,3825,1993,4460,1358
2010,Rural,Odisha,Other Crimes,Corruption,Female,60+,3727,2383,1344,2593,1134
2006,Rural,West Bengal,Crime Against Men,Assault,Female,13-17,825,662,163,820,5
2001,Rural,Assam,Other Crimes,Fraud,Female,18-30,8185,7134,1051,7964,221
2002,Rural,Jharkhand,Crime Against Women,Rape,Female,18-30,6224,5569,655,6181,43
2006,Rural,Delhi,Crime Against Men,Extortion,Male,31-45,1932,951,981,1349,583
2010,Urban,Rajasthan,Other Crimes,Drug Offense,Male,13-17,5517,626,4891,1909,3608
2001,Rural,Rajasthan,Crime Against Women,Molestation,Male,13-17,8806,7726,1080,8028,778
2007,Rural,Himachal Pradesh,Crime Against Women,Molestation,Female,31-45,8648,1964,6684,6124,2524
2005,Rural,Sikkim,Crime Against Men,Extortion,Female,31-45,5411,1940,3471,3858,1553
2001,Rural,Jammu & Kashmir,Crime Against Women,Domestic Violence,Female,46-60,1560,1227,333,1290,270
2002,Urban,Bihar,Crime Against Children,Trafficking,Male,60+,9194,4534,4660,5017,4177
2004,Rural,Haryana,Crime Against Women,Rape,Female,13-17,927,334,593,493,434
2008,Rural,Sikkim,Crime Against Women,Molestation,Male,18-30,6888,499,6389,515,6373
2009,Urban,Punjab,Other Crimes,Corruption,Female,46-60,8959,6047,2912,7118,1841
2006,Urban,Karnataka,Other Crimes,Corruption,Female,0-12,1756,1692,64,1745,11
2008,Rural,Telangana,Crime Against Children,Trafficking,Male,31-45,4869,4793,76,4822,47
2009,Urban,Chhattisgarh,Crime Against Women,Molestation,Male,13-17,1604,1173,431,1262,342
2003,Rural,Delhi,Crime Against Women,Domestic Violence,Male,60+,2210,2179,31,2199,11
2001,Urban,Karnataka,Crime Against Children,Child Abuse,Male,13-17,6919,3717,3202,4335,2584
2003,Rural,Bihar,Crime Against Men,Extortion,Male,46-60,7678,2280,5398,4615,3063
2002,Rural,Punjab,Crime Against Children,Child Abuse,Female,0-12,2224,1960,264,2022,202
2002,Rural,Maharashtra,Property Crime,Burglary,Male,18-30,726,104,622,110,616
2003,Urban,Odisha,Crime Against Children,Child Abuse,Female,46-60,3772,2632,1140,3726,46
2009,Rural,Sikkim,Crime Against Children,Trafficking,Female,13-17,7688,6984,704,7631,57
2009,Rural,Jharkhand,Other Crimes,Fraud,Female,46-60,4031,2719,1312,3086,945
2001,Urban,Himachal Pradesh,Crime Against Women,Rape,Female,13-17,8188,4814,3374,6956,1232
2001,Rural,Sikkim,Crime Against Men,Extortion,Male,13-17,334,325,9,334,0
2009,Urban,Sikkim,Property Crime,Arson,Male,46-60,8086,7547,539,7996,90
2009,Rural,Assam,Crime Against Children,Child Labor,Male,31-45,2238,651,1587,2223,15
2005,Urban,Maharashtra,Property Crime,Theft,Male,0-12,406,96,310,107,299
2007,Urban,Assam,Property Crime,Vandalism,Male,13-17,3852,370,3482,1138,2714
2001,Rural,Rajasthan,Other Crimes,Corruption,Female,31-45,2465,1702,763,2208,257
2006,Rural,Karnataka,Property Crime,Arson,Male,18-30,2567,924,1643,1827,740
2005,Rural,Chhattisgarh,Property Crime,Theft,Female,46-60,5979,4851,1128,5467,512
2009,Rural,Himachal Pradesh,Other Crimes,Fraud,Male,18-30,6320,403,5917,2131,4189
2010,Rural,Delhi,Property Crime,Burglary,Male,46-60,9958,8536,1422,9626,332
2009,Urban,Punjab,Crime Against Children,Kidnapping,Female,18-30,2306,441,1865,2044,262
2007,Urban,Delhi,Crime Against Women,Rape,Male,13-17,7132,7092,40,7129,3
2001,Urban,Jammu & Kashmir,Crime Against Men,Robbery,Female,0-12,9427,7296,2131,8785,642
2007,Rural,Meghalaya,Crime Against Men,Extortion,Female,46-60,6412,4931,1481,5433,979
2001,Rural,Haryana,Other Crimes,Drug Offense,Female,31-45,113,111,2,113,0
2010,Rural,Punjab,Crime Against Children,Child Abuse,Female,13-17,2736,1239,1497,2258,478
2009,Rural,Bihar,Crime Against Men,Assault,Male,60+,5436,4913,523,5436,0
2007,Rural,Uttar Pradesh,Property Crime,Vandalism,Male,0-12,9994,5711,4283,7928,2066
2002,Urban,Goa,Property Crime,Vandalism,Female,60+,2284,1304,980,2185,99
2001,Rural,Jharkhand,Crime Against Women,Domestic Violence,Female,0-12,7282,2374,4908,4067,3215
2006,Urban,Goa,Crime Against Women,Dowry Deaths,Male,13-17,9985,106,9879,6440,3545
2006,Rural,Tamil Nadu,Property Crime,Vandalism,Female,18-30,765,479,286,498,267
2003,Rural,Haryana,Crime Against Men,Murder,Female,31-45,1759,301,1458,1686,73
2002,Urban,Chhattisgarh,Property Crime,Burglary,Male,60+,4312,3211,1101,3425,887
2003,Rural,Delhi,Other Crimes,Fraud,Female,0-12,1746,658,1088,1440,306
2010,Rural,Gujarat,Crime Against Women,Molestation,Female,46-60,6878,1869,5009,6782,96
2005,Urban,Uttar Pradesh,Crime Against Women,Rape,Female,18-30,2357,483,1874,587,1770
2009,Urban,Himachal Pradesh,Property Crime,Arson,Female,46-60,587,235,352,340,247
2001,Rural,Sikkim,Crime Against Children,Child Abuse,Female,60+,1355,1104,251,1320,35
2006,Urban,Maharashtra,Property Crime,Theft,Male,0-12,1815,369,1446,1319,496
2009,Rural,Haryana,Crime Against Women,Molestation,Male,46-60,9012,3985,5027,7444,1568
2007,Rural,Himachal Pradesh,Other Crimes,Cyber Crime,Female,31-45,7603,4692,2911,6509,1094
2006,Rural,Assam,Crime Against Children,Child Abuse,Female,31-45,9838,7394,2444,9687,151
2005,Rural,Karnataka,Crime Against Women,Rape,Female,0-12,2815,442,2373,2397,418
2004,Urban,Jharkhand,Other Crimes,Cyber Crime,Female,31-45,7939,7897,42,7899,40
2005,Urban,Arunachal Pradesh,Crime Against Women,Molestation,Male,31-45,1062,481,581,699,363
2004,Urban,Manipur,Crime Against Men,Murder,Female,60+,4726,3918,808,4538,188
2003,Rural,Gujarat,Other Crimes,Corruption,Female,18-30,3624,1647,1977,3021,603
2005,Urban,Nagaland,Crime Against Children,Trafficking,Female,60+,6762,5888,874,6741,21
2007,Rural,Rajasthan,Property Crime,Vandalism,Male,46-60,217,35,182,161,56
2007,Rural,Rajasthan,Crime Against Children,Trafficking,Female,0-12,7406,1122,6284,5750,1656
2004,Rural,Jammu & Kashmir,Crime Against Women,Domestic Violence,Male,18-30,6763,6348,415,6620,143
2006,Rural,Telangana,Crime Against Women,Domestic Violence,Female,18-30,9670,3570,6100,4206,5464
2005,Rural,Mizoram,Other Crimes,Drug Offense,Female,0-12,4094,1630,2464,3823,271
2002,Urban,Haryana,Crime Against Children,Trafficking,Female,0-12,823,707,116,806,17
2010,Urban,Haryana,Property Crime,Burglary,Male,18-30,6409,1705,4704,4674,1735
2010,Rural,Himachal Pradesh,Crime Against Women,Rape,Female,31-45,3947,3832,115,3910,37
2002,Rural,Jammu & Kashmir,Crime Against Women,Dowry Deaths,Male,0-12,9706,5001,4705,8585,1121
2010,Urban,Uttar Pradesh,Other Crimes,Fraud,Male,18-30,7552,141,7411,6362,1190
2005,Rural,Manipur,Crime Against Men,Robbery,Male,18-30,2787,2133,654,2520,267
2008,Rural,Chhattisgarh,Other Crimes,Drug Offense,Male,31-45,6161,1004,5157,2350,3811
2008,Rural,Uttarakhand,Crime Against Women,Rape,Male,0-12,7218,1231,5987,6130,1088
2010,Rural,Meghalaya,Crime Against Children,Trafficking,Male,46-60,1704,912,792,1550,154
2001,Rural,Jharkhand,Property Crime,Arson,Female,60+,5192,4489,703,4802,390
2002,Urban,Chhattisgarh,Other Crimes,Cyber Crime,Female,18-30,9830,8502,1328,8563,1267
2005,Urban,Bihar,Crime Against Men,Extortion,Male,60+,1862,142,1720,1204,658
2009,Rural,Haryana,Crime Against Women,Molestation,Female,46-60,3341,1001,2340,2184,1157
2006,Urban,Madhya Pradesh,Property Crime,Arson,Male,18-30,5840,3581,2259,5125,715
2004,Urban,Rajasthan,Other Crimes,Cyber Crime,Male,46-60,8752,2286,6466,2442,6310
2009,Rural,Andhra Pradesh,Crime Against Women,Molestation,Male,13-17,7978,6423,1555,6634,1344
2005,Urban,Madhya Pradesh,Crime Against Men,Assault,Female,0-12,6217,641,5576,2086,4131
2007,Urban,Telangana,Crime Against Women,Dowry Deaths,Male,60+,4372,2681,1691,2869,1503
2002,Urban,Delhi,Crime Against Women,Domestic Violence,Male,13-17,1643,688,955,1339,304
2005,Rural,Maharashtra,Crime Against Women,Domestic Violence,Female,0-12,1157,721,436,1004,153
2008,Urban,Meghalaya,Other Crimes,Fraud,Female,0-12,4958,4932,26,4942,16
2006,Rural,Jharkhand,Other Crimes,Drug Offense,Male,31-45,9169,3277,5892,6041,3128
2008,Urban,Goa,Other Crimes,Fraud,Male,60+,158,151,7,155,3
2007,Urban,Gujarat,Other Crimes,Drug Offense,Female,60+,7344,5278,2066,7335,9
2001,Urban,Arunachal Pradesh,Crime Against Children,Kidnapping,Female,13-17,270,94,176,134,136
2002,Urban,Uttar Pradesh,Crime Against Children,Child Abuse,Female,18-30,8501,4382,4119,8402,99
2002,Rural,Uttarakhand,Crime Against Men,Extortion,Male,18-30,2222,451,1771,2173,49
2007,Urban,Punjab,Other Crimes,Corruption,Female,60+,7619,262,7357,3272,4347
2010,Rural,Punjab,Crime Against Children,Child Abuse,Female,46-60,4978,4512,466,4827,151
2005,Urban,Chhattisgarh,Crime Against Men,Robbery,Female,13-17,8249,6595,1654,7706,543
2007,Rural,Bihar,Crime Against Women,Molestation,Male,31-45,478,456,22,470,8
2002,Urban,Tripura,Property Crime,Arson,Female,46-60,2880,311,2569,2363,517
2009,Rural,Tripura,Crime Against Children,Child Abuse,Female,18-30,4148,37,4111,2809,1339
2008,Rural,Delhi,Property Crime,Burglary,Female,31-45,5689,5381,308,5656,33
2004,Urban,Meghalaya,Other Crimes,Fraud,Male,31-45,6022,2587,3435,5364,658
2007,Rural,Chhattisgarh,Crime Against Men,Robbery,Male,0-12,4707,4452,255,4499,208
2003,Urban,Assam,Crime Against Children,Kidnapping,Female,60+,6857,1034,5823,5632,1225
2004,Rural,Jammu & Kashmir,Crime Against Men,Murder,Male,13-17,8820,4119,4701,6699,2121
2005,Urban,Uttarakhand,Crime Against Women,Rape,Female,46-60,1621,1478,143,1560,61
2004,Urban,Kerala,Crime Against Children,Child Labor,Male,18-30,4478,3900,578,4465,13
2008,Urban,Assam,Crime Against Women,Molestation,Male,13-17,1623,1452,171,1547,76
2010,Rural,Punjab,Crime Against Women,Dowry Deaths,Male,18-30,3986,3606,380,3845,141
2008,Urban,Madhya Pradesh,Crime Against Women,Dowry Deaths,Male,18-30,5089,1821,3268,3503,1586
2006,Rural,Gujarat,Crime Against Children,Child Abuse,Male,46-60,9582,2167,7415,5485,4097
2001,Rural,Gujarat,Crime Against Women,Rape,Male,60+,8191,4024,4167,5055,3136
2009,Urban,Assam,Crime Against Children,Kidnapping,Male,60+,9344,5850,3494,8470,874
2007,Rural,Assam,Crime Against Men,Murder,Female,60+,6261,4647,1614,5788,473
2010,Urban,Uttarakhand,Property Crime,Theft,Male,31-45,8508,2717,5791,8089,419
2006,Urban,Assam,Crime Against Children,Trafficking,Female,60+,9271,3776,5495,5026,4245
2004,Urban,Nagaland,Property Crime,Arson,Male,31-45,3335,2350,985,2864,471
2008,Urban,Himachal Pradesh,Crime Against Men,Murder,Male,46-60,9692,9686,6,9686,6
2010,Urban,Uttar Pradesh,Other Crimes,Corruption,Male,0-12,2699,1863,836,2697,2
2005,Rural,Telangana,Crime Against Men,Assault,Male,46-60,2361,2088,273,2145,216
2009,Urban,Uttarakhand,Crime Against Children,Kidnapping,Female,46-60,6959,1090,5869,3431,3528
2003,Urban,Madhya Pradesh,Other Crimes,Drug Offense,Male,31-45,6495,4079,2416,6042,453
2010,Urban,West Bengal,Crime Against Men,Robbery,Male,13-17,4142,3192,950,3244,898
2008,Rural,West Bengal,Crime Against Men,Assault,Male,13-17,9939,3667,6272,6396,3543
2006,Rural,Jammu & Kashmir,Crime Against Children,Kidnapping,Female,31-45,866,758,108,768,98
2010,Urban,Arunachal Pradesh,Crime Against Children,Trafficking,Female,0-12,8717,4975,3742,5320,3397
2002,Rural,Tripura,Other Crimes,Drug Offense,Female,18-30,3140,585,2555,1510,1630
2003,Rural,Odisha,Property Crime,Vandalism,Male,60+,2529,1264,1265,1894,635
2002,Rural,Meghalaya,Property Crime,Theft,Female,31-45,9758,1248,8510,2924,6834
2004,Rural,Uttar Pradesh,Crime Against Men,Extortion,Female,13-17,6129,3503,2626,5926,203
2006,Rural,Odisha,Crime Against Men,Extortion,Female,0-12,7429,4375,3054,6107,1322
2003,Urban,Sikkim,Other Crimes,Cyber Crime,Female,18-30,6191,323,5868,3701,2490
2001,Urban,Kerala,Crime Against Men,Robbery,Male,60+,4731,2436,2295,3970,761
2007,Rural,Delhi,Property Crime,Arson,Male,31-45,2987,415,2572,1163,1824
2006,Urban,Goa,Crime Against Men,Robbery,Female,0-12,4607,3549,1058,4046,561
2002,Rural,Telangana,Crime Against Men,Assault,Female,46-60,5766,361,5405,1465,4301
2003,Rural,Odisha,Other Crimes,Fraud,Male,46-60,8784,1783,7001,4681,4103
2008,Rural,Haryana,Property Crime,Arson,Male,18-30,8618,7974,644,8476,142
2009,Urban,Andhra Pradesh,Crime Against Men,Assault,Male,46-60,874,757,117,807,67
2005,Rural,Jammu & Kashmir,Other Crimes,Drug Offense,Male,18-30,3273,245,3028,301,2972
2001,Urban,Tripura,Crime Against Men,Assault,Male,31-45,9428,3953,5475,7186,2242
2002,Urban,Gujarat,Other Crimes,Cyber Crime,Male,13-17,8053,506,7547,2872,5181
2008,Rural,Maharashtra,Property Crime,Theft,Female,13-17,6018,889,5129,4694,1324
2003,Urban,West Bengal,Property Crime,Burglary,Male,13-17,1495,1114,381,1457,38
2009,Urban,Punjab,Crime Against Men,Extortion,Male,13-17,8130,1261,6869,4403,3727
2008,Rural,Arunachal Pradesh,Other Crimes,Cyber Crime,Male,18-30,5462,3956,1506,4446,1016
2002,Urban,Rajasthan,Crime Against Women,Domestic Violence,Female,31-45,9613,8090,1523,9212,401
2009,Rural,Jammu & Kashmir,Crime Against Women,Domestic Violence,Female,46-60,3497,3254,243,3332,165
2005,Urban,Manipur,Other Crimes,Corruption,Female,18-30,9994,5523,4471,7361,2633
2007,Rural,Odisha,Property Crime,Theft,Female,46-60,6684,6362,322,6541,143
2002,Rural,Himachal Pradesh,Crime Against Women,Domestic Violence,Female,46-60,6424,3588,2836,5071,1353
2008,Rural,Jharkhand,Crime Against Men,Extortion,Male,60+,5571,3801,1770,4804,767
2007,Rural,Kerala,Property Crime,Arson,Male,46-60,9013,2565,6448,6224,2789
2006,Urban,Karnataka,Other Crimes,Corruption,Male,18-30,8099,1449,6650,6986,1113
2010,Rural,Rajasthan,Property Crime,Vandalism,Male,60+,4916,4799,117,4855,61
2001,Rural,Delhi,Crime Against Children,Trafficking,Male,31-45,6476,942,5534,5811,665
2007,Rural,Jammu & Kashmir,Crime Against Women,Dowry Deaths,Male,18-30,5189,5133,56,5163,26
2008,Urban,Jharkhand,Crime Against Women,Dowry Deaths,Female,46-60,4347,3510,837,3855,492
2005,Rural,Odisha,Crime Against Men,Robbery,Male,0-12,2830,1837,993,2737,93
2004,Rural,Kerala,Other Crimes,Drug Offense,Male,60+,6204,5030,1174,5686,518
2010,Rural,Bihar,Crime Against Men,Assault,Male,13-17,5155,629,4526,2301,2854
2009,Rural,Mizoram,Crime Against Women,Molestation,Female,13-17,4512,3305,1207,4146,366
2004,Urban,Jharkhand,Crime Against Women,Domestic Violence,Female,31-45,1230,747,483,1194,36
2003,Rural,Goa,Crime Against Women,Dowry Deaths,Male,18-30,3065,1306,1759,2249,816
2007,Urban,Meghalaya,Crime Against Children,Kidnapping,Female,31-45,9459,734,8725,7131,2328
2003,Urban,Karnataka,Other Crimes,Drug Offense,Female,18-30,4128,1800,2328,2477,1651
2008,Urban,Delhi,Crime Against Women,Dowry Deaths,Female,0-12,3566,1524,2042,2857,709
2009,Urban,Uttarakhand,Crime Against Men,Assault,Male,18-30,509,48,461,486,23
2002,Urban,West Bengal,Crime Against Men,Robbery,Female,18-30,7420,4503,2917,6152,1268
2003,Urban,Tamil Nadu,Crime Against Children,Trafficking,Male,46-60,4097,1232,2865,1612,2485
2001,Rural,Uttar Pradesh,Crime Against Men,Robbery,Female,46-60,890,813,77,826,64
2007,Rural,Odisha,Property Crime,Arson,Female,13-17,8963,5696,3267,8522,441
2006,Rural,Chhattisgarh,Other Crimes,Cyber Crime,Male,0-12,8590,2728,5862,6950,1640
2002,Urban,Chhattisgarh,Property Crime,Vandalism,Female,60+,9485,3938,5547,8562,923
2008,Rural,Chhattisgarh,Crime Against Men,Extortion,Female,60+,2361,323,2038,1857,504
2010,Rural,Odisha,Other Crimes,Fraud,Female,0-12,885,662,223,808,77
2004,Urban,Meghalaya,Other Crimes,Corruption,Male,0-12,1243,14,1229,1227,16
2004,Urban,Gujarat,Crime Against Men,Extortion,Female,0-12,5802,734,5068,2810,2992
2002,Urban,Jharkhand,Crime Against Men,Murder,Female,13-17,8182,3505,4677,4361,3821
2003,Urban,Jharkhand,Crime Against Women,Rape,Male,60+,4800,4355,445,4680,120
2004,Rural,West Bengal,Crime Against Women,Rape,Male,60+,3913,98,3815,1608,2305
2005,Urban,Kerala,Property Crime,Burglary,Female,60+,6513,4862,1651,5019,1494
2005,Rural,Karnataka,Crime Against Women,Molestation,Male,18-30,8445,4405,4040,8316,129
2009,Urban,Uttarakhand,Crime Against Men,Extortion,Male,46-60,9448,1976,7472,6403,3045
2002,Urban,Himachal Pradesh,Crime Against Children,Child Labor,Male,18-30,9963,1846,8117,5950,4013
2001,Rural,Jammu & Kashmir,Property Crime,Theft,Male,0-12,6812,4647,2165,6213,599
2008,Rural,Jharkhand,Other Crimes,Corruption,Female,31-45,7289,2236,5053,6807,482
2010,Urban,Kerala,Other Crimes,Drug Offense,Female,31-45,6576,2016,4560,6409,167
2007,Urban,Andhra Pradesh,Crime Against Men,Assault,Male,31-45,2603,1307,1296,1889,714
2008,Urban,Uttarakhand,Crime Against Men,Murder,Female,18-30,5769,3557,2212,4934,835
2002,Urban,Uttar Pradesh,Other Crimes,Cyber Crime,Male,31-45,1577,187,1390,304,1273
2003,Rural,Manipur,Crime Against Women,Domestic Violence,Male,60+,9871,1486,8385,3294,6577
2007,Urban,Himachal Pradesh,Other Crimes,Cyber Crime,Male,0-12,8891,170,8721,434,8457
2002,Rural,Mizoram,Crime Against Women,Domestic Violence,Female,0-12,6001,4070,1931,5696,305
2010,Urban,Arunachal Pradesh,Property Crime,Burglary,Male,0-12,6341,94,6247,935,5406
2004,Rural,Manipur,Crime Against Women,Rape,Female,0-12,5099,2720,2379,4707,392
2009,Urban,Mizoram,Crime Against Men,Robbery,Male,0-12,5701,1079,4622,1740,3961
2010,Urban,Odisha,Crime Against Children,Trafficking,Female,18-30,9544,8788,756,9077,467
2010,Rural,Delhi,Property Crime,Vandalism,Male,46-60,3314,2237,1077,2370,944
2002,Rural,Telangana,Crime Against Women,Rape,Male,46-60,5583,5184,399,5230,353
2007,Rural,Kerala,Property Crime,Burglary,Male,46-60,1812,777,1035,815,997
2003,Rural,Karnataka,Crime Against Men,Murder,Female,18-30,5811,1791,4020,3079,2732
2005,Rural,Jammu & Kashmir,Other Crimes,Drug Offense,Male,18-30,4806,610,4196,1080,3726
2002,Urban,Tripura,Property Crime,Burglary,Male,31-45,5371,2922,2449,4221,1150
2010,Rural,Goa,Crime Against Men,Extortion,Male,18-30,8286,6342,1944,7414,872
2001,Rural,Gujarat,Crime Against Children,Kidnapping,Male,31-45,7042,4137,2905,4955,2087
2007,Urban,Andhra Pradesh,Crime Against Women,Dowry Deaths,Female,18-30,6120,808,5312,1174,4946
2008,Rural,Uttarakhand,Other Crimes,Fraud,Male,46-60,842,205,637,246,596
2003,Rural,Meghalaya,Crime Against Children,Kidnapping,Female,0-12,5562,2528,3034,3587,1975
2005,Urban,Assam,Property Crime,Vandalism,Male,0-12,4435,643,3792,990,3445
2010,Rural,Haryana,Crime Against Women,Rape,Female,60+,6182,5528,654,5646,536
2001,Urban,Telangana,Crime Against Men,Murder,Female,18-30,8237,155,8082,1078,7159
2007,Urban,Delhi,Property Crime,Vandalism,Male,31-45,6232,1391,4841,6057,175
2004,Urban,Odisha,Crime Against Children,Kidnapping,Male,13-17,7050,2953,4097,6045,1005
2006,Rural,Goa,Crime Against Children,Kidnapping,Female,0-12,9658,3957,5701,9204,454
2009,Urban,Arunachal Pradesh,Property Crime,Burglary,Male,46-60,8987,6470,2517,7124,1863
2010,Rural,Jammu & Kashmir,Crime Against Men,Assault,Female,0-12,4412,2868,1544,3225,1187
2003,Rural,Tripura,Crime Against Men,Assault,Female,31-45,965,586,379,678,287
2008,Urban,Delhi,Other Crimes,Cyber Crime,Male,46-60,4149,1071,3078,3113,1036
2001,Rural,Arunachal Pradesh,Other Crimes,Cyber Crime,Female,18-30,4881,3689,1192,4334,547
2007,Urban,Nagaland,Property Crime,Burglary,Female,46-60,1981,1927,54,1969,12
2009,Urban,Madhya Pradesh,Crime Against Women,Dowry Deaths,Male,13-17,3786,604,3182,2432,1354
2002,Rural,Assam,Other Crimes,Corruption,Female,60+,2667,2492,175,2631,36
2006,Urban,West Bengal,Crime Against Men,Murder,Male,46-60,8918,1070,7848,1407,7511
2009,Urban,Haryana,Property Crime,Burglary,Male,46-60,4013,1731,2282,3822,191
2008,Urban,Nagaland,Crime Against Women,Dowry Deaths,Female,60+,3335,1408,1927,3253,82
2001,Urban,Tamil Nadu,Crime Against Children,Child Labor,Female,60+,8120,4800,3320,5690,2430
2006,Rural,Delhi,Crime Against Men,Robbery,Male,60+,245,119,126,200,45
2008,Rural,Nagaland,Property Crime,Vandalism,Female,18-30,8122,3046,5076,6134,1988
2001,Urban,Manipur,Crime Against Children,Child Abuse,Male,46-60,6874,153,6721,353,6521
2004,Urban,Andhra Pradesh,Crime Against Men,Robbery,Male,60+,4082,2876,1206,3297,785
2009,Rural,Manipur,Other Crimes,Corruption,Male,18-30,6288,3884,2404,5326,962
2008,Urban,Bihar,Property Crime,Vandalism,Female,0-12,9227,9220,7,9223,4
2002,Urban,Karnataka,Other Crimes,Drug Offense,Female,18-30,169,106,63,138,31
2010,Rural,Bihar,Crime Against Men,Extortion,Female,13-17,196,80,116,153,43
2002,Urban,Punjab,Crime Against Women,Domestic Violence,Male,0-12,9674,8254,1420,8469,1205
2003,Urban,Maharashtra,Property Crime,Arson,Female,13-17,5601,2226,3375,3776,1825
2002,Urban,Uttar Pradesh,Crime Against Men,Assault,Male,0-12,6994,169,6825,6748,246
2003,Urban,West Bengal,Crime Against Men,Robbery,Male,18-30,8900,4554,4346,8323,577
2009,Urban,Nagaland,Crime Against Children,Child Labor,Female,0-12,2845,2216,629,2443,402
2006,Rural,Jammu & Kashmir,Crime Against Women,Rape,Male,18-30,5914,4712,1202,4818,1096
2006,Rural,Uttarakhand,Crime Against Children,Kidnapping,Female,31-45,7940,234,7706,6514,1426
2010,Urban,Arunachal Pradesh,Crime Against Men,Assault,Male,31-45,9752,3550,6202,9666,86
2004,Rural,Mizoram,Crime Against Men,Murder,Male,46-60,6075,3460,2615,5201,874
2002,Urban,Mizoram,Crime Against Men,Robbery,Female,0-12,1393,734,659,960,433
2001,Rural,Andhra Pradesh,Crime Against Children,Child Labor,Female,60+,2663,344,2319,2539,124
2005,Rural,Jammu & Kashmir,Other Crimes,Drug Offense,Female,46-60,796,175,621,639,157
2007,Urban,Delhi,Property Crime,Arson,Male,13-17,7929,3858,4071,6456,1473
2009,Rural,Manipur,Crime Against Children,Kidnapping,Male,46-60,9239,656,8583,7270,1969
2008,Urban,Chhattisgarh,Other Crimes,Drug Offense,Male,46-60,368,114,254,253,115
2009,Rural,West Bengal,Other Crimes,Drug Offense,Female,13-17,5629,30,5599,3671,1958
2003,Urban,Himachal Pradesh,Crime Against Women,Rape,Male,46-60,5597,1636,3961,2443,3154
2007,Urban,Karnataka,Crime Against Men,Robbery,Female,0-12,2334,1486,848,1993,341
2004,Rural,Maharashtra,Crime Against Women,Dowry Deaths,Male,18-30,2987,2797,190,2918,69
2006,Urban,Manipur,Crime Against Children,Child Labor,Male,0-12,1622,1251,371,1359,263
2004,Rural,Jammu & Kashmir,Crime Against Men,Murder,Female,13-17,3716,2909,807,3241,475
2002,Urban,Chhattisgarh,Crime Against Men,Assault,Male,13-17,4998,4467,531,4994,4
2008,Urban,Bihar,Crime Against Men,Murder,Male,18-30,880,408,472,570,310
2006,Urban,Rajasthan,Crime Against Women,Molestation,Male,46-60,8153,3962,4191,4233,3920
2009,Urban,West Bengal,Property Crime,Theft,Female,0-12,8003,5035,2968,6852,1151
2009,Rural,Meghalaya,Property Crime,Burglary,Male,0-12,6281,3512,2769,3625,2656
2003,Rural,Assam,Crime Against Women,Dowry Deaths,Male,46-60,4045,1837,2208,3989,56
2007,Rural,Madhya Pradesh,Property Crime,Theft,Female,31-45,6358,3897,2461,6156,202
2001,Rural,Madhya Pradesh,Crime Against Women,Molestation,Female,13-17,1901,324,1577,755,1146
2006,Urban,Tamil Nadu,Other Crimes,Fraud,Female,31-45,5745,3551,2194,4735,1010
2006,Urban,Chhattisgarh,Crime Against Men,Extortion,Male,18-30,7576,5258,2318,5806,1770
2010,Urban,Uttar Pradesh,Crime Against Women,Molestation,Male,13-17,2159,859,1300,1167,992
2001,Rural,Delhi,Crime Against Men,Murder,Male,60+,2875,1356,1519,1904,971
2010,Rural,Uttar Pradesh,Crime Against Men,Assault,Female,31-45,1919,1529,390,1622,297
2010,Urban,Uttar Pradesh,Crime Against Children,Child Labor,Female,31-45,5225,4715,510,4846,379
2003,Rural,Goa,Property Crime,Vandalism,Female,18-30,6714,2422,4292,3369,3345
2010,Urban,Sikkim,Property Crime,Theft,Male,31-45,1064,189,875,914,150
2003,Urban,Uttar Pradesh,Crime Against Children,Child Abuse,Male,13-17,7444,2466,4978,6468,976
2010,Rural,Tripura,Crime Against Men,Robbery,Female,0-12,311,94,217,202,109
2008,Urban,Goa,Property Crime,Arson,Female,13-17,9870,521,9349,8915,955
2007,Rural,Kerala,Property Crime,Vandalism,Male,46-60,8622,2006,6616,2368,6254
2002,Urban,Meghalaya,Crime Against Women,Molestation,Female,31-45,4307,1914,2393,4166,141
2010,Urban,Nagaland,Crime Against Women,Domestic Violence,Male,13-17,4710,1964,2746,2766,1944
2009,Rural,Rajasthan,Other Crimes,Cyber Crime,Female,13-17,6488,2799,3689,3448,3040
2010,Rural,Delhi,Crime Against Men,Robbery,Male,13-17,4491,1592,2899,2786,1705
2002,Rural,Uttar Pradesh,Crime Against Women,Domestic Violence,Male,46-60,2869,1604,1265,2049,820
2003,Urban,Tripura,Other Crimes,Drug Offense,Male,60+,2737,126,2611,1068,1669
2007,Urban,Jammu & Kashmir,Property Crime,Burglary,Female,13-17,3330,1372,1958,1502,1828
2007,Rural,Odisha,Crime Against Men,Extortion,Female,60+,4169,303,3866,4109,60
2004,Rural,Tripura,Crime Against Women,Dowry Deaths,Male,60+,5502,4376,1126,4988,514
2007,Urban,Haryana,Property Crime,Arson,Female,60+,7342,6528,814,7123,219
2008,Rural,Gujarat,Crime Against Men,Assault,Female,13-17,8139,2601,5538,6822,1317
2009,Urban,Delhi,Other Crimes,Fraud,Male,18-30,7802,303,7499,552,7250
2001,Urban,Bihar,Crime Against Women,Domestic Violence,Male,60+,5969,722,5247,2957,3012
2002,Rural,Jammu & Kashmir,Property Crime,Burglary,Female,46-60,95,65,30,79,16
2001,Urban,Odisha,Crime Against Women,Molestation,Female,31-45,7052,627,6425,3273,3779
2004,Rural,Karnataka,Other Crimes,Cyber Crime,Male,60+,7263,1973,5290,3739,3524
2010,Urban,Sikkim,Crime Against Women,Molestation,Female,46-60,5969,4993,976,5020,949
2006,Rural,Manipur,Property Crime,Vandalism,Female,46-60,3088,1796,1292,2274,814
2006,Rural,Arunachal Pradesh,Property Crime,Theft,Male,46-60,6324,1840,4484,4133,2191
2009,Rural,Delhi,Crime Against Children,Child Labor,Male,60+,2453,2410,43,2433,20
2008,Rural,Gujarat,Crime Against Children,Child Abuse,Male,31-45,5068,1960,3108,4019,1049
2003,Urban,Haryana,Other Crimes,Fraud,Female,60+,171,163,8,170,1
2001,Rural,Telangana,Other Crimes,Drug Offense,Male,31-45,9571,7248,2323,7509,2062
2004,Rural,Goa,Crime Against Children,Child Abuse,Male,46-60,1608,1444,164,1459,149
2003,Urban,Nagaland,Crime Against Women,Dowry Deaths,Female,18-30,8014,1942,6072,2630,5384
2001,Rural,Uttar Pradesh,Other Crimes,Corruption,Female,13-17,1186,904,282,1167,19
2003,Urban,Madhya Pradesh,Crime Against Men,Murder,Female,18-30,3653,1147,2506,2060,1593
2004,Urban,West Bengal,Crime Against Children,Child Abuse,Male,46-60,7580,145,7435,4688,2892
2002,Urban,Rajasthan,Crime Against Women,Dowry Deaths,Female,60+,7611,4884,2727,6113,1498
2001,Urban,West Bengal,Crime Against Men,Extortion,Male,13-17,2434,1736,698,1943,491
2004,Rural,Andhra Pradesh,Crime Against Women,Domestic Violence,Male,31-45,2272,1655,617,2145,127
2005,Rural,Assam,Crime Against Men,Robbery,Male,46-60,9875,9283,592,9848,27
2010,Urban,Haryana,Crime Against Children,Trafficking,Female,60+,9261,1240,8021,1439,7822
2005,Urban,Nagaland,Crime Against Women,Dowry Deaths,Male,18-30,5734,3430,2304,4048,1686
2006,Rural,Jammu & Kashmir,Crime Against Men,Murder,Female,0-12,6900,2112,4788,5091,1809
2002,Urban,Tripura,Crime Against Women,Rape,Male,46-60,4961,4438,523,4830,131
2005,Urban,Maharashtra,Other Crimes,Drug Offense,Male,46-60,8922,3436,5486,3572,5350
2002,Urban,Uttarakhand,Crime Against Women,Dowry Deaths,Male,31-45,4991,630,4361,2781,2210
2008,Urban,Karnataka,Crime Against Women,Dowry Deaths,Male,18-30,1389,888,501,972,417
2008,Rural,West Bengal,Crime Against Children,Kidnapping,Male,13-17,9773,1585,8188,3499,6274
2010,Urban,Telangana,Crime Against Children,Kidnapping,Male,46-60,1355,200,1155,634,721
2008,Urban,Tripura,Crime Against Children,Trafficking,Female,60+,6907,5514,1393,5944,963
2005,Rural,Jammu & Kashmir,Crime Against Men,Assault,Female,60+,3780,2178,1602,2976,804
2001,Rural,Meghalaya,Crime Against Children,Kidnapping,Female,18-30,6957,2491,4466,3655,3302
2008,Urban,Sikkim,Other Crimes,Cyber Crime,Male,31-45,5332,2407,2925,2575,2757
2007,Urban,Telangana,Crime Against Children,Kidnapping,Female,13-17,5859,4628,1231,5226,633
2006,Urban,Himachal Pradesh,Other Crimes,Corruption,Male,60+,1231,171,1060,724,507
2007,Rural,Odisha,Crime Against Men,Murder,Male,18-30,9123,5083,4040,7258,1865
2001,Urban,Telangana,Crime Against Children,Child Abuse,Male,18-30,5238,3700,1538,4754,484
2004,Rural,Bihar,Property Crime,Burglary,Female,0-12,2438,388,2050,1515,923
2004,Rural,Chhattisgarh,Crime Against Women,Molestation,Male,31-45,6091,4746,1345,5915,176
2004,Rural,Meghalaya,Property Crime,Burglary,Male,60+,3436,945,2491,2662,774
2004,Urban,Tripura,Crime Against Men,Assault,Male,13-17,827,148,679,445,382
2002,Rural,Mizoram,Crime Against Children,Child Labor,Female,0-12,5131,2529,2602,3898,1233
2007,Rural,Karnataka,Crime Against Children,Child Abuse,Male,18-30,6327,6100,227,6139,188
2008,Rural,Jharkhand,Other Crimes,Drug Offense,Male,0-12,2143,1168,975,1707,436
2009,Urban,Jammu & Kashmir,Crime Against Men,Assault,Male,13-17,2450,331,2119,909,1541
2005,Rural,Chhattisgarh,Crime Against Children,Child Abuse,Male,31-45,5611,3791,1820,4221,1390
2010,Rural,Uttar Pradesh,Crime Against Men,Murder,Female,31-45,6228,5008,1220,5940,288
2002,Rural,Sikkim,Other Crimes,Fraud,Male,13-17,8623,559,8064,3106,5517
2003,Rural,Sikkim,Other Crimes,Fraud,Male,0-12,3616,1303,2313,1811,1805
2010,Rural,Jharkhand,Crime Against Children,Child Abuse,Male,13-17,7063,6862,201,7057,6
2007,Rural,Jharkhand,Crime Against Men,Robbery,Male,31-45,3474,2942,532,3172,302
2008,Rural,Madhya Pradesh,Crime Against Children,Kidnapping,Female,60+,1367,247,1120,1143,224
2002,Rural,Arunachal Pradesh,Other Crimes,Corruption,Male,0-12,1257,708,549,910,347
2009,Rural,Tamil Nadu,Property Crime,Burglary,Male,13-17,1692,1619,73,1677,15
2009,Rural,Himachal Pradesh,Property Crime,Vandalism,Female,31-45,4866,665,4201,846,4020
2009,Rural,Andhra Pradesh,Other Crimes,Corruption,Female,31-45,3627,645,2982,1297,2330
2009,Urban,Odisha,Crime Against Men,Extortion,Male,31-45,4839,23,4816,3790,1049
2004,Rural,Odisha,Property Crime,Theft,Female,13-17,4055,2765,1290,3082,973
2006,Urban,Karnataka,Crime Against Men,Robbery,Female,0-12,4546,2978,1568,3877,669
2008,Urban,Assam,Crime Against Women,Dowry Deaths,Female,13-17,7340,6662,678,6802,538
2001,Urban,Uttarakhand,Crime Against Children,Child Labor,Female,13-17,2324,698,1626,1085,1239
2001,Rural,Madhya Pradesh,Crime Against Children,Child Labor,Female,46-60,5066,1241,3825,3222,1844
2004,Rural,Chhattisgarh,Property Crime,Theft,Male,46-60,5113,449,4664,1490,3623
2007,Rural,Jammu & Kashmir,Property Crime,Arson,Male,31-45,8348,1106,7242,1898,6450
2010,Urban,Jharkhand,Crime Against Women,Rape,Female,31-45,8449,6355,2094,6694,1755
2003,Rural,Tripura,Property Crime,Burglary,Female,60+,8945,1450,7495,7857,1088
2010,Rural,Karnataka,Crime Against Men,Robbery,Female,46-60,2952,1708,1244,2253,699
2004,Urban,Odisha,Crime Against Men,Murder,Female,0-12,238,149,89,176,62
2001,Urban,Nagaland,Other Crimes,Cyber Crime,Female,31-45,1018,662,356,708,310
2005,Rural,Arunachal Pradesh,Other Crimes,Corruption,Male,0-12,363,43,320,73,290
2008,Urban,Arunachal Pradesh,Crime Against Men,Murder,Female,46-60,2902,1573,1329,1861,1041
2008,Rural,Sikkim,Crime Against Women,Molestation,Male,0-12,6204,546,5658,2779,3425
2001,Urban,Tripura,Crime Against Men,Assault,Male,0-12,1750,460,1290,1452,298
2004,Rural,Chhattisgarh,Crime Against Men,Robbery,Female,0-12,788,365,423,533,255
2009,Urban,Rajasthan,Other Crimes,Drug Offense,Female,60+,9443,9074,369,9253,190
2001,Rural,Punjab,Crime Against Women,Dowry Deaths,Female,13-17,9290,2802,6488,8643,647
2001,Rural,Punjab,Crime Against Men,Extortion,Male,60+,8672,8298,374,8603,69
2001,Urban,Gujarat,Crime Against Men,Robbery,Male,18-30,9113,1987,7126,7580,1533
2004,Urban,Karnataka,Crime Against Men,Assault,Male,0-12,7124,540,6584,3173,3951
2009,Urban,Tamil Nadu,Crime Against Children,Trafficking,Female,46-60,9285,345,8940,4271,5014
2010,Rural,Punjab,Other Crimes,Fraud,Male,18-30,5368,2481,2887,5350,18
2005,Rural,Tamil Nadu,Crime Against Women,Dowry Deaths,Male,31-45,2565,181,2384,934,1631
2001,Rural,Haryana,Crime Against Women,Domestic Violence,Male,13-17,4727,2000,2727,2311,2416
2004,Rural,Maharashtra,Property Crime,Theft,Male,60+,522,479,43,501,21
2010,Rural,Maharashtra,Property Crime,Vandalism,Female,0-12,3420,2788,632,2791,629
2003,Rural,Punjab,Other Crimes,Corruption,Female,31-45,7746,2450,5296,5266,2480
2006,Urban,Rajasthan,Crime Against Men,Extortion,Male,0-12,4250,1572,2678,2601,1649
2009,Rural,Goa,Crime Against Children,Trafficking,Female,13-17,7056,695,6361,4370,2686
2009,Rural,Sikkim,Crime Against Men,Extortion,Female,13-17,9070,5463,3607,7592,1478
2001,Rural,Jharkhand,Other Crimes,Corruption,Male,13-17,5142,2660,2482,4915,227
2001,Rural,Karnataka,Crime Against Women,Domestic Violence,Male,0-12,483,322,161,448,35
2003,Rural,Mizoram,Other Crimes,Drug Offense,Male,60+,1186,1114,72,1177,9
2009,Urban,Maharashtra,Crime Against Women,Molestation,Female,18-30,9141,3893,5248,5947,3194
2004,Rural,Jharkhand,Crime Against Children,Child Abuse,Male,31-45,8002,5552,2450,6993,1009
2003,Urban,Mizoram,Crime Against Men,Robbery,Female,46-60,342,11,331,274,68
2002,Rural,Chhattisgarh,Crime Against Men,Assault,Male,18-30,3205,602,2603,2032,1173
2002,Rural,Bihar,Crime Against Men,Robbery,Male,31-45,9231,6382,2849,6536,2695
2007,Rural,Jammu & Kashmir,Crime Against Women,Rape,Female,46-60,979,662,317,908,71
2007,Rural,Odisha,Crime Against Children,Child Abuse,Male,0-12,7566,6137,1429,7440,126
2001,Urban,Maharashtra,Other Crimes,Drug Offense,Female,0-12,4924,1900,3024,2179,2745
2001,Urban,Punjab,Crime Against Women,Domestic Violence,Female,13-17,9306,6683,2623,8852,454
2005,Rural,Maharashtra,Other Crimes,Corruption,Male,0-12,2511,1307,1204,2177,334
2008,Rural,Mizoram,Crime Against Women,Domestic Violence,Female,18-30,3293,2220,1073,2584,709
2003,Urban,Karnataka,Crime Against Children,Child Labor,Male,31-45,9681,8021,1660,9450,231
2010,Rural,Telangana,Crime Against Children,Child Abuse,Male,18-30,1317,413,904,1166,151
2008,Rural,Tripura,Property Crime,Burglary,Female,46-60,783,627,156,762,21
2010,Rural,Mizoram,Property Crime,Burglary,Male,0-12,6994,4992,2002,5479,1515
2004,Urban,Punjab,Crime Against Women,Molestation,Female,13-17,731,49,682,405,326
2003,Urban,Assam,Crime Against Women,Domestic Violence,Male,13-17,7157,2420,4737,4952,2205
2004,Urban,West Bengal,Other Crimes,Fraud,Female,60+,2547,2411,136,2531,16
2001,Rural,Bihar,Crime Against Women,Domestic Violence,Female,13-17,4073,321,3752,3924,149
2005,Urban,Nagaland,Other Crimes,Fraud,Male,31-45,5113,866,4247,4465,648
2006,Urban,Sikkim,Other Crimes,Corruption,Male,13-17,8992,7329,1663,8258,734
2006,Urban,Uttar Pradesh,Property Crime,Vandalism,Male,18-30,6319,25,6294,5424,895
2004,Urban,Manipur,Crime Against Women,Dowry Deaths,Male,31-45,7893,5909,1984,6211,1682
2005,Rural,Rajasthan,Crime Against Women,Rape,Female,31-45,9906,6716,3190,7247,2659
2004,Rural,Maharashtra,Property Crime,Theft,Female,13-17,1632,398,1234,1086,546
2006,Rural,Manipur,Other Crimes,Drug Offense,Male,31-45,775,65,710,242,533
2008,Rural,Rajasthan,Other Crimes,Drug Offense,Male,18-30,8705,936,7769,8122,583
2008,Urban,Jammu & Kashmir,Crime Against Women,Dowry Deaths,Female,18-30,3005,2090,915,2558,447
2003,Urban,Himachal Pradesh,Crime Against Children,Kidnapping,Female,13-17,1592,1124,468,1502,90
2009,Urban,Sikkim,Property Crime,Arson,Male,46-60,7263,2570,4693,5521,1742
2003,Urban,Odisha,Other Crimes,Fraud,Male,18-30,184,129,55,131,53
2010,Urban,Assam,Crime Against Women,Rape,Male,0-12,4669,1867,2802,4474,195
2003,Rural,Punjab,Crime Against Children,Child Abuse,Male,13-17,3939,411,3528,1603,2336
2007,Rural,Chhattisgarh,Crime Against Women,Molestation,Male,18-30,9567,4155,5412,8152,1415
2010,Urban,Tripura,Crime Against Men,Assault,Male,0-12,5506,1644,3862,1835,3671
2008,Rural,Bihar,Other Crimes,Corruption,Male,0-12,3294,2345,949,2806,488
2005,Urban,Manipur,Crime Against Women,Rape,Male,31-45,2930,213,2717,893,2037
2004,Urban,Meghalaya,Property Crime,Burglary,Female,60+,5743,4950,793,5378,365
2004,Urban,Madhya Pradesh,Crime Against Men,Robbery,Male,31-45,4793,2871,1922,2895,1898
2003,Urban,Bihar,Other Crimes,Fraud,Female,46-60,1073,37,1036,414,659
2002,Urban,Meghalaya,Property Crime,Vandalism,Female,60+,8246,7350,896,7555,691
2006,Rural,Maharashtra,Crime Against Men,Extortion,Female,13-17,9598,2741,6857,3619,5979
2004,Rural,Goa,Other Crimes,Corruption,Female,0-12,1526,426,1100,1050,476
2004,Rural,Sikkim,Crime Against Men,Assault,Female,18-30,5062,3490,1572,3540,1522
2001,Rural,Madhya Pradesh,Crime Against Men,Extortion,Female,13-17,5806,2065,3741,3917,1889
2001,Urban,Manipur,Property Crime,Vandalism,Male,46-60,5926,2319,3607,5827,99
2004,Urban,Rajasthan,Property Crime,Theft,Female,0-12,4278,470,3808,3355,923
2001,Rural,Chhattisgarh,Crime Against Men,Robbery,Female,60+,1214,239,975,1153,61
2001,Urban,Telangana,Crime Against Men,Robbery,Male,13-17,810,383,427,452,358
2003,Rural,Nagaland,Other Crimes,Fraud,Female,46-60,387,32,355,251,136
2003,Rural,Goa,Other Crimes,Cyber Crime,Female,13-17,3019,1769,1250,2456,563
2009,Urban,Uttarakhand,Crime Against Women,Domestic Violence,Female,31-45,7529,4660,2869,5422,2107
2006,Urban,Punjab,Property Crime,Arson,Male,60+,3940,1117,2823,3150,790
2003,Rural,West Bengal,Other Crimes,Fraud,Male,31-45,2427,9,2418,1964,463
2009,Rural,Tamil Nadu,Other Crimes,Drug Offense,Male,0-12,6654,4361,2293,4932,1722
2003,Rural,Uttar Pradesh,Crime Against Women,Domestic Violence,Female,31-45,7166,5642,1524,5814,1352
2007,Urban,Odisha,Crime Against Children,Child Labor,Female,31-45,9922,1862,8060,3491,6431
2005,Urban,Meghalaya,Crime Against Women,Rape,Female,46-60,9458,2319,7139,4200,5258
2002,Urban,Bihar,Property Crime,Theft,Female,13-17,2478,64,2414,1533,945
2007,Rural,Maharashtra,Crime Against Women,Molestation,Female,13-17,2447,1925,522,2221,226
2009,Rural,Chhattisgarh,Property Crime,Vandalism,Female,31-45,6487,575,5912,3899,2588
2007,Urban,Manipur,Other Crimes,Cyber Crime,Female,0-12,8230,5580,2650,7654,576
2003,Urban,Karnataka,Crime Against Women,Dowry Deaths,Female,31-45,7268,858,6410,4187,3081
2007,Rural,Madhya Pradesh,Crime Against Children,Child Labor,Female,18-30,6062,831,5231,3619,2443
2009,Urban,Rajasthan,Other Crimes,Fraud,Male,60+,691,559,132,588,103
2008,Urban,Jammu & Kashmir,Property Crime,Theft,Male,46-60,9824,7194,2630,7388,2436
2008,Rural,Goa,Property Crime,Arson,Male,13-17,149,31,118,129,20
2006,Urban,Goa,Other Crimes,Corruption,Male,46-60,90,23,67,68,22
2004,Rural,Delhi,Property Crime,Arson,Male,18-30,4180,443,3737,2761,1419
2010,Rural,Mizoram,Crime Against Men,Murder,Male,46-60,2429,1680,749,2038,391
2010,Rural,West Bengal,Crime Against Children,Child Abuse,Male,18-30,7918,7478,440,7578,340
2009,Rural,Delhi,Other Crimes,Fraud,Female,46-60,3829,2081,1748,3513,316
2003,Urban,Uttar Pradesh,Crime Against Women,Molestation,Male,46-60,6119,3232,2887,3694,2425
2002,Rural,Bihar,Other Crimes,Fraud,Male,60+,8231,4124,4107,8013,218
2007,Rural,West Bengal,Crime Against Women,Dowry Deaths,Female,60+,6061,3942,2119,4232,1829
2007,Urban,Kerala,Crime Against Children,Trafficking,Male,0-12,7230,3053,4177,5118,2112
2001,Rural,Haryana,Other Crimes,Drug Offense,Female,18-30,2250,1024,1226,2228,22
2006,Rural,Manipur,Property Crime,Vandalism,Male,31-45,1274,641,633,1209,65
2006,Urban,West Bengal,Property Crime,Burglary,Male,31-45,2885,127,2758,1058,1827
2001,Urban,Rajasthan,Property Crime,Burglary,Female,46-60,1293,401,892,695,598
2007,Urban,Assam,Crime Against Men,Extortion,Female,31-45,6644,5154,1490,6544,100
2003,Urban,Meghalaya,Crime Against Women,Dowry Deaths,Female,13-17,2277,1466,811,2272,5
2002,Urban,Rajasthan,Property Crime,Vandalism,Female,13-17,8738,1983,6755,5115,3623
2002,Urban,Kerala,Other Crimes,Drug Offense,Female,0-12,2656,1729,927,2107,549
2002,Urban,Andhra Pradesh,Other Crimes,Corruption,Female,0-12,4316,3802,514,4151,165
2009,Rural,Chhattisgarh,Crime Against Women,Rape,Female,60+,9191,5571,3620,7735,1456
2002,Rural,Goa,Crime Against Women,Rape,Male,13-17,323,256,67,321,2
2004,Urban,Manipur,Crime Against Men,Murder,Female,13-17,8736,920,7816,6460,2276
2005,Urban,Maharashtra,Crime Against Children,Child Abuse,Male,0-12,4896,2899,1997,3464,1432
2001,Urban,Madhya Pradesh,Crime Against Children,Kidnapping,Male,13-17,7255,3624,3631,4068,3187
2003,Rural,Odisha,Other Crimes,Drug Offense,Male,13-17,6272,2008,4264,3212,3060
2007,Urban,Arunachal Pradesh,Crime Against Men,Extortion,Male,46-60,4748,1143,3605,1916,2832
2001,Rural,Karnataka,Crime Against Children,Kidnapping,Female,13-17,2073,1995,78,2047,26
2010,Urban,Bihar,Crime Against Children,Kidnapping,Female,18-30,4361,4229,132,4358,3
2006,Urban,Andhra Pradesh,Crime Against Men,Assault,Female,31-45,6619,5617,1002,6349,270
2009,Urban,Punjab,Property Crime,Vandalism,Male,13-17,3050,404,2646,2668,382
2007,Rural,Telangana,Property Crime,Burglary,Male,46-60,5363,4455,908,4691,672
2004,Urban,Mizoram,Property Crime,Burglary,Female,46-60,2524,1731,793,2182,342
2009,Rural,Telangana,Other Crimes,Fraud,Male,60+,3570,2749,821,3316,254
2003,Urban,Meghalaya,Crime Against Women,Dowry Deaths,Female,60+,7974,2087,5887,6986,988
2006,Urban,Haryana,Property Crime,Arson,Male,31-45,9084,5342,3742,8136,948
2004,Rural,Bihar,Crime Against Women,Molestation,Female,18-30,463,66,397,425,38
2006,Urban,Kerala,Crime Against Men,Murder,Female,13-17,7937,5082,2855,6477,1460
2001,Urban,Delhi,Crime Against Women,Domestic Violence,Male,18-30,5050,1812,3238,4669,381
2008,Urban,Andhra Pradesh,Crime Against Women,Molestation,Male,46-60,1820,1680,140,1717,103
2009,Urban,Haryana,Other Crimes,Corruption,Male,46-60,5151,2471,2680,3446,1705
2001,Urban,Gujarat,Crime Against Men,Extortion,Female,60+,7639,1036,6603,3627,4012
2007,Urban,Uttarakhand,Property Crime,Theft,Female,31-45,5118,4440,678,5016,102
2003,Urban,Meghalaya,Crime Against Women,Domestic Violence,Male,0-12,4131,3344,787,3885,246
2008,Rural,Haryana,Crime Against Men,Robbery,Male,60+,3374,2409,965,3260,114
2006,Rural,Delhi,Crime Against Children,Child Abuse,Female,60+,6127,1232,4895,1412,4715
2001,Rural,Maharashtra,Property Crime,Theft,Male,0-12,6400,3467,2933,6115,285
2009,Urban,Andhra Pradesh,Crime Against Men,Robbery,Female,60+,3099,400,2699,1927,1172
2007,Rural,Delhi,Crime Against Men,Robbery,Male,31-45,8118,308,7810,5427,2691
2009,Urban,Tamil Nadu,Crime Against Children,Kidnapping,Male,60+,2292,96,2196,1988,304
2001,Urban,West Bengal,Crime Against Women,Rape,Male,46-60,4317,4054,263,4112,205
2005,Rural,Telangana,Crime Against Women,Molestation,Male,13-17,3645,2157,1488,3523,122
2004,Urban,Tamil Nadu,Crime Against Men,Robbery,Male,18-30,4080,1938,2142,3814,266
2003,Rural,Mizoram,Other Crimes,Fraud,Male,31-45,5142,4936,206,5046,96
2006,Urban,West Bengal,Crime Against Children,Kidnapping,Female,31-45,1086,746,340,1047,39
2004,Rural,Bihar,Property Crime,Arson,Male,0-12,9436,5078,4358,7799,1637
2006,Rural,Himachal Pradesh,Crime Against Women,Dowry Deaths,Female,31-45,8945,7737,1208,8087,858
2001,Urban,Chhattisgarh,Property Crime,Burglary,Female,13-17,391,156,235,350,41
2005,Rural,Andhra Pradesh,Crime Against Children,Trafficking,Male,13-17,3576,1868,1708,2907,669
2007,Urban,Meghalaya,Crime Against Men,Murder,Female,13-17,8655,2496,6159,7478,1177
2004,Urban,Jharkhand,Property Crime,Arson,Female,46-60,2579,2503,76,2511,68
2003,Urban,Manipur,Crime Against Men,Robbery,Male,46-60,1131,733,398,756,375
2008,Rural,Gujarat,Crime Against Children,Child Labor,Female,18-30,4806,3201,1605,3395,1411
2006,Rural,Meghalaya,Property Crime,Arson,Male,18-30,4474,4013,461,4230,244
2004,Rural,Manipur,Crime Against Women,Domestic Violence,Female,60+,1256,744,512,1133,123
2003,Rural,Karnataka,Crime Against Women,Molestation,Male,60+,6784,1603,5181,3913,2871
2006,Rural,Telangana,Crime Against Men,Assault,Male,13-17,3433,2642,791,2883,550
2005,Rural,Sikkim,Crime Against Men,Murder,Male,60+,1730,1327,403,1462,268
2009,Rural,Bihar,Crime Against Children,Kidnapping,Female,60+,8325,5855,2470,6493,1832
2008,Urban,Manipur,Crime Against Children,Trafficking,Female,18-30,5427,4671,756,4831,596
2002,Urban,West Bengal,Crime Against Women,Domestic Violence,Male,60+,9145,3625,5520,8814,331
2006,Urban,Goa,Property Crime,Arson,Female,13-17,1121,299,822,461,660
2004,Rural,Goa,Crime Against Women,Rape,Male,0-12,1832,281,1551,757,1075
2006,Urban,Bihar,Other Crimes,Fraud,Male,60+,5076,3516,1560,3708,1368
2002,Rural,West Bengal,Crime Against Women,Dowry Deaths,Female,31-45,1236,1189,47,1219,17
2004,Urban,Bihar,Crime Against Women,Rape,Female,13-17,5406,5314,92,5356,50
2009,Urban,Telangana,Crime Against Men,Robbery,Male,31-45,6328,1851,4477,5292,1036
2010,Rural,Assam,Crime Against Women,Rape,Male,0-12,1247,16,1231,64,1183
2005,Rural,Kerala,Crime Against Children,Trafficking,Male,18-30,5254,3391,1863,3475,1779
2004,Rural,Punjab,Property Crime,Vandalism,Male,31-45,4670,755,3915,1432,3238
2004,Rural,Uttarakhand,Crime Against Men,Robbery,Female,0-12,1080,871,209,876,204
2005,Rural,Assam,Other Crimes,Cyber Crime,Female,0-12,7482,6372,1110,7165,317
2005,Rural,Jharkhand,Other Crimes,Drug Offense,Male,13-17,270,6,264,259,11
2002,Urban,Andhra Pradesh,Crime Against Men,Murder,Male,46-60,4158,1303,2855,1570,2588
2005,Rural,Tamil Nadu,Crime Against Men,Assault,Male,0-12,1506,1160,346,1435,71
2007,Urban,Haryana,Crime Against Women,Rape,Male,46-60,2661,1128,1533,2251,410
2006,Rural,Rajasthan,Property Crime,Arson,Female,60+,7991,215,7776,2558,5433
2006,Urban,Tripura,Property Crime,Burglary,Male,31-45,7196,5841,1355,6207,989
2009,Rural,Telangana,Crime Against Women,Domestic Violence,Female,31-45,8465,825,7640,7241,1224
2010,Rural,Tamil Nadu,Other Crimes,Drug Offense,Female,46-60,5790,3143,2647,5330,460
2003,Urban,Maharashtra,Crime Against Men,Robbery,Female,13-17,2581,983,1598,1558,1023
2002,Urban,Assam,Other Crimes,Fraud,Male,60+,3559,1857,1702,2198,1361
2004,Rural,Tripura,Crime Against Men,Assault,Female,13-17,1090,657,433,677,413
2010,Urban,Odisha,Property Crime,Burglary,Male,18-30,5477,2488,2989,2889,2588
2002,Urban,Goa,Crime Against Women,Domestic Violence,Male,18-30,1661,1081,580,1385,276
2002,Urban,Delhi,Crime Against Men,Assault,Male,13-17,2253,1141,1112,1147,1106
2008,Rural,Jharkhand,Crime Against Men,Assault,Male,46-60,4600,1861,2739,2267,2333
2009,Urban,Manipur,Crime Against Children,Child Labor,Female,13-17,1106,662,444,914,192
2008,Rural,Goa,Other Crimes,Cyber Crime,Male,13-17,8078,6105,1973,6516,1562
2003,Rural,Bihar,Crime Against Women,Rape,Male,60+,3160,1845,1315,2086,1074
2010,Urban,Meghalaya,Other Crimes,Cyber Crime,Female,31-45,8301,4269,4032,4364,3937
2005,Rural,Nagaland,Crime Against Children,Kidnapping,Male,18-30,2633,999,1634,1964,669
2009,Rural,Jharkhand,Crime Against Children,Kidnapping,Female,31-45,5836,1937,3899,5145,691
2004,Urban,Delhi,Property Crime,Theft,Male,60+,3447,1973,1474,3200,247
2010,Rural,Telangana,Crime Against Men,Extortion,Female,46-60,7445,5021,2424,6744,701
2009,Rural,Tripura,Crime Against Women,Molestation,Male,0-12,5193,3672,1521,5175,18
2007,Rural,Mizoram,Other Crimes,Corruption,Male,18-30,114,111,3,113,1
2009,Urban,Kerala,Crime Against Men,Extortion,Male,31-45,8687,493,8194,6371,2316
2004,Urban,Tripura,Crime Against Men,Assault,Female,46-60,400,1,399,153,247
2003,Rural,Rajasthan,Property Crime,Theft,Male,46-60,5579,1251,4328,3514,2065
2001,Rural,Assam,Crime Against Children,Child Abuse,Female,18-30,2794,1231,1563,1981,813
2008,Urban,Kerala,Other Crimes,Drug Offense,Female,46-60,341,125,216,212,129
2002,Urban,Telangana,Property Crime,Vandalism,Male,46-60,667,590,77,592,75
2001,Rural,Rajasthan,Property Crime,Vandalism,Female,60+,5043,2641,2402,4927,116
2001,Rural,Sikkim,Crime Against Women,Rape,Male,60+,8298,1676,6622,4844,3454
2001,Rural,Haryana,Other Crimes,Cyber Crime,Male,13-17,5185,2907,2278,4924,261
2007,Rural,Tamil Nadu,Property Crime,Burglary,Female,18-30,8457,1187,7270,8125,332
2006,Urban,Andhra Pradesh,Crime Against Women,Rape,Female,0-12,9798,8512,1286,9016,782
2006,Rural,Rajasthan,Crime Against Children,Trafficking,Male,0-12,9344,7659,1685,9005,339
2006,Rural,Madhya Pradesh,Other Crimes,Fraud,Male,46-60,6250,645,5605,4071,2179
2003,Urban,Uttar Pradesh,Other Crimes,Drug Offense,Female,31-45,9055,3949,5106,4259,4796
2010,Rural,Nagaland,Property Crime,Burglary,Male,60+,3476,1863,1613,2520,956
2002,Rural,Tripura,Crime Against Children,Child Abuse,Male,0-12,402,266,136,385,17
2005,Urban,Goa,Crime Against Women,Domestic Violence,Male,18-30,3172,1178,1994,1794,1378
2007,Urban,Madhya Pradesh,Other Crimes,Fraud,Female,46-60,5532,1444,4088,3855,1677
2003,Urban,Himachal Pradesh,Crime Against Women,Molestation,Male,18-30,7925,6654,1271,6861,1064
2006,Rural,Tamil Nadu,Crime Against Women,Rape,Female,31-45,3626,975,2651,3593,33
2005,Urban,Nagaland,Other Crimes,Fraud,Female,0-12,5322,2967,2355,2990,2332
2008,Urban,Manipur,Other Crimes,Drug Offense,Female,31-45,8614,5546,3068,6725,1889
2005,Rural,Himachal Pradesh,Other Crimes,Cyber Crime,Male,18-30,7745,3020,4725,5849,1896
2002,Rural,Jharkhand,Crime Against Women,Molestation,Female,18-30,8996,6077,2919,6110,2886
2009,Urban,Delhi,Property Crime,Theft,Female,13-17,1438,317,1121,1035,403
2006,Urban,Jharkhand,Crime Against Men,Robbery,Male,46-60,4499,2097,2402,2802,1697
2007,Rural,Nagaland,Crime Against Men,Robbery,Male,31-45,5771,1735,4036,3164,2607
2008,Urban,Maharashtra,Crime Against Men,Extortion,Male,18-30,4501,3516,985,4429,72
2009,Rural,Madhya Pradesh,Property Crime,Theft,Female,46-60,2202,2071,131,2177,25
2007,Rural,Telangana,Crime Against Children,Trafficking,Male,13-17,6467,83,6384,4940,1527
2009,Urban,Andhra Pradesh,Other Crimes,Drug Offense,Female,46-60,4057,121,3936,2679,1378
2006,Rural,Meghalaya,Property Crime,Burglary,Female,60+,8596,8117,479,8300,296
2009,Urban,Odisha,Crime Against Men,Assault,Female,31-45,1109,502,607,945,164
2004,Urban,Sikkim,Crime Against Women,Domestic Violence,Male,13-17,3211,2378,833,2409,802
2004,Urban,West Bengal,Crime Against Children,Child Labor,Female,31-45,3454,118,3336,2496,958
2008,Urban,Himachal Pradesh,Crime Against Women,Rape,Female,46-60,7939,1133,6806,6554,1385
2010,Rural,Chhattisgarh,Crime Against Women,Dowry Deaths,Female,13-17,623,418,205,605,18
2001,Urban,Uttarakhand,Crime Against Men,Robbery,Male,46-60,2158,1995,163,2093,65
2003,Urban,Bihar,Crime Against Men,Murder,Female,31-45,9862,1870,7992,7502,2360
2003,Urban,Goa,Other Crimes,Cyber Crime,Female,13-17,7118,6496,622,6625,493
2010,Urban,Bihar,Crime Against Women,Domestic Violence,Male,60+,3992,503,3489,2521,1471
2005,Rural,Chhattisgarh,Crime Against Men,Extortion,Male,13-17,6544,5928,616,6285,259
2004,Urban,Punjab,Crime Against Children,Child Labor,Male,60+,526,25,501,223,303
2008,Urban,Odisha,Other Crimes,Fraud,Male,13-17,4726,4280,446,4697,29
2004,Urban,Gujarat,Crime Against Women,Molestation,Female,31-45,7427,4202,3225,7033,394
2006,Rural,Arunachal Pradesh,Crime Against Women,Molestation,Female,13-17,8941,1876,7065,4393,4548
2004,Rural,Kerala,Other Crimes,Corruption,Female,18-30,104,75,29,85,19
2009,Urban,Jharkhand,Other Crimes,Corruption,Female,18-30,7931,1179,6752,6741,1190
2003,Urban,Tripura,Property Crime,Vandalism,Female,31-45,7486,4001,3485,5988,1498
2002,Urban,Andhra Pradesh,Other Crimes,Fraud,Female,13-17,357,239,118,352,5
2004,Urban,Odisha,Crime Against Men,Murder,Female,18-30,9419,6465,2954,6770,2649
2002,Rural,Tamil Nadu,Crime Against Children,Trafficking,Female,46-60,9432,142,9290,9121,311
2004,Urban,Manipur,Crime Against Children,Kidnapping,Female,13-17,8236,2581,5655,7395,841
2004,Urban,Tamil Nadu,Crime Against Men,Robbery,Female,0-12,5075,873,4202,1114,3961
2002,Rural,Punjab,Crime Against Children,Child Labor,Male,13-17,8664,7030,1634,7313,1351
2004,Urban,Goa,Crime Against Children,Child Abuse,Female,18-30,3077,1538,1539,2270,807
2006,Urban,Delhi,Crime Against Women,Dowry Deaths,Male,18-30,3604,3268,336,3590,14
2007,Urban,Kerala,Crime Against Men,Robbery,Male,0-12,1414,694,720,716,698
2001,Rural,West Bengal,Other Crimes,Corruption,Male,0-12,9874,370,9504,6997,2877
2009,Rural,Punjab,Crime Against Men,Assault,Female,13-17,3039,2198,841,2958,81
2006,Urban,Odisha,Crime Against Women,Molestation,Male,60+,7196,6304,892,6877,319
2006,Rural,Nagaland,Crime Against Men,Robbery,Male,60+,3911,3212,699,3712,199
2008,Urban,Manipur,Crime Against Children,Trafficking,Male,60+,8755,4559,4196,7113,1642
2007,Rural,Bihar,Crime Against Men,Assault,Male,0-12,2793,374,2419,1594,1199
2005,Urban,Haryana,Crime Against Women,Domestic Violence,Female,46-60,6896,2083,4813,3122,3774
2001,Rural,Jharkhand,Property Crime,Arson,Male,18-30,3458,1759,1699,2685,773
2007,Urban,Mizoram,Crime Against Children,Kidnapping,Female,31-45,6825,6599,226,6704,121
2005,Urban,Tripura,Property Crime,Vandalism,Male,31-45,9534,7178,2356,8660,874
2005,Urban,Jharkhand,Crime Against Women,Domestic Violence,Female,60+,4989,2762,2227,3960,1029
2003,Urban,Assam,Other Crimes,Cyber Crime,Female,60+,217,47,170,160,57
2005,Urban,Meghalaya,Other Crimes,Fraud,Female,0-12,8628,5516,3112,6898,1730
2001,Rural,Maharashtra,Crime Against Men,Extortion,Male,18-30,6456,4256,2200,5886,570
2009,Urban,Gujarat,Crime Against Men,Assault,Female,46-60,1472,1177,295,1232,240
2001,Urban,Tamil Nadu,Property Crime,Arson,Female,31-45,2076,1,2075,1594,482
2001,Urban,Tripura,Property Crime,Theft,Female,31-45,3893,2592,1301,3810,83
2003,Rural,Assam,Property Crime,Arson,Male,13-17,8136,4868,3268,7566,570
2003,Urban,Karnataka,Crime Against Men,Robbery,Female,31-45,6675,4868,1807,5361,1314
2010,Rural,Rajasthan,Other Crimes,Drug Offense,Female,60+,2718,357,2361,1350,1368
2002,Rural,Assam,Crime Against Children,Trafficking,Male,46-60,9793,2371,7422,8234,1559
2010,Urban,Meghalaya,Other Crimes,Cyber Crime,Male,18-30,9924,3839,6085,7614,2310
2006,Urban,West Bengal,Crime Against Children,Kidnapping,Female,60+,5025,2629,2396,3267,1758
2006,Urban,Arunachal Pradesh,Crime Against Women,Dowry Deaths,Female,13-17,2260,987,1273,1396,864
2002,Urban,Himachal Pradesh,Crime Against Women,Dowry Deaths,Male,60+,7365,3669,3696,4004,3361
2001,Rural,Odisha,Crime Against Men,Extortion,Female,60+,495,249,246,324,171
2010,Rural,Jammu & Kashmir,Other Crimes,Corruption,Female,18-30,4053,264,3789,1742,2311
2008,Rural,Mizoram,Crime Against Children,Trafficking,Female,13-17,6416,2157,4259,4405,2011
2009,Urban,Maharashtra,Crime Against Men,Robbery,Female,46-60,8959,1940,7019,2927,6032
2002,Rural,Goa,Crime Against Children,Child Abuse,Female,31-45,3010,703,2307,1482,1528
2008,Rural,Manipur,Crime Against Women,Domestic Violence,Female,0-12,5863,4239,1624,4438,1425
2009,Rural,Punjab,Other Crimes,Corruption,Female,60+,4582,2250,2332,3731,851
2010,Urban,Sikkim,Crime Against Women,Domestic Violence,Female,46-60,7432,5629,1803,6795,637
2002,Urban,Gujarat,Property Crime,Burglary,Female,18-30,9468,5622,3846,5805,3663
2002,Urban,Arunachal Pradesh,Crime Against Men,Assault,Female,0-12,770,310,460,332,438
2009,Urban,Punjab,Other Crimes,Cyber Crime,Male,46-60,9490,3156,6334,8464,1026
2001,Urban,Delhi,Property Crime,Burglary,Female,46-60,970,380,590,960,10
2007,Urban,Rajasthan,Other Crimes,Cyber Crime,Female,13-17,5276,175,5101,3831,1445
2003,Urban,Andhra Pradesh,Crime Against Women,Dowry Deaths,Male,31-45,507,494,13,498,9
2004,Rural,Haryana,Crime Against Men,Extortion,Female,31-45,3474,2378,1096,2825,649
2007,Rural,Punjab,Other Crimes,Drug Offense,Male,31-45,3158,2643,515,2905,253
2008,Rural,Chhattisgarh,Other Crimes,Cyber Crime,Male,60+,6297,5655,642,5770,527
2004,Rural,Madhya Pradesh,Crime Against Men,Extortion,Male,31-45,5428,2456,2972,5127,301
2002,Rural,Gujarat,Property Crime,Vandalism,Female,0-12,6922,3013,3909,3671,3251
2002,Rural,Delhi,Other Crimes,Corruption,Male,46-60,1321,250,1071,984,337
2009,Urban,Arunachal Pradesh,Property Crime,Theft,Male,18-30,576,209,367,373,203
2006,Urban,Sikkim,Crime Against Men,Extortion,Male,18-30,2999,1767,1232,2888,111
2003,Rural,Himachal Pradesh,Crime Against Men,Murder,Male,0-12,2131,1773,358,1808,323
2009,Urban,Telangana,Property Crime,Vandalism,Male,13-17,3392,729,2663,1015,2377
2010,Urban,Jharkhand,Crime Against Women,Dowry Deaths,Male,60+,1947,996,951,1395,552
2001,Urban,Goa,Crime Against Children,Trafficking,Female,13-17,9556,2033,7523,5075,4481
2002,Urban,Tripura,Crime Against Children,Child Labor,Female,0-12,2944,143,2801,904,2040
2007,Urban,Rajasthan,Property Crime,Theft,Female,46-60,7298,4,7294,5589,1709
2003,Rural,Uttarakhand,Crime Against Women,Domestic Violence,Male,18-30,9873,1548,8325,5237,4636
2008,Urban,Tamil Nadu,Crime Against Children,Kidnapping,Male,31-45,3398,3013,385,3221,177
2008,Rural,Gujarat,Other Crimes,Drug Offense,Male,31-45,5518,4864,654,5191,327
2004,Rural,Odisha,Crime Against Women,Rape,Female,13-17,8102,4426,3676,6200,1902
2006,Urban,Chhattisgarh,Other Crimes,Cyber Crime,Female,0-12,8358,7859,499,7893,465
2004,Rural,Manipur,Crime Against Women,Domestic Violence,Male,46-60,3404,1530,1874,1949,1455
2008,Rural,Manipur,Crime Against Children,Child Labor,Female,13-17,7108,978,6130,6434,674
2010,Urban,Gujarat,Crime Against Men,Robbery,Male,46-60,8187,6617,1570,6732,1455
2003,Urban,Madhya Pradesh,Property Crime,Vandalism,Female,18-30,7590,1557,6033,5060,2530
2004,Rural,Meghalaya,Crime Against Men,Assault,Female,13-17,2815,2222,593,2404,411
2005,Rural,Manipur,Property Crime,Arson,Male,60+,7931,7470,461,7613,318
2006,Urban,Karnataka,Other Crimes,Fraud,Male,13-17,9308,4932,4376,7562,1746
2008,Urban,Nagaland,Crime Against Men,Extortion,Male,46-60,8653,4675,3978,5898,2755
2003,Rural,Chhattisgarh,Other Crimes,Cyber Crime,Male,0-12,6658,1940,4718,6580,78
2003,Rural,Tripura,Other Crimes,Drug Offense,Female,46-60,5644,3198,2446,5633,11
2006,Rural,Gujarat,Property Crime,Vandalism,Female,13-17,9073,3574,5499,4285,4788
2006,Urban,Chhattisgarh,Crime Against Women,Molestation,Male,31-45,9072,5221,3851,6246,2826
2005,Urban,Goa,Crime Against Women,Dowry Deaths,Male,60+,1352,269,1083,1219,133
2004,Rural,Goa,Property Crime,Theft,Female,60+,4156,3323,833,3590,566
2002,Urban,West Bengal,Crime Against Children,Kidnapping,Female,46-60,7379,6700,679,7014,365
2001,Rural,Maharashtra,Property Crime,Theft,Female,13-17,9061,8620,441,8632,429
2004,Rural,Jharkhand,Property Crime,Burglary,Female,60+,8838,5082,3756,6623,2215
2004,Urban,Tamil Nadu,Property Crime,Arson,Male,0-12,5635,4988,647,5340,295
2002,Rural,Uttarakhand,Other Crimes,Corruption,Female,13-17,1351,890,461,1306,45
2010,Rural,Manipur,Property Crime,Theft,Female,18-30,8744,3910,4834,6112,2632
2010,Urban,Rajasthan,Crime Against Children,Child Abuse,Male,0-12,4385,873,3512,2434,1951
2001,Rural,Gujarat,Crime Against Women,Dowry Deaths,Male,60+,7031,3416,3615,6365,666
2006,Urban,Rajasthan,Other Crimes,Drug Offense,Female,46-60,776,585,191,681,95
2009,Rural,West Bengal,Crime Against Men,Robbery,Female,18-30,3135,1223,1912,2671,464
2010,Urban,Andhra Pradesh,Crime Against Men,Murder,Female,0-12,3315,2800,515,3039,276
2005,Rural,Manipur,Crime Against Women,Rape,Male,18-30,3460,780,2680,800,2660
2010,Urban,Goa,Crime Against Children,Trafficking,Female,13-17,3994,2009,1985,2913,1081
2009,Urban,Chhattisgarh,Crime Against Women,Rape,Male,31-45,2062,950,1112,1263,799
2003,Rural,Andhra Pradesh,Crime Against Men,Robbery,Male,46-60,3673,284,3389,2812,861
2001,Rural,Bihar,Other Crimes,Drug Offense,Male,0-12,983,88,895,976,7
2001,Urban,Telangana,Crime Against Men,Murder,Male,13-17,7267,2271,4996,5939,1328
2005,Urban,Assam,Crime Against Children,Kidnapping,Female,0-12,8349,6320,2029,6818,1531
2002,Urban,Jammu & Kashmir,Crime Against Men,Murder,Male,31-45,3672,1975,1697,2754,918
2002,Rural,Delhi,Crime Against Women,Dowry Deaths,Male,0-12,1770,1163,607,1283,487
2002,Rural,Tripura,Crime Against Women,Molestation,Male,18-30,2182,1592,590,1785,397
2001,Urban,Punjab,Other Crimes,Cyber Crime,Male,46-60,3933,1879,2054,2434,1499
2007,Rural,Chhattisgarh,Crime Against Children,Child Labor,Male,13-17,7472,3247,4225,4862,2610
2010,Rural,Nagaland,Crime Against Men,Extortion,Female,60+,2934,1040,1894,2312,622
2003,Urban,Assam,Property Crime,Theft,Male,18-30,3812,2874,938,3003,809
2002,Urban,Maharashtra,Property Crime,Arson,Female,31-45,5809,3179,2630,4712,1097
2001,Urban,Bihar,Crime Against Women,Molestation,Male,60+,3781,1212,2569,1832,1949
2002,Rural,Karnataka,Other Crimes,Corruption,Female,13-17,7994,1378,6616,7023,971
2008,Urban,Nagaland,Crime Against Men,Extortion,Female,60+,5315,2091,3224,4888,427
2003,Rural,Jammu & Kashmir,Crime Against Children,Kidnapping,Male,46-60,3192,683,2509,1993,1199
2006,Rural,Kerala,Crime Against Children,Kidnapping,Female,60+,3967,1347,2620,1539,2428
2006,Urban,Goa,Crime Against Men,Extortion,Female,18-30,8073,7948,125,7967,106
2010,Rural,Karnataka,Crime Against Women,Molestation,Female,13-17,3164,1960,1204,2135,1029
2010,Urban,Andhra Pradesh,Property Crime,Vandalism,Male,60+,300,209,91,228,72
2004,Urban,Delhi,Other Crimes,Drug Offense,Female,46-60,6084,2463,3621,5238,846
2006,Rural,Assam,Property Crime,Theft,Male,0-12,6401,3287,3114,3440,2961
2010,Urban,Mizoram,Crime Against Men,Murder,Male,46-60,8814,6449,2365,6565,2249
2008,Urban,Uttarakhand,Property Crime,Theft,Female,0-12,5351,5021,330,5133,218
2002,Urban,Jammu & Kashmir,Crime Against Men,Assault,Male,13-17,7423,3700,3723,6932,491
2006,Rural,Haryana,Property Crime,Theft,Male,18-30,9713,5475,4238,7183,2530
2009,Urban,Uttarakhand,Crime Against Children,Child Labor,Male,46-60,9812,5185,4627,7956,1856
2001,Rural,Madhya Pradesh,Other Crimes,Fraud,Female,13-17,3394,2965,429,3247,147
2007,Rural,Delhi,Crime Against Women,Rape,Female,46-60,1988,1581,407,1680,308
2002,Rural,Goa,Other Crimes,Fraud,Male,0-12,7104,4213,2891,6538,566
2008,Rural,Uttarakhand,Crime Against Women,Dowry Deaths,Male,0-12,9625,1005,8620,8209,1416
2003,Urban,Goa,Other Crimes,Drug Offense,Male,13-17,9705,5020,4685,5822,3883
2001,Rural,Rajasthan,Crime Against Women,Molestation,Female,31-45,1987,437,1550,1853,134
2002,Rural,Mizoram,Other Crimes,Drug Offense,Male,13-17,9708,2051,7657,4018,5690
2008,Urban,Haryana,Crime Against Children,Trafficking,Female,46-60,9109,3575,5534,5540,3569
2008,Rural,Jharkhand,Crime Against Men,Extortion,Male,60+,6474,4986,1488,5137,1337
2001,Rural,Himachal Pradesh,Crime Against Women,Dowry Deaths,Male,31-45,7207,3126,4081,3547,3660
2009,Urban,Arunachal Pradesh,Other Crimes,Fraud,Male,13-17,1674,552,1122,1056,618
2001,Urban,Maharashtra,Crime Against Children,Child Labor,Male,13-17,681,74,607,444,237
2002,Rural,Chhattisgarh,Other Crimes,Fraud,Female,60+,6661,4642,2019,6464,197
2001,Rural,Haryana,Other Crimes,Cyber Crime,Male,0-12,3868,809,3059,1024,2844
2002,Rural,Goa,Property Crime,Arson,Male,46-60,8646,5939,2707,7211,1435
2008,Rural,Arunachal Pradesh,Other Crimes,Corruption,Male,60+,6001,5563,438,5935,66
2003,Urban,Rajasthan,Property Crime,Vandalism,Male,13-17,800,157,643,765,35
2004,Rural,Tamil Nadu,Crime Against Men,Assault,Male,13-17,7519,5275,2244,7057,462
2004,Urban,Goa,Other Crimes,Cyber Crime,Female,13-17,3068,214,2854,2448,620
2007,Rural,Kerala,Other Crimes,Drug Offense,Male,0-12,2238,1200,1038,1363,875
2003,Urban,Mizoram,Property Crime,Arson,Male,0-12,4320,1975,2345,2325,1995
2004,Rural,Tripura,Crime Against Children,Kidnapping,Female,18-30,8776,6354,2422,8776,0
2002,Urban,Chhattisgarh,Crime Against Men,Extortion,Male,60+,300,251,49,269,31
2010,Rural,Meghalaya,Crime Against Women,Rape,Male,18-30,8339,2649,5690,4350,3989
2002,Rural,Tamil Nadu,Other Crimes,Fraud,Male,13-17,9394,7005,2389,8396,998
2010,Rural,Chhattisgarh,Property Crime,Vandalism,Female,18-30,5198,1452,3746,4732,466
2002,Urban,Himachal Pradesh,Crime Against Men,Robbery,Female,46-60,7218,1288,5930,6369,849
2005,Urban,Punjab,Crime Against Women,Molestation,Female,46-60,7468,6692,776,6899,569
2009,Rural,Rajasthan,Crime Against Men,Murder,Male,0-12,8714,7768,946,8505,209
2004,Urban,Assam,Other Crimes,Corruption,Male,18-30,3919,455,3464,1729,2190
2004,Urban,Uttarakhand,Other Crimes,Drug Offense,Female,13-17,2316,279,2037,1672,644
2005,Urban,Assam,Crime Against Women,Molestation,Male,46-60,7397,7127,270,7364,33
2003,Urban,Arunachal Pradesh,Crime Against Men,Murder,Male,46-60,9045,3098,5947,6996,2049
2002,Urban,Odisha,Property Crime,Arson,Male,18-30,9596,9158,438,9419,177
2001,Urban,Andhra Pradesh,Crime Against Men,Robbery,Male,60+,9131,6698,2433,8093,1038
2010,Rural,Andhra Pradesh,Crime Against Children,Child Labor,Female,46-60,2668,200,2468,207,2461
2006,Rural,Odisha,Property Crime,Vandalism,Male,18-30,1122,63,1059,1056,66
2009,Rural,Andhra Pradesh,Other Crimes,Fraud,Female,13-17,8384,5735,2649,5841,2543
2006,Urban,Mizoram,Crime Against Women,Molestation,Female,0-12,8459,893,7566,2126,6333
2002,Urban,Bihar,Crime Against Men,Extortion,Female,0-12,9905,74,9831,8706,1199
2004,Rural,Delhi,Other Crimes,Corruption,Female,60+,6468,4140,2328,6327,141
2002,Urban,Meghalaya,Crime Against Men,Assault,Male,13-17,5545,1026,4519,2567,2978
2001,Rural,Arunachal Pradesh,Crime Against Women,Rape,Female,46-60,363,73,290,253,110
2003,Rural,Jammu & Kashmir,Crime Against Children,Trafficking,Female,46-60,333,194,139,218,115
2008,Urban,Jharkhand,Property Crime,Theft,Female,0-12,3887,1167,2720,3758,129
2005,Rural,Assam,Property Crime,Vandalism,Female,18-30,8779,3882,4897,4972,3807
2005,Urban,Punjab,Property Crime,Arson,Male,46-60,1793,1504,289,1664,129
2008,Rural,Assam,Other Crimes,Corruption,Female,31-45,4048,3303,745,3554,494
2006,Rural,Mizoram,Crime Against Women,Rape,Male,31-45,9773,1226,8547,2412,7361
2003,Rural,Goa,Property Crime,Theft,Female,60+,5700,4620,1080,5184,516
2001,Rural,Karnataka,Property Crime,Arson,Female,31-45,8302,4250,4052,7374,928
2007,Rural,Bihar,Other Crimes,Cyber Crime,Male,0-12,3222,1461,1761,1528,1694
2003,Urban,Meghalaya,Crime Against Children,Kidnapping,Female,13-17,6334,1976,4358,5462,872
2009,Urban,Karnataka,Crime Against Men,Robbery,Female,0-12,8647,4789,3858,8618,29
2010,Rural,Mizoram,Crime Against Women,Molestation,Female,60+,1411,826,585,1345,66
2004,Urban,Himachal Pradesh,Crime Against Children,Trafficking,Male,18-30,6511,6121,390,6458,53
2008,Urban,Rajasthan,Other Crimes,Drug Offense,Male,13-17,62,1,61,45,17
2010,Urban,Odisha,Crime Against Children,Child Abuse,Male,13-17,7627,2139,5488,4046,3581
2002,Urban,Rajasthan,Crime Against Women,Dowry Deaths,Female,0-12,701,201,500,503,198
2001,Rural,Mizoram,Crime Against Men,Extortion,Male,0-12,6262,4410,1852,5809,453
2003,Rural,Rajasthan,Property Crime,Burglary,Male,13-17,9231,8914,317,8967,264
2006,Rural,Tripura,Crime Against Women,Dowry Deaths,Male,13-17,1214,518,696,679,535
2010,Rural,Jammu & Kashmir,Crime Against Children,Kidnapping,Female,18-30,8134,1727,6407,3503,4631
2001,Urban,Karnataka,Crime Against Women,Dowry Deaths,Female,60+,181,166,15,168,13
2003,Rural,Uttar Pradesh,Crime Against Women,Dowry Deaths,Female,13-17,7501,6869,632,6957,544
2001,Rural,Tamil Nadu,Crime Against Men,Assault,Male,46-60,3308,1264,2044,1940,1368
2007,Urban,Meghalaya,Crime Against Men,Extortion,Female,0-12,4023,708,3315,1765,2258
2004,Urban,Maharashtra,Crime Against Men,Murder,Male,46-60,4598,2405,2193,4054,544
2009,Rural,Goa,Property Crime,Arson,Male,18-30,1203,980,223,982,221
2007,Urban,Chhattisgarh,Crime Against Men,Robbery,Male,13-17,3160,1375,1785,1934,1226
2007,Rural,Uttar Pradesh,Other Crimes,Cyber Crime,Male,0-12,3994,1902,2092,2262,1732
2002,Urban,Gujarat,Other Crimes,Fraud,Male,46-60,8962,4089,4873,4110,4852
2008,Urban,Goa,Crime Against Men,Extortion,Male,60+,3176,1608,1568,1720,1456
2002,Rural,Chhattisgarh,Crime Against Women,Molestation,Male,18-30,4607,3745,862,4103,504
2008,Urban,Karnataka,Other Crimes,Corruption,Male,18-30,6458,2604,3854,5527,931
2004,Urban,Gujarat,Crime Against Men,Assault,Female,18-30,5392,4576,816,4616,776
2001,Urban,Odisha,Property Crime,Theft,Female,18-30,5454,444,5010,4026,1428
2005,Urban,Gujarat,Crime Against Men,Extortion,Male,18-30,3941,18,3923,3311,630
2008,Urban,Karnataka,Crime Against Women,Dowry Deaths,Female,18-30,6492,1370,5122,3439,3053
2005,Urban,Tripura,Crime Against Women,Rape,Female,13-17,8357,1131,7226,7465,892
2005,Urban,Maharashtra,Crime Against Women,Domestic Violence,Female,31-45,3253,2126,1127,3002,251
2006,Rural,Haryana,Crime Against Men,Extortion,Male,60+,8658,5486,3172,7168,1490
2004,Rural,Sikkim,Property Crime,Theft,Male,13-17,5035,1922,3113,2846,2189
2002,Urban,Telangana,Other Crimes,Cyber Crime,Female,13-17,1335,1287,48,1294,41
2006,Urban,Uttar Pradesh,Other Crimes,Corruption,Female,13-17,202,142,60,172,30
2005,Rural,Mizoram,Other Crimes,Corruption,Female,18-30,3889,2971,918,3380,509
2009,Urban,Tamil Nadu,Other Crimes,Corruption,Male,18-30,7043,6352,691,6832,211
2008,Rural,Rajasthan,Crime Against Men,Assault,Male,46-60,1590,1030,560,1537,53
2004,Rural,Himachal Pradesh,Other Crimes,Fraud,Female,46-60,7109,417,6692,2669,4440
2003,Urban,Manipur,Property Crime,Theft,Female,31-45,5262,4112,1150,4772,490
2001,Urban,Karnataka,Property Crime,Arson,Female,46-60,636,596,40,619,17
2005,Rural,Himachal Pradesh,Crime Against Men,Murder,Male,13-17,256,219,37,220,36
2007,Rural,Meghalaya,Crime Against Women,Domestic Violence,Male,60+,1814,1175,639,1617,197
2002,Rural,Tripura,Crime Against Women,Domestic Violence,Female,13-17,3371,1457,1914,1526,1845
2006,Urban,Bihar,Crime Against Men,Assault,Male,60+,5681,4624,1057,5213,468
2003,Rural,Punjab,Property Crime,Burglary,Male,60+,260,236,24,254,6
2010,Rural,Meghalaya,Crime Against Children,Child Labor,Female,18-30,4851,1156,3695,2489,2362
2007,Rural,Kerala,Crime Against Men,Extortion,Female,18-30,6629,3355,3274,3930,2699
2008,Urban,Kerala,Crime Against Women,Molestation,Male,18-30,7102,5792,1310,6317,785
2005,Urban,Manipur,Crime Against Women,Dowry Deaths,Male,60+,3454,1914,1540,2590,864
2004,Rural,Delhi,Property Crime,Vandalism,Male,31-45,1277,379,898,920,357
2004,Urban,Goa,Property Crime,Theft,Female,60+,3841,1079,2762,1244,2597
2001,Rural,Gujarat,Other Crimes,Corruption,Male,46-60,4487,1477,3010,3567,920
2010,Rural,Rajasthan,Crime Against Children,Child Abuse,Male,31-45,4538,114,4424,1403,3135
2001,Rural,Rajasthan,Crime Against Children,Trafficking,Female,0-12,332,172,160,278,54
2002,Rural,Maharashtra,Other Crimes,Cyber Crime,Female,13-17,7286,248,7038,4089,3197
2006,Rural,Arunachal Pradesh,Crime Against Men,Murder,Female,31-45,7032,135,6897,1332,5700
2003,Rural,Delhi,Crime Against Women,Molestation,Male,60+,6610,2962,3648,5668,942
2003,Rural,Himachal Pradesh,Property Crime,Arson,Male,31-45,6580,414,6166,1532,5048
2005,Urban,Delhi,Other Crimes,Drug Offense,Female,31-45,8514,357,8157,516,7998
2007,Rural,Tripura,Crime Against Children,Kidnapping,Male,18-30,8904,5836,3068,6859,2045
2008,Urban,Gujarat,Crime Against Women,Rape,Male,46-60,1391,971,420,1084,307
2006,Urban,Punjab,Crime Against Women,Dowry Deaths,Male,46-60,7111,4414,2697,6553,558
2008,Urban,Meghalaya,Crime Against Children,Kidnapping,Male,60+,5800,1543,4257,4018,1782
2001,Rural,Assam,Crime Against Men,Assault,Female,18-30,6278,4398,1880,5359,919
2004,Rural,Goa,Crime Against Women,Rape,Female,60+,6666,1743,4923,3847,2819
2001,Urban,Punjab,Other Crimes,Corruption,Male,46-60,930,622,308,752,178
2002,Rural,Rajasthan,Crime Against Children,Child Labor,Female,46-60,4895,1005,3890,3863,1032
2010,Rural,Jammu & Kashmir,Other Crimes,Cyber Crime,Female,13-17,203,191,12,200,3
2003,Rural,Punjab,Other Crimes,Fraud,Female,46-60,7571,7192,379,7520,51
2001,Rural,Maharashtra,Crime Against Women,Rape,Female,46-60,7145,3878,3267,4015,3130
2001,Urban,Manipur,Property Crime,Vandalism,Male,18-30,963,3,960,132,831
2006,Urban,Arunachal Pradesh,Crime Against Children,Trafficking,Male,46-60,6077,4774,1303,5422,655
2005,Rural,Manipur,Property Crime,Vandalism,Female,46-60,3327,2742,585,2929,398
2002,Urban,Arunachal Pradesh,Crime Against Women,Dowry Deaths,Female,60+,7616,2167,5449,4384,3232
2004,Urban,Uttar Pradesh,Property Crime,Theft,Male,13-17,7915,4435,3480,6140,1775
2004,Urban,Kerala,Other Crimes,Drug Offense,Female,31-45,7645,4805,2840,5683,1962
2005,Urban,Goa,Other Crimes,Corruption,Male,13-17,8243,2524,5719,7406,837
2003,Urban,Delhi,Crime Against Children,Trafficking,Female,18-30,2183,1479,704,1704,479
2006,Urban,Himachal Pradesh,Crime Against Men,Robbery,Male,46-60,2221,2008,213,2175,46
2004,Rural,Himachal Pradesh,Crime Against Children,Child Abuse,Male,13-17,9232,7779,1453,7967,1265
2002,Urban,Himachal Pradesh,Crime Against Women,Molestation,Male,31-45,7243,4449,2794,6207,1036
2009,Urban,Karnataka,Property Crime,Vandalism,Female,13-17,5147,2189,2958,4227,920
2003,Urban,Kerala,Crime Against Children,Child Labor,Female,46-60,1629,569,1060,1589,40
2002,Urban,Tripura,Property Crime,Theft,Female,13-17,3077,2884,193,3063,14
2010,Urban,Assam,Crime Against Men,Robbery,Female,13-17,3167,2317,850,2874,293
2004,Urban,Maharashtra,Crime Against Children,Child Labor,Female,0-12,8425,687,7738,3727,4698
2009,Urban,Odisha,Property Crime,Theft,Male,46-60,5448,1789,3659,3818,1630
2002,Rural,Sikkim,Crime Against Men,Murder,Male,31-45,7294,6287,1007,6434,860
2009,Urban,Delhi,Crime Against Men,Assault,Male,13-17,3068,1712,1356,1996,1072
2001,Rural,Uttarakhand,Crime Against Children,Kidnapping,Male,31-45,3296,2109,1187,2662,634
2006,Rural,Chhattisgarh,Crime Against Children,Kidnapping,Male,46-60,2290,784,1506,1644,646
2007,Rural,Arunachal Pradesh,Crime Against Children,Child Abuse,Female,46-60,4110,832,3278,3253,857
2008,Rural,Sikkim,Other Crimes,Fraud,Female,60+,3325,425,2900,1910,1415
2003,Rural,West Bengal,Crime Against Men,Assault,Female,31-45,1418,899,519,958,460
2007,Rural,Goa,Other Crimes,Cyber Crime,Female,60+,6702,5266,1436,6116,586
2009,Rural,Tamil Nadu,Crime Against Women,Molestation,Male,18-30,8835,1065,7770,8538,297
2004,Rural,Assam,Crime Against Women,Domestic Violence,Male,0-12,3833,1167,2666,1503,2330
2010,Rural,Andhra Pradesh,Crime Against Women,Molestation,Female,0-12,470,378,92,440,30
2002,Urban,Uttarakhand,Property Crime,Burglary,Female,60+,2724,607,2117,995,1729
2003,Rural,Tripura,Property Crime,Theft,Female,13-17,1590,185,1405,972,618
2001,Urban,Arunachal Pradesh,Property Crime,Arson,Female,18-30,7023,1987,5036,2808,4215
2010,Rural,Sikkim,Other Crimes,Fraud,Male,13-17,9549,6170,3379,6926,2623
2008,Urban,Uttar Pradesh,Property Crime,Theft,Female,46-60,8143,3023,5120,7664,479
2008,Rural,Himachal Pradesh,Property Crime,Vandalism,Male,60+,4534,2478,2056,3086,1448
2002,Urban,Uttar Pradesh,Property Crime,Burglary,Male,46-60,907,633,274,649,258
2001,Urban,Kerala,Crime Against Children,Child Abuse,Male,18-30,7571,1901,5670,5266,2305
2008,Rural,Sikkim,Other Crimes,Fraud,Male,0-12,8003,660,7343,2780,5223
2001,Rural,West Bengal,Crime Against Women,Molestation,Male,46-60,7114,1004,6110,4106,3008
2002,Rural,Kerala,Property Crime,Burglary,Male,13-17,9472,4058,5414,6734,2738
2007,Rural,Punjab,Crime Against Men,Robbery,Female,13-17,4972,3528,1444,3937,1035
2002,Urban,Chhattisgarh,Crime Against Children,Child Abuse,Male,31-45,6855,6621,234,6703,152
2004,Urban,Haryana,Crime Against Men,Robbery,Female,31-45,7782,7033,749,7605,177
2006,Urban,Bihar,Property Crime,Vandalism,Male,31-45,4493,2471,2022,3916,577
2004,Urban,Delhi,Crime Against Men,Extortion,Male,0-12,9249,4361,4888,6852,2397
2003,Rural,Bihar,Other Crimes,Drug Offense,Male,0-12,3354,1487,1867,1652,1702
2007,Rural,Chhattisgarh,Other Crimes,Fraud,Female,0-12,8592,1725,6867,2340,6252
2003,Rural,Jharkhand,Crime Against Children,Child Labor,Female,13-17,8911,922,7989,6711,2200
2005,Rural,Jharkhand,Crime Against Children,Child Abuse,Male,13-17,6411,640,5771,5965,446
2008,Rural,Gujarat,Other Crimes,Fraud,Male,31-45,9201,1989,7212,6283,2918
2010,Urban,Arunachal Pradesh,Crime Against Women,Domestic Violence,Female,0-12,1234,248,986,1195,39
2010,Urban,Mizoram,Crime Against Men,Extortion,Male,46-60,6942,2481,4461,4792,2150
2004,Urban,Kerala,Crime Against Children,Child Labor,Female,46-60,6924,2959,3965,5817,1107
2002,Urban,Meghalaya,Crime Against Women,Rape,Female,60+,5341,342,4999,1024,4317
2003,Rural,Gujarat,Crime Against Children,Child Labor,Female,13-17,6271,3727,2544,4321,1950
2008,Urban,Gujarat,Other Crimes,Cyber Crime,Male,13-17,82,29,53,58,24
2007,Urban,Kerala,Crime Against Children,Kidnapping,Female,31-45,7782,2428,5354,2769,5013
2005,Rural,Kerala,Crime Against Children,Trafficking,Female,46-60,4746,3752,994,4447,299
2004,Rural,Nagaland,Other Crimes,Cyber Crime,Female,46-60,6984,6255,729,6874,110
2010,Rural,Bihar,Other Crimes,Corruption,Female,0-12,4908,942,3966,3762,1146
2006,Rural,Jharkhand,Property Crime,Burglary,Male,46-60,1055,441,614,606,449
2007,Rural,Tripura,Other Crimes,Cyber Crime,Female,31-45,803,307,496,728,75
2001,Rural,Mizoram,Other Crimes,Cyber Crime,Male,13-17,4077,1539,2538,3024,1053
2009,Urban,Karnataka,Crime Against Children,Kidnapping,Male,46-60,2240,1407,833,2205,35
2004,Urban,Meghalaya,Other Crimes,Fraud,Male,0-12,8305,2202,6103,4125,4180
2003,Rural,Andhra Pradesh,Crime Against Women,Dowry Deaths,Male,46-60,8385,4945,3440,5903,2482
2005,Urban,Jharkhand,Other Crimes,Cyber Crime,Male,18-30,241,164,77,167,74
2009,Rural,Rajasthan,Other Crimes,Drug Offense,Male,31-45,4955,4222,733,4492,463
2009,Rural,Punjab,Crime Against Women,Dowry Deaths,Female,60+,2855,2356,499,2754,101
2010,Rural,Jammu & Kashmir,Property Crime,Theft,Female,60+,6721,3518,3203,5074,1647
2006,Rural,Tamil Nadu,Crime Against Men,Assault,Female,60+,427,233,194,337,90
2010,Rural,Maharashtra,Crime Against Men,Murder,Female,46-60,280,9,271,236,44
2001,Rural,Tamil Nadu,Crime Against Women,Dowry Deaths,Male,60+,4283,215,4068,3614,669
2004,Urban,Rajasthan,Property Crime,Burglary,Female,18-30,7036,5356,1680,5954,1082
2008,Urban,Goa,Other Crimes,Corruption,Female,46-60,6525,5631,894,5834,691
2003,Rural,Gujarat,Crime Against Women,Domestic Violence,Female,0-12,5047,2787,2260,3953,1094
2002,Urban,Odisha,Crime Against Women,Rape,Male,0-12,4289,607,3682,3138,1151
2002,Urban,Karnataka,Property Crime,Vandalism,Male,0-12,3358,2949,409,3307,51
2001,Rural,Meghalaya,Crime Against Men,Extortion,Male,60+,8204,2521,5683,3666,4538
2003,Urban,Assam,Crime Against Children,Child Abuse,Male,31-45,7527,3392,4135,3577,3950
2002,Rural,Tamil Nadu,Crime Against Men,Murder,Male,13-17,455,371,84,397,58
2009,Rural,Gujarat,Crime Against Children,Child Abuse,Female,46-60,5037,4557,480,4996,41
2006,Urban,Goa,Property Crime,Arson,Female,0-12,8540,3362,5178,5141,3399
2002,Urban,Madhya Pradesh,Crime Against Women,Molestation,Female,0-12,1597,1288,309,1325,272
2005,Urban,Chhattisgarh,Crime Against Men,Robbery,Female,18-30,3068,2856,212,3045,23
2010,Rural,Tamil Nadu,Crime Against Women,Domestic Violence,Male,31-45,5984,17,5967,3677,2307
2006,Urban,Bihar,Property Crime,Burglary,Male,60+,3785,1058,2727,3749,36
2004,Rural,Arunachal Pradesh,Crime Against Children,Trafficking,Female,0-12,981,64,917,924,57
2006,Rural,Jammu & Kashmir,Crime Against Men,Assault,Male,31-45,3924,1121,2803,3919,5
2005,Rural,Bihar,Property Crime,Vandalism,Male,46-60,7083,5828,1255,5961,1122
2006,Urban,Delhi,Crime Against Men,Assault,Male,0-12,8803,5254,3549,6176,2627
2008,Rural,Tripura,Crime Against Women,Dowry Deaths,Male,0-12,606,331,275,602,4
2008,Rural,Tripura,Crime Against Children,Trafficking,Female,18-30,1153,73,1080,272,881
2002,Rural,Himachal Pradesh,Crime Against Men,Assault,Male,0-12,3198,835,2363,1320,1878
2008,Urban,Maharashtra,Other Crimes,Fraud,Male,18-30,7499,3341,4158,6574,925
2002,Rural,Uttar Pradesh,Property Crime,Burglary,Female,13-17,3770,629,3141,3365,405
2001,Urban,Uttar Pradesh,Property Crime,Theft,Female,13-17,398,85,313,384,14
2002,Urban,Gujarat,Crime Against Children,Trafficking,Female,60+,5200,3006,2194,3782,1418
2008,Urban,Arunachal Pradesh,Crime Against Children,Child Abuse,Male,13-17,2171,705,1466,1044,1127
2004,Urban,Jammu & Kashmir,Crime Against Women,Dowry Deaths,Female,31-45,6844,3521,3323,3584,3260
2009,Rural,Punjab,Other Crimes,Fraud,Female,18-30,6744,5731,1013,6056,688
2002,Rural,Haryana,Property Crime,Burglary,Male,18-30,6099,3920,2179,5294,805
2006,Rural,Punjab,Other Crimes,Drug Offense,Female,31-45,9159,8863,296,9051,108
2006,Rural,Madhya Pradesh,Property Crime,Burglary,Female,18-30,3008,2069,939,2193,815
2007,Urban,Andhra Pradesh,Property Crime,Burglary,Male,46-60,8420,4755,3665,8344,76
2004,Urban,Gujarat,Crime Against Men,Robbery,Female,60+,7625,828,6797,3235,4390
2005,Rural,Uttar Pradesh,Other Crimes,Drug Offense,Female,13-17,233,4,229,202,31
2007,Rural,Tripura,Crime Against Children,Trafficking,Male,31-45,9924,4788,5136,6780,3144
2007,Urban,Tamil Nadu,Other Crimes,Corruption,Male,46-60,2428,1329,1099,1534,894
2010,Rural,Himachal Pradesh,Crime Against Children,Child Abuse,Female,18-30,3042,2429,613,2536,506
2002,Urban,Tripura,Other Crimes,Drug Offense,Male,46-60,4583,1674,2909,3366,1217
2006,Rural,Bihar,Crime Against Men,Murder,Male,60+,5047,2371,2676,3444,1603
2010,Urban,Mizoram,Property Crime,Theft,Male,13-17,311,80,231,240,71
2008,Rural,Uttarakhand,Crime Against Children,Child Labor,Male,46-60,4608,266,4342,3437,1171
2007,Rural,Punjab,Other Crimes,Fraud,Female,13-17,6128,1230,4898,5702,426
2007,Rural,Andhra Pradesh,Crime Against Men,Murder,Male,13-17,683,360,323,530,153
2008,Rural,Nagaland,Crime Against Women,Rape,Male,46-60,9666,7226,2440,9075,591
2002,Urban,Arunachal Pradesh,Crime Against Men,Assault,Female,13-17,5638,330,5308,3908,1730
2009,Urban,Delhi,Other Crimes,Fraud,Male,13-17,3886,470,3416,2178,1708
2003,Urban,Kerala,Property Crime,Arson,Female,0-12,3419,748,2671,2205,1214
2010,Rural,Bihar,Property Crime,Vandalism,Male,46-60,5399,2724,2675,4605,794
2005,Rural,Odisha,Crime Against Men,Murder,Female,46-60,1049,249,800,610,439
2004,Urban,West Bengal,Property Crime,Theft,Female,60+,5462,4000,1462,5096,366
2001,Rural,Meghalaya,Crime Against Men,Extortion,Male,0-12,7105,4197,2908,5952,1153
2009,Rural,Telangana,Property Crime,Arson,Female,18-30,3166,1436,1730,2850,316
2005,Urban,Bihar,Crime Against Children,Child Labor,Male,46-60,275,139,136,230,45
2006,Urban,Uttarakhand,Crime Against Women,Domestic Violence,Female,60+,1442,56,1386,403,1039
2009,Rural,Manipur,Crime Against Women,Domestic Violence,Male,18-30,6499,6031,468,6366,133
2006,Rural,Nagaland,Crime Against Men,Assault,Male,31-45,8536,1917,6619,4522,4014
2001,Urban,Himachal Pradesh,Crime Against Men,Extortion,Male,31-45,7729,1283,6446,1944,5785
2001,Urban,Sikkim,Other Crimes,Corruption,Male,0-12,9921,3499,6422,9179,742
2004,Urban,West Bengal,Crime Against Men,Murder,Male,60+,6026,2117,3909,2967,3059
2003,Urban,Uttar Pradesh,Property Crime,Arson,Male,18-30,2979,435,2544,2733,246
2005,Urban,Madhya Pradesh,Crime Against Women,Molestation,Female,46-60,75,29,46,59,16
2001,Rural,Kerala,Crime Against Men,Robbery,Male,46-60,3407,1222,2185,3366,41
2006,Urban,Assam,Crime Against Men,Robbery,Female,0-12,3461,1479,1982,1681,1780
2006,Rural,Madhya Pradesh,Other Crimes,Fraud,Female,31-45,3035,2380,655,2471,564
2010,Rural,Uttar Pradesh,Crime Against Children,Trafficking,Male,18-30,7644,682,6962,7226,418
2008,Urban,Bihar,Property Crime,Burglary,Male,60+,2796,369,2427,2665,131
2010,Rural,Karnataka,Property Crime,Arson,Male,46-60,2922,2318,604,2654,268
2010,Rural,Jammu & Kashmir,Crime Against Women,Rape,Male,0-12,4708,3161,1547,4378,330
2001,Urban,Gujarat,Other Crimes,Corruption,Female,18-30,6840,965,5875,1887,4953
2003,Rural,Haryana,Other Crimes,Drug Offense,Female,0-12,4529,2507,2022,3333,1196
2004,Rural,Karnataka,Crime Against Children,Child Abuse,Female,46-60,3742,468,3274,2156,1586
2002,Urban,Tamil Nadu,Crime Against Men,Murder,Male,60+,5759,5195,564,5758,1
2004,Urban,Maharashtra,Crime Against Women,Molestation,Female,13-17,8059,7470,589,7937,122
2002,Urban,Rajasthan,Other Crimes,Corruption,Female,46-60,9855,7258,2597,7272,2583
2005,Rural,Jharkhand,Crime Against Women,Molestation,Male,46-60,1873,1078,795,1789,84
2004,Urban,Tamil Nadu,Property Crime,Burglary,Female,60+,1406,628,778,1098,308
2003,Rural,Bihar,Crime Against Children,Trafficking,Female,46-60,9782,5208,4574,6514,3268
2002,Urban,Uttar Pradesh,Crime Against Men,Robbery,Male,31-45,8302,5624,2678,7323,979
2001,Urban,Karnataka,Crime Against Women,Dowry Deaths,Female,60+,9844,2394,7450,6334,3510
2005,Rural,Tripura,Crime Against Men,Robbery,Male,18-30,6465,51,6414,525,5940
2002,Rural,Tripura,Crime Against Women,Dowry Deaths,Male,31-45,2554,2268,286,2383,171
2007,Rural,Chhattisgarh,Crime Against Women,Dowry Deaths,Male,60+,1101,718,383,903,198
2006,Rural,Nagaland,Crime Against Children,Child Labor,Female,60+,2257,1961,296,2159,98
2007,Urban,Arunachal Pradesh,Other Crimes,Drug Offense,Female,31-45,4021,3281,740,3313,708
2007,Rural,Tamil Nadu,Property Crime,Theft,Male,31-45,9416,8213,1203,8659,757
2007,Rural,Uttarakhand,Crime Against Men,Robbery,Female,46-60,3549,1799,1750,3220,329
2002,Rural,Odisha,Property Crime,Arson,Female,13-17,8935,934,8001,6723,2212
2003,Rural,Uttar Pradesh,Crime Against Women,Rape,Female,31-45,6048,4952,1096,5182,866
2005,Urban,Manipur,Crime Against Children,Child Labor,Male,60+,9371,2237,7134,7019,2352
2002,Urban,Uttarakhand,Crime Against Men,Murder,Male,31-45,710,283,427,376,334
2005,Urban,Jammu & Kashmir,Crime Against Women,Domestic Violence,Male,0-12,1533,114,1419,1451,82
2006,Rural,Haryana,Other Crimes,Drug Offense,Male,13-17,4244,1872,2372,3160,1084
2001,Urban,West Bengal,Crime Against Men,Murder,Female,60+,5921,2510,3411,5313,608
2005,Rural,Andhra Pradesh,Crime Against Men,Robbery,Male,60+,7637,1775,5862,2679,4958
2003,Urban,Karnataka,Crime Against Children,Child Labor,Female,60+,3370,1293,2077,1457,1913
2002,Rural,Jammu & Kashmir,Crime Against Children,Kidnapping,Female,18-30,2925,192,2733,2668,257
2002,Urban,Nagaland,Property Crime,Burglary,Female,18-30,5637,406,5231,1089,4548
2010,Urban,Tamil Nadu,Property Crime,Burglary,Female,18-30,9191,8713,478,8773,418
2003,Rural,Meghalaya,Other Crimes,Cyber Crime,Female,46-60,5752,2214,3538,5342,410
2009,Rural,Manipur,Crime Against Men,Robbery,Female,46-60,5230,2771,2459,4126,1104
2002,Urban,Goa,Crime Against Children,Trafficking,Male,60+,2806,519,2287,1414,1392
2008,Urban,Maharashtra,Property Crime,Vandalism,Male,31-45,3073,2254,819,2456,617
2003,Rural,Assam,Crime Against Men,Robbery,Female,31-45,871,152,719,777,94
2001,Rural,Gujarat,Property Crime,Theft,Female,13-17,8541,2667,5874,6503,2038
2010,Urban,Kerala,Crime Against Children,Child Labor,Male,31-45,6638,2358,4280,6270,368
2001,Rural,Tripura,Crime Against Children,Trafficking,Female,18-30,1121,16,1105,443,678
2002,Rural,Chhattisgarh,Other Crimes,Corruption,Male,13-17,1527,1288,239,1479,48
2001,Rural,Madhya Pradesh,Crime Against Men,Extortion,Male,13-17,7857,1336,6521,3861,3996
2002,Rural,Assam,Property Crime,Arson,Female,18-30,4826,23,4803,4787,39
2001,Rural,Chhattisgarh,Crime Against Children,Child Abuse,Female,13-17,4487,458,4029,3813,674
2002,Urban,Gujarat,Crime Against Men,Extortion,Female,60+,2093,287,1806,1358,735
2006,Urban,Odisha,Crime Against Children,Child Labor,Male,18-30,997,812,185,903,94
2004,Urban,Jammu & Kashmir,Crime Against Children,Trafficking,Female,18-30,9377,3515,5862,4648,4729
2007,Rural,Odisha,Property Crime,Burglary,Female,46-60,2227,1939,288,2171,56
2003,Rural,Madhya Pradesh,Crime Against Women,Dowry Deaths,Male,31-45,199,0,199,25,174
2005,Rural,Arunachal Pradesh,Crime Against Women,Dowry Deaths,Male,0-12,7669,2676,4993,5452,2217
2007,Rural,Arunachal Pradesh,Crime Against Men,Murder,Female,46-60,9980,1660,8320,2763,7217
2003,Rural,Himachal Pradesh,Other Crimes,Fraud,Male,60+,2451,1327,1124,1730,721
2010,Urban,Telangana,Crime Against Women,Rape,Male,18-30,8243,3521,4722,5540,2703
2002,Rural,Jammu & Kashmir,Crime Against Children,Kidnapping,Male,13-17,2426,2351,75,2406,20
2006,Rural,Nagaland,Other Crimes,Corruption,Female,31-45,2351,659,1692,1023,1328
2002,Rural,Himachal Pradesh,Property Crime,Burglary,Female,18-30,4408,4134,274,4211,197
2008,Urban,Chhattisgarh,Other Crimes,Drug Offense,Female,46-60,1035,478,557,890,145
2008,Urban,Manipur,Other Crimes,Fraud,Male,0-12,2913,2631,282,2904,9
2010,Rural,Odisha,Other Crimes,Drug Offense,Male,31-45,7920,2312,5608,7117,803
2008,Rural,Mizoram,Other Crimes,Corruption,Female,13-17,1444,939,505,975,469
2005,Rural,Jammu & Kashmir,Crime Against Children,Trafficking,Male,13-17,5545,4256,1289,4863,682
2007,Urban,Jammu & Kashmir,Other Crimes,Drug Offense,Female,46-60,1153,560,593,903,250
2004,Urban,Arunachal Pradesh,Crime Against Children,Kidnapping,Female,13-17,1552,148,1404,1144,408
2006,Urban,Bihar,Crime Against Children,Kidnapping,Female,0-12,2782,365,2417,623,2159
2010,Rural,Mizoram,Crime Against Women,Rape,Female,18-30,303,271,32,272,31
2005,Rural,Uttarakhand,Other Crimes,Corruption,Female,18-30,8834,5738,3096,7483,1351
2009,Urban,Maharashtra,Crime Against Men,Assault,Female,13-17,3997,3548,449,3910,87
2007,Urban,Odisha,Crime Against Children,Child Labor,Female,60+,6863,5004,1859,5184,1679
2007,Rural,Andhra Pradesh,Crime Against Children,Trafficking,Female,0-12,4860,687,4173,4238,622
2007,Rural,Nagaland,Property Crime,Theft,Male,60+,9156,1858,7298,8550,606
2001,Rural,Andhra Pradesh,Crime Against Children,Child Abuse,Female,18-30,5892,2310,3582,5628,264
2008,Urban,Odisha,Crime Against Children,Kidnapping,Male,13-17,3198,585,2613,2725,473
2002,Urban,Sikkim,Crime Against Children,Trafficking,Male,46-60,7573,5811,1762,7027,546
2005,Urban,Assam,Crime Against Men,Robbery,Male,13-17,5964,4271,1693,4828,1136
2009,Rural,Mizoram,Crime Against Women,Rape,Male,0-12,9995,1592,8403,8783,1212
2003,Urban,Uttar Pradesh,Crime Against Women,Dowry Deaths,Female,0-12,2003,290,1713,429,1574
2003,Urban,Assam,Property Crime,Theft,Male,0-12,6003,2694,3309,5146,857
2010,Urban,Himachal Pradesh,Crime Against Children,Kidnapping,Female,18-30,4211,1658,2553,3369,842
2004,Urban,Odisha,Crime Against Women,Rape,Male,13-17,7029,1650,5379,6598,431
2009,Rural,Tripura,Crime Against Men,Extortion,Male,60+,3242,413,2829,1702,1540
2007,Rural,Mizoram,Crime Against Men,Robbery,Female,0-12,3027,472,2555,1411,1616
2003,Rural,Tripura,Property Crime,Theft,Male,60+,343,177,166,232,111
2004,Rural,Bihar,Other Crimes,Corruption,Female,60+,8177,66,8111,2422,5755
2008,Rural,Kerala,Other Crimes,Fraud,Male,18-30,3277,452,2825,1024,2253
2008,Urban,Rajasthan,Property Crime,Theft,Female,13-17,6365,331,6034,3875,2490
2004,Urban,Jammu & Kashmir,Crime Against Women,Domestic Violence,Male,60+,4960,277,4683,3319,1641
2008,Rural,Chhattisgarh,Crime Against Women,Dowry Deaths,Female,18-30,8326,4406,3920,7024,1302
2006,Rural,Jammu & Kashmir,Crime Against Children,Kidnapping,Male,46-60,4983,998,3985,1662,3321
2004,Urban,Maharashtra,Property Crime,Arson,Male,46-60,9693,1373,8320,6581,3112
2005,Rural,Kerala,Crime Against Men,Robbery,Female,18-30,2303,1866,437,1915,388
2003,Rural,Haryana,Crime Against Women,Molestation,Male,0-12,2196,2078,118,2154,42
2009,Rural,Jammu & Kashmir,Property Crime,Theft,Male,60+,6874,3443,3431,6387,487
2007,Urban,Uttarakhand,Crime Against Women,Molestation,Female,60+,3800,2876,924,3269,531
2010,Rural,Meghalaya,Crime Against Women,Dowry Deaths,Male,46-60,6968,5799,1169,6505,463
2009,Rural,Goa,Crime Against Children,Trafficking,Male,46-60,3167,561,2606,724,2443
2006,Rural,Sikkim,Other Crimes,Drug Offense,Female,46-60,5875,5741,134,5769,106
2006,Urban,West Bengal,Property Crime,Arson,Female,18-30,255,38,217,172,83
2001,Urban,Rajasthan,Crime Against Women,Rape,Female,13-17,9590,8539,1051,8668,922
2010,Rural,Kerala,Property Crime,Theft,Male,0-12,2062,514,1548,1675,387
2006,Urban,Uttar Pradesh,Crime Against Children,Kidnapping,Female,18-30,9249,6178,3071,7772,1477
2002,Urban,Tripura,Crime Against Children,Child Labor,Male,0-12,2864,226,2638,1210,1654
2006,Rural,Bihar,Crime Against Men,Murder,Female,13-17,8114,3490,4624,4696,3418
2009,Urban,Punjab,Property Crime,Vandalism,Male,60+,4099,1573,2526,3926,173
2003,Rural,Gujarat,Other Crimes,Cyber Crime,Female,18-30,4258,1343,2915,1686,2572
2004,Urban,Jharkhand,Crime Against Women,Domestic Violence,Female,13-17,4502,2047,2455,2056,2446
2007,Rural,Tripura,Property Crime,Vandalism,Male,60+,3048,1043,2005,1887,1161
2003,Rural,Jammu & Kashmir,Crime Against Men,Assault,Female,0-12,4916,1296,3620,4283,633
2002,Urban,Meghalaya,Crime Against Men,Assault,Female,0-12,9471,7958,1513,9355,116
2009,Rural,Mizoram,Other Crimes,Fraud,Male,18-30,5486,866,4620,2264,3222
2001,Urban,Kerala,Crime Against Children,Trafficking,Female,31-45,2296,779,1517,1138,1158
2009,Urban,Odisha,Other Crimes,Fraud,Male,60+,6143,5985,158,6070,73
2007,Urban,Rajasthan,Other Crimes,Fraud,Male,46-60,7603,6189,1414,6420,1183
2006,Urban,Himachal Pradesh,Crime Against Children,Trafficking,Female,60+,8550,2148,6402,3506,5044
2002,Rural,Mizoram,Property Crime,Burglary,Male,46-60,488,134,354,273,215
2004,Urban,Kerala,Other Crimes,Corruption,Male,18-30,267,137,130,158,109
2004,Rural,Tamil Nadu,Crime Against Children,Child Abuse,Male,31-45,7082,5296,1786,5795,1287
2010,Urban,Uttar Pradesh,Crime Against Men,Robbery,Male,0-12,1390,610,780,1294,96
2008,Urban,Nagaland,Crime Against Men,Murder,Female,0-12,5050,3482,1568,4385,665
2005,Rural,Gujarat,Crime Against Women,Rape,Female,13-17,4204,2061,2143,2097,2107
2003,Urban,Manipur,Crime Against Children,Trafficking,Male,0-12,6670,5797,873,6196,474
2003,Urban,Sikkim,Crime Against Women,Dowry Deaths,Male,13-17,1202,1096,106,1149,53
2008,Urban,Jharkhand,Crime Against Children,Trafficking,Female,46-60,7539,7122,417,7288,251
2009,Rural,Jammu & Kashmir,Crime Against Children,Child Labor,Male,18-30,6497,187,6310,4331,2166
2006,Urban,Rajasthan,Crime Against Women,Dowry Deaths,Male,31-45,4047,3897,150,3898,149
2002,Rural,Himachal Pradesh,Property Crime,Arson,Male,13-17,5971,1097,4874,2872,3099
2006,Urban,Jharkhand,Crime Against Men,Extortion,Male,60+,8454,1840,6614,7170,1284
2008,Urban,Odisha,Crime Against Men,Extortion,Male,0-12,2493,1265,1228,2028,465
2004,Rural,Goa,Crime Against Men,Murder,Female,13-17,3850,1220,2630,1418,2432
2002,Urban,Nagaland,Crime Against Children,Kidnapping,Male,46-60,7497,1104,6393,7196,301
2007,Rural,Arunachal Pradesh,Crime Against Women,Rape,Male,31-45,4039,2793,1246,3574,465
2005,Rural,Telangana,Crime Against Women,Rape,Male,60+,1686,462,1224,1295,391
2002,Rural,Jharkhand,Property Crime,Vandalism,Female,60+,7002,3145,3857,3554,3448
2005,Urban,Madhya Pradesh,Crime Against Men,Extortion,Female,18-30,5362,1761,3601,2075,3287
2001,Urban,Sikkim,Property Crime,Vandalism,Male,18-30,6680,4935,1745,6413,267
2002,Rural,Punjab,Other Crimes,Fraud,Female,60+,6232,4382,1850,5910,322
2004,Urban,Punjab,Crime Against Men,Robbery,Female,13-17,9712,7252,2460,7812,1900
2008,Urban,Goa,Crime Against Women,Molestation,Male,31-45,6302,1751,4551,4026,2276
2003,Urban,Jammu & Kashmir,Crime Against Children,Child Abuse,Female,31-45,8173,4141,4032,8135,38
2010,Urban,Meghalaya,Property Crime,Theft,Male,18-30,1608,173,1435,869,739
2010,Urban,West Bengal,Crime Against Women,Domestic Violence,Female,13-17,4514,2706,1808,3486,1028
2006,Rural,Maharashtra,Property Crime,Vandalism,Female,60+,3245,1048,2197,3201,44
2008,Urban,Andhra Pradesh,Property Crime,Vandalism,Female,13-17,1985,714,1271,1692,293
2006,Rural,West Bengal,Crime Against Men,Murder,Male,60+,1156,94,1062,620,536
2004,Rural,Meghalaya,Crime Against Men,Robbery,Female,18-30,2656,2217,439,2221,435
2002,Urban,Uttar Pradesh,Other Crimes,Corruption,Male,18-30,736,299,437,665,71
2004,Rural,Kerala,Other Crimes,Cyber Crime,Male,31-45,8506,637,7869,6427,2079
2008,Rural,Odisha,Crime Against Women,Molestation,Male,13-17,7936,6258,1678,7624,312
2009,Rural,Odisha,Property Crime,Burglary,Female,18-30,2398,2052,346,2120,278
2003,Urban,Punjab,Other Crimes,Drug Offense,Male,46-60,7225,332,6893,432,6793
2002,Rural,Jammu & Kashmir,Crime Against Women,Dowry Deaths,Male,60+,8754,804,7950,4845,3909
2001,Rural,Andhra Pradesh,Property Crime,Theft,Female,46-60,8627,3698,4929,6333,2294
2009,Urban,Punjab,Crime Against Men,Extortion,Male,0-12,1569,940,629,1145,424
2008,Rural,Meghalaya,Crime Against Men,Robbery,Female,13-17,2300,801,1499,1176,1124
2007,Urban,Uttar Pradesh,Other Crimes,Fraud,Male,31-45,7288,4595,2693,4695,2593
2006,Urban,Chhattisgarh,Crime Against Men,Murder,Female,31-45,2328,87,2241,586,1742
2005,Urban,Jharkhand,Crime Against Women,Domestic Violence,Male,0-12,8290,6366,1924,8010,280
2009,Urban,Telangana,Crime Against Children,Child Labor,Male,31-45,6012,3200,2812,5132,880
2003,Rural,West Bengal,Crime Against Women,Molestation,Female,46-60,5330,4743,587,4754,576
2007,Urban,Himachal Pradesh,Other Crimes,Fraud,Female,31-45,7011,496,6515,6137,874
2001,Urban,Uttarakhand,Crime Against Women,Dowry Deaths,Male,60+,5873,3572,2301,5180,693
2001,Rural,Assam,Property Crime,Arson,Female,31-45,3534,952,2582,3166,368
2006,Rural,Gujarat,Crime Against Men,Assault,Female,18-30,3123,3086,37,3114,9
2001,Urban,Nagaland,Crime Against Children,Child Labor,Female,18-30,9237,6419,2818,6631,2606
2002,Urban,Kerala,Crime Against Men,Assault,Female,13-17,2477,548,1929,1598,879
2008,Urban,Punjab,Other Crimes,Corruption,Female,0-12,6539,2904,3635,3566,2973
2008,Rural,Meghalaya,Other Crimes,Corruption,Female,13-17,2265,2012,253,2145,120
2008,Rural,Tamil Nadu,Crime Against Women,Molestation,Male,31-45,4226,1162,3064,2388,1838
2004,Rural,Odisha,Crime Against Women,Rape,Female,46-60,7471,5573,1898,5870,1601
2002,Rural,Karnataka,Property Crime,Vandalism,Male,31-45,2900,252,2648,842,2058
2001,Rural,Odisha,Crime Against Children,Child Abuse,Female,31-45,3241,658,2583,2530,711
2008,Urban,Delhi,Crime Against Men,Assault,Female,0-12,1045,649,396,730,315
2002,Urban,Arunachal Pradesh,Other Crimes,Cyber Crime,Female,13-17,1997,1297,700,1867,130
2004,Urban,Maharashtra,Crime Against Men,Murder,Male,60+,8629,4585,4044,6883,1746
2007,Urban,Jharkhand,Crime Against Men,Murder,Male,13-17,3458,2399,1059,3417,41
2007,Urban,Meghalaya,Property Crime,Arson,Female,18-30,1712,519,1193,1114,598
2002,Urban,Telangana,Property Crime,Theft,Male,13-17,473,403,70,445,28
2001,Urban,Karnataka,Property Crime,Burglary,Female,31-45,4063,1107,2956,1314,2749
2008,Rural,Arunachal Pradesh,Other Crimes,Drug Offense,Male,46-60,1264,1245,19,1249,15
2010,Rural,Goa,Crime Against Women,Dowry Deaths,Male,13-17,327,18,309,213,114
2010,Rural,Jammu & Kashmir,Crime Against Children,Kidnapping,Female,13-17,4982,2853,2129,3931,1051
2002,Urban,Tripura,Other Crimes,Fraud,Male,31-45,9319,5889,3430,8233,1086
2005,Urban,Jharkhand,Property Crime,Arson,Female,13-17,9902,4619,5283,7689,2213
2002,Urban,Gujarat,Other Crimes,Fraud,Female,46-60,4075,3208,867,3354,721
2003,Rural,Nagaland,Other Crimes,Corruption,Female,0-12,2445,192,2253,1037,1408
2006,Urban,Tamil Nadu,Crime Against Children,Child Abuse,Male,13-17,2169,1936,233,2105,64
2008,Rural,Sikkim,Other Crimes,Fraud,Male,46-60,227,171,56,219,8
2010,Rural,Goa,Property Crime,Burglary,Male,18-30,6052,2905,3147,5383,669
2001,Rural,Jammu & Kashmir,Crime Against Men,Robbery,Female,31-45,4804,4113,691,4200,604
2009,Rural,Telangana,Property Crime,Arson,Female,13-17,2161,892,1269,1489,672
2010,Rural,Madhya Pradesh,Crime Against Men,Extortion,Male,60+,4725,285,4440,3495,1230
2009,Urban,Jammu & Kashmir,Property Crime,Arson,Male,60+,1773,1335,438,1382,391
2008,Urban,Sikkim,Crime Against Children,Kidnapping,Male,18-30,1336,671,665,1128,208
2007,Urban,Andhra Pradesh,Property Crime,Burglary,Male,31-45,7084,3395,3689,3491,3593
2010,Rural,Telangana,Property Crime,Burglary,Female,0-12,9327,2845,6482,6980,2347
2010,Rural,Madhya Pradesh,Crime Against Women,Domestic Violence,Male,13-17,3351,2990,361,3101,250
2007,Urban,Bihar,Crime Against Men,Murder,Female,31-45,6105,3071,3034,4341,1764
2010,Urban,Telangana,Other Crimes,Fraud,Male,60+,8996,8437,559,8760,236
2006,Urban,West Bengal,Crime Against Men,Robbery,Female,13-17,5541,1814,3727,4664,877
2009,Urban,Tripura,Crime Against Women,Domestic Violence,Male,18-30,1482,1308,174,1415,67
2006,Rural,West Bengal,Property Crime,Theft,Male,60+,5810,300,5510,935,4875
2001,Urban,Karnataka,Other Crimes,Fraud,Female,0-12,1084,922,162,989,95
2006,Urban,Kerala,Property Crime,Vandalism,Male,60+,5102,3151,1951,4095,1007
2009,Urban,Arunachal Pradesh,Other Crimes,Drug Offense,Female,46-60,6203,4030,2173,4197,2006
2007,Urban,Uttar Pradesh,Crime Against Children,Child Abuse,Male,60+,6025,2620,3405,2902,3123
2003,Rural,Kerala,Other Crimes,Cyber Crime,Female,60+,8002,849,7153,3976,4026
2004,Urban,Goa,Crime Against Children,Trafficking,Female,13-17,9153,8321,832,8897,256
2003,Urban,Arunachal Pradesh,Crime Against Children,Trafficking,Male,18-30,3926,3621,305,3667,259
2004,Urban,Chhattisgarh,Property Crime,Vandalism,Male,46-60,1961,416,1545,1866,95
2008,Urban,Manipur,Other Crimes,Fraud,Male,46-60,7749,274,7475,6815,934
2001,Urban,Meghalaya,Crime Against Women,Molestation,Female,60+,165,66,99,102,63
2006,Urban,Haryana,Crime Against Men,Extortion,Female,46-60,3118,442,2676,772,2346
2008,Rural,Tripura,Property Crime,Theft,Female,46-60,1846,1251,595,1752,94
2006,Rural,Uttarakhand,Property Crime,Vandalism,Female,0-12,9904,9512,392,9883,21
2008,Urban,Goa,Crime Against Women,Domestic Violence,Male,0-12,6483,3868,2615,4548,1935
2010,Urban,Haryana,Property Crime,Burglary,Female,0-12,3709,1143,2566,1603,2106
2004,Urban,Jharkhand,Crime Against Men,Murder,Female,18-30,2108,12,2096,974,1134
2009,Urban,Nagaland,Crime Against Women,Domestic Violence,Male,0-12,9369,4979,4390,5253,4116
2001,Rural,Meghalaya,Crime Against Children,Kidnapping,Female,46-60,3601,632,2969,3001,600
2002,Urban,Manipur,Crime Against Children,Child Abuse,Female,18-30,1187,376,811,477,710
2007,Rural,Jharkhand,Other Crimes,Fraud,Female,13-17,8826,3620,5206,7016,1810
2007,Urban,Telangana,Property Crime,Theft,Male,13-17,4358,177,4181,4098,260
2002,Urban,Haryana,Crime Against Men,Robbery,Male,13-17,4856,4136,720,4776,80
2004,Urban,Meghalaya,Crime Against Children,Kidnapping,Female,31-45,2072,1507,565,1788,284
2003,Rural,Telangana,Crime Against Men,Robbery,Female,18-30,8851,4667,4184,8275,576
2005,Urban,Meghalaya,Property Crime,Arson,Female,60+,3410,2043,1367,2708,702
2008,Urban,Tamil Nadu,Crime Against Children,Kidnapping,Female,46-60,7380,4724,2656,5411,1969
2009,Rural,Tripura,Crime Against Women,Domestic Violence,Male,0-12,6220,3673,2547,5491,729
2007,Urban,Himachal Pradesh,Crime Against Women,Domestic Violence,Male,46-60,9250,5202,4048,9173,77
2002,Rural,Haryana,Property Crime,Burglary,Female,13-17,3408,765,2643,847,2561
2001,Rural,Goa,Property Crime,Vandalism,Male,60+,9903,7993,1910,8703,1200
2009,Urban,Chhattisgarh,Property Crime,Burglary,Male,0-12,6254,314,5940,6197,57
2008,Rural,Uttar Pradesh,Crime Against Men,Extortion,Male,60+,7756,7404,352,7481,275
2007,Rural,Andhra Pradesh,Crime Against Men,Extortion,Male,13-17,548,162,386,380,168
2001,Urban,Uttarakhand,Property Crime,Arson,Female,60+,9773,1405,8368,5998,3775
2010,Rural,Odisha,Crime Against Men,Robbery,Male,13-17,5092,4525,567,4639,453
2007,Urban,Karnataka,Crime Against Men,Assault,Male,0-12,5432,361,5071,5243,189
2006,Urban,Arunachal Pradesh,Crime Against Women,Rape,Female,18-30,3683,3496,187,3549,134
2009,Rural,Sikkim,Crime Against Men,Extortion,Male,60+,6040,3955,2085,5906,134
2004,Rural,Delhi,Crime Against Children,Trafficking,Female,13-17,6948,6373,575,6650,298
2002,Rural,Jammu & Kashmir,Other Crimes,Drug Offense,Male,60+,6168,4852,1316,5063,1105
2002,Rural,Madhya Pradesh,Property Crime,Theft,Female,31-45,9483,5857,3626,7346,2137
2003,Urban,Nagaland,Crime Against Men,Murder,Female,46-60,4325,1681,2644,3612,713
2007,Urban,Andhra Pradesh,Other Crimes,Corruption,Male,60+,5259,2686,2573,4847,412
2007,Rural,Sikkim,Crime Against Women,Rape,Female,0-12,833,99,734,821,12
2004,Rural,Punjab,Property Crime,Burglary,Male,18-30,6385,5149,1236,5256,1129
2004,Rural,Telangana,Crime Against Women,Dowry Deaths,Male,13-17,5231,5034,197,5055,176
2006,Rural,Maharashtra,Crime Against Women,Dowry Deaths,Male,46-60,9880,8006,1874,9473,407
2001,Urban,Uttar Pradesh,Other Crimes,Cyber Crime,Male,60+,3987,1821,2166,1908,2079
2001,Rural,Rajasthan,Crime Against Women,Domestic Violence,Female,46-60,7469,583,6886,4751,2718
2007,Urban,Sikkim,Crime Against Children,Child Abuse,Male,46-60,4191,256,3935,2904,1287
2007,Rural,Rajasthan,Crime Against Children,Trafficking,Male,60+,5852,2255,3597,3603,2249
2008,Urban,Delhi,Property Crime,Burglary,Female,13-17,9618,5970,3648,9488,130
2010,Urban,Mizoram,Crime Against Women,Dowry Deaths,Male,0-12,3514,2657,857,2666,848
2002,Urban,Arunachal Pradesh,Property Crime,Vandalism,Female,31-45,8377,303,8074,7600,777
2009,Urban,Meghalaya,Crime Against Children,Kidnapping,Female,60+,8436,6953,1483,7853,583
2005,Rural,Sikkim,Crime Against Women,Molestation,Female,46-60,4635,2632,2003,4399,236
2009,Urban,Uttar Pradesh,Crime Against Men,Robbery,Male,46-60,7080,3246,3834,6704,376
2010,Urban,Manipur,Crime Against Men,Extortion,Female,46-60,2609,1391,1218,2385,224
2005,Urban,Odisha,Crime Against Men,Extortion,Female,13-17,1528,1237,291,1321,207
2008,Urban,Chhattisgarh,Crime Against Women,Rape,Female,31-45,4673,2774,1899,3585,1088
2002,Urban,Jharkhand,Crime Against Children,Trafficking,Female,13-17,2649,1921,728,2390,259
2008,Rural,Nagaland,Crime Against Children,Child Labor,Female,31-45,3359,1594,1765,3056,303
2003,Urban,Delhi,Other Crimes,Cyber Crime,Female,18-30,7831,1537,6294,4609,3222
2002,Urban,Meghalaya,Crime Against Women,Rape,Male,13-17,8642,7829,813,8061,581
2007,Rural,Tamil Nadu,Crime Against Children,Child Abuse,Male,60+,4902,3597,1305,4607,295
2009,Rural,Manipur,Crime Against Children,Child Abuse,Male,18-30,1819,441,1378,704,1115
2009,Rural,Andhra Pradesh,Crime Against Children,Child Abuse,Male,0-12,158,110,48,156,2
2010,Urban,Rajasthan,Crime Against Children,Child Labor,Male,0-12,6976,6621,355,6678,298
2005,Rural,Delhi,Crime Against Women,Dowry Deaths,Male,31-45,8993,1809,7184,2183,6810
2007,Rural,Bihar,Crime Against Women,Rape,Male,60+,3238,1997,1241,2676,562
2006,Rural,Sikkim,Property Crime,Burglary,Male,0-12,3679,2053,1626,2078,1601
2001,Rural,Punjab,Crime Against Women,Dowry Deaths,Male,46-60,4825,621,4204,1861,2964
2002,Rural,Gujarat,Property Crime,Theft,Female,13-17,3695,2369,1326,2793,902
2003,Rural,Haryana,Crime Against Men,Murder,Male,13-17,9581,4522,5059,9454,127
2006,Urban,Telangana,Crime Against Children,Child Labor,Female,60+,1573,1133,440,1332,241
2009,Rural,Andhra Pradesh,Property Crime,Vandalism,Male,13-17,9902,8043,1859,8254,1648
2005,Urban,Sikkim,Property Crime,Theft,Female,46-60,5961,5852,109,5958,3
2001,Urban,Nagaland,Crime Against Women,Domestic Violence,Female,46-60,2032,482,1550,648,1384
2002,Rural,Goa,Crime Against Women,Domestic Violence,Female,46-60,6803,186,6617,6281,522
2004,Urban,Punjab,Crime Against Women,Molestation,Female,46-60,5734,5722,12,5723,11
2007,Urban,Maharashtra,Property Crime,Theft,Female,18-30,3901,2806,1095,3282,619
2003,Urban,Assam,Crime Against Men,Robbery,Female,13-17,8910,6595,2315,8373,537
2003,Urban,Assam,Crime Against Men,Assault,Male,60+,1916,668,1248,807,1109
2008,Urban,Meghalaya,Crime Against Women,Molestation,Male,0-12,4167,2472,1695,3679,488
2005,Urban,Delhi,Crime Against Men,Murder,Male,0-12,1970,1561,409,1934,36
2001,Urban,Bihar,Property Crime,Burglary,Female,18-30,8490,6873,1617,8024,466
2001,Urban,Meghalaya,Other Crimes,Cyber Crime,Male,31-45,1849,680,1169,1488,361
2010,Urban,Rajasthan,Other Crimes,Fraud,Male,31-45,7815,768,7047,2413,5402
2004,Rural,Haryana,Property Crime,Theft,Female,60+,2810,676,2134,2292,518
2008,Rural,Nagaland,Crime Against Men,Robbery,Female,60+,6134,4839,1295,5936,198
2009,Rural,Bihar,Crime Against Children,Child Labor,Female,60+,7570,632,6938,5872,1698
2001,Urban,Andhra Pradesh,Crime Against Men,Extortion,Male,46-60,8186,6927,1259,7962,224
2010,Rural,Uttarakhand,Other Crimes,Fraud,Male,18-30,5638,4849,789,5023,615
2007,Rural,Tamil Nadu,Crime Against Men,Murder,Male,13-17,2393,2117,276,2117,276
2007,Rural,Punjab,Crime Against Women,Molestation,Female,18-30,9012,6000,3012,6069,2943
2001,Urban,Odisha,Property Crime,Arson,Male,18-30,2831,2535,296,2786,45
2006,Rural,Sikkim,Crime Against Children,Child Abuse,Female,13-17,5217,4322,895,4926,291
2005,Rural,Arunachal Pradesh,Other Crimes,Fraud,Female,31-45,6265,6076,189,6254,11
2003,Rural,Telangana,Crime Against Children,Child Labor,Female,0-12,9673,8245,1428,9490,183
2009,Urban,Tripura,Crime Against Men,Murder,Male,13-17,6388,3283,3105,6262,126
2005,Rural,Maharashtra,Crime Against Men,Robbery,Female,31-45,4313,1169,3144,1764,2549
2003,Rural,West Bengal,Crime Against Men,Extortion,Female,31-45,6077,3515,2562,5231,846
2003,Urban,West Bengal,Other Crimes,Drug Offense,Male,13-17,4098,3217,881,3455,643
2002,Urban,Odisha,Property Crime,Arson,Female,60+,8662,8635,27,8640,22
2010,Urban,Kerala,Property Crime,Vandalism,Female,13-17,9966,6936,3030,7921,2045
2007,Rural,Meghalaya,Property Crime,Arson,Female,13-17,8803,6047,2756,7281,1522
2004,Urban,Madhya Pradesh,Crime Against Men,Extortion,Female,13-17,4980,1637,3343,4061,919
2004,Urban,Odisha,Property Crime,Theft,Male,13-17,2255,791,1464,1221,1034
2001,Urban,Mizoram,Crime Against Women,Molestation,Male,18-30,7208,3166,4042,5112,2096
2007,Urban,Jharkhand,Other Crimes,Drug Offense,Female,60+,7768,5064,2704,6598,1170
2008,Rural,Himachal Pradesh,Property Crime,Arson,Male,13-17,8938,7684,1254,8269,669
2004,Urban,Haryana,Crime Against Men,Murder,Female,46-60,117,24,93,111,6
2007,Urban,West Bengal,Crime Against Men,Assault,Male,18-30,5847,4353,1494,5476,371
2002,Urban,Telangana,Other Crimes,Corruption,Female,0-12,4114,2820,1294,3606,508
2003,Urban,Goa,Crime Against Women,Dowry Deaths,Female,18-30,5627,1632,3995,5297,330
2007,Rural,Manipur,Other Crimes,Cyber Crime,Female,31-45,8772,7958,814,8332,440
2002,Urban,Punjab,Property Crime,Arson,Male,18-30,6495,4879,1616,6097,398
2002,Urban,Uttar Pradesh,Crime Against Men,Assault,Female,60+,7005,4231,2774,6262,743
2002,Rural,Odisha,Other Crimes,Fraud,Female,31-45,9337,6035,3302,8944,393
2006,Urban,Karnataka,Crime Against Men,Extortion,Female,31-45,975,142,833,630,345
2003,Urban,Chhattisgarh,Crime Against Men,Robbery,Female,60+,3963,3016,947,3718,245
2007,Rural,Jharkhand,Crime Against Men,Assault,Female,0-12,9409,3288,6121,6632,2777
2007,Rural,West Bengal,Property Crime,Arson,Male,31-45,3592,1732,1860,2716,876
2006,Urban,Maharashtra,Crime Against Men,Assault,Male,18-30,6582,5380,1202,6445,137
2008,Rural,Bihar,Crime Against Men,Murder,Female,18-30,3091,2830,261,2870,221
2001,Urban,Bihar,Crime Against Men,Murder,Male,31-45,1330,44,1286,1198,132
2005,Rural,Delhi,Property Crime,Theft,Female,60+,2448,1859,589,2431,17
2006,Rural,Mizoram,Crime Against Women,Rape,Female,0-12,8559,3307,5252,3753,4806
2008,Rural,Manipur,Property Crime,Theft,Female,0-12,9559,6209,3350,6306,3253
2004,Rural,Mizoram,Crime Against Men,Assault,Male,0-12,7796,1891,5905,7001,795
2009,Rural,Meghalaya,Other Crimes,Corruption,Male,0-12,202,18,184,88,114
2007,Rural,Rajasthan,Other Crimes,Fraud,Female,0-12,9575,8163,1412,9124,451
2008,Urban,Delhi,Crime Against Men,Murder,Male,46-60,5368,1568,3800,5000,368
2010,Rural,Maharashtra,Property Crime,Theft,Male,0-12,3999,902,3097,2404,1595
2006,Urban,Madhya Pradesh,Property Crime,Arson,Male,0-12,1173,1027,146,1157,16
2004,Urban,Haryana,Crime Against Women,Molestation,Female,31-45,6597,4139,2458,4588,2009
2005,Rural,Andhra Pradesh,Property Crime,Vandalism,Female,18-30,5127,1686,3441,4891,236
2009,Rural,Kerala,Crime Against Women,Rape,Male,46-60,106,94,12,95,11
2004,Urban,Kerala,Property Crime,Theft,Male,46-60,5749,5526,223,5689,60
2006,Rural,Odisha,Crime Against Men,Assault,Female,18-30,1325,515,810,895,430
2005,Rural,Jammu & Kashmir,Other Crimes,Drug Offense,Female,46-60,1415,471,944,500,915
2004,Urban,Himachal Pradesh,Other Crimes,Drug Offense,Female,0-12,5718,5261,457,5471,247
2001,Rural,Tamil Nadu,Crime Against Men,Murder,Female,18-30,199,94,105,132,67
2003,Urban,Uttarakhand,Crime Against Men,Extortion,Female,18-30,2941,230,2711,1360,1581
2003,Urban,Tamil Nadu,Property Crime,Vandalism,Female,0-12,8562,2451,6111,5542,3020
2010,Rural,Delhi,Other Crimes,Drug Offense,Female,60+,2243,1466,777,2007,236
2001,Urban,Haryana,Other Crimes,Corruption,Male,60+,5703,2264,3439,4989,714
2008,Urban,Mizoram,Other Crimes,Corruption,Male,13-17,2698,2328,370,2557,141
2002,Urban,Goa,Crime Against Children,Kidnapping,Female,0-12,1671,1222,449,1364,307
2010,Rural,Kerala,Other Crimes,Cyber Crime,Male,13-17,898,157,741,407,491
2006,Urban,Odisha,Crime Against Women,Domestic Violence,Male,13-17,5067,2553,2514,4361,706
2009,Rural,Jharkhand,Crime Against Children,Trafficking,Female,13-17,7632,889,6743,2244,5388
2007,Rural,Haryana,Crime Against Children,Child Labor,Male,13-17,7622,4405,3217,5064,2558
2003,Urban,Meghalaya,Other Crimes,Drug Offense,Male,13-17,7336,3393,3943,5848,1488
2007,Urban,West Bengal,Crime Against Women,Dowry Deaths,Male,0-12,7358,2118,5240,2345,5013
2006,Urban,Maharashtra,Crime Against Children,Kidnapping,Female,0-12,6480,1358,5122,4672,1808
2010,Rural,Arunachal Pradesh,Crime Against Children,Trafficking,Female,31-45,3526,1190,2336,2211,1315
2010,Rural,Uttarakhand,Crime Against Women,Molestation,Male,18-30,8313,5612,2701,7462,851
2001,Rural,Uttar Pradesh,Other Crimes,Corruption,Female,18-30,7397,5595,1802,6302,1095
2007,Rural,Meghalaya,Property Crime,Arson,Male,60+,7045,716,6329,1739,5306
2007,Urban,Odisha,Property Crime,Theft,Female,60+,1262,378,884,740,522
2006,Urban,Nagaland,Other Crimes,Corruption,Female,0-12,4880,917,3963,4265,615
2007,Rural,Gujarat,Other Crimes,Drug Offense,Female,46-60,9700,2321,7379,4005,5695
2005,Urban,Jammu & Kashmir,Crime Against Women,Molestation,Female,18-30,7091,5622,1469,6670,421
2010,Urban,Chhattisgarh,Crime Against Women,Dowry Deaths,Female,31-45,7476,6434,1042,7401,75
2006,Rural,Madhya Pradesh,Property Crime,Theft,Female,18-30,4875,4169,706,4776,99
2008,Rural,Uttar Pradesh,Crime Against Women,Rape,Female,13-17,7783,3299,4484,5331,2452
2001,Urban,Rajasthan,Property Crime,Burglary,Female,0-12,2199,21,2178,1953,246
2004,Rural,Assam,Other Crimes,Corruption,Male,46-60,5514,5443,71,5481,33
2003,Rural,Jammu & Kashmir,Other Crimes,Corruption,Male,13-17,6973,1144,5829,3544,3429
2008,Urban,Mizoram,Property Crime,Burglary,Female,0-12,3318,3275,43,3298,20
2008,Urban,Odisha,Other Crimes,Cyber Crime,Female,60+,7808,6974,834,7283,525
2006,Urban,Odisha,Crime Against Women,Domestic Violence,Female,31-45,330,207,123,290,40
2006,Rural,Rajasthan,Property Crime,Theft,Male,46-60,9256,3367,5889,8281,975
2001,Urban,Jammu & Kashmir,Crime Against Women,Dowry Deaths,Female,18-30,8373,1249,7124,5270,3103
2010,Rural,Rajasthan,Crime Against Men,Robbery,Female,13-17,5581,4512,1069,5201,380
2002,Urban,West Bengal,Other Crimes,Cyber Crime,Female,13-17,977,956,21,977,0
2001,Urban,Bihar,Other Crimes,Drug Offense,Female,46-60,1610,324,1286,1315,295
2007,Urban,Tripura,Crime Against Children,Child Labor,Male,31-45,3852,626,3226,723,3129
2007,Urban,Tripura,Property Crime,Arson,Female,31-45,1884,11,1873,149,1735
2002,Urban,Haryana,Crime Against Women,Domestic Violence,Male,18-30,8417,1323,7094,4994,3423
2001,Urban,Haryana,Crime Against Women,Rape,Male,60+,6557,3805,2752,4405,2152
2009,Rural,Bihar,Crime Against Children,Trafficking,Female,18-30,57,48,9,54,3
2005,Rural,Karnataka,Property Crime,Burglary,Female,0-12,2673,1114,1559,1382,1291
2003,Urban,West Bengal,Property Crime,Theft,Male,46-60,7440,626,6814,1287,6153
2002,Urban,Arunachal Pradesh,Property Crime,Vandalism,Male,0-12,6961,1396,5565,6625,336
2008,Urban,Manipur,Crime Against Children,Child Abuse,Female,60+,9415,3025,6390,8706,709
2003,Urban,Sikkim,Property Crime,Theft,Male,46-60,1126,207,919,676,450
2005,Rural,Uttar Pradesh,Crime Against Women,Rape,Female,18-30,8998,1332,7666,6114,2884
2004,Urban,Chhattisgarh,Crime Against Women,Rape,Female,31-45,9234,8961,273,9131,103
2003,Rural,Himachal Pradesh,Crime Against Men,Robbery,Male,18-30,8143,5144,2999,5205,2938
2008,Rural,Tamil Nadu,Property Crime,Vandalism,Female,46-60,5272,1980,3292,2234,3038
2003,Urban,Punjab,Crime Against Women,Molestation,Female,60+,5542,4958,584,5323,219
2010,Rural,Rajasthan,Crime Against Men,Assault,Female,31-45,262,126,136,135,127
2003,Urban,Kerala,Crime Against Women,Dowry Deaths,Male,0-12,2801,1138,1663,1760,1041
2005,Urban,Mizoram,Crime Against Children,Child Labor,Female,60+,1627,948,679,1597,30
2008,Urban,Punjab,Crime Against Children,Trafficking,Male,18-30,9797,6857,2940,8696,1101
2010,Urban,West Bengal,Property Crime,Arson,Female,46-60,8905,3610,5295,8864,41
2003,Urban,Maharashtra,Property Crime,Burglary,Male,0-12,861,103,758,229,632
2007,Rural,Nagaland,Crime Against Women,Dowry Deaths,Male,0-12,6109,386,5723,5897,212
2010,Urban,Tamil Nadu,Crime Against Children,Child Abuse,Female,31-45,9718,340,9378,5327,4391
2002,Urban,Jharkhand,Property Crime,Burglary,Male,13-17,1638,87,1551,138,1500
2008,Urban,Tripura,Crime Against Women,Dowry Deaths,Female,0-12,5861,750,5111,1672,4189
2006,Urban,Rajasthan,Other Crimes,Drug Offense,Male,0-12,4771,938,3833,2371,2400
2006,Urban,Punjab,Crime Against Men,Robbery,Male,18-30,5208,3841,1367,4239,969
2007,Urban,Sikkim,Crime Against Women,Domestic Violence,Female,18-30,1926,806,1120,1759,167
2001,Rural,Goa,Crime Against Men,Robbery,Female,60+,5147,2882,2265,4750,397
2001,Urban,Haryana,Crime Against Children,Kidnapping,Male,13-17,1779,253,1526,739,1040
2008,Rural,Delhi,Crime Against Women,Rape,Male,0-12,4317,1562,2755,1776,2541
2002,Rural,Nagaland,Crime Against Women,Dowry Deaths,Female,60+,9208,2896,6312,4002,5206
2004,Urban,Kerala,Property Crime,Burglary,Female,60+,3405,642,2763,2400,1005
2009,Rural,Manipur,Property Crime,Arson,Female,60+,2116,816,1300,1778,338
2009,Rural,Meghalaya,Other Crimes,Corruption,Male,60+,90,70,20,89,1
2003,Urban,Manipur,Crime Against Children,Trafficking,Female,31-45,1324,178,1146,264,1060
2001,Rural,Assam,Crime Against Children,Trafficking,Female,18-30,1217,1011,206,1190,27
2003,Rural,Odisha,Other Crimes,Fraud,Male,31-45,5157,1136,4021,2599,2558
2001,Urban,West Bengal,Crime Against Women,Dowry Deaths,Female,13-17,4026,652,3374,2220,1806
2005,Urban,Chhattisgarh,Property Crime,Arson,Male,60+,7413,5882,1531,7397,16
2004,Rural,Madhya Pradesh,Crime Against Men,Murder,Male,60+,7528,5538,1990,5928,1600
2005,Urban,Telangana,Crime Against Women,Dowry Deaths,Male,13-17,654,24,630,516,138
2003,Rural,Goa,Crime Against Men,Assault,Female,46-60,3384,114,3270,3156,228
2010,Urban,Manipur,Crime Against Men,Murder,Female,0-12,5139,1997,3142,2327,2812
2005,Rural,Tamil Nadu,Crime Against Women,Dowry Deaths,Female,0-12,8353,4359,3994,7617,736
2010,Rural,Karnataka,Crime Against Women,Molestation,Female,13-17,6452,889,5563,3672,2780
2004,Urban,Gujarat,Property Crime,Burglary,Male,31-45,563,216,347,513,50
2008,Urban,Telangana,Property Crime,Vandalism,Female,60+,9228,146,9082,8604,624
2001,Rural,Andhra Pradesh,Property Crime,Theft,Male,60+,5270,5234,36,5267,3
2004,Urban,Chhattisgarh,Crime Against Children,Child Labor,Female,13-17,2943,1508,1435,2257,686
2004,Rural,Sikkim,Other Crimes,Drug Offense,Female,0-12,2372,1020,1352,2199,173
2006,Rural,Madhya Pradesh,Other Crimes,Corruption,Male,18-30,6162,2207,3955,6004,158
2004,Rural,Arunachal Pradesh,Other Crimes,Corruption,Female,13-17,7412,3701,3711,6245,1167
2007,Urban,Karnataka,Crime Against Women,Domestic Violence,Male,18-30,3412,1037,2375,1806,1606
2005,Rural,Jharkhand,Crime Against Children,Child Abuse,Male,18-30,3435,424,3011,720,2715
2006,Urban,Kerala,Property Crime,Arson,Male,31-45,5170,944,4226,2844,2326
2007,Rural,Telangana,Crime Against Men,Murder,Male,13-17,9051,7857,1194,8936,115
2001,Urban,Himachal Pradesh,Crime Against Women,Domestic Violence,Male,31-45,1124,563,561,1001,123
2006,Urban,Gujarat,Crime Against Women,Rape,Female,0-12,5916,2614,3302,2727,3189
2008,Rural,Rajasthan,Other Crimes,Fraud,Female,60+,1487,1034,453,1418,69
2008,Rural,Tamil Nadu,Crime Against Women,Molestation,Female,60+,2623,1847,776,2112,511
2010,Rural,Odisha,Crime Against Women,Domestic Violence,Female,31-45,634,172,462,437,197
2006,Urban,Jharkhand,Crime Against Children,Trafficking,Female,60+,2050,4,2046,1753,297
2002,Urban,Madhya Pradesh,Crime Against Children,Kidnapping,Male,31-45,3996,280,3716,3332,664
2003,Urban,Jammu & Kashmir,Other Crimes,Drug Offense,Male,46-60,4946,3978,968,4294,652
2004,Urban,Punjab,Property Crime,Burglary,Male,46-60,374,321,53,344,30
2002,Rural,Delhi,Property Crime,Burglary,Male,31-45,3127,20,3107,1182,1945
2004,Rural,Assam,Crime Against Men,Assault,Female,31-45,3904,277,3627,2005,1899
2007,Urban,Punjab,Crime Against Children,Child Labor,Male,0-12,3492,1133,2359,2516,976
2004,Urban,Himachal Pradesh,Crime Against Children,Child Abuse,Male,0-12,5714,2797,2917,4875,839
2002,Rural,Jammu & Kashmir,Crime Against Children,Child Labor,Female,31-45,9042,2893,6149,5379,3663
2004,Rural,Karnataka,Crime Against Women,Molestation,Female,31-45,3040,796,2244,2155,885
2006,Urban,Gujarat,Other Crimes,Drug Offense,Female,0-12,2282,414,1868,927,1355
2010,Urban,Manipur,Crime Against Children,Trafficking,Male,13-17,3962,1197,2765,1746,2216
2005,Rural,Jammu & Kashmir,Other Crimes,Cyber Crime,Female,18-30,6061,1726,4335,4158,1903
2004,Rural,Tamil Nadu,Crime Against Women,Domestic Violence,Female,60+,8865,7347,1518,8837,28
2002,Rural,Jammu & Kashmir,Crime Against Men,Extortion,Female,46-60,4654,3898,756,4168,486
2002,Urban,Punjab,Crime Against Men,Extortion,Male,46-60,2059,709,1350,1209,850
2001,Urban,Odisha,Crime Against Women,Domestic Violence,Female,31-45,3876,1024,2852,1928,1948
2010,Rural,Jammu & Kashmir,Crime Against Women,Molestation,Female,46-60,8924,1797,7127,2435,6489
2007,Urban,Mizoram,Crime Against Women,Molestation,Female,13-17,251,196,55,243,8
2002,Urban,Kerala,Crime Against Men,Extortion,Female,46-60,8561,7735,826,7948,613
2004,Rural,Tamil Nadu,Crime Against Women,Rape,Male,60+,9698,7440,2258,9524,174
2010,Rural,Goa,Crime Against Children,Child Abuse,Male,31-45,5414,1926,3488,4197,1217
2007,Rural,Uttar Pradesh,Crime Against Women,Dowry Deaths,Female,18-30,6201,231,5970,918,5283
2001,Rural,Chhattisgarh,Other Crimes,Cyber Crime,Female,46-60,2708,2040,668,2633,75
2005,Urban,Bihar,Crime Against Children,Trafficking,Male,0-12,1072,45,1027,656,416
2003,Urban,Maharashtra,Crime Against Women,Molestation,Female,31-45,8002,5316,2686,7649,353
2006,Rural,Chhattisgarh,Crime Against Women,Domestic Violence,Male,0-12,1004,180,824,914,90
2005,Rural,Maharashtra,Crime Against Men,Robbery,Male,18-30,3825,2931,894,3041,784
2006,Urban,Madhya Pradesh,Property Crime,Arson,Female,46-60,6900,4148,2752,6772,128
2002,Urban,Tripura,Crime Against Men,Assault,Male,18-30,5516,4550,966,4561,955
2003,Urban,Kerala,Crime Against Men,Extortion,Male,31-45,3438,1662,1776,3113,325
2005,Urban,Tamil Nadu,Crime Against Children,Kidnapping,Female,0-12,748,229,519,283,465
2007,Rural,Assam,Crime Against Men,Robbery,Male,46-60,3524,1939,1585,3261,263
2010,Urban,Jammu & Kashmir,Other Crimes,Drug Offense,Male,60+,5313,205,5108,1263,4050
2005,Rural,Nagaland,Property Crime,Burglary,Female,31-45,5289,3267,2022,4730,559
2006,Rural,West Bengal,Crime Against Children,Child Abuse,Female,31-45,1389,860,529,1038,351
2010,Rural,Gujarat,Crime Against Women,Dowry Deaths,Female,46-60,7402,4186,3216,4878,2524
2001,Rural,West Bengal,Crime Against Men,Assault,Male,13-17,3198,3152,46,3169,29
2005,Urban,Delhi,Other Crimes,Drug Offense,Female,60+,4758,1309,3449,1913,2845
2004,Urban,Telangana,Crime Against Women,Rape,Female,18-30,6959,2727,4232,4124,2835
2004,Urban,Tamil Nadu,Crime Against Women,Domestic Violence,Female,18-30,5313,340,4973,584,4729
2004,Urban,Punjab,Property Crime,Burglary,Male,46-60,197,119,78,174,23
2009,Rural,Arunachal Pradesh,Crime Against Women,Rape,Male,60+,9403,6437,2966,6863,2540
2001,Rural,Nagaland,Crime Against Men,Extortion,Male,18-30,5037,687,4350,2404,2633
2004,Rural,Uttar Pradesh,Other Crimes,Corruption,Male,31-45,5414,5062,352,5150,264
2010,Urban,Chhattisgarh,Other Crimes,Corruption,Male,46-60,3671,2138,1533,2266,1405
2009,Urban,Jharkhand,Other Crimes,Drug Offense,Female,18-30,2122,969,1153,1269,853
2007,Urban,Rajasthan,Crime Against Children,Child Abuse,Male,31-45,3667,2690,977,2813,854
2002,Urban,Uttarakhand,Other Crimes,Drug Offense,Female,0-12,4279,3898,381,4087,192
2003,Urban,Bihar,Other Crimes,Cyber Crime,Female,60+,4354,2037,2317,3264,1090
2005,Rural,Meghalaya,Other Crimes,Drug Offense,Female,60+,4751,4451,300,4601,150
2010,Rural,Arunachal Pradesh,Property Crime,Burglary,Female,0-12,458,90,368,449,9
2004,Rural,Gujarat,Property Crime,Burglary,Male,46-60,1244,705,539,730,514
2006,Urban,Telangana,Property Crime,Arson,Male,46-60,7639,5374,2265,5569,2070
2010,Urban,Uttar Pradesh,Crime Against Children,Kidnapping,Male,46-60,8523,6998,1525,7220,1303
2002,Urban,West Bengal,Crime Against Women,Molestation,Female,31-45,9473,1365,8108,6732,2741
2006,Rural,Punjab,Crime Against Women,Molestation,Male,31-45,418,79,339,283,135
2008,Rural,Jharkhand,Crime Against Children,Child Labor,Female,13-17,3888,3385,503,3857,31
2008,Urban,Nagaland,Crime Against Men,Robbery,Male,18-30,9263,8090,1173,8709,554
2002,Rural,Sikkim,Other Crimes,Drug Offense,Male,18-30,4816,4496,320,4805,11
2001,Urban,Delhi,Property Crime,Burglary,Female,0-12,6793,3197,3596,6610,183
2008,Rural,Nagaland,Crime Against Women,Molestation,Male,18-30,4876,4389,487,4467,409
2008,Urban,Manipur,Other Crimes,Corruption,Female,0-12,6086,5715,371,5939,147
2005,Urban,Kerala,Property Crime,Theft,Male,31-45,4802,251,4551,2638,2164
2001,Rural,Telangana,Property Crime,Theft,Male,31-45,5595,38,5557,1661,3934
2004,Urban,Gujarat,Crime Against Women,Rape,Male,46-60,1832,907,925,1124,708
2006,Rural,Haryana,Crime Against Men,Assault,Male,46-60,3928,2144,1784,3648,280
2009,Urban,Arunachal Pradesh,Other Crimes,Fraud,Male,60+,9235,1577,7658,5423,3812
2010,Rural,Odisha,Property Crime,Burglary,Female,18-30,9362,6076,3286,7005,2357
2003,Urban,Arunachal Pradesh,Other Crimes,Drug Offense,Female,13-17,3938,1254,2684,3156,782
2001,Rural,Kerala,Other Crimes,Cyber Crime,Female,13-17,5934,2980,2954,3327,2607
2005,Rural,Rajasthan,Crime Against Children,Kidnapping,Male,60+,621,4,617,286,335
2005,Urban,Arunachal Pradesh,Crime Against Women,Rape,Male,18-30,2187,1591,596,1778,409
2005,Rural,Haryana,Other Crimes,Drug Offense,Female,46-60,7690,5229,2461,7034,656
2005,Urban,Delhi,Crime Against Men,Assault,Female,31-45,9853,4180,5673,5881,3972
2007,Rural,Mizoram,Property Crime,Burglary,Male,13-17,3127,2158,969,2583,544
2002,Urban,Karnataka,Crime Against Children,Child Labor,Male,0-12,3730,2673,1057,3126,604
2007,Urban,Kerala,Crime Against Children,Child Labor,Male,31-45,596,448,148,456,140
2004,Rural,Madhya Pradesh,Other Crimes,Cyber Crime,Male,18-30,3933,2483,1450,3497,436
2005,Urban,Uttar Pradesh,Other Crimes,Corruption,Male,18-30,502,49,453,243,259
2009,Rural,Telangana,Crime Against Women,Rape,Female,31-45,65,8,57,39,26
2002,Rural,Goa,Other Crimes,Cyber Crime,Female,46-60,3963,1888,2075,2923,1040
2007,Rural,West Bengal,Crime Against Men,Robbery,Female,13-17,6597,6046,551,6063,534
2008,Rural,Bihar,Property Crime,Burglary,Female,18-30,1946,468,1478,772,1174
2006,Urban,Uttarakhand,Property Crime,Arson,Male,60+,2644,2628,16,2636,8
2007,Urban,Odisha,Other Crimes,Drug Offense,Male,60+,8022,5594,2428,5681,2341
2006,Rural,Telangana,Property Crime,Theft,Female,60+,1207,496,711,509,698
2008,Urban,Delhi,Property Crime,Theft,Female,60+,1919,915,1004,1514,405
2004,Rural,Assam,Property Crime,Theft,Male,18-30,5269,1455,3814,4672,597
2003,Urban,Himachal Pradesh,Other Crimes,Cyber Crime,Male,31-45,3772,2349,1423,3070,702
2009,Urban,Uttar Pradesh,Crime Against Men,Assault,Male,46-60,7333,118,7215,3655,3678
2001,Rural,Haryana,Crime Against Children,Trafficking,Female,46-60,9085,2830,6255,8707,378
2009,Urban,Kerala,Property Crime,Burglary,Female,46-60,8780,8026,754,8411,369
2009,Rural,Madhya Pradesh,Property Crime,Burglary,Male,18-30,4729,4311,418,4426,303
2002,Rural,Karnataka,Crime Against Women,Molestation,Female,0-12,2445,2324,121,2331,114
2006,Rural,Telangana,Other Crimes,Corruption,Male,18-30,7726,2706,5020,3775,3951
2010,Rural,Arunachal Pradesh,Crime Against Men,Extortion,Female,60+,4364,278,4086,4093,271
2005,Rural,Gujarat,Crime Against Children,Child Labor,Male,31-45,6329,2826,3503,5095,1234
2003,Urban,Himachal Pradesh,Crime Against Women,Dowry Deaths,Male,46-60,6821,1354,5467,3454,3367
2003,Rural,Odisha,Crime Against Men,Robbery,Female,60+,469,449,20,467,2
2003,Rural,Gujarat,Property Crime,Arson,Female,18-30,7818,2527,5291,6058,1760
2003,Urban,Kerala,Crime Against Women,Dowry Deaths,Male,60+,6817,3334,3483,3477,3340
2002,Rural,Goa,Property Crime,Vandalism,Female,18-30,7298,6254,1044,6722,576
2001,Urban,Maharashtra,Crime Against Women,Domestic Violence,Female,46-60,9264,8353,911,8375,889
2002,Urban,Arunachal Pradesh,Crime Against Children,Child Labor,Male,13-17,3626,78,3548,1846,1780
2009,Rural,Madhya Pradesh,Other Crimes,Fraud,Female,46-60,3779,606,3173,2180,1599
2003,Urban,Karnataka,Crime Against Men,Extortion,Male,18-30,3060,542,2518,1037,2023
2004,Rural,Uttarakhand,Other Crimes,Cyber Crime,Male,18-30,9880,4411,5469,8808,1072
2006,Urban,Chhattisgarh,Crime Against Children,Trafficking,Male,46-60,2482,2128,354,2456,26
2003,Urban,Tripura,Property Crime,Vandalism,Female,60+,6320,5331,989,6226,94
2003,Rural,Haryana,Crime Against Men,Murder,Male,46-60,1524,1369,155,1478,46
2001,Rural,Meghalaya,Crime Against Men,Assault,Female,60+,3133,636,2497,1154,1979
2002,Rural,Arunachal Pradesh,Other Crimes,Cyber Crime,Female,18-30,100,41,59,53,47
2007,Rural,Goa,Property Crime,Arson,Female,31-45,6365,4374,1991,5103,1262
2003,Urban,Gujarat,Crime Against Men,Extortion,Female,60+,6789,3841,2948,4042,2747
2001,Rural,Andhra Pradesh,Other Crimes,Drug Offense,Female,18-30,7002,5610,1392,6733,269
2002,Rural,West Bengal,Crime Against Children,Trafficking,Female,46-60,5584,1418,4166,1763,3821
2005,Urban,Goa,Crime Against Women,Dowry Deaths,Male,46-60,6561,914,5647,2786,3775
2008,Urban,Gujarat,Crime Against Men,Robbery,Female,18-30,2798,1545,1253,2005,793
2010,Urban,Meghalaya,Other Crimes,Fraud,Female,0-12,3519,179,3340,1972,1547
2008,Urban,Delhi,Other Crimes,Cyber Crime,Male,18-30,3445,20,3425,1386,2059
2010,Urban,Jharkhand,Crime Against Women,Domestic Violence,Male,60+,7500,7375,125,7397,103
2005,Rural,Kerala,Crime Against Men,Assault,Female,46-60,3346,520,2826,3287,59
2001,Rural,Haryana,Crime Against Men,Assault,Male,0-12,7027,575,6452,3505,3522
2006,Urban,Manipur,Other Crimes,Corruption,Male,46-60,950,870,80,887,63
2008,Rural,Goa,Property Crime,Vandalism,Female,60+,3148,2910,238,3064,84
2007,Urban,Mizoram,Other Crimes,Drug Offense,Female,46-60,4734,4613,121,4643,91
2005,Urban,Tripura,Property Crime,Burglary,Male,0-12,7012,6661,351,6688,324
2001,Rural,Uttar Pradesh,Crime Against Women,Domestic Violence,Female,0-12,6784,4011,2773,6418,366
2006,Urban,Himachal Pradesh,Crime Against Children,Trafficking,Female,31-45,1893,309,1584,407,1486
2002,Urban,Assam,Property Crime,Theft,Male,13-17,4224,1070,3154,2711,1513
2007,Rural,Punjab,Property Crime,Burglary,Male,13-17,9094,3463,5631,4168,4926
2006,Rural,Manipur,Property Crime,Theft,Male,0-12,7819,6666,1153,6784,1035
2009,Urban,Assam,Other Crimes,Drug Offense,Female,0-12,4742,1923,2819,2192,2550
2001,Rural,Delhi,Property Crime,Burglary,Male,0-12,9218,1799,7419,8061,1157
2010,Urban,Haryana,Other Crimes,Cyber Crime,Female,60+,3838,1409,2429,3179,659
2003,Urban,Delhi,Crime Against Women,Dowry Deaths,Male,18-30,4963,3321,1642,4421,542
2009,Rural,Meghalaya,Property Crime,Theft,Female,60+,9415,2662,6753,6094,3321
2007,Rural,Meghalaya,Property Crime,Arson,Male,13-17,4482,843,3639,3578,904
2008,Rural,Delhi,Crime Against Women,Molestation,Female,13-17,7717,378,7339,2942,4775
2006,Urban,Chhattisgarh,Other Crimes,Corruption,Female,31-45,265,181,84,243,22
2002,Urban,Uttarakhand,Other Crimes,Fraud,Female,60+,6124,764,5360,6003,121
2005,Rural,Nagaland,Crime Against Children,Child Abuse,Male,13-17,9112,4569,4543,4637,4475
2007,Rural,Maharashtra,Crime Against Children,Trafficking,Male,60+,7903,1739,6164,2107,5796
2009,Urban,Odisha,Crime Against Women,Dowry Deaths,Male,18-30,5550,1448,4102,3328,2222
2006,Urban,Sikkim,Other Crimes,Corruption,Male,46-60,8441,2093,6348,5920,2521
2009,Rural,Punjab,Crime Against Children,Child Abuse,Male,13-17,6998,2423,4575,2451,4547
2008,Rural,Goa,Property Crime,Arson,Male,18-30,4749,495,4254,3553,1196
2007,Rural,Gujarat,Crime Against Men,Extortion,Male,0-12,6608,1656,4952,2758,3850
2008,Rural,Mizoram,Property Crime,Burglary,Male,60+,2180,1271,909,1374,806
2007,Rural,Telangana,Crime Against Women,Molestation,Female,60+,7448,3248,4200,7162,286
2003,Urban,Kerala,Crime Against Women,Molestation,Female,46-60,8470,3307,5163,5756,2714
2002,Urban,Haryana,Crime Against Children,Child Abuse,Female,46-60,9563,2963,6600,5025,4538
2002,Urban,Manipur,Property Crime,Vandalism,Female,18-30,1953,764,1189,904,1049
2001,Urban,Arunachal Pradesh,Property Crime,Arson,Female,0-12,8847,6167,2680,7063,1784
2005,Urban,Sikkim,Crime Against Women,Domestic Violence,Female,13-17,5389,1659,3730,3213,2176
2007,Rural,Uttar Pradesh,Property Crime,Arson,Female,31-45,8867,7360,1507,8061,806
2002,Urban,Andhra Pradesh,Property Crime,Arson,Female,31-45,3962,2684,1278,3104,858
2007,Rural,Tamil Nadu,Crime Against Men,Extortion,Female,18-30,8624,3553,5071,4649,3975
2005,Rural,Arunachal Pradesh,Crime Against Men,Extortion,Female,18-30,7443,2534,4909,5547,1896
2007,Urban,Uttarakhand,Crime Against Men,Assault,Male,13-17,2247,820,1427,1957,290
2007,Rural,Sikkim,Crime Against Women,Dowry Deaths,Male,13-17,2238,922,1316,1540,698
2008,Urban,Delhi,Crime Against Children,Kidnapping,Female,60+,1013,298,715,409,604
2002,Rural,Jammu & Kashmir,Crime Against Men,Murder,Female,18-30,3729,3152,577,3199,530
2001,Urban,Haryana,Property Crime,Vandalism,Male,31-45,4060,1351,2709,1943,2117
2008,Rural,Tripura,Crime Against Women,Rape,Male,46-60,187,42,145,79,108
2006,Urban,Kerala,Crime Against Children,Child Labor,Male,18-30,5753,536,5217,4679,1074
2002,Rural,Goa,Property Crime,Vandalism,Male,13-17,1240,1232,8,1232,8
2010,Urban,Himachal Pradesh,Crime Against Children,Kidnapping,Male,13-17,8093,3377,4716,4202,3891
2003,Urban,Tamil Nadu,Crime Against Children,Kidnapping,Male,0-12,386,105,281,322,64
2008,Urban,Rajasthan,Crime Against Children,Child Abuse,Female,60+,9736,9015,721,9109,627
2006,Urban,Kerala,Crime Against Children,Kidnapping,Female,60+,4081,371,3710,483,3598
2010,Urban,Tripura,Crime Against Men,Robbery,Female,18-30,2713,1210,1503,2473,240
2006,Rural,Goa,Crime Against Children,Trafficking,Female,18-30,2459,2300,159,2340,119
2002,Urban,Manipur,Crime Against Men,Robbery,Male,46-60,4153,3474,679,3772,381
2004,Urban,Gujarat,Crime Against Men,Murder,Male,31-45,1083,431,652,539,544
2003,Rural,Assam,Crime Against Children,Trafficking,Male,60+,5203,4388,815,5193,10
2004,Urban,Madhya Pradesh,Crime Against Children,Kidnapping,Male,18-30,9422,7412,2010,8933,489
2001,Rural,Tamil Nadu,Property Crime,Burglary,Male,46-60,6109,4577,1532,5715,394
2005,Urban,Chhattisgarh,Crime Against Men,Assault,Female,18-30,9234,5394,3840,6041,3193
2006,Urban,Andhra Pradesh,Other Crimes,Drug Offense,Female,31-45,7469,4310,3159,5180,2289
2006,Urban,Chhattisgarh,Property Crime,Arson,Male,46-60,407,9,398,241,166
2003,Rural,Delhi,Crime Against Men,Robbery,Male,31-45,371,297,74,358,13
2005,Urban,Mizoram,Other Crimes,Cyber Crime,Female,0-12,287,187,100,277,10
2005,Rural,Telangana,Property Crime,Vandalism,Female,0-12,7534,7467,67,7477,57
2008,Urban,Uttarakhand,Crime Against Children,Kidnapping,Male,18-30,4429,498,3931,2571,1858
2003,Rural,Mizoram,Crime Against Women,Rape,Male,60+,3498,3067,431,3156,342
2010,Urban,Rajasthan,Crime Against Women,Dowry Deaths,Female,60+,6521,2147,4374,4033,2488
2010,Urban,Mizoram,Other Crimes,Corruption,Male,46-60,712,110,602,132,580
2004,Urban,Bihar,Crime Against Women,Molestation,Female,46-60,2445,1553,892,1580,865
2010,Rural,Manipur,Crime Against Women,Dowry Deaths,Male,60+,9277,1643,7634,2940,6337
2009,Rural,Meghalaya,Crime Against Men,Murder,Male,13-17,7314,5995,1319,6236,1078
2006,Rural,Uttarakhand,Property Crime,Arson,Female,46-60,3230,1137,2093,1490,1740
2001,Urban,Sikkim,Crime Against Children,Trafficking,Male,0-12,3011,1646,1365,2704,307
2007,Rural,Jammu & Kashmir,Crime Against Children,Kidnapping,Male,60+,85,79,6,82,3
2005,Rural,Arunachal Pradesh,Crime Against Women,Molestation,Male,0-12,2663,17,2646,1072,1591
2006,Rural,Bihar,Crime Against Children,Kidnapping,Male,13-17,9783,4268,5515,5513,4270
2001,Rural,Arunachal Pradesh,Crime Against Women,Molestation,Female,18-30,9141,6718,2423,8420,721
2009,Rural,Rajasthan,Crime Against Men,Murder,Female,13-17,1337,25,1312,1050,287
2008,Rural,Odisha,Property Crime,Vandalism,Female,46-60,5146,4655,491,4952,194
2002,Urban,Assam,Other Crimes,Fraud,Male,18-30,4013,1172,2841,3094,919
2002,Urban,Arunachal Pradesh,Crime Against Women,Dowry Deaths,Female,31-45,4953,3371,1582,4813,140
2005,Urban,Arunachal Pradesh,Crime Against Women,Dowry Deaths,Female,0-12,6808,2648,4160,6250,558
2006,Rural,Tamil Nadu,Property Crime,Theft,Female,60+,581,36,545,64,517
2003,Rural,Telangana,Crime Against Men,Assault,Male,31-45,8427,6857,1570,7175,1252
2009,Urban,Haryana,Property Crime,Theft,Female,18-30,9057,8119,938,8717,340
2004,Rural,Bihar,Crime Against Men,Murder,Male,13-17,6044,3709,2335,5802,242
2007,Rural,Manipur,Crime Against Women,Domestic Violence,Female,18-30,8488,2917,5571,6325,2163
2008,Urban,Sikkim,Other Crimes,Corruption,Male,46-60,9897,7364,2533,9326,571
2001,Rural,Kerala,Crime Against Children,Child Abuse,Male,60+,4751,1850,2901,3109,1642
2005,Urban,Sikkim,Property Crime,Burglary,Male,13-17,8914,8284,630,8890,24
2009,Urban,Bihar,Crime Against Men,Assault,Male,31-45,3333,257,3076,1353,1980
2002,Rural,Tripura,Crime Against Women,Domestic Violence,Female,0-12,5430,2333,3097,4605,825
2006,Urban,West Bengal,Crime Against Men,Assault,Female,0-12,5235,3290,1945,4661,574
2007,Urban,Madhya Pradesh,Crime Against Women,Domestic Violence,Female,18-30,6203,5210,993,5685,518
2010,Urban,Haryana,Other Crimes,Corruption,Male,46-60,4652,2184,2468,3254,1398
2001,Urban,Gujarat,Property Crime,Burglary,Male,31-45,9249,3003,6246,8966,283
2005,Rural,Nagaland,Crime Against Men,Robbery,Female,13-17,9540,713,8827,6142,3398
2006,Rural,Andhra Pradesh,Crime Against Women,Domestic Violence,Female,31-45,1113,238,875,1024,89
2010,Urban,Tripura,Property Crime,Vandalism,Female,18-30,3715,3592,123,3626,89
2008,Urban,Himachal Pradesh,Crime Against Women,Rape,Male,46-60,2066,123,1943,915,1151
2007,Urban,Jharkhand,Crime Against Women,Domestic Violence,Female,31-45,1954,729,1225,1054,900
2004,Rural,West Bengal,Crime Against Children,Trafficking,Female,60+,4037,71,3966,3500,537
2001,Rural,Bihar,Crime Against Women,Molestation,Female,0-12,4861,1533,3328,3685,1176
2006,Urban,Punjab,Crime Against Women,Domestic Violence,Male,46-60,1860,1529,331,1806,54
2004,Urban,Tripura,Other Crimes,Fraud,Female,31-45,6594,2666,3928,3800,2794
2004,Urban,Tamil Nadu,Crime Against Children,Trafficking,Male,31-45,930,131,799,658,272
2006,Rural,Meghalaya,Crime Against Children,Kidnapping,Male,13-17,7314,1425,5889,4122,3192
2006,Rural,Odisha,Other Crimes,Corruption,Male,60+,589,165,424,384,205
2003,Urban,Manipur,Crime Against Women,Molestation,Male,0-12,5042,1049,3993,3464,1578
2003,Rural,West Bengal,Other Crimes,Corruption,Female,46-60,4906,4209,697,4692,214
2004,Urban,Haryana,Crime Against Men,Extortion,Male,0-12,6608,621,5987,5435,1173
2004,Urban,Manipur,Crime Against Women,Molestation,Male,18-30,933,656,277,751,182
2001,Rural,Jammu & Kashmir,Crime Against Men,Assault,Male,13-17,8535,6974,1561,7355,1180
2005,Rural,Himachal Pradesh,Crime Against Children,Trafficking,Male,18-30,5534,1387,4147,4197,1337
2006,Rural,Himachal Pradesh,Other Crimes,Fraud,Female,13-17,4247,903,3344,4067,180
2006,Rural,Chhattisgarh,Other Crimes,Corruption,Female,46-60,679,565,114,583,96
2004,Urban,West Bengal,Crime Against Men,Assault,Female,46-60,199,54,145,170,29
2010,Rural,Bihar,Crime Against Children,Kidnapping,Female,13-17,8096,1422,6674,6258,1838
2010,Rural,Telangana,Other Crimes,Fraud,Female,31-45,7473,3451,4022,7346,127
2010,Urban,Tripura,Crime Against Women,Molestation,Male,46-60,4104,940,3164,1850,2254
2008,Rural,Odisha,Crime Against Women,Molestation,Male,18-30,4761,3137,1624,3360,1401
2002,Urban,Gujarat,Crime Against Women,Rape,Male,31-45,6858,6587,271,6617,241
2009,Rural,Bihar,Crime Against Men,Assault,Female,31-45,1970,1465,505,1836,134
2009,Urban,Meghalaya,Crime Against Children,Child Abuse,Male,46-60,6405,3121,3284,5687,718
2002,Urban,Haryana,Crime Against Women,Domestic Violence,Male,60+,5834,1079,4755,2466,3368
2001,Rural,Haryana,Property Crime,Arson,Male,18-30,5640,5134,506,5449,191
2008,Urban,Assam,Other Crimes,Cyber Crime,Male,46-60,9174,4113,5061,7224,1950
2010,Rural,Karnataka,Property Crime,Theft,Female,60+,8501,7101,1400,8257,244
2009,Urban,Goa,Crime Against Men,Robbery,Female,31-45,6340,2943,3397,5094,1246
2007,Urban,Tamil Nadu,Crime Against Men,Extortion,Male,13-17,7543,7020,523,7050,493
2007,Urban,Meghalaya,Other Crimes,Cyber Crime,Female,31-45,5688,66,5622,1829,3859
2002,Urban,Maharashtra,Crime Against Men,Murder,Female,0-12,4084,1327,2757,2294,1790
2001,Rural,Jammu & Kashmir,Property Crime,Vandalism,Female,46-60,6298,5025,1273,6113,185
2001,Rural,Odisha,Other Crimes,Drug Offense,Male,46-60,3542,1716,1826,3378,164
2002,Urban,Kerala,Property Crime,Burglary,Male,46-60,2092,1441,651,1891,201
2009,Rural,Rajasthan,Crime Against Children,Child Labor,Male,31-45,6087,5094,993,5439,648
2006,Rural,Madhya Pradesh,Crime Against Children,Kidnapping,Male,13-17,6276,3426,2850,5750,526
2007,Rural,Goa,Crime Against Men,Robbery,Male,18-30,738,132,606,216,522
2008,Urban,Uttar Pradesh,Crime Against Men,Extortion,Female,60+,3621,1039,2582,3438,183
2004,Urban,Uttarakhand,Other Crimes,Cyber Crime,Male,60+,2660,1351,1309,1685,975
2010,Rural,Bihar,Other Crimes,Fraud,Male,60+,2210,1887,323,2070,140
2009,Urban,Goa,Other Crimes,Fraud,Female,46-60,1705,795,910,1197,508
2007,Rural,Goa,Property Crime,Theft,Male,0-12,3919,3092,827,3581,338
2001,Urban,Tripura,Other Crimes,Drug Offense,Female,46-60,3278,3173,105,3270,8
2004,Urban,Mizoram,Crime Against Women,Domestic Violence,Male,13-17,807,510,297,541,266
2007,Rural,Jammu & Kashmir,Crime Against Men,Extortion,Male,46-60,1272,807,465,827,445
2003,Urban,Madhya Pradesh,Crime Against Children,Child Abuse,Female,60+,6600,4420,2180,4945,1655
2008,Rural,Meghalaya,Crime Against Men,Murder,Male,13-17,6512,6199,313,6322,190
2010,Urban,Telangana,Crime Against Children,Child Abuse,Male,60+,4416,4114,302,4305,111
2002,Urban,Himachal Pradesh,Crime Against Women,Rape,Female,31-45,5307,1585,3722,2933,2374
2007,Urban,Delhi,Crime Against Women,Rape,Male,18-30,4741,4139,602,4606,135
2008,Urban,Gujarat,Crime Against Children,Child Abuse,Male,18-30,5289,3199,2090,4987,302
2004,Urban,Assam,Property Crime,Burglary,Female,31-45,9950,8252,1698,9555,395
2001,Urban,Kerala,Other Crimes,Drug Offense,Female,18-30,7057,3331,3726,5240,1817
2006,Rural,Uttarakhand,Crime Against Men,Extortion,Female,18-30,1653,1370,283,1584,69
2010,Urban,Rajasthan,Crime Against Men,Assault,Female,0-12,8957,8183,774,8320,637
2006,Urban,Kerala,Property Crime,Arson,Male,18-30,2728,1842,886,1959,769
2001,Urban,Odisha,Crime Against Children,Child Labor,Female,31-45,8318,3116,5202,5385,2933
2007,Urban,Manipur,Crime Against Men,Assault,Male,60+,1590,512,1078,1493,97
2004,Rural,Jammu & Kashmir,Crime Against Women,Rape,Female,0-12,553,49,504,486,67
2002,Rural,Maharashtra,Property Crime,Burglary,Female,31-45,2717,675,2042,2346,371
2005,Rural,Sikkim,Crime Against Women,Domestic Violence,Male,31-45,6372,6112,260,6347,25
2003,Urban,Arunachal Pradesh,Other Crimes,Drug Offense,Male,18-30,3038,1987,1051,2909,129
2008,Rural,Jharkhand,Other Crimes,Cyber Crime,Male,13-17,4970,3650,1320,3702,1268
2009,Rural,Karnataka,Crime Against Women,Domestic Violence,Male,46-60,1350,236,1114,805,545
2010,Rural,Odisha,Property Crime,Burglary,Male,46-60,9938,7424,2514,7693,2245
2004,Rural,Arunachal Pradesh,Crime Against Children,Kidnapping,Male,31-45,5739,2831,2908,3926,1813
2005,Urban,Madhya Pradesh,Crime Against Men,Assault,Male,18-30,927,57,870,789,138
2001,Urban,Haryana,Crime Against Men,Extortion,Male,46-60,2460,2330,130,2379,81
2006,Rural,Punjab,Other Crimes,Cyber Crime,Male,46-60,247,23,224,170,77
2001,Urban,Rajasthan,Crime Against Men,Extortion,Female,18-30,1368,1146,222,1354,14
2008,Urban,Maharashtra,Crime Against Children,Trafficking,Female,13-17,2583,1256,1327,1559,1024
2008,Rural,Jammu & Kashmir,Crime Against Women,Domestic Violence,Male,0-12,6498,2147,4351,6021,477
2010,Rural,Arunachal Pradesh,Property Crime,Theft,Male,0-12,6287,931,5356,1996,4291
2002,Rural,Odisha,Crime Against Men,Assault,Female,60+,3130,1051,2079,1217,1913
2007,Rural,Delhi,Crime Against Women,Dowry Deaths,Female,0-12,905,516,389,788,117
2009,Rural,Maharashtra,Other Crimes,Cyber Crime,Female,13-17,9185,8528,657,9128,57
2005,Urban,Maharashtra,Crime Against Men,Assault,Female,60+,8317,1422,6895,2091,6226
2002,Urban,West Bengal,Property Crime,Theft,Male,0-12,4463,2534,1929,4298,165
2006,Rural,Maharashtra,Crime Against Children,Trafficking,Male,13-17,3566,2185,1381,3463,103
2009,Urban,Manipur,Other Crimes,Corruption,Female,31-45,7057,6727,330,6866,191
2007,Urban,Telangana,Crime Against Children,Child Abuse,Male,13-17,213,39,174,168,45
2003,Urban,Gujarat,Crime Against Children,Trafficking,Female,18-30,9518,7862,1656,8808,710
2007,Rural,Sikkim,Crime Against Men,Robbery,Male,18-30,3359,1102,2257,2681,678
2001,Rural,Sikkim,Crime Against Men,Murder,Male,46-60,8588,5373,3215,7201,1387
2008,Rural,Jammu & Kashmir,Crime Against Children,Trafficking,Female,31-45,7530,2266,5264,5957,1573
2006,Rural,Bihar,Property Crime,Theft,Male,0-12,1855,108,1747,1584,271
2008,Urban,Kerala,Crime Against Children,Child Abuse,Male,0-12,6389,5593,796,6234,155
2008,Rural,Odisha,Property Crime,Burglary,Female,31-45,4842,1607,3235,1622,3220
2001,Urban,Nagaland,Crime Against Women,Rape,Male,46-60,9635,8100,1535,8484,1151
2005,Urban,Jharkhand,Crime Against Children,Trafficking,Female,46-60,7767,3252,4515,5246,2521
2001,Rural,Telangana,Other Crimes,Corruption,Female,13-17,7954,6867,1087,7435,519
2003,Rural,Haryana,Other Crimes,Corruption,Male,31-45,5008,4234,774,4925,83
2003,Rural,Karnataka,Property Crime,Arson,Female,60+,6857,1377,5480,3388,3469
2005,Urban,Maharashtra,Property Crime,Theft,Male,13-17,8054,3445,4609,5581,2473
2008,Rural,Manipur,Property Crime,Theft,Male,31-45,8284,768,7516,8161,123
2002,Rural,Meghalaya,Crime Against Children,Child Abuse,Female,46-60,584,122,462,200,384
2005,Rural,Andhra Pradesh,Property Crime,Burglary,Male,46-60,5341,3994,1347,4917,424
2008,Rural,Madhya Pradesh,Crime Against Men,Robbery,Female,0-12,4696,1929,2767,3852,844
2008,Urban,Uttar Pradesh,Property Crime,Burglary,Male,31-45,3671,1160,2511,3127,544
2006,Urban,Andhra Pradesh,Property Crime,Arson,Female,13-17,9229,9135,94,9169,60
2006,Urban,Tamil Nadu,Crime Against Children,Trafficking,Female,0-12,9641,4024,5617,5308,4333
2002,Rural,Karnataka,Property Crime,Theft,Female,31-45,6476,1932,4544,4838,1638
2003,Urban,Punjab,Property Crime,Arson,Male,18-30,908,102,806,787,121
2008,Rural,Madhya Pradesh,Other Crimes,Fraud,Female,18-30,5242,169,5073,4569,673
2006,Urban,Goa,Crime Against Children,Trafficking,Male,13-17,629,466,163,534,95
2006,Rural,Jammu & Kashmir,Crime Against Women,Molestation,Male,18-30,2128,328,1800,596,1532
2005,Urban,West Bengal,Other Crimes,Corruption,Female,31-45,9072,8793,279,8848,224
2003,Urban,Sikkim,Other Crimes,Cyber Crime,Male,46-60,9801,7190,2611,7256,2545
2005,Urban,Gujarat,Crime Against Children,Child Abuse,Male,60+,1314,1010,304,1027,287
2008,Urban,Uttar Pradesh,Property Crime,Theft,Female,13-17,6890,2325,4565,5716,1174
2002,Urban,Tamil Nadu,Property Crime,Vandalism,Female,13-17,4932,4521,411,4596,336
2006,Rural,Manipur,Property Crime,Vandalism,Female,46-60,7940,1720,6220,5682,2258
2005,Urban,Kerala,Property Crime,Vandalism,Female,31-45,4620,2937,1683,3148,1472
2007,Urban,Uttarakhand,Property Crime,Vandalism,Male,46-60,3523,3041,482,3482,41
2002,Urban,Gujarat,Crime Against Men,Robbery,Female,46-60,7884,1936,5948,2181,5703
2006,Urban,Arunachal Pradesh,Property Crime,Vandalism,Female,18-30,6224,3305,2919,5537,687
2005,Rural,West Bengal,Property Crime,Arson,Female,60+,9348,2520,6828,2829,6519
2002,Urban,Sikkim,Crime Against Men,Extortion,Male,13-17,6163,4416,1747,4938,1225
2002,Rural,Punjab,Crime Against Children,Trafficking,Female,18-30,2306,823,1483,1925,381
2009,Rural,Arunachal Pradesh,Crime Against Children,Trafficking,Female,18-30,1565,968,597,1145,420
2006,Rural,Jammu & Kashmir,Crime Against Men,Extortion,Female,46-60,4257,2404,1853,2521,1736
2007,Rural,Chhattisgarh,Crime Against Children,Trafficking,Male,0-12,4384,9,4375,2397,1987
2003,Rural,Manipur,Crime Against Children,Kidnapping,Male,31-45,5444,4499,945,4700,744
2009,Urban,Jammu & Kashmir,Crime Against Women,Molestation,Male,60+,965,898,67,925,40
2001,Urban,Himachal Pradesh,Property Crime,Theft,Female,31-45,5962,5905,57,5925,37
2002,Urban,Gujarat,Crime Against Women,Dowry Deaths,Female,13-17,445,31,414,175,270
2003,Urban,Assam,Crime Against Children,Child Labor,Male,31-45,3222,1838,1384,2892,330
2001,Rural,Haryana,Property Crime,Vandalism,Female,13-17,1531,939,592,1404,127
2005,Rural,Tripura,Crime Against Men,Extortion,Female,31-45,8627,8238,389,8425,202
2007,Rural,Madhya Pradesh,Crime Against Children,Child Abuse,Female,0-12,2640,268,2372,2503,137
2010,Urban,Andhra Pradesh,Property Crime,Vandalism,Male,31-45,6242,1060,5182,4327,1915
2007,Rural,Uttarakhand,Property Crime,Arson,Male,46-60,8294,5571,2723,7192,1102
2001,Rural,Delhi,Crime Against Men,Murder,Male,18-30,6184,849,5335,2923,3261
2007,Rural,Andhra Pradesh,Crime Against Women,Molestation,Female,0-12,8471,1858,6613,5270,3201
2009,Urban,Delhi,Property Crime,Vandalism,Female,18-30,5777,1212,4565,2241,3536
2010,Rural,Madhya Pradesh,Other Crimes,Drug Offense,Male,0-12,1328,1198,130,1312,16
2001,Urban,Nagaland,Property Crime,Theft,Female,60+,9995,3779,6216,7842,2153
2001,Rural,Punjab,Crime Against Children,Kidnapping,Female,60+,7168,1438,5730,3039,4129
2008,Urban,Uttar Pradesh,Other Crimes,Cyber Crime,Female,13-17,213,122,91,186,27
2002,Urban,West Bengal,Other Crimes,Fraud,Male,18-30,333,130,203,135,198
2001,Rural,Kerala,Crime Against Women,Molestation,Female,13-17,6597,564,6033,5057,1540
2005,Rural,Jharkhand,Crime Against Women,Dowry Deaths,Male,13-17,395,195,200,373,22
2007,Rural,Maharashtra,Crime Against Children,Kidnapping,Male,13-17,176,118,58,170,6
2008,Rural,Chhattisgarh,Other Crimes,Cyber Crime,Male,13-17,581,395,186,513,68
2005,Rural,Punjab,Property Crime,Burglary,Male,13-17,1049,898,151,912,137
2004,Urban,Kerala,Crime Against Women,Rape,Female,31-45,350,132,218,340,10
2002,Rural,Nagaland,Crime Against Children,Trafficking,Female,31-45,2511,1863,648,1880,631
2009,Urban,Andhra Pradesh,Property Crime,Theft,Female,46-60,1239,1160,79,1197,42
2005,Rural,Arunachal Pradesh,Property Crime,Burglary,Female,0-12,707,304,403,521,186
2006,Urban,Andhra Pradesh,Other Crimes,Fraud,Female,46-60,9747,9092,655,9642,105
2008,Urban,Karnataka,Other Crimes,Cyber Crime,Male,13-17,6761,3627,3134,4998,1763
2001,Urban,Gujarat,Crime Against Men,Murder,Male,0-12,537,186,351,370,167
2008,Urban,Meghalaya,Property Crime,Burglary,Male,18-30,7057,3738,3319,3740,3317
2010,Rural,Jharkhand,Other Crimes,Drug Offense,Female,31-45,5605,3395,2210,5317,288
2002,Rural,Uttarakhand,Property Crime,Vandalism,Female,0-12,69,31,38,45,24
2007,Rural,Uttar Pradesh,Crime Against Men,Murder,Female,46-60,2371,1919,452,2005,366
2002,Urban,Himachal Pradesh,Property Crime,Theft,Female,31-45,5509,48,5461,5470,39
2005,Urban,Tripura,Crime Against Women,Dowry Deaths,Female,60+,8497,5339,3158,6259,2238
2009,Rural,Rajasthan,Crime Against Women,Molestation,Male,13-17,8673,1969,6704,7425,1248
2008,Urban,Jharkhand,Property Crime,Theft,Male,18-30,7903,4373,3530,4860,3043
2001,Urban,Arunachal Pradesh,Crime Against Women,Molestation,Male,46-60,3744,3609,135,3733,11
2004,Rural,Kerala,Property Crime,Vandalism,Female,13-17,2950,2050,900,2690,260
2004,Rural,Manipur,Property Crime,Arson,Male,60+,2035,393,1642,961,1074
2009,Rural,Goa,Crime Against Children,Kidnapping,Male,60+,6666,3624,3042,5516,1150
2007,Rural,Arunachal Pradesh,Crime Against Women,Rape,Male,0-12,6831,6176,655,6819,12
2010,Urban,Karnataka,Crime Against Women,Domestic Violence,Female,13-17,4953,2257,2696,4838,115
2008,Rural,Manipur,Other Crimes,Cyber Crime,Male,46-60,7126,6862,264,6879,247
2010,Rural,Meghalaya,Crime Against Children,Child Abuse,Female,18-30,3372,2135,1237,2706,666
2008,Rural,Manipur,Crime Against Children,Trafficking,Female,18-30,6808,773,6035,841,5967
2010,Urban,Sikkim,Property Crime,Theft,Male,60+,8465,4128,4337,7456,1009
2006,Rural,Rajasthan,Crime Against Children,Child Abuse,Male,13-17,7007,2411,4596,3883,3124
2007,Rural,Punjab,Crime Against Men,Extortion,Male,18-30,2284,1003,1281,1036,1248
2006,Urban,Nagaland,Property Crime,Burglary,Male,13-17,4532,359,4173,1464,3068
2007,Rural,Arunachal Pradesh,Crime Against Women,Rape,Male,60+,6153,2229,3924,6016,137
2004,Urban,Goa,Crime Against Women,Domestic Violence,Male,60+,945,286,659,412,533
2005,Urban,Meghalaya,Crime Against Women,Domestic Violence,Male,46-60,9172,5542,3630,8514,658
2007,Urban,Jammu & Kashmir,Crime Against Men,Assault,Male,60+,2359,1985,374,2261,98
2003,Urban,Tamil Nadu,Crime Against Children,Kidnapping,Male,13-17,9815,6936,2879,9740,75
2004,Urban,Rajasthan,Other Crimes,Cyber Crime,Female,31-45,1557,1460,97,1505,52
2001,Urban,Jammu & Kashmir,Crime Against Women,Molestation,Female,0-12,3132,1891,1241,2080,1052
2005,Urban,Tamil Nadu,Other Crimes,Fraud,Male,0-12,1502,202,1300,802,700
2009,Rural,Nagaland,Other Crimes,Drug Offense,Male,13-17,9243,8830,413,9133,110
2004,Urban,Nagaland,Other Crimes,Fraud,Female,46-60,5759,1577,4182,4926,833
2004,Urban,Gujarat,Other Crimes,Fraud,Female,46-60,2983,2410,573,2557,426
2005,Urban,Goa,Property Crime,Vandalism,Male,60+,9312,2547,6765,5219,4093
2003,Rural,Punjab,Crime Against Children,Child Labor,Female,0-12,6574,1495,5079,2874,3700
2006,Rural,Arunachal Pradesh,Property Crime,Burglary,Female,60+,9942,2953,6989,8875,1067
2004,Urban,Delhi,Crime Against Women,Rape,Male,31-45,6063,4772,1291,5844,219
2004,Rural,Gujarat,Crime Against Women,Dowry Deaths,Male,0-12,7459,3451,4008,3497,3962
2001,Urban,Sikkim,Crime Against Women,Molestation,Male,0-12,1281,406,875,652,629
2009,Rural,Uttar Pradesh,Crime Against Children,Kidnapping,Female,60+,5458,5333,125,5372,86
2008,Rural,Himachal Pradesh,Other Crimes,Corruption,Female,60+,8770,1255,7515,6727,2043
2006,Urban,Punjab,Crime Against Children,Child Abuse,Female,18-30,9564,3642,5922,6826,2738
2002,Rural,Maharashtra,Crime Against Children,Trafficking,Female,60+,1184,1018,166,1169,15
2006,Rural,Uttarakhand,Property Crime,Theft,Female,13-17,5161,3037,2124,4333,828
2001,Urban,Manipur,Other Crimes,Corruption,Female,13-17,8170,7886,284,8085,85
2006,Urban,Chhattisgarh,Other Crimes,Drug Offense,Male,0-12,6431,2603,3828,4657,1774
2010,Rural,Chhattisgarh,Property Crime,Arson,Female,60+,9087,1774,7313,3907,5180
2005,Urban,Karnataka,Property Crime,Vandalism,Female,46-60,6664,3617,3047,4198,2466
2010,Urban,Karnataka,Crime Against Women,Dowry Deaths,Male,31-45,579,438,141,558,21
2010,Urban,Madhya Pradesh,Crime Against Women,Domestic Violence,Female,31-45,4331,2810,1521,3052,1279
2005,Urban,Andhra Pradesh,Other Crimes,Drug Offense,Male,13-17,3357,1539,1818,2765,592
2009,Urban,Mizoram,Crime Against Children,Kidnapping,Male,0-12,1916,879,1037,1006,910
2005,Rural,Gujarat,Crime Against Women,Rape,Female,60+,9436,6304,3132,8335,1101
2008,Rural,Goa,Crime Against Women,Molestation,Male,0-12,2436,540,1896,1103,1333
2005,Urban,Chhattisgarh,Crime Against Women,Rape,Male,18-30,7725,4622,3103,7467,258
2004,Rural,Arunachal Pradesh,Other Crimes,Drug Offense,Male,46-60,7087,4748,2339,5866,1221
2004,Rural,Himachal Pradesh,Crime Against Children,Child Labor,Male,18-30,8554,2750,5804,7905,649
2002,Rural,Punjab,Crime Against Women,Molestation,Female,31-45,3742,1428,2314,3237,505
2006,Rural,Haryana,Other Crimes,Corruption,Male,31-45,5614,1717,3897,2415,3199
2010,Urban,Tripura,Property Crime,Vandalism,Male,46-60,6186,3630,2556,5451,735
2009,Rural,Delhi,Crime Against Children,Child Abuse,Male,13-17,56,9,47,42,14
2009,Rural,Kerala,Property Crime,Arson,Female,0-12,7923,2490,5433,4268,3655
2007,Urban,Tripura,Crime Against Children,Trafficking,Male,0-12,4073,1138,2935,1780,2293
2002,Urban,Punjab,Property Crime,Burglary,Female,18-30,3817,466,3351,1325,2492
2002,Rural,Madhya Pradesh,Crime Against Women,Rape,Male,60+,8931,3934,4997,6030,2901
2008,Rural,Kerala,Crime Against Men,Assault,Female,60+,9379,6708,2671,9247,132
2005,Rural,Maharashtra,Crime Against Women,Domestic Violence,Female,13-17,694,320,374,335,359
2005,Rural,Maharashtra,Crime Against Children,Trafficking,Male,13-17,4651,694,3957,3517,1134
2008,Urban,Odisha,Crime Against Children,Trafficking,Female,60+,4465,4428,37,4462,3
2004,Rural,Haryana,Crime Against Men,Robbery,Male,13-17,1581,1127,454,1259,322
2010,Rural,Rajasthan,Other Crimes,Drug Offense,Male,13-17,3940,686,3254,3501,439
2004,Rural,Maharashtra,Crime Against Women,Domestic Violence,Male,18-30,911,899,12,907,4
2004,Urban,Maharashtra,Crime Against Women,Dowry Deaths,Male,60+,976,84,892,714,262
2010,Urban,Odisha,Crime Against Women,Molestation,Female,18-30,8568,464,8104,8217,351
2002,Rural,Kerala,Crime Against Men,Extortion,Male,60+,4593,324,4269,2340,2253
2010,Rural,Tripura,Property Crime,Burglary,Female,13-17,3162,3006,156,3148,14
2003,Rural,Tamil Nadu,Crime Against Men,Robbery,Male,31-45,795,714,81,731,64
2004,Urban,Punjab,Crime Against Children,Kidnapping,Male,60+,563,367,196,539,24
2007,Urban,Himachal Pradesh,Other Crimes,Corruption,Female,60+,6227,3628,2599,4864,1363
2010,Urban,Assam,Crime Against Men,Assault,Male,13-17,9579,6397,3182,6642,2937
2004,Urban,Goa,Crime Against Men,Extortion,Female,31-45,2493,441,2052,1738,755
2009,Urban,Rajasthan,Crime Against Women,Domestic Violence,Male,13-17,6430,2790,3640,5288,1142
2005,Urban,Himachal Pradesh,Crime Against Women,Rape,Male,0-12,3039,2260,779,3006,33
2003,Rural,Maharashtra,Crime Against Children,Child Labor,Male,60+,3369,2461,908,2879,490
2002,Rural,Jharkhand,Other Crimes,Fraud,Female,46-60,596,561,35,572,24
2010,Rural,Uttar Pradesh,Crime Against Children,Kidnapping,Female,13-17,7107,6076,1031,6823,284
2003,Urban,Rajasthan,Crime Against Men,Assault,Female,13-17,1412,1024,388,1219,193
2003,Rural,Chhattisgarh,Crime Against Children,Child Labor,Female,31-45,2213,2181,32,2208,5
2004,Rural,Jharkhand,Crime Against Women,Domestic Violence,Female,46-60,1654,476,1178,478,1176
2009,Rural,Nagaland,Crime Against Children,Child Labor,Male,18-30,1936,892,1044,1713,223
2007,Urban,Meghalaya,Crime Against Women,Domestic Violence,Male,0-12,1311,271,1040,524,787
2001,Urban,Telangana,Crime Against Children,Child Labor,Male,0-12,6829,5115,1714,5937,892
2008,Urban,Telangana,Crime Against Men,Murder,Male,31-45,789,152,637,570,219
2010,Urban,Karnataka,Other Crimes,Corruption,Female,31-45,9602,5083,4519,5207,4395
2002,Rural,Uttar Pradesh,Crime Against Women,Molestation,Male,31-45,3663,1191,2472,3541,122
2001,Rural,Delhi,Property Crime,Theft,Male,46-60,2762,454,2308,1399,1363
2010,Rural,Punjab,Crime Against Men,Robbery,Female,13-17,7361,6657,704,7360,1
2003,Rural,Karnataka,Property Crime,Arson,Male,46-60,8431,5970,2461,6814,1617
2006,Rural,West Bengal,Crime Against Women,Rape,Female,31-45,9389,2289,7100,6667,2722
2010,Rural,Manipur,Other Crimes,Corruption,Female,31-45,1769,1687,82,1718,51
2003,Rural,Arunachal Pradesh,Crime Against Women,Rape,Female,46-60,7358,3525,3833,3749,3609
2001,Urban,Jharkhand,Property Crime,Theft,Female,13-17,7528,5965,1563,7064,464
2009,Urban,Andhra Pradesh,Crime Against Children,Kidnapping,Male,46-60,2708,2096,612,2574,134
2010,Urban,Maharashtra,Property Crime,Theft,Female,0-12,8763,4610,4153,4713,4050
2006,Urban,Goa,Crime Against Children,Child Labor,Male,13-17,1659,1301,358,1622,37
2006,Urban,Nagaland,Other Crimes,Corruption,Female,31-45,5398,1507,3891,5319,79
2005,Rural,Bihar,Crime Against Women,Domestic Violence,Female,31-45,4010,3220,790,3277,733
2003,Rural,Jammu & Kashmir,Property Crime,Vandalism,Female,31-45,5803,4343,1460,4449,1354
2003,Urban,Punjab,Property Crime,Vandalism,Male,0-12,8305,1350,6955,3375,4930
2010,Rural,Goa,Crime Against Men,Robbery,Male,0-12,7798,2303,5495,6577,1221
2009,Urban,Jammu & Kashmir,Crime Against Men,Extortion,Male,46-60,264,238,26,252,12
2003,Rural,Arunachal Pradesh,Crime Against Children,Child Abuse,Male,18-30,4918,595,4323,2452,2466
2008,Urban,Uttarakhand,Property Crime,Arson,Male,0-12,7605,4117,3488,7588,17
2006,Urban,Rajasthan,Crime Against Women,Domestic Violence,Female,0-12,5989,425,5564,5862,127
2006,Urban,Manipur,Other Crimes,Cyber Crime,Male,60+,374,210,164,286,88
2008,Urban,Maharashtra,Crime Against Men,Murder,Male,13-17,9863,6384,3479,9153,710
2005,Rural,Kerala,Crime Against Women,Dowry Deaths,Female,46-60,6182,233,5949,1666,4516
2009,Rural,Odisha,Crime Against Children,Child Abuse,Male,18-30,4345,2804,1541,3894,451
2008,Rural,Himachal Pradesh,Crime Against Children,Child Abuse,Male,60+,686,396,290,587,99
2004,Rural,Assam,Property Crime,Burglary,Male,31-45,5117,1224,3893,1336,3781
2002,Rural,West Bengal,Crime Against Children,Kidnapping,Male,18-30,1810,999,811,1138,672
2001,Rural,Jammu & Kashmir,Crime Against Men,Robbery,Male,60+,1090,769,321,1000,90
2006,Urban,Uttar Pradesh,Crime Against Women,Molestation,Male,31-45,6653,5022,1631,6550,103
2010,Urban,Punjab,Crime Against Men,Murder,Female,46-60,3689,1380,2309,2899,790
2002,Rural,Telangana,Other Crimes,Corruption,Male,31-45,4954,1947,3007,2202,2752
2001,Urban,Assam,Crime Against Children,Trafficking,Female,60+,4221,180,4041,935,3286
2006,Rural,Maharashtra,Property Crime,Vandalism,Male,18-30,4753,328,4425,2227,2526
2008,Urban,Rajasthan,Crime Against Men,Extortion,Female,31-45,2936,442,2494,2381,555
2006,Urban,Meghalaya,Crime Against Children,Kidnapping,Male,60+,8040,7956,84,7971,69
2003,Rural,Mizoram,Property Crime,Arson,Female,18-30,9731,286,9445,8982,749
2003,Urban,Delhi,Crime Against Children,Trafficking,Female,31-45,6774,1735,5039,5993,781
2005,Rural,Madhya Pradesh,Other Crimes,Drug Offense,Female,60+,1838,1498,340,1754,84
2005,Urban,Jharkhand,Crime Against Children,Trafficking,Female,60+,3595,2265,1330,2834,761
2007,Urban,Manipur,Crime Against Women,Domestic Violence,Male,60+,4603,2510,2093,3750,853
2005,Urban,Maharashtra,Crime Against Men,Assault,Male,18-30,9523,4445,5078,8835,688
2001,Urban,Haryana,Other Crimes,Fraud,Male,46-60,8539,6878,1661,7437,1102
2001,Rural,Uttarakhand,Crime Against Men,Murder,Female,60+,9216,2139,7077,8062,1154
2001,Rural,West Bengal,Other Crimes,Drug Offense,Female,46-60,7900,7516,384,7861,39
2002,Rural,Karnataka,Crime Against Children,Trafficking,Male,18-30,2581,1932,649,2299,282
2006,Rural,Jammu & Kashmir,Property Crime,Burglary,Male,13-17,1496,535,961,776,720
2001,Urban,Uttarakhand,Property Crime,Burglary,Female,46-60,5066,5064,2,5064,2
2006,Rural,Tamil Nadu,Other Crimes,Drug Offense,Female,46-60,9985,7629,2356,9011,974
2008,Urban,Punjab,Crime Against Men,Robbery,Male,31-45,856,558,298,840,16
2007,Urban,Madhya Pradesh,Crime Against Men,Murder,Male,0-12,7932,6521,1411,6780,1152
2006,Urban,Arunachal Pradesh,Crime Against Women,Molestation,Male,18-30,7909,1002,6907,5560,2349
2007,Urban,Kerala,Other Crimes,Drug Offense,Female,13-17,3478,1167,2311,2433,1045
2002,Rural,Maharashtra,Property Crime,Vandalism,Female,13-17,3306,1273,2033,2090,1216
2004,Rural,Karnataka,Crime Against Women,Domestic Violence,Female,18-30,9445,4043,5402,4145,5300
2010,Rural,Sikkim,Crime Against Children,Child Abuse,Female,31-45,3204,2823,381,3157,47
2010,Urban,Chhattisgarh,Crime Against Men,Robbery,Male,18-30,9830,7067,2763,9158,672
2008,Urban,Telangana,Other Crimes,Fraud,Male,60+,4393,2250,2143,2343,2050
2007,Urban,Chhattisgarh,Crime Against Men,Extortion,Male,18-30,4609,1608,3001,2817,1792
2002,Urban,Uttarakhand,Crime Against Women,Rape,Female,13-17,6495,2501,3994,5158,1337
2006,Urban,Rajasthan,Crime Against Children,Child Abuse,Male,31-45,8742,7478,1264,7625,1117
2009,Urban,Rajasthan,Crime Against Women,Molestation,Female,46-60,2334,667,1667,1378,956
2005,Rural,Chhattisgarh,Crime Against Women,Dowry Deaths,Male,60+,9327,3617,5710,6386,2941
2005,Rural,Punjab,Property Crime,Theft,Male,31-45,1262,290,972,1196,66
2010,Urban,Kerala,Crime Against Women,Molestation,Male,0-12,7139,361,6778,7119,20
2007,Rural,Punjab,Crime Against Men,Assault,Female,46-60,860,279,581,663,197
2007,Rural,Manipur,Crime Against Women,Dowry Deaths,Male,18-30,9717,711,9006,3096,6621
2004,Rural,Telangana,Crime Against Children,Child Labor,Male,46-60,9388,3580,5808,8178,1210
2003,Urban,Rajasthan,Crime Against Men,Extortion,Female,18-30,7121,1689,5432,4921,2200
2008,Urban,Maharashtra,Crime Against Men,Extortion,Female,46-60,2653,264,2389,1556,1097
2005,Rural,Arunachal Pradesh,Property Crime,Theft,Male,31-45,4704,4286,418,4636,68
2005,Rural,Delhi,Crime Against Men,Murder,Female,60+,2629,1431,1198,2151,478
2004,Rural,Delhi,Crime Against Children,Child Abuse,Female,0-12,8716,2431,6285,3754,4962
2003,Rural,Rajasthan,Crime Against Children,Child Abuse,Female,60+,3654,3240,414,3603,51
2003,Urban,Chhattisgarh,Property Crime,Theft,Female,18-30,6265,1400,4865,4250,2015
2001,Urban,Assam,Crime Against Women,Domestic Violence,Female,18-30,4713,2301,2412,3262,1451
2010,Urban,Chhattisgarh,Crime Against Children,Child Abuse,Female,31-45,5116,1549,3567,3994,1122
2001,Rural,Manipur,Crime Against Women,Domestic Violence,Female,0-12,9618,6465,3153,9178,440
2007,Rural,Uttarakhand,Crime Against Women,Domestic Violence,Female,0-12,5140,2837,2303,4235,905
2003,Rural,Odisha,Crime Against Children,Child Abuse,Female,13-17,877,818,59,866,11
2002,Rural,Maharashtra,Property Crime,Burglary,Male,18-30,3299,347,2952,1566,1733
2005,Rural,Kerala,Other Crimes,Corruption,Female,31-45,7259,5355,1904,5884,1375
2004,Rural,Haryana,Crime Against Women,Domestic Violence,Female,13-17,6789,5764,1025,6651,138
2007,Urban,Manipur,Property Crime,Arson,Male,13-17,286,95,191,113,173
2006,Rural,Jammu & Kashmir,Crime Against Men,Murder,Female,18-30,9925,8860,1065,9411,514
2004,Rural,Uttarakhand,Property Crime,Arson,Male,46-60,8640,3652,4988,3984,4656
2002,Rural,Chhattisgarh,Property Crime,Vandalism,Male,31-45,5694,5542,152,5572,122
2007,Rural,Andhra Pradesh,Other Crimes,Corruption,Male,18-30,6974,1212,5762,6357,617
2008,Urban,Uttarakhand,Other Crimes,Drug Offense,Female,60+,5506,3832,1674,4615,891
2009,Rural,Madhya Pradesh,Crime Against Children,Trafficking,Female,60+,7077,4873,2204,6634,443
2005,Rural,Uttarakhand,Crime Against Men,Assault,Male,46-60,928,777,151,909,19
2003,Urban,Tripura,Other Crimes,Fraud,Male,46-60,7959,3556,4403,3670,4289
2002,Rural,Telangana,Property Crime,Burglary,Female,0-12,7257,1964,5293,6933,324
2005,Rural,Mizoram,Other Crimes,Fraud,Male,60+,9004,5227,3777,5663,3341
2001,Rural,Sikkim,Crime Against Children,Trafficking,Male,13-17,5533,4888,645,5329,204
2005,Rural,Nagaland,Crime Against Women,Domestic Violence,Female,31-45,9036,6181,2855,8122,914
2005,Urban,Bihar,Crime Against Men,Murder,Male,46-60,2052,734,1318,1159,893
2001,Urban,Mizoram,Other Crimes,Fraud,Male,13-17,5833,959,4874,1708,4125
2010,Urban,Jharkhand,Crime Against Women,Rape,Male,31-45,4602,2980,1622,4564,38
2007,Urban,Odisha,Other Crimes,Corruption,Female,31-45,8043,6051,1992,6164,1879
2006,Urban,Manipur,Property Crime,Vandalism,Male,31-45,8521,2874,5647,7367,1154
2006,Urban,Himachal Pradesh,Other Crimes,Fraud,Male,31-45,8544,2428,6116,5942,2602
2004,Rural,Manipur,Other Crimes,Fraud,Female,46-60,4945,4092,853,4221,724
2008,Urban,Andhra Pradesh,Crime Against Women,Rape,Female,13-17,2289,1861,428,2222,67
2005,Urban,Tamil Nadu,Property Crime,Vandalism,Female,31-45,7849,2777,5072,5874,1975
2007,Rural,Assam,Crime Against Women,Rape,Female,60+,1009,141,868,266,743
2008,Rural,Uttarakhand,Property Crime,Arson,Male,0-12,1382,489,893,1373,9
2006,Rural,Kerala,Property Crime,Theft,Female,31-45,5987,3530,2457,3695,2292
2010,Rural,Jammu & Kashmir,Property Crime,Vandalism,Female,0-12,8090,6490,1600,7085,1005
2009,Rural,Gujarat,Other Crimes,Fraud,Male,31-45,9380,8909,471,8914,466
2007,Urban,Andhra Pradesh,Property Crime,Theft,Male,13-17,4610,1805,2805,3712,898
2008,Rural,Manipur,Crime Against Men,Assault,Male,60+,5660,2356,3304,5490,170
2004,Urban,Madhya Pradesh,Crime Against Women,Molestation,Female,13-17,2097,1848,249,1966,131
2005,Urban,Kerala,Crime Against Men,Assault,Male,0-12,2638,575,2063,1593,1045
2009,Rural,Himachal Pradesh,Other Crimes,Drug Offense,Female,0-12,3412,2130,1282,3286,126
2007,Urban,Assam,Other Crimes,Corruption,Female,31-45,8104,4259,3845,6365,1739
2005,Rural,Uttar Pradesh,Crime Against Women,Rape,Male,0-12,5788,260,5528,2737,3051
2009,Rural,Goa,Crime Against Men,Assault,Male,13-17,8398,6216,2182,7780,618
2002,Urban,West Bengal,Crime Against Children,Child Labor,Male,31-45,4302,4095,207,4171,131
2008,Rural,Kerala,Crime Against Children,Trafficking,Female,46-60,7555,3490,4065,4009,3546
2001,Rural,Gujarat,Other Crimes,Drug Offense,Male,13-17,724,404,320,508,216
2006,Rural,Andhra Pradesh,Property Crime,Burglary,Male,46-60,9713,977,8736,7992,1721
2004,Urban,West Bengal,Property Crime,Arson,Female,0-12,8464,921,7543,2112,6352
2007,Urban,Delhi,Other Crimes,Fraud,Female,13-17,8220,5584,2636,6510,1710
2003,Rural,Telangana,Crime Against Men,Assault,Female,60+,5237,3520,1717,3642,1595
2006,Rural,Nagaland,Property Crime,Burglary,Female,31-45,7799,7170,629,7375,424
2001,Urban,Uttar Pradesh,Crime Against Children,Child Labor,Female,31-45,1674,1103,571,1670,4
2008,Rural,Uttarakhand,Property Crime,Vandalism,Female,13-17,2725,1061,1664,1867,858
2006,Urban,Arunachal Pradesh,Crime Against Children,Kidnapping,Male,60+,4550,279,4271,325,4225
2005,Rural,Haryana,Other Crimes,Cyber Crime,Female,13-17,3178,2533,645,2828,350
2003,Rural,Punjab,Other Crimes,Drug Offense,Female,0-12,3743,2715,1028,2764,979
2004,Urban,Punjab,Crime Against Children,Kidnapping,Female,46-60,467,20,447,319,148
2008,Rural,Delhi,Crime Against Children,Kidnapping,Female,31-45,769,177,592,252,517
2002,Urban,Gujarat,Other Crimes,Cyber Crime,Female,0-12,8362,2507,5855,6813,1549
2009,Rural,Uttarakhand,Crime Against Women,Rape,Male,18-30,2008,1459,549,1927,81
2001,Urban,Goa,Crime Against Women,Rape,Male,13-17,3951,2548,1403,2807,1144
2003,Rural,Odisha,Crime Against Children,Child Abuse,Male,13-17,1715,958,757,1234,481
2003,Rural,Delhi,Crime Against Children,Trafficking,Male,0-12,2128,460,1668,645,1483
2004,Urban,Jammu & Kashmir,Property Crime,Burglary,Male,60+,4454,4127,327,4279,175
2003,Urban,Haryana,Other Crimes,Drug Offense,Female,0-12,1968,1451,517,1759,209
2001,Rural,Manipur,Other Crimes,Drug Offense,Male,31-45,895,747,148,834,61
2010,Urban,Arunachal Pradesh,Crime Against Children,Kidnapping,Male,46-60,9968,494,9474,2185,7783
2010,Rural,Bihar,Crime Against Children,Child Abuse,Female,46-60,8890,1539,7351,8699,191
2007,Rural,Nagaland,Other Crimes,Corruption,Male,60+,9491,780,8711,6742,2749
2005,Rural,Tamil Nadu,Other Crimes,Drug Offense,Male,46-60,3282,1791,1491,2593,689
2009,Rural,Nagaland,Crime Against Women,Domestic Violence,Male,31-45,8791,1792,6999,2325,6466
2008,Urban,Telangana,Crime Against Men,Assault,Female,13-17,3989,2625,1364,3612,377
2001,Urban,Haryana,Crime Against Men,Murder,Male,13-17,8851,4832,4019,6380,2471
2001,Rural,Uttarakhand,Crime Against Men,Robbery,Male,18-30,3903,3313,590,3903,0
2010,Rural,Gujarat,Crime Against Children,Kidnapping,Female,46-60,2973,1244,1729,1646,1327
2005,Rural,Tripura,Property Crime,Arson,Male,13-17,4012,1813,2199,3584,428
2001,Rural,Madhya Pradesh,Crime Against Children,Kidnapping,Male,18-30,6606,3541,3065,3620,2986
2010,Rural,Andhra Pradesh,Crime Against Men,Murder,Female,31-45,5743,749,4994,1347,4396
2005,Urban,Mizoram,Crime Against Children,Trafficking,Female,60+,4079,3241,838,3257,822
2006,Urban,Rajasthan,Crime Against Children,Trafficking,Female,13-17,6674,114,6560,1197,5477
2008,Rural,Uttar Pradesh,Crime Against Women,Dowry Deaths,Male,46-60,1399,747,652,1361,38
2005,Urban,Arunachal Pradesh,Crime Against Men,Robbery,Female,18-30,2905,2398,507,2683,222
2005,Rural,Jharkhand,Other Crimes,Corruption,Male,31-45,518,376,142,429,89
2005,Rural,Sikkim,Crime Against Men,Robbery,Male,46-60,6334,2153,4181,5102,1232
2004,Urban,Nagaland,Crime Against Men,Robbery,Male,18-30,6570,4970,1600,6430,140
2007,Rural,Odisha,Crime Against Children,Kidnapping,Male,0-12,7941,5137,2804,7491,450
2003,Urban,Punjab,Other Crimes,Corruption,Male,13-17,7154,5754,1400,6154,1000
2010,Rural,Gujarat,Other Crimes,Drug Offense,Female,46-60,348,284,64,338,10
2010,Rural,Mizoram,Crime Against Children,Trafficking,Male,46-60,1893,1279,614,1663,230
2007,Rural,Rajasthan,Property Crime,Burglary,Male,46-60,3280,3086,194,3152,128
2005,Rural,West Bengal,Crime Against Men,Assault,Female,31-45,3478,592,2886,2270,1208
2008,Urban,Goa,Crime Against Children,Kidnapping,Female,13-17,6488,3032,3456,5457,1031
2010,Urban,Mizoram,Other Crimes,Corruption,Female,0-12,833,81,752,452,381
2004,Rural,Goa,Crime Against Children,Child Labor,Male,0-12,5948,363,5585,4508,1440
2002,Rural,Tripura,Other Crimes,Corruption,Female,13-17,293,233,60,254,39
2008,Rural,Madhya Pradesh,Crime Against Children,Child Labor,Male,13-17,60,49,11,52,8
2006,Rural,Arunachal Pradesh,Property Crime,Burglary,Female,60+,5286,947,4339,4489,797
2010,Urban,Tripura,Crime Against Children,Kidnapping,Male,46-60,5737,4111,1626,4574,1163
2010,Urban,Telangana,Crime Against Men,Robbery,Female,0-12,8903,7692,1211,8671,232
2010,Rural,Mizoram,Crime Against Men,Extortion,Female,13-17,6413,1628,4785,3388,3025
2008,Rural,Gujarat,Property Crime,Burglary,Female,13-17,7653,5049,2604,5658,1995
2002,Urban,Nagaland,Other Crimes,Drug Offense,Female,31-45,6559,6256,303,6361,198
2008,Urban,Chhattisgarh,Crime Against Men,Extortion,Male,13-17,6099,5122,977,5967,132
2008,Urban,Andhra Pradesh,Property Crime,Burglary,Female,60+,4306,2264,2042,3006,1300
2001,Urban,Jharkhand,Property Crime,Arson,Male,18-30,8183,3444,4739,6686,1497
2006,Rural,West Bengal,Crime Against Men,Assault,Male,31-45,8310,4471,3839,5256,3054
2008,Rural,West Bengal,Other Crimes,Drug Offense,Female,13-17,1059,321,738,1034,25
2003,Rural,Tamil Nadu,Property Crime,Theft,Male,60+,3704,2152,1552,2631,1073
2006,Urban,Maharashtra,Crime Against Men,Assault,Male,0-12,5100,1190,3910,2042,3058
2009,Rural,Uttarakhand,Crime Against Children,Kidnapping,Female,18-30,2681,1565,1116,2031,650
2009,Rural,West Bengal,Crime Against Women,Molestation,Male,0-12,7432,2034,5398,6309,1123
2008,Rural,Sikkim,Crime Against Men,Murder,Male,18-30,9249,1623,7626,6711,2538
2002,Rural,Andhra Pradesh,Crime Against Children,Trafficking,Male,31-45,9101,565,8536,3399,5702
2007,Urban,Haryana,Crime Against Children,Kidnapping,Male,18-30,4152,2210,1942,2425,1727
2010,Urban,Nagaland,Crime Against Children,Trafficking,Male,60+,773,119,654,710,63
2010,Rural,Odisha,Crime Against Children,Kidnapping,Male,31-45,856,355,501,417,439
2010,Rural,Tripura,Crime Against Children,Kidnapping,Male,46-60,8554,6022,2532,8075,479
2002,Urban,Maharashtra,Crime Against Children,Kidnapping,Male,31-45,5601,5260,341,5426,175
2006,Rural,Andhra Pradesh,Crime Against Women,Rape,Male,18-30,5319,3786,1533,4507,812
2003,Rural,Goa,Other Crimes,Corruption,Female,0-12,8205,318,7887,4276,3929
2005,Rural,Nagaland,Other Crimes,Drug Offense,Male,0-12,1096,484,612,746,350
2004,Urban,Himachal Pradesh,Other Crimes,Corruption,Male,31-45,8300,3124,5176,5182,3118
2003,Rural,Uttarakhand,Crime Against Women,Rape,Male,13-17,2528,2180,348,2514,14
2005,Rural,Maharashtra,Crime Against Men,Robbery,Male,60+,4735,2400,2335,3739,996
2010,Urban,Meghalaya,Crime Against Children,Child Labor,Male,31-45,3192,3014,178,3028,164
2006,Rural,Tamil Nadu,Property Crime,Arson,Female,31-45,6329,5164,1165,6316,13
2006,Rural,Andhra Pradesh,Crime Against Men,Assault,Female,31-45,3236,2587,649,2848,388
2005,Urban,Uttarakhand,Crime Against Children,Kidnapping,Male,13-17,3732,3148,584,3424,308
2007,Rural,Andhra Pradesh,Crime Against Women,Domestic Violence,Female,46-60,6484,6374,110,6484,0
2002,Rural,Uttar Pradesh,Crime Against Children,Trafficking,Female,13-17,9189,5374,3815,7063,2126
2004,Urban,Chhattisgarh,Crime Against Men,Robbery,Male,18-30,7762,1047,6715,2844,4918
2002,Urban,Himachal Pradesh,Property Crime,Theft,Female,0-12,9844,533,9311,3052,6792
2006,Rural,Andhra Pradesh,Other Crimes,Corruption,Female,18-30,2977,1101,1876,1201,1776
2009,Urban,Tamil Nadu,Property Crime,Burglary,Female,46-60,5195,3778,1417,4601,594
2010,Rural,Kerala,Crime Against Women,Dowry Deaths,Male,31-45,3774,925,2849,3115,659
2003,Urban,Sikkim,Crime Against Men,Murder,Female,60+,4015,2056,1959,3176,839
2008,Urban,Kerala,Crime Against Men,Murder,Female,0-12,5053,2180,2873,4244,809
2004,Urban,Punjab,Property Crime,Theft,Female,31-45,6546,5545,1001,6412,134
2009,Urban,Kerala,Property Crime,Arson,Male,60+,7106,4737,2369,6459,647
2007,Rural,Punjab,Other Crimes,Cyber Crime,Female,31-45,8857,103,8754,3168,5689
2008,Urban,Nagaland,Crime Against Women,Molestation,Female,31-45,1949,1687,262,1948,1
2007,Rural,Arunachal Pradesh,Crime Against Women,Domestic Violence,Female,60+,1315,569,746,829,486
2007,Rural,Delhi,Property Crime,Burglary,Male,31-45,7068,4517,2551,5289,1779
2010,Urban,Karnataka,Crime Against Men,Extortion,Female,46-60,2687,690,1997,1255,1432
2007,Urban,Jharkhand,Crime Against Women,Dowry Deaths,Male,60+,824,201,623,257,567
2008,Rural,Chhattisgarh,Property Crime,Vandalism,Male,60+,6126,6090,36,6124,2
2010,Rural,Jammu & Kashmir,Other Crimes,Cyber Crime,Female,13-17,3449,1802,1647,1984,1465
2005,Urban,Karnataka,Crime Against Women,Molestation,Female,13-17,2076,1130,946,1341,735
2006,Urban,Sikkim,Crime Against Children,Kidnapping,Female,46-60,1826,141,1685,362,1464
2009,Urban,Maharashtra,Crime Against Women,Rape,Female,31-45,8972,626,8346,8199,773
2001,Urban,Uttar Pradesh,Other Crimes,Cyber Crime,Female,0-12,3015,2322,693,2725,290
2001,Urban,West Bengal,Other Crimes,Fraud,Male,46-60,4966,507,4459,3082,1884
2004,Rural,Odisha,Crime Against Women,Rape,Female,18-30,7868,5001,2867,5982,1886
2003,Rural,Punjab,Crime Against Children,Trafficking,Female,0-12,5844,2609,3235,3843,2001
2005,Urban,Maharashtra,Crime Against Children,Child Abuse,Female,31-45,201,67,134,137,64
2004,Rural,Uttar Pradesh,Crime Against Women,Rape,Male,0-12,3234,1068,2166,1654,1580
2010,Rural,Tripura,Crime Against Men,Murder,Male,18-30,3308,223,3085,3149,159
2007,Urban,Punjab,Crime Against Children,Kidnapping,Female,46-60,8500,4667,3833,6206,2294
2009,Urban,Punjab,Crime Against Women,Domestic Violence,Male,60+,9577,1292,8285,5255,4322
2009,Urban,Punjab,Crime Against Men,Extortion,Female,18-30,6883,1244,5639,6076,807
2003,Rural,Sikkim,Crime Against Men,Extortion,Female,60+,4438,4010,428,4089,349
2001,Urban,Karnataka,Crime Against Children,Trafficking,Female,18-30,8438,1316,7122,3788,4650
2009,Rural,West Bengal,Property Crime,Burglary,Male,60+,6284,1213,5071,4320,1964
2009,Urban,Haryana,Crime Against Men,Robbery,Female,18-30,9456,6504,2952,9001,455
2003,Urban,Karnataka,Crime Against Men,Assault,Female,31-45,2402,802,1600,1916,486
2005,Rural,Delhi,Other Crimes,Drug Offense,Male,13-17,1238,1001,237,1206,32
2008,Rural,Tripura,Crime Against Women,Dowry Deaths,Male,13-17,5849,1610,4239,4607,1242
2007,Urban,Karnataka,Property Crime,Burglary,Male,0-12,5717,1818,3899,5659,58
2001,Urban,Maharashtra,Other Crimes,Drug Offense,Female,46-60,6756,1681,5075,3510,3246
2006,Urban,Bihar,Crime Against Children,Kidnapping,Male,18-30,1426,62,1364,1391,35
2004,Urban,Nagaland,Crime Against Children,Trafficking,Female,46-60,5145,3568,1577,4820,325
2002,Urban,Jammu & Kashmir,Property Crime,Arson,Male,18-30,742,140,602,388,354
2003,Urban,Mizoram,Crime Against Children,Kidnapping,Male,18-30,5551,1214,4337,1389,4162
2002,Urban,Arunachal Pradesh,Crime Against Children,Trafficking,Male,13-17,3327,2404,923,3251,76
2003,Urban,Punjab,Crime Against Children,Kidnapping,Female,13-17,7207,5782,1425,6672,535
2008,Urban,West Bengal,Other Crimes,Cyber Crime,Female,0-12,3399,1038,2361,2869,530
2004,Urban,Karnataka,Crime Against Women,Dowry Deaths,Female,31-45,189,40,149,161,28
2004,Rural,Tamil Nadu,Crime Against Women,Molestation,Male,60+,4403,1513,2890,2338,2065
2010,Urban,Chhattisgarh,Property Crime,Vandalism,Female,0-12,7823,6209,1614,6438,1385
2002,Rural,Telangana,Crime Against Children,Child Labor,Male,46-60,773,346,427,668,105
2008,Urban,Assam,Crime Against Children,Child Labor,Female,46-60,7697,1188,6509,6258,1439
2010,Rural,Himachal Pradesh,Crime Against Men,Murder,Male,46-60,260,168,92,217,43
2008,Rural,Madhya Pradesh,Crime Against Women,Molestation,Male,0-12,2766,1148,1618,2469,297
2006,Rural,West Bengal,Crime Against Women,Molestation,Male,0-12,4896,224,4672,240,4656
2008,Rural,Mizoram,Other Crimes,Drug Offense,Female,46-60,6071,3773,2298,4163,1908
2007,Rural,Maharashtra,Crime Against Women,Domestic Violence,Male,18-30,4290,763,3527,801,3489
2001,Rural,Assam,Crime Against Women,Rape,Female,31-45,3256,207,3049,1579,1677
2008,Urban,Haryana,Crime Against Men,Robbery,Male,0-12,84,79,5,82,2
2009,Urban,Chhattisgarh,Crime Against Children,Child Abuse,Male,18-30,2546,1672,874,2278,268
2002,Rural,Punjab,Crime Against Women,Domestic Violence,Female,13-17,8711,1408,7303,3672,5039
2010,Urban,Gujarat,Other Crimes,Drug Offense,Male,60+,9335,6573,2762,8217,1118
2005,Rural,Tamil Nadu,Other Crimes,Drug Offense,Female,18-30,2239,341,1898,694,1545
2006,Urban,Mizoram,Crime Against Men,Extortion,Male,13-17,7561,6887,674,7455,106
2010,Urban,Telangana,Crime Against Men,Robbery,Male,13-17,3264,1372,1892,1400,1864
2002,Urban,Karnataka,Crime Against Women,Dowry Deaths,Female,0-12,1322,1006,316,1235,87
2006,Rural,Manipur,Crime Against Men,Murder,Female,46-60,1260,1006,254,1136,124
2007,Rural,Rajasthan,Property Crime,Burglary,Female,46-60,9295,3065,6230,5980,3315
2006,Rural,Maharashtra,Other Crimes,Corruption,Male,0-12,5136,4768,368,4890,246
2003,Rural,Jammu & Kashmir,Crime Against Men,Robbery,Male,60+,2159,1049,1110,1757,402
2003,Urban,Meghalaya,Crime Against Children,Child Abuse,Female,13-17,3066,604,2462,1176,1890
2006,Rural,Jharkhand,Crime Against Children,Trafficking,Male,60+,9777,4823,4954,7265,2512
2005,Urban,Uttar Pradesh,Crime Against Men,Robbery,Male,46-60,81,17,64,49,32
2003,Rural,Telangana,Other Crimes,Corruption,Female,18-30,6961,734,6227,1452,5509
2007,Rural,Karnataka,Property Crime,Arson,Female,46-60,558,204,354,223,335
2003,Rural,Andhra Pradesh,Other Crimes,Cyber Crime,Male,0-12,4064,416,3648,2680,1384
2009,Rural,Mizoram,Property Crime,Burglary,Female,18-30,4695,2833,1862,3398,1297
2002,Urban,Kerala,Other Crimes,Cyber Crime,Male,0-12,7737,4419,3318,5194,2543
2003,Rural,Arunachal Pradesh,Property Crime,Arson,Male,46-60,774,670,104,704,70
2002,Urban,Tripura,Property Crime,Theft,Male,60+,4217,1200,3017,3608,609
2001,Rural,Arunachal Pradesh,Other Crimes,Drug Offense,Male,46-60,2947,99,2848,2119,828
2005,Rural,Bihar,Other Crimes,Cyber Crime,Male,18-30,8228,2992,5236,4091,4137
2006,Rural,Kerala,Crime Against Children,Child Abuse,Male,60+,5931,4793,1138,5911,20
2010,Rural,Bihar,Crime Against Children,Trafficking,Female,60+,595,362,233,510,85
2004,Urban,Uttarakhand,Other Crimes,Corruption,Male,60+,2690,2218,472,2586,104
2003,Urban,Nagaland,Crime Against Men,Assault,Male,60+,7450,2932,4518,6391,1059
2009,Rural,Manipur,Crime Against Children,Trafficking,Female,13-17,4016,1952,2064,2854,1162
2008,Urban,Maharashtra,Property Crime,Arson,Female,60+,6650,3972,2678,6539,111
2009,Rural,Maharashtra,Property Crime,Arson,Female,60+,1728,847,881,943,785
2009,Urban,West Bengal,Crime Against Men,Robbery,Male,0-12,4310,3801,509,3839,471
2010,Rural,Gujarat,Crime Against Children,Kidnapping,Male,60+,6486,2356,4130,4929,1557
2007,Rural,West Bengal,Property Crime,Theft,Female,18-30,8116,6118,1998,6717,1399
2004,Rural,Himachal Pradesh,Crime Against Children,Child Abuse,Female,60+,6046,2142,3904,3966,2080
2001,Rural,Goa,Crime Against Children,Child Abuse,Female,60+,2321,1883,438,2297,24
2007,Rural,Jammu & Kashmir,Property Crime,Arson,Male,46-60,1886,750,1136,1455,431
2010,Urban,Manipur,Crime Against Men,Murder,Female,18-30,1124,314,810,623,501
2002,Rural,Kerala,Crime Against Children,Trafficking,Male,0-12,1417,659,758,1022,395
2010,Urban,West Bengal,Crime Against Men,Assault,Male,46-60,7476,4533,2943,5691,1785
2001,Urban,Gujarat,Crime Against Women,Domestic Violence,Female,13-17,3926,1592,2334,3585,341
2006,Urban,Maharashtra,Crime Against Men,Assault,Male,13-17,7369,768,6601,5208,2161
2003,Rural,Gujarat,Crime Against Women,Dowry Deaths,Male,13-17,9268,5062,4206,5430,3838
2008,Urban,Odisha,Crime Against Women,Rape,Female,18-30,7692,6112,1580,7069,623
2002,Urban,Uttarakhand,Crime Against Men,Assault,Male,60+,3645,390,3255,715,2930
2008,Rural,Mizoram,Crime Against Children,Kidnapping,Male,13-17,8424,1169,7255,6341,2083
2004,Rural,Manipur,Other Crimes,Cyber Crime,Male,60+,5244,4118,1126,4282,962
2002,Rural,Sikkim,Property Crime,Arson,Male,13-17,9959,964,8995,1359,8600
2008,Rural,Tripura,Crime Against Men,Murder,Male,46-60,5859,4558,1301,5672,187
2003,Rural,Haryana,Crime Against Women,Dowry Deaths,Male,60+,5534,2536,2998,3933,1601
2004,Urban,Karnataka,Property Crime,Burglary,Female,46-60,147,90,57,107,40
2001,Urban,Mizoram,Crime Against Men,Murder,Female,0-12,7814,3156,4658,7502,312
2006,Urban,Meghalaya,Property Crime,Theft,Male,46-60,8134,6596,1538,8043,91
2002,Rural,Gujarat,Other Crimes,Drug Offense,Female,13-17,7975,2676,5299,7471,504
2001,Urban,Odisha,Property Crime,Theft,Female,46-60,527,40,487,445,82
2010,Rural,Chhattisgarh,Crime Against Men,Murder,Female,31-45,3527,369,3158,654,2873
2005,Rural,Chhattisgarh,Crime Against Children,Kidnapping,Male,46-60,8601,1452,7149,7129,1472
2006,Rural,Assam,Crime Against Children,Child Labor,Male,31-45,2968,283,2685,1920,1048
2008,Rural,Maharashtra,Crime Against Women,Rape,Male,13-17,8008,4274,3734,7497,511
2009,Urban,Andhra Pradesh,Crime Against Children,Trafficking,Male,60+,6249,4152,2097,5290,959
2004,Rural,Sikkim,Other Crimes,Fraud,Male,46-60,9246,8308,938,8965,281
2009,Rural,Arunachal Pradesh,Crime Against Women,Molestation,Male,46-60,9125,4702,4423,4966,4159
2003,Urban,Haryana,Crime Against Men,Murder,Male,18-30,5045,3558,1487,3733,1312
2001,Rural,Odisha,Other Crimes,Drug Offense,Male,60+,1443,148,1295,1196,247
2003,Rural,Manipur,Crime Against Men,Assault,Male,18-30,2957,581,2376,2070,887
2006,Rural,Nagaland,Crime Against Men,Murder,Male,31-45,7457,7377,80,7378,79
2010,Rural,Jharkhand,Crime Against Children,Child Labor,Male,31-45,5354,4834,520,4938,416
2003,Rural,Jammu & Kashmir,Property Crime,Arson,Male,13-17,7081,2278,4803,6176,905
2008,Urban,Tamil Nadu,Crime Against Children,Child Abuse,Female,60+,6453,1580,4873,1679,4774
2008,Urban,Chhattisgarh,Crime Against Children,Kidnapping,Male,31-45,4243,506,3737,655,3588
2006,Urban,Madhya Pradesh,Other Crimes,Fraud,Male,0-12,9502,3530,5972,7539,1963
2004,Rural,Jammu & Kashmir,Crime Against Men,Extortion,Female,13-17,9083,531,8552,7781,1302
2006,Rural,Gujarat,Property Crime,Burglary,Male,31-45,1860,1181,679,1404,456
2003,Urban,Uttarakhand,Property Crime,Burglary,Female,31-45,9750,7117,2633,8160,1590
2010,Urban,Kerala,Other Crimes,Fraud,Female,31-45,6331,3352,2979,6182,149
2006,Urban,Manipur,Property Crime,Theft,Male,18-30,1142,316,826,461,681
2008,Rural,Nagaland,Property Crime,Burglary,Male,31-45,4690,121,4569,2315,2375
2003,Urban,Meghalaya,Crime Against Women,Dowry Deaths,Female,60+,7305,1089,6216,6744,561
2009,Rural,Mizoram,Crime Against Women,Rape,Female,18-30,1170,974,196,1140,30
2005,Urban,Andhra Pradesh,Other Crimes,Drug Offense,Female,60+,919,148,771,907,12
2004,Urban,Manipur,Crime Against Women,Domestic Violence,Female,13-17,8169,3958,4211,4819,3350
2003,Rural,Mizoram,Crime Against Children,Kidnapping,Male,60+,179,169,10,179,0
2003,Rural,Madhya Pradesh,Other Crimes,Drug Offense,Male,31-45,5698,4405,1293,4701,997
2006,Urban,Madhya Pradesh,Property Crime,Burglary,Male,46-60,8739,4936,3803,5072,3667
2008,Rural,Mizoram,Crime Against Women,Rape,Male,18-30,8080,5678,2402,7168,912
2001,Urban,Goa,Crime Against Men,Assault,Male,31-45,5437,1822,3615,3890,1547
2001,Urban,Bihar,Property Crime,Vandalism,Male,18-30,3804,3197,607,3257,547
2005,Urban,Nagaland,Other Crimes,Cyber Crime,Female,0-12,3698,1624,2074,3201,497
2009,Urban,Uttar Pradesh,Crime Against Men,Murder,Male,46-60,6438,4547,1891,5067,1371
2003,Urban,Jharkhand,Other Crimes,Corruption,Female,0-12,7159,6619,540,6681,478
2006,Rural,Assam,Crime Against Women,Molestation,Male,13-17,249,217,32,226,23
2010,Urban,Goa,Crime Against Women,Domestic Violence,Male,31-45,1941,113,1828,533,1408
2010,Urban,Tamil Nadu,Property Crime,Arson,Male,60+,5277,5125,152,5169,108
2009,Rural,Rajasthan,Property Crime,Burglary,Female,18-30,7240,3075,4165,5835,1405
2006,Urban,Nagaland,Crime Against Women,Dowry Deaths,Female,60+,6403,4540,1863,4953,1450
2004,Urban,Chhattisgarh,Crime Against Women,Molestation,Male,18-30,4399,1946,2453,1996,2403
2007,Urban,Haryana,Crime Against Women,Dowry Deaths,Male,0-12,185,27,158,128,57
2007,Rural,West Bengal,Crime Against Women,Domestic Violence,Male,18-30,5487,177,5310,1618,3869
2005,Urban,Assam,Crime Against Men,Robbery,Female,60+,6181,329,5852,3474,2707
2006,Rural,Mizoram,Property Crime,Theft,Male,31-45,2094,600,1494,1076,1018
2005,Rural,Gujarat,Property Crime,Burglary,Male,0-12,2177,1415,762,1657,520
2008,Urban,Delhi,Crime Against Men,Murder,Female,31-45,178,176,2,177,1
2006,Rural,Tripura,Crime Against Women,Dowry Deaths,Female,31-45,9476,5627,3849,6699,2777
2010,Rural,Assam,Crime Against Women,Dowry Deaths,Male,0-12,7467,7159,308,7202,265
2006,Urban,Maharashtra,Other Crimes,Drug Offense,Female,0-12,2169,230,1939,1503,666
2006,Rural,Tamil Nadu,Crime Against Women,Domestic Violence,Female,18-30,9470,1113,8357,2308,7162
2004,Rural,Himachal Pradesh,Property Crime,Theft,Female,46-60,4689,4353,336,4533,156
2006,Rural,Jammu & Kashmir,Crime Against Men,Extortion,Male,46-60,5124,3280,1844,4155,969
2003,Rural,Jammu & Kashmir,Crime Against Men,Robbery,Female,13-17,4074,4017,57,4046,28
2005,Urban,Manipur,Crime Against Children,Child Labor,Female,13-17,1514,770,744,850,664
2003,Rural,Gujarat,Other Crimes,Drug Offense,Male,46-60,4856,484,4372,4313,543
2002,Urban,Goa,Property Crime,Vandalism,Male,31-45,5432,2217,3215,4174,1258
2006,Urban,West Bengal,Crime Against Women,Rape,Female,31-45,4507,2773,1734,2970,1537
2009,Rural,Tripura,Crime Against Men,Extortion,Male,46-60,646,155,491,629,17
2007,Urban,Telangana,Crime Against Children,Kidnapping,Male,46-60,3831,3322,509,3764,67
2010,Rural,Bihar,Other Crimes,Fraud,Female,18-30,3396,1376,2020,2935,461
2008,Urban,Manipur,Crime Against Children,Trafficking,Female,13-17,1311,451,860,1193,118
2005,Urban,Delhi,Property Crime,Burglary,Female,13-17,8749,6514,2235,8602,147
2001,Urban,Gujarat,Crime Against Children,Kidnapping,Male,31-45,3466,2633,833,2698,768
2001,Urban,Delhi,Other Crimes,Drug Offense,Male,18-30,597,411,186,549,48
2007,Urban,Haryana,Crime Against Men,Assault,Female,60+,7849,2542,5307,6784,1065
2003,Urban,Manipur,Crime Against Men,Extortion,Female,60+,1754,1399,355,1731,23
2007,Urban,Himachal Pradesh,Property Crime,Arson,Female,0-12,9862,7701,2161,8384,1478
2010,Urban,Arunachal Pradesh,Crime Against Children,Child Labor,Female,18-30,5157,18,5139,326,4831
2002,Urban,Maharashtra,Crime Against Women,Molestation,Female,0-12,5758,4348,1410,4391,1367
2010,Urban,Chhattisgarh,Other Crimes,Corruption,Male,18-30,2638,1334,1304,2596,42
2010,Rural,Madhya Pradesh,Other Crimes,Drug Offense,Female,31-45,6291,325,5966,2107,4184
2006,Rural,Manipur,Other Crimes,Drug Offense,Female,31-45,8585,1706,6879,8271,314
2010,Rural,Manipur,Crime Against Women,Rape,Female,46-60,1512,1444,68,1485,27
2006,Urban,Jharkhand,Crime Against Children,Child Abuse,Male,60+,2607,2489,118,2555,52
2003,Rural,Mizoram,Crime Against Men,Assault,Female,13-17,274,230,44,250,24
2002,Urban,Goa,Crime Against Children,Kidnapping,Male,60+,3921,2571,1350,2803,1118
2008,Rural,Tripura,Property Crime,Theft,Female,18-30,9240,7143,2097,8958,282
2003,Rural,Karnataka,Other Crimes,Drug Offense,Female,18-30,8743,8108,635,8541,202
2002,Urban,Himachal Pradesh,Other Crimes,Cyber Crime,Male,13-17,7397,6564,833,7360,37
2010,Urban,Uttar Pradesh,Crime Against Men,Extortion,Male,31-45,6388,1274,5114,2409,3979
2008,Rural,Odisha,Crime Against Women,Molestation,Male,46-60,2948,2553,395,2793,155
2009,Rural,Sikkim,Crime Against Women,Molestation,Male,13-17,3271,2802,469,3225,46
2005,Urban,Delhi,Crime Against Children,Trafficking,Male,13-17,2213,742,1471,1847,366
2006,Rural,Manipur,Crime Against Children,Kidnapping,Male,0-12,4319,1825,2494,2880,1439
2008,Rural,Madhya Pradesh,Other Crimes,Drug Offense,Female,60+,2771,1888,883,1889,882
2010,Rural,Meghalaya,Crime Against Children,Child Labor,Female,13-17,9803,6518,3285,9688,115
2001,Rural,Delhi,Crime Against Women,Rape,Male,46-60,9342,7982,1360,8963,379
2006,Rural,Jammu & Kashmir,Crime Against Women,Rape,Male,0-12,118,17,101,27,91
2004,Rural,Odisha,Other Crimes,Drug Offense,Male,13-17,6066,3291,2775,5446,620
2006,Rural,Chhattisgarh,Crime Against Women,Dowry Deaths,Male,31-45,7100,2193,4907,6513,587
2005,Urban,Jammu & Kashmir,Crime Against Women,Rape,Male,18-30,7296,5174,2122,6600,696
2004,Urban,Delhi,Crime Against Women,Dowry Deaths,Male,0-12,1749,368,1381,464,1285
2008,Rural,Madhya Pradesh,Crime Against Men,Extortion,Male,60+,8535,5947,2588,8079,456
2006,Rural,Punjab,Crime Against Women,Dowry Deaths,Male,18-30,1793,1718,75,1719,74
2009,Rural,Meghalaya,Other Crimes,Corruption,Male,46-60,5594,1524,4070,3803,1791
2008,Urban,Himachal Pradesh,Other Crimes,Fraud,Male,60+,8429,5746,2683,7140,1289
2001,Urban,Karnataka,Crime Against Men,Robbery,Male,0-12,2110,1781,329,2006,104
2005,Rural,Odisha,Property Crime,Burglary,Male,18-30,4801,2765,2036,3507,1294
2003,Urban,Maharashtra,Crime Against Children,Child Labor,Female,60+,8518,133,8385,1119,7399
2008,Urban,Odisha,Crime Against Children,Kidnapping,Male,0-12,6667,637,6030,3577,3090
2009,Rural,Karnataka,Other Crimes,Cyber Crime,Female,31-45,2301,1151,1150,1844,457
2006,Rural,Uttar Pradesh,Property Crime,Arson,Male,46-60,5148,4145,1003,5028,120
2003,Rural,Sikkim,Crime Against Women,Rape,Female,13-17,7767,1990,5777,5692,2075
2005,Rural,Jammu & Kashmir,Crime Against Women,Domestic Violence,Female,18-30,5039,2916,2123,3271,1768
2009,Urban,Karnataka,Other Crimes,Drug Offense,Male,46-60,1177,863,314,1166,11
2010,Urban,Tripura,Other Crimes,Cyber Crime,Male,46-60,3051,2890,161,3046,5
2001,Rural,West Bengal,Crime Against Children,Child Abuse,Male,60+,5310,3521,1789,4603,707
2001,Urban,Manipur,Property Crime,Arson,Female,13-17,4121,1512,2609,3027,1094
2003,Rural,Delhi,Other Crimes,Drug Offense,Male,46-60,3764,3237,527,3268,496
2009,Rural,Goa,Crime Against Children,Trafficking,Female,46-60,1450,42,1408,896,554
2005,Urban,Assam,Crime Against Children,Kidnapping,Male,60+,8093,7187,906,7211,882
2001,Urban,Jharkhand,Property Crime,Burglary,Female,60+,7993,4357,3636,5103,2890
2008,Rural,Jammu & Kashmir,Crime Against Children,Child Abuse,Male,18-30,1357,1196,161,1285,72
2005,Urban,Gujarat,Crime Against Women,Domestic Violence,Male,13-17,9546,6033,3513,8496,1050
2010,Urban,Odisha,Property Crime,Arson,Male,13-17,929,351,578,750,179
2004,Rural,Maharashtra,Crime Against Children,Trafficking,Male,31-45,237,112,125,138,99
2010,Rural,Kerala,Other Crimes,Cyber Crime,Male,13-17,3881,924,2957,3381,500
2001,Urban,Punjab,Other Crimes,Cyber Crime,Female,18-30,5406,3875,1531,4830,576
2005,Rural,Maharashtra,Property Crime,Arson,Female,13-17,4485,1178,3307,3251,1234
2010,Rural,Andhra Pradesh,Property Crime,Theft,Male,60+,3189,1645,1544,3036,153
2003,Rural,Tamil Nadu,Crime Against Men,Assault,Female,60+,8377,6145,2232,8296,81
2004,Urban,Andhra Pradesh,Crime Against Men,Robbery,Female,60+,6715,2185,4530,3306,3409
2004,Rural,Haryana,Other Crimes,Drug Offense,Female,60+,5069,544,4525,4759,310
2006,Rural,Jammu & Kashmir,Crime Against Men,Assault,Female,60+,3982,3664,318,3944,38
2004,Urban,Punjab,Property Crime,Theft,Male,0-12,6349,4684,1665,6018,331
2002,Urban,Manipur,Other Crimes,Fraud,Male,13-17,3879,2993,886,3414,465
2010,Rural,Tripura,Property Crime,Theft,Male,31-45,7764,4527,3237,6743,1021
2003,Urban,Jammu & Kashmir,Crime Against Children,Child Abuse,Male,60+,3197,420,2777,1010,2187
2003,Urban,Andhra Pradesh,Crime Against Women,Domestic Violence,Male,0-12,5303,1272,4031,1301,4002
2008,Urban,Andhra Pradesh,Other Crimes,Fraud,Female,46-60,6863,717,6146,3870,2993
2004,Rural,Mizoram,Crime Against Children,Trafficking,Male,46-60,7567,615,6952,4064,3503
2008,Rural,Jharkhand,Crime Against Men,Robbery,Male,18-30,2004,1666,338,1886,118
2001,Rural,Bihar,Other Crimes,Drug Offense,Female,0-12,6274,2706,3568,2891,3383
2005,Rural,Sikkim,Other Crimes,Fraud,Male,60+,2501,2062,439,2294,207
2007,Urban,Kerala,Other Crimes,Drug Offense,Male,13-17,3893,3379,514,3593,300
2008,Urban,Uttar Pradesh,Crime Against Children,Child Labor,Male,13-17,4085,1830,2255,3065,1020
2005,Rural,Manipur,Other Crimes,Fraud,Male,0-12,948,702,246,812,136
2003,Urban,Arunachal Pradesh,Crime Against Children,Child Abuse,Male,13-17,2916,1007,1909,1923,993
2008,Rural,Tamil Nadu,Crime Against Men,Assault,Female,13-17,2634,206,2428,358,2276
2001,Rural,Kerala,Property Crime,Burglary,Female,46-60,5405,895,4510,3367,2038
2004,Rural,Telangana,Other Crimes,Fraud,Male,46-60,1137,795,342,828,309
2005,Urban,Sikkim,Crime Against Children,Kidnapping,Male,0-12,8274,5713,2561,6942,1332
2006,Urban,Madhya Pradesh,Property Crime,Theft,Female,60+,7312,1529,5783,6370,942
2003,Urban,Jammu & Kashmir,Property Crime,Vandalism,Male,60+,4970,4872,98,4963,7
2003,Rural,Uttar Pradesh,Property Crime,Vandalism,Female,60+,6208,5751,457,6196,12
2004,Urban,Tamil Nadu,Crime Against Men,Assault,Female,31-45,556,284,272,357,199
2003,Rural,Rajasthan,Other Crimes,Cyber Crime,Male,46-60,3847,2762,1085,3652,195
2007,Urban,Assam,Property Crime,Theft,Male,0-12,807,386,421,679,128
2003,Rural,Uttar Pradesh,Other Crimes,Drug Offense,Female,60+,382,215,167,263,119
2007,Urban,Goa,Crime Against Women,Dowry Deaths,Female,13-17,415,13,402,32,383
2010,Rural,Gujarat,Other Crimes,Fraud,Female,18-30,8660,4150,4510,8436,224
2002,Rural,Kerala,Crime Against Men,Assault,Female,46-60,930,248,682,758,172
2004,Urban,Madhya Pradesh,Property Crime,Burglary,Male,46-60,2827,609,2218,2254,573
2005,Rural,Meghalaya,Other Crimes,Drug Offense,Female,18-30,2600,1149,1451,2033,567
2001,Rural,Karnataka,Property Crime,Vandalism,Female,31-45,5189,4818,371,4870,319
2010,Rural,Madhya Pradesh,Crime Against Women,Molestation,Female,13-17,7779,213,7566,5638,2141
2009,Rural,Karnataka,Property Crime,Arson,Male,18-30,6421,2870,3551,4077,2344
2004,Urban,Jammu & Kashmir,Crime Against Women,Dowry Deaths,Female,31-45,1145,751,394,1110,35
2007,Urban,Kerala,Crime Against Children,Child Abuse,Female,0-12,6433,5438,995,6279,154
2001,Urban,Nagaland,Property Crime,Burglary,Female,46-60,6726,1814,4912,6719,7
2009,Urban,Delhi,Crime Against Women,Dowry Deaths,Female,46-60,3641,3633,8,3638,3
2007,Rural,Telangana,Crime Against Children,Kidnapping,Female,13-17,8350,8165,185,8333,17
2003,Rural,Assam,Other Crimes,Drug Offense,Male,13-17,6740,4093,2647,5799,941
2001,Urban,Chhattisgarh,Crime Against Women,Dowry Deaths,Male,60+,6524,4368,2156,4897,1627
2004,Urban,Nagaland,Other Crimes,Fraud,Female,60+,6601,6546,55,6575,26
2008,Urban,Tamil Nadu,Property Crime,Theft,Female,60+,5532,1928,3604,3329,2203
2002,Urban,Arunachal Pradesh,Crime Against Children,Trafficking,Female,13-17,5593,4575,1018,4970,623
2006,Rural,Sikkim,Property Crime,Arson,Female,31-45,1934,852,1082,1391,543
2006,Urban,Kerala,Other Crimes,Corruption,Female,60+,2729,414,2315,1287,1442
2004,Rural,Jharkhand,Property Crime,Vandalism,Female,31-45,6417,3621,2796,3742,2675
2002,Urban,Maharashtra,Crime Against Men,Murder,Female,13-17,4140,2618,1522,2712,1428
2010,Rural,Gujarat,Crime Against Women,Dowry Deaths,Female,0-12,2701,456,2245,2391,310
2003,Rural,Bihar,Property Crime,Vandalism,Male,0-12,7365,3702,3663,4525,2840
2004,Rural,Karnataka,Crime Against Women,Molestation,Male,60+,2509,94,2415,860,1649
2004,Rural,Delhi,Property Crime,Vandalism,Male,13-17,1083,1050,33,1072,11
2004,Urban,Nagaland,Crime Against Men,Murder,Female,46-60,7308,246,7062,3359,3949
2007,Rural,Andhra Pradesh,Other Crimes,Fraud,Female,46-60,5694,5404,290,5654,40
2005,Rural,Tripura,Crime Against Children,Child Labor,Male,0-12,5763,2749,3014,3687,2076
2005,Rural,Haryana,Property Crime,Arson,Female,0-12,1207,306,901,425,782
2001,Rural,Tamil Nadu,Crime Against Men,Robbery,Female,18-30,2252,83,2169,938,1314
2010,Rural,Himachal Pradesh,Crime Against Children,Child Abuse,Female,46-60,7236,620,6616,1811,5425
2009,Rural,Gujarat,Property Crime,Vandalism,Female,0-12,7425,1382,6043,4010,3415
2003,Rural,Delhi,Crime Against Women,Molestation,Male,18-30,6107,792,5315,1787,4320
2005,Urban,Assam,Crime Against Men,Murder,Male,0-12,3069,1888,1181,2483,586
2002,Rural,Nagaland,Crime Against Children,Child Abuse,Male,60+,4146,4109,37,4141,5
2001,Urban,Tripura,Crime Against Men,Extortion,Female,31-45,3628,2013,1615,2452,1176
2009,Urban,Tripura,Crime Against Men,Assault,Male,31-45,1604,371,1233,678,926
2005,Urban,Uttar Pradesh,Property Crime,Arson,Female,46-60,9805,4901,4904,8032,1773
2010,Urban,Chhattisgarh,Property Crime,Arson,Male,18-30,2124,990,1134,1452,672
2002,Urban,Jharkhand,Property Crime,Burglary,Male,60+,9742,9140,602,9245,497
2007,Urban,Tripura,Crime Against Men,Robbery,Male,13-17,6747,1079,5668,6114,633
2006,Urban,Himachal Pradesh,Crime Against Men,Assault,Female,0-12,9741,5944,3797,8539,1202
2001,Urban,Meghalaya,Other Crimes,Drug Offense,Female,13-17,8329,1011,7318,6946,1383
2008,Rural,Mizoram,Other Crimes,Fraud,Male,46-60,8873,2512,6361,2776,6097
2005,Urban,Gujarat,Crime Against Women,Molestation,Male,0-12,5238,2525,2713,4775,463
2002,Urban,Assam,Crime Against Children,Kidnapping,Male,18-30,1655,533,1122,1167,488
2004,Urban,Assam,Other Crimes,Drug Offense,Male,18-30,1533,1417,116,1449,84
2009,Rural,Delhi,Property Crime,Theft,Male,0-12,4758,2725,2033,3755,1003
2008,Rural,Kerala,Property Crime,Burglary,Female,60+,2556,1721,835,2035,521
2006,Urban,Rajasthan,Crime Against Children,Trafficking,Male,18-30,3900,633,3267,887,3013
2006,Urban,Punjab,Other Crimes,Cyber Crime,Female,46-60,537,169,368,371,166
2003,Urban,Uttarakhand,Crime Against Women,Rape,Male,46-60,5738,3099,2639,3386,2352
2008,Urban,Sikkim,Crime Against Children,Child Abuse,Female,60+,6561,3055,3506,3772,2789
2009,Rural,Nagaland,Crime Against Men,Murder,Male,46-60,9571,6292,3279,8419,1152
2005,Rural,Himachal Pradesh,Crime Against Children,Kidnapping,Female,18-30,8931,2105,6826,2438,6493
2001,Rural,Tamil Nadu,Other Crimes,Drug Offense,Male,18-30,6564,3612,2952,6105,459
2001,Urban,Himachal Pradesh,Crime Against Men,Extortion,Male,18-30,6374,5032,1342,5352,1022
2010,Urban,Uttarakhand,Property Crime,Vandalism,Male,60+,386,377,9,384,2
2001,Rural,Manipur,Property Crime,Arson,Male,0-12,9800,358,9442,2639,7161
2001,Urban,Uttarakhand,Crime Against Men,Murder,Female,60+,1867,859,1008,1079,788
2006,Rural,Gujarat,Crime Against Men,Extortion,Male,60+,8359,3420,4939,3922,4437
2003,Rural,Uttar Pradesh,Crime Against Women,Dowry Deaths,Male,46-60,3769,1332,2437,3296,473
2006,Urban,Himachal Pradesh,Crime Against Women,Molestation,Female,18-30,3899,3362,537,3485,414
2002,Urban,Jammu & Kashmir,Crime Against Children,Child Labor,Male,60+,8563,1881,6682,6362,2201
2006,Rural,Punjab,Property Crime,Arson,Female,0-12,4853,4664,189,4811,42
2009,Urban,West Bengal,Property Crime,Burglary,Male,13-17,56,14,42,33,23
2006,Rural,Jammu & Kashmir,Crime Against Children,Child Abuse,Male,0-12,7311,7120,191,7297,14
2001,Rural,Nagaland,Crime Against Men,Robbery,Male,60+,6561,516,6045,5818,743
2006,Urban,Jharkhand,Other Crimes,Fraud,Male,31-45,4325,2733,1592,3194,1131
2002,Rural,Tripura,Other Crimes,Fraud,Male,0-12,6349,1497,4852,4885,1464
2007,Urban,Meghalaya,Other Crimes,Fraud,Female,18-30,9858,1444,8414,8149,1709
2002,Rural,Karnataka,Crime Against Men,Extortion,Male,46-60,5018,3548,1470,4180,838
2001,Rural,Telangana,Crime Against Men,Extortion,Male,0-12,328,54,274,166,162
2005,Rural,Haryana,Crime Against Children,Child Abuse,Male,13-17,4853,162,4691,2538,2315
2005,Rural,Meghalaya,Crime Against Women,Dowry Deaths,Female,46-60,6782,5855,927,6376,406
2003,Rural,West Bengal,Crime Against Men,Assault,Female,46-60,9645,7851,1794,9638,7
2006,Urban,Andhra Pradesh,Crime Against Women,Molestation,Female,0-12,2142,548,1594,1258,884
2004,Urban,Meghalaya,Crime Against Children,Child Labor,Male,31-45,4545,1917,2628,4243,302
2005,Rural,Manipur,Other Crimes,Cyber Crime,Male,0-12,8406,8310,96,8405,1
2004,Rural,Madhya Pradesh,Crime Against Women,Domestic Violence,Female,60+,8632,2526,6106,3032,5600
2009,Urban,Goa,Property Crime,Burglary,Male,13-17,6963,490,6473,2789,4174
2010,Rural,Chhattisgarh,Property Crime,Theft,Female,46-60,9968,3389,6579,5984,3984
2003,Urban,Uttar Pradesh,Crime Against Men,Assault,Female,18-30,2202,1555,647,1827,375
2007,Rural,Uttar Pradesh,Other Crimes,Drug Offense,Male,13-17,209,104,105,193,16
2006,Rural,Sikkim,Other Crimes,Fraud,Male,13-17,4898,4291,607,4669,229
2003,Rural,Gujarat,Other Crimes,Cyber Crime,Male,0-12,4482,3431,1051,4319,163
2001,Urban,Haryana,Crime Against Men,Extortion,Female,18-30,476,471,5,473,3
2007,Rural,Madhya Pradesh,Property Crime,Vandalism,Male,0-12,7706,4556,3150,6436,1270
2005,Urban,Tripura,Crime Against Women,Rape,Male,31-45,8139,7872,267,8071,68
2008,Urban,Jharkhand,Crime Against Men,Extortion,Male,60+,7657,4733,2924,5258,2399
2007,Urban,Delhi,Other Crimes,Fraud,Male,46-60,163,92,71,161,2
2003,Rural,Tripura,Crime Against Men,Murder,Male,13-17,9127,3305,5822,4648,4479
2009,Urban,Arunachal Pradesh,Crime Against Children,Child Abuse,Female,31-45,1228,224,1004,1208,20
2003,Urban,Jammu & Kashmir,Crime Against Women,Rape,Female,60+,1233,1069,164,1099,134
2002,Rural,Kerala,Property Crime,Burglary,Female,18-30,2967,114,2853,875,2092
2005,Urban,Odisha,Crime Against Women,Rape,Female,46-60,9269,2907,6362,5954,3315
2007,Urban,Delhi,Crime Against Women,Molestation,Male,18-30,9671,6876,2795,7950,1721
2005,Rural,Gujarat,Other Crimes,Corruption,Male,60+,8027,1626,6401,3706,4321
2007,Urban,Uttar Pradesh,Property Crime,Arson,Female,13-17,5364,5327,37,5341,23
2007,Urban,Telangana,Crime Against Men,Robbery,Female,46-60,5727,702,5025,2639,3088
2009,Urban,Punjab,Crime Against Men,Murder,Female,60+,5067,3676,1391,4784,283
2003,Urban,Jammu & Kashmir,Crime Against Children,Child Abuse,Female,18-30,3838,2960,878,3384,454
2001,Urban,Tamil Nadu,Crime Against Children,Trafficking,Male,0-12,840,145,695,278,562
2003,Urban,Andhra Pradesh,Crime Against Children,Child Labor,Female,18-30,7706,2342,5364,2541,5165
2009,Rural,Meghalaya,Property Crime,Vandalism,Male,18-30,5344,2608,2736,3626,1718
2002,Urban,Tamil Nadu,Other Crimes,Fraud,Female,31-45,3141,2845,296,3081,60
2008,Urban,West Bengal,Crime Against Children,Child Labor,Female,18-30,1871,632,1239,1321,550
2008,Rural,Uttarakhand,Property Crime,Vandalism,Male,31-45,5106,1228,3878,2593,2513
2004,Urban,Tripura,Property Crime,Vandalism,Male,0-12,6877,2073,4804,6058,819
2009,Urban,Meghalaya,Property Crime,Theft,Female,0-12,4364,2751,1613,2798,1566
2005,Urban,Nagaland,Other Crimes,Fraud,Male,18-30,7889,6667,1222,6958,931
2003,Urban,Jharkhand,Crime Against Children,Child Labor,Male,18-30,9441,4,9437,231,9210
2007,Urban,Odisha,Other Crimes,Cyber Crime,Male,0-12,5227,4339,888,4621,606
2003,Urban,Andhra Pradesh,Crime Against Children,Kidnapping,Female,0-12,6262,623,5639,3936,2326
2010,Urban,Punjab,Crime Against Women,Molestation,Female,60+,3134,1485,1649,2802,332
2002,Urban,Arunachal Pradesh,Other Crimes,Corruption,Male,31-45,4451,3618,833,4330,121
2009,Rural,Rajasthan,Crime Against Men,Assault,Male,13-17,9825,9177,648,9567,258
2004,Rural,West Bengal,Other Crimes,Drug Offense,Female,60+,2661,2420,241,2655,6
2007,Urban,Tripura,Crime Against Children,Kidnapping,Female,31-45,2987,1309,1678,2173,814
2005,Rural,Bihar,Crime Against Men,Extortion,Female,31-45,2224,824,1400,1417,807
2010,Rural,Meghalaya,Crime Against Children,Kidnapping,Male,60+,8250,1079,7171,1353,6897
2007,Rural,Telangana,Property Crime,Vandalism,Male,13-17,4839,3333,1506,4001,838
2002,Rural,Tripura,Crime Against Children,Kidnapping,Female,31-45,1958,138,1820,624,1334
2009,Urban,Karnataka,Crime Against Children,Kidnapping,Female,13-17,5827,1230,4597,4402,1425
2010,Urban,Meghalaya,Other Crimes,Drug Offense,Male,60+,3665,3298,367,3384,281
2010,Urban,Andhra Pradesh,Crime Against Women,Domestic Violence,Male,31-45,9870,7224,2646,8506,1364
2009,Urban,Odisha,Property Crime,Theft,Female,46-60,6182,5235,947,6049,133
2001,Urban,Himachal Pradesh,Crime Against Children,Child Labor,Male,0-12,4873,3588,1285,4118,755
2001,Rural,Delhi,Crime Against Children,Child Abuse,Male,60+,1191,1061,130,1116,75
2008,Urban,Rajasthan,Other Crimes,Cyber Crime,Female,18-30,4040,3256,784,3969,71
2006,Urban,Himachal Pradesh,Crime Against Men,Assault,Male,31-45,8513,4999,3514,8221,292
2010,Rural,Odisha,Crime Against Men,Assault,Male,46-60,5064,168,4896,4380,684
2001,Rural,Delhi,Other Crimes,Fraud,Male,18-30,2323,928,1395,1955,368
2005,Rural,Karnataka,Other Crimes,Cyber Crime,Female,13-17,5334,4362,972,4667,667
2008,Urban,Jammu & Kashmir,Property Crime,Burglary,Female,13-17,5314,491,4823,1199,4115
2004,Rural,Odisha,Other Crimes,Drug Offense,Male,31-45,2213,1459,754,2121,92
2009,Urban,Karnataka,Other Crimes,Drug Offense,Male,31-45,3945,3533,412,3666,279
2007,Urban,Rajasthan,Other Crimes,Drug Offense,Male,31-45,3350,2418,932,2751,599
2006,Rural,Haryana,Crime Against Women,Rape,Male,46-60,9976,2998,6978,7375,2601
2007,Urban,Madhya Pradesh,Crime Against Men,Murder,Male,46-60,6676,6355,321,6386,290
2009,Rural,Chhattisgarh,Property Crime,Burglary,Female,60+,5940,3117,2823,4981,959
2010,Rural,Arunachal Pradesh,Other Crimes,Cyber Crime,Male,46-60,74,57,17,62,12
2008,Rural,Tamil Nadu,Crime Against Women,Rape,Male,46-60,2213,141,2072,358,1855
2008,Rural,Andhra Pradesh,Other Crimes,Cyber Crime,Male,31-45,2757,2166,591,2215,542
2003,Urban,Karnataka,Crime Against Women,Dowry Deaths,Male,31-45,6788,388,6400,2738,4050
2009,Urban,Nagaland,Other Crimes,Fraud,Male,46-60,3587,2487,1100,3543,44
2003,Rural,Assam,Crime Against Women,Rape,Female,13-17,4332,2917,1415,3993,339
2008,Rural,Tripura,Crime Against Men,Assault,Female,60+,5036,4246,790,4596,440
2002,Rural,Tamil Nadu,Crime Against Men,Extortion,Male,18-30,9106,1395,7711,3307,5799
2005,Urban,Manipur,Other Crimes,Fraud,Female,13-17,8827,3948,4879,4200,4627
2003,Rural,Kerala,Other Crimes,Cyber Crime,Female,60+,7151,4011,3140,4675,2476
2010,Urban,Uttar Pradesh,Crime Against Men,Murder,Female,18-30,8429,6941,1488,8191,238
2004,Rural,Jammu & Kashmir,Crime Against Men,Robbery,Male,60+,8644,240,8404,6292,2352
2010,Rural,Karnataka,Crime Against Women,Domestic Violence,Male,13-17,3844,2285,1559,2959,885
2006,Urban,Tripura,Other Crimes,Drug Offense,Male,46-60,8473,8121,352,8323,150
2004,Rural,Sikkim,Crime Against Men,Robbery,Female,46-60,3155,3061,94,3111,44
2005,Rural,Delhi,Crime Against Men,Murder,Female,60+,1697,1631,66,1665,32
2008,Urban,Tripura,Property Crime,Arson,Female,0-12,6998,6363,635,6773,225
2004,Rural,Delhi,Crime Against Children,Trafficking,Male,0-12,9847,8951,896,9787,60
2003,Urban,Manipur,Crime Against Men,Murder,Male,0-12,7276,3143,4133,7016,260
2010,Rural,Arunachal Pradesh,Property Crime,Theft,Male,0-12,3486,3472,14,3481,5
2002,Rural,Sikkim,Crime Against Women,Molestation,Male,18-30,4974,4752,222,4832,142
2006,Rural,Karnataka,Other Crimes,Corruption,Female,46-60,6295,3478,2817,4418,1877
2008,Rural,Bihar,Crime Against Children,Kidnapping,Male,13-17,6267,1248,5019,6196,71
2007,Urban,West Bengal,Crime Against Women,Rape,Female,60+,8589,2086,6503,6429,2160
2006,Rural,Kerala,Crime Against Children,Trafficking,Male,46-60,4645,2068,2577,4064,581
2003,Rural,Assam,Other Crimes,Drug Offense,Male,18-30,4750,949,3801,4277,473
2004,Urban,Jharkhand,Other Crimes,Corruption,Male,18-30,2992,455,2537,2675,317
2006,Urban,Telangana,Crime Against Children,Child Abuse,Female,60+,2497,168,2329,1165,1332
2001,Rural,Mizoram,Other Crimes,Drug Offense,Female,13-17,4285,1012,3273,2317,1968
2006,Rural,Assam,Other Crimes,Corruption,Female,18-30,7473,713,6760,3050,4423
2009,Rural,West Bengal,Crime Against Men,Extortion,Male,18-30,9022,6156,2866,7985,1037
2005,Rural,Madhya Pradesh,Crime Against Men,Murder,Male,60+,1399,337,1062,1246,153
2001,Rural,Jharkhand,Property Crime,Theft,Male,31-45,1356,785,571,1083,273
2006,Urban,Tamil Nadu,Crime Against Children,Child Abuse,Female,18-30,6832,3224,3608,6151,681
2009,Urban,Delhi,Crime Against Men,Robbery,Female,13-17,9457,3893,5564,7613,1844
2001,Rural,Kerala,Crime Against Women,Molestation,Female,31-45,3903,20,3883,597,3306
2003,Urban,Jharkhand,Other Crimes,Corruption,Male,13-17,7119,500,6619,2184,4935
2009,Rural,Madhya Pradesh,Other Crimes,Corruption,Female,13-17,4580,3651,929,3753,827
2009,Urban,Karnataka,Property Crime,Vandalism,Male,46-60,276,65,211,151,125
2008,Rural,Goa,Crime Against Women,Dowry Deaths,Male,60+,4769,1019,3750,3676,1093
2005,Rural,Karnataka,Crime Against Children,Child Abuse,Male,18-30,249,234,15,243,6
2002,Urban,Goa,Crime Against Children,Child Labor,Female,60+,4057,876,3181,1532,2525
2001,Urban,Nagaland,Crime Against Children,Trafficking,Female,13-17,8400,7601,799,8054,346
2009,Rural,Manipur,Crime Against Women,Domestic Violence,Male,0-12,657,184,473,302,355
2007,Rural,Punjab,Crime Against Men,Assault,Female,46-60,3569,2179,1390,2917,652
2010,Rural,Mizoram,Crime Against Children,Child Labor,Female,31-45,734,211,523,390,344
2005,Urban,Delhi,Crime Against Children,Child Abuse,Female,0-12,2542,1095,1447,1488,1054
2005,Urban,Bihar,Crime Against Children,Kidnapping,Male,46-60,146,57,89,108,38
2004,Urban,West Bengal,Crime Against Children,Trafficking,Male,46-60,9093,8088,1005,8672,421
2009,Urban,Nagaland,Property Crime,Arson,Female,0-12,4406,1544,2862,2667,1739
2002,Urban,Gujarat,Crime Against Women,Domestic Violence,Female,60+,8147,4447,3700,5333,2814
2010,Urban,Gujarat,Crime Against Women,Rape,Female,0-12,4706,977,3729,2024,2682
2007,Rural,Jharkhand,Property Crime,Arson,Male,60+,5520,5063,457,5385,135
2004,Rural,Gujarat,Property Crime,Arson,Female,0-12,3417,1578,1839,3141,276
2009,Urban,Uttarakhand,Crime Against Children,Trafficking,Female,0-12,5457,4327,1130,4370,1087
2008,Urban,Uttar Pradesh,Crime Against Children,Child Labor,Female,46-60,1397,596,801,674,723
2003,Urban,Punjab,Crime Against Children,Child Abuse,Male,60+,7033,6797,236,6998,35
2007,Rural,Maharashtra,Property Crime,Theft,Male,31-45,679,238,441,348,331
2010,Rural,Mizoram,Crime Against Men,Assault,Male,60+,4649,3472,1177,4286,363
2002,Rural,Goa,Crime Against Women,Rape,Female,0-12,3916,620,3296,1631,2285
2002,Rural,Goa,Crime Against Women,Molestation,Male,18-30,3423,3004,419,3170,253
2008,Urban,Uttar Pradesh,Property Crime,Arson,Female,31-45,9683,7301,2382,9621,62
2008,Urban,Jharkhand,Property Crime,Burglary,Female,46-60,5113,3722,1391,4679,434
2003,Rural,Himachal Pradesh,Property Crime,Arson,Male,13-17,1329,649,680,1207,122
2006,Rural,Tamil Nadu,Property Crime,Theft,Male,13-17,2107,435,1672,1598,509
2002,Rural,Madhya Pradesh,Property Crime,Arson,Male,18-30,9517,7734,1783,7978,1539
2004,Rural,Telangana,Property Crime,Theft,Male,18-30,5087,3335,1752,3888,1199
2006,Urban,Punjab,Property Crime,Vandalism,Male,18-30,9282,5664,3618,5851,3431
2007,Urban,Himachal Pradesh,Crime Against Women,Dowry Deaths,Male,18-30,4101,2257,1844,3274,827
2002,Urban,Jharkhand,Crime Against Children,Child Abuse,Male,31-45,7006,2081,4925,2749,4257
2006,Rural,Kerala,Crime Against Men,Assault,Female,18-30,3394,231,3163,2450,944
2001,Rural,Telangana,Other Crimes,Drug Offense,Female,31-45,5464,3315,2149,4492,972
2006,Rural,Karnataka,Other Crimes,Fraud,Male,60+,3814,395,3419,1389,2425
2006,Urban,Telangana,Property Crime,Arson,Male,0-12,8992,490,8502,4530,4462
2005,Urban,Delhi,Crime Against Children,Trafficking,Female,46-60,9755,219,9536,6287,3468
2002,Urban,Sikkim,Property Crime,Theft,Male,31-45,9534,2168,7366,3137,6397
2007,Urban,Haryana,Property Crime,Theft,Male,46-60,674,152,522,199,475
2002,Urban,West Bengal,Crime Against Children,Kidnapping,Male,60+,5440,1757,3683,4342,1098
2006,Urban,Tripura,Crime Against Children,Trafficking,Male,31-45,9598,9524,74,9591,7
2004,Urban,Jammu & Kashmir,Crime Against Women,Rape,Female,46-60,3613,3574,39,3604,9
2007,Rural,Jammu & Kashmir,Crime Against Women,Molestation,Female,13-17,8048,6289,1759,7911,137
2001,Urban,Odisha,Other Crimes,Cyber Crime,Female,60+,7382,2901,4481,3113,4269
2002,Rural,Punjab,Crime Against Children,Kidnapping,Female,31-45,6908,4671,2237,5366,1542
2003,Urban,Goa,Crime Against Women,Rape,Female,0-12,8225,6066,2159,7171,1054
2006,Rural,Gujarat,Crime Against Men,Assault,Female,18-30,1115,745,370,922,193
2004,Rural,Kerala,Property Crime,Arson,Female,31-45,5309,878,4431,3278,2031
2010,Rural,Punjab,Other Crimes,Cyber Crime,Male,46-60,3920,451,3469,1726,2194
2002,Urban,Chhattisgarh,Crime Against Women,Rape,Female,46-60,9692,4077,5615,5076,4616
2007,Urban,Rajasthan,Other Crimes,Cyber Crime,Male,0-12,2404,2008,396,2233,171
2006,Rural,Madhya Pradesh,Crime Against Children,Trafficking,Female,31-45,725,571,154,692,33
2009,Rural,Nagaland,Property Crime,Theft,Female,18-30,8792,7282,1510,7614,1178
2010,Urban,Delhi,Crime Against Children,Kidnapping,Male,13-17,3965,1916,2049,3919,46
2004,Rural,Chhattisgarh,Other Crimes,Fraud,Female,13-17,4280,3169,1111,3563,717
2006,Urban,Assam,Crime Against Women,Dowry Deaths,Female,0-12,6503,2044,4459,2840,3663
2006,Urban,Nagaland,Property Crime,Burglary,Male,31-45,9342,4031,5311,6220,3122
2004,Urban,Himachal Pradesh,Crime Against Women,Rape,Female,13-17,4843,605,4238,4726,117
2002,Rural,Punjab,Crime Against Men,Murder,Male,0-12,3395,2330,1065,3166,229
2006,Rural,Uttarakhand,Crime Against Men,Assault,Female,46-60,8117,3475,4642,6539,1578
2001,Rural,Meghalaya,Property Crime,Arson,Female,31-45,1079,22,1057,815,264
2001,Urban,Arunachal Pradesh,Crime Against Men,Robbery,Female,0-12,6053,2830,3223,5048,1005
2003,Urban,Maharashtra,Other Crimes,Drug Offense,Male,18-30,8106,4138,3968,6697,1409
2004,Urban,Assam,Crime Against Men,Murder,Female,31-45,6467,5392,1075,6159,308
2006,Urban,Manipur,Other Crimes,Corruption,Female,31-45,3205,551,2654,2573,632
2005,Urban,Jharkhand,Property Crime,Vandalism,Female,18-30,3542,1075,2467,1299,2243
2008,Urban,Tamil Nadu,Crime Against Women,Domestic Violence,Female,60+,9293,6383,2910,6619,2674
2004,Urban,Uttar Pradesh,Crime Against Women,Dowry Deaths,Female,0-12,4587,2827,1760,4496,91
2003,Urban,Tamil Nadu,Property Crime,Vandalism,Female,0-12,9194,8200,994,8571,623
2005,Urban,Himachal Pradesh,Property Crime,Vandalism,Male,0-12,961,630,331,801,160
2002,Rural,Odisha,Other Crimes,Fraud,Male,18-30,543,10,533,422,121
2002,Rural,Uttar Pradesh,Crime Against Children,Child Labor,Female,31-45,5592,3632,1960,3853,1739
2003,Rural,Madhya Pradesh,Crime Against Women,Domestic Violence,Male,18-30,4988,3374,1614,4341,647
2006,Urban,Arunachal Pradesh,Crime Against Children,Kidnapping,Male,46-60,6443,1023,5420,3119,3324
2007,Rural,Assam,Crime Against Men,Robbery,Male,13-17,9915,5075,4840,7004,2911
2003,Rural,Kerala,Crime Against Men,Extortion,Male,13-17,7358,7007,351,7318,40
2002,Urban,Sikkim,Other Crimes,Fraud,Female,60+,4984,640,4344,2759,2225
2002,Rural,Odisha,Crime Against Men,Murder,Female,13-17,6953,1386,5567,6272,681
2006,Rural,Bihar,Other Crimes,Cyber Crime,Female,18-30,5790,5092,698,5297,493
2002,Rural,Tamil Nadu,Other Crimes,Drug Offense,Male,46-60,7492,6301,1191,7118,374
2009,Rural,Uttar Pradesh,Crime Against Men,Assault,Female,18-30,7219,5982,1237,7092,127
2005,Urban,West Bengal,Other Crimes,Fraud,Female,31-45,6498,1112,5386,6372,126
2010,Urban,Assam,Other Crimes,Corruption,Male,46-60,2342,251,2091,2197,145
2003,Rural,Nagaland,Other Crimes,Corruption,Female,18-30,5390,4452,938,4777,613
2008,Urban,Gujarat,Crime Against Men,Extortion,Female,46-60,1327,1234,93,1287,40
2004,Urban,Karnataka,Other Crimes,Cyber Crime,Male,0-12,4315,492,3823,2559,1756
2006,Rural,Jammu & Kashmir,Crime Against Men,Extortion,Female,13-17,7986,1028,6958,5528,2458
2003,Urban,Assam,Crime Against Children,Child Labor,Male,46-60,5994,3038,2956,3877,2117
2009,Rural,Tripura,Crime Against Men,Robbery,Female,13-17,1345,222,1123,250,1095
2010,Urban,Uttarakhand,Crime Against Women,Rape,Female,31-45,6690,5655,1035,6058,632
2004,Urban,Tamil Nadu,Crime Against Children,Child Labor,Female,60+,2742,2598,144,2648,94
2001,Urban,Goa,Property Crime,Burglary,Male,46-60,1519,1149,370,1201,318
2009,Rural,Goa,Crime Against Men,Assault,Male,18-30,943,713,230,724,219
2001,Urban,Odisha,Other Crimes,Drug Offense,Female,46-60,9764,1680,8084,7317,2447
2007,Rural,Uttarakhand,Property Crime,Theft,Male,13-17,6618,5349,1269,6414,204
2005,Urban,Arunachal Pradesh,Property Crime,Arson,Male,46-60,414,383,31,400,14
2001,Rural,Haryana,Crime Against Children,Kidnapping,Male,0-12,3441,614,2827,942,2499
2007,Urban,Assam,Crime Against Women,Molestation,Male,13-17,6837,3297,3540,6000,837
2005,Rural,Uttarakhand,Other Crimes,Cyber Crime,Male,13-17,2949,1087,1862,2243,706
2006,Urban,Manipur,Other Crimes,Fraud,Female,46-60,4336,1933,2403,2420,1916
2007,Rural,Chhattisgarh,Property Crime,Theft,Female,13-17,9334,7832,1502,9126,208
2005,Rural,Maharashtra,Crime Against Women,Molestation,Female,60+,3982,1945,2037,2364,1618
2004,Rural,Goa,Crime Against Men,Murder,Male,0-12,978,522,456,700,278
2010,Rural,Kerala,Crime Against Women,Dowry Deaths,Female,0-12,3250,735,2515,1521,1729
2009,Rural,Arunachal Pradesh,Crime Against Children,Trafficking,Male,46-60,5360,772,4588,1754,3606
2003,Urban,Jammu & Kashmir,Crime Against Children,Child Abuse,Female,46-60,8235,2109,6126,4773,3462
2003,Urban,Telangana,Other Crimes,Drug Offense,Female,0-12,4916,1577,3339,2746,2170
2005,Rural,Mizoram,Property Crime,Theft,Male,13-17,6879,3874,3005,3962,2917
2007,Rural,Punjab,Crime Against Men,Extortion,Male,0-12,1450,351,1099,590,860
2003,Urban,Tripura,Crime Against Children,Trafficking,Female,13-17,9929,9190,739,9775,154
2006,Urban,Delhi,Crime Against Children,Kidnapping,Male,31-45,8058,6354,1704,6399,1659
2002,Urban,Andhra Pradesh,Property Crime,Arson,Male,18-30,2338,1352,986,2116,222
2003,Urban,Manipur,Crime Against Men,Murder,Male,31-45,280,84,196,125,155
2009,Urban,Telangana,Property Crime,Theft,Female,31-45,159,78,81,140,19
2001,Rural,Haryana,Crime Against Women,Molestation,Male,0-12,5828,1267,4561,2046,3782
2007,Rural,Telangana,Crime Against Men,Murder,Female,31-45,2968,2779,189,2934,34
2006,Urban,Maharashtra,Crime Against Women,Rape,Male,46-60,332,179,153,189,143
2008,Rural,Kerala,Other Crimes,Cyber Crime,Male,60+,1702,1206,496,1410,292
2007,Urban,Chhattisgarh,Crime Against Women,Dowry Deaths,Female,46-60,7097,142,6955,5562,1535
2010,Rural,Bihar,Property Crime,Vandalism,Male,13-17,290,30,260,251,39
2008,Rural,Haryana,Crime Against Women,Molestation,Male,0-12,1400,1222,178,1348,52
2002,Urban,Haryana,Other Crimes,Corruption,Male,13-17,9448,7425,2023,8082,1366
2009,Urban,Assam,Crime Against Children,Child Abuse,Female,60+,8715,755,7960,3392,5323
2005,Urban,Telangana,Property Crime,Vandalism,Female,46-60,986,735,251,788,198
2002,Urban,Tamil Nadu,Crime Against Children,Child Abuse,Female,60+,5487,5437,50,5467,20
2009,Urban,Meghalaya,Property Crime,Vandalism,Male,60+,8308,3257,5051,5550,2758
2003,Urban,Chhattisgarh,Crime Against Children,Trafficking,Male,31-45,8735,3588,5147,6950,1785
2003,Urban,Meghalaya,Crime Against Men,Assault,Male,13-17,1279,1014,265,1057,222
2002,Urban,West Bengal,Crime Against Men,Robbery,Male,13-17,4525,2047,2478,2329,2196
2005,Rural,Haryana,Crime Against Men,Extortion,Male,18-30,1577,1307,270,1517,60
2010,Rural,Telangana,Other Crimes,Drug Offense,Male,18-30,4263,1525,2738,2981,1282
2008,Urban,Goa,Other Crimes,Cyber Crime,Female,31-45,9854,3080,6774,4033,5821
2007,Rural,Madhya Pradesh,Crime Against Children,Child Labor,Female,18-30,7628,1428,6200,5735,1893
2008,Urban,Delhi,Crime Against Women,Domestic Violence,Female,18-30,2338,118,2220,200,2138
2003,Rural,Tamil Nadu,Property Crime,Arson,Female,13-17,5597,4002,1595,5586,11
2009,Rural,Bihar,Crime Against Women,Dowry Deaths,Female,18-30,668,83,585,546,122
2004,Rural,Telangana,Other Crimes,Drug Offense,Female,60+,7604,7099,505,7594,10
2002,Urban,Tamil Nadu,Crime Against Women,Molestation,Male,13-17,5516,1145,4371,1299,4217
2009,Urban,Uttarakhand,Crime Against Children,Kidnapping,Male,18-30,5990,4830,1160,4950,1040
2004,Urban,Uttar Pradesh,Crime Against Men,Extortion,Female,46-60,9824,7112,2712,9222,602
2008,Rural,Delhi,Crime Against Women,Molestation,Male,13-17,305,29,276,103,202
2001,Rural,Nagaland,Crime Against Men,Assault,Male,0-12,2051,621,1430,1929,122
2004,Rural,Odisha,Crime Against Children,Child Labor,Male,18-30,7224,7026,198,7103,121
2008,Rural,Nagaland,Crime Against Men,Assault,Male,31-45,583,447,136,517,66
2003,Rural,Madhya Pradesh,Crime Against Women,Dowry Deaths,Male,13-17,8651,1443,7208,1704,6947
2004,Urban,Delhi,Crime Against Men,Extortion,Male,46-60,6289,4565,1724,5101,1188
2004,Rural,Haryana,Property Crime,Vandalism,Male,46-60,2262,1766,496,2258,4
2005,Urban,Uttarakhand,Property Crime,Theft,Female,0-12,3894,3890,4,3894,0
2004,Urban,Goa,Crime Against Men,Murder,Female,60+,6563,5623,940,6261,302
2006,Urban,Chhattisgarh,Crime Against Men,Assault,Female,18-30,6828,6506,322,6699,129
2005,Urban,Jharkhand,Crime Against Men,Assault,Male,60+,245,49,196,230,15
2008,Rural,Andhra Pradesh,Crime Against Women,Rape,Female,18-30,5479,3592,1887,4042,1437
2001,Rural,Chhattisgarh,Other Crimes,Corruption,Female,46-60,257,177,80,218,39
2009,Rural,Rajasthan,Property Crime,Arson,Male,0-12,603,67,536,82,521
2004,Rural,Jharkhand,Crime Against Men,Murder,Male,31-45,9887,1276,8611,5803,4084
2007,Rural,Punjab,Crime Against Women,Domestic Violence,Male,18-30,2979,1793,1186,2937,42
2006,Rural,Punjab,Crime Against Men,Murder,Male,13-17,457,421,36,426,31
2006,Urban,Nagaland,Crime Against Children,Kidnapping,Female,13-17,694,619,75,619,75
2007,Rural,Manipur,Crime Against Children,Child Labor,Female,46-60,2820,972,1848,2241,579
2001,Urban,Jammu & Kashmir,Crime Against Children,Kidnapping,Female,46-60,3440,928,2512,2949,491
2006,Rural,Assam,Property Crime,Burglary,Male,31-45,9434,8518,916,9259,175
2009,Rural,Nagaland,Other Crimes,Corruption,Female,0-12,8940,2893,6047,4525,4415
2005,Rural,Telangana,Crime Against Men,Extortion,Male,0-12,965,142,823,881,84
2010,Rural,Haryana,Other Crimes,Cyber Crime,Female,0-12,2662,202,2460,2384,278
2010,Urban,Maharashtra,Crime Against Women,Domestic Violence,Male,18-30,87,67,20,79,8
2001,Rural,Jharkhand,Other Crimes,Drug Offense,Male,18-30,8231,7587,644,7728,503
2006,Rural,Goa,Crime Against Men,Extortion,Male,60+,8477,1380,7097,7473,1004
2007,Urban,Haryana,Crime Against Women,Rape,Female,13-17,8641,1913,6728,2091,6550
2002,Urban,Himachal Pradesh,Other Crimes,Drug Offense,Female,31-45,6580,6319,261,6335,245
2001,Rural,Kerala,Crime Against Men,Murder,Female,18-30,9613,1765,7848,8443,1170
2004,Rural,Tripura,Crime Against Children,Kidnapping,Female,0-12,6559,2945,3614,3249,3310
2008,Urban,Tripura,Crime Against Children,Child Labor,Female,13-17,2582,2007,575,2258,324
2008,Rural,Arunachal Pradesh,Property Crime,Theft,Male,46-60,5038,1746,3292,4935,103
2001,Rural,Uttarakhand,Other Crimes,Corruption,Male,60+,5718,5485,233,5624,94
2002,Urban,Delhi,Crime Against Children,Trafficking,Female,46-60,7405,7096,309,7303,102
2008,Rural,Uttar Pradesh,Crime Against Women,Dowry Deaths,Male,31-45,496,75,421,351,145
2008,Rural,Uttarakhand,Property Crime,Arson,Female,13-17,2151,46,2105,1565,586
2006,Urban,Uttar Pradesh,Crime Against Children,Child Labor,Female,60+,7313,6837,476,6894,419
2007,Urban,Madhya Pradesh,Crime Against Children,Child Abuse,Female,31-45,3628,3127,501,3535,93
2007,Rural,Uttar Pradesh,Crime Against Children,Trafficking,Female,31-45,5192,2577,2615,2968,2224
2006,Rural,Rajasthan,Crime Against Children,Kidnapping,Male,46-60,5146,4486,660,4947,199
2010,Rural,Haryana,Crime Against Children,Kidnapping,Male,60+,4335,3286,1049,4029,306
2003,Rural,Meghalaya,Property Crime,Burglary,Female,31-45,4841,2381,2460,3322,1519
2006,Rural,Kerala,Crime Against Children,Kidnapping,Female,18-30,3429,230,3199,2116,1313
2010,Rural,Uttar Pradesh,Crime Against Men,Murder,Female,46-60,1582,691,891,1484,98
2002,Rural,Meghalaya,Crime Against Children,Kidnapping,Female,46-60,9970,4385,5585,8424,1546
2003,Urban,Sikkim,Crime Against Women,Molestation,Female,31-45,7993,1611,6382,4134,3859
2006,Rural,Assam,Crime Against Women,Molestation,Female,60+,4633,3556,1077,4482,151
2007,Rural,Sikkim,Crime Against Women,Domestic Violence,Male,60+,7683,7495,188,7559,124
2006,Urban,Kerala,Crime Against Women,Molestation,Female,31-45,188,140,48,170,18
2009,Urban,West Bengal,Other Crimes,Corruption,Female,60+,9076,5125,3951,7284,1792
2002,Rural,Sikkim,Crime Against Men,Extortion,Male,31-45,5940,1228,4712,1487,4453
2003,Urban,Gujarat,Crime Against Children,Child Abuse,Female,0-12,6624,5622,1002,6523,101
2003,Urban,Meghalaya,Property Crime,Arson,Female,18-30,2545,1441,1104,2358,187
2007,Rural,Manipur,Property Crime,Burglary,Female,60+,7341,4581,2760,5426,1915
2005,Urban,Andhra Pradesh,Crime Against Women,Rape,Female,60+,7326,5414,1912,5793,1533
2004,Urban,Tripura,Other Crimes,Cyber Crime,Female,13-17,5612,4390,1222,5358,254
2003,Rural,Tamil Nadu,Crime Against Men,Assault,Male,31-45,4442,3828,614,4337,105
2009,Rural,Uttarakhand,Crime Against Children,Trafficking,Female,46-60,9189,8474,715,8508,681
2010,Rural,Manipur,Crime Against Children,Kidnapping,Male,46-60,9435,3424,6011,5025,4410
2009,Urban,Andhra Pradesh,Crime Against Women,Dowry Deaths,Female,13-17,1482,1168,314,1295,187
2003,Urban,Uttar Pradesh,Property Crime,Burglary,Female,31-45,8445,5100,3345,5601,2844
2010,Rural,Sikkim,Crime Against Children,Trafficking,Male,0-12,4602,2692,1910,2910,1692
2002,Urban,Punjab,Crime Against Children,Child Abuse,Female,31-45,7185,1113,6072,2371,4814
2006,Urban,Karnataka,Crime Against Men,Robbery,Male,46-60,1970,718,1252,1709,261
2004,Urban,Rajasthan,Property Crime,Burglary,Female,13-17,7120,7090,30,7115,5
2008,Rural,Punjab,Crime Against Men,Extortion,Female,60+,5440,2303,3137,2591,2849
2001,Rural,Rajasthan,Other Crimes,Fraud,Male,13-17,7303,2098,5205,5242,2061
2007,Urban,Arunachal Pradesh,Property Crime,Arson,Male,18-30,2453,1687,766,2180,273
2003,Urban,Uttar Pradesh,Crime Against Women,Domestic Violence,Male,60+,6149,5621,528,5836,313
2010,Rural,Haryana,Crime Against Women,Rape,Male,13-17,1377,1160,217,1310,67
2002,Rural,Kerala,Crime Against Women,Domestic Violence,Female,31-45,9471,1492,7979,7686,1785
2009,Rural,Jharkhand,Crime Against Women,Rape,Female,18-30,1467,428,1039,594,873
2004,Rural,Jammu & Kashmir,Crime Against Women,Dowry Deaths,Female,18-30,3021,1306,1715,2517,504
2003,Urban,Manipur,Other Crimes,Drug Offense,Male,60+,2137,815,1322,1009,1128
2004,Urban,Kerala,Crime Against Men,Extortion,Male,46-60,2827,354,2473,1184,1643
2006,Rural,Meghalaya,Crime Against Women,Rape,Male,18-30,8329,611,7718,1429,6900
2006,Rural,Punjab,Crime Against Women,Rape,Male,13-17,3602,1603,1999,3000,602
2008,Urban,Chhattisgarh,Property Crime,Theft,Female,46-60,343,328,15,343,0
2003,Rural,Arunachal Pradesh,Other Crimes,Fraud,Female,46-60,8019,5996,2023,6070,1949
2007,Urban,Maharashtra,Crime Against Women,Domestic Violence,Male,18-30,9712,6063,3649,8822,890
2001,Urban,Kerala,Crime Against Women,Dowry Deaths,Male,13-17,3442,1781,1661,2224,1218
2003,Urban,Rajasthan,Crime Against Women,Rape,Female,13-17,2530,2150,380,2307,223
2002,Rural,Madhya Pradesh,Crime Against Men,Assault,Female,60+,1370,319,1051,1125,245
2002,Rural,Odisha,Other Crimes,Drug Offense,Female,0-12,2081,245,1836,1521,560
2004,Rural,Tripura,Other Crimes,Fraud,Female,13-17,4706,3703,1003,4096,610
2010,Urban,Andhra Pradesh,Other Crimes,Corruption,Female,18-30,3902,1205,2697,3579,323
2005,Urban,Gujarat,Property Crime,Burglary,Male,46-60,8834,1493,7341,3891,4943
2008,Urban,Sikkim,Crime Against Women,Molestation,Female,60+,408,23,385,309,99
2004,Rural,Karnataka,Crime Against Children,Trafficking,Female,31-45,9485,849,8636,7469,2016
2010,Rural,Maharashtra,Crime Against Women,Dowry Deaths,Female,18-30,4741,1487,3254,4468,273
2006,Urban,Rajasthan,Property Crime,Burglary,Female,60+,3390,3104,286,3253,137
2002,Urban,Kerala,Crime Against Men,Extortion,Female,60+,6019,3670,2349,4342,1677
2007,Urban,Manipur,Crime Against Men,Murder,Female,13-17,4718,3812,906,4600,118
2001,Rural,Gujarat,Crime Against Women,Rape,Female,0-12,7910,7203,707,7734,176
2009,Rural,Odisha,Crime Against Women,Domestic Violence,Female,18-30,4683,196,4487,2621,2062
2005,Rural,Telangana,Property Crime,Arson,Male,13-17,5867,5702,165,5814,53
2009,Rural,Assam,Crime Against Children,Child Abuse,Male,60+,8177,2907,5270,7935,242
2005,Urban,Assam,Property Crime,Burglary,Female,46-60,8050,388,7662,7226,824
2004,Rural,Goa,Crime Against Children,Child Labor,Male,46-60,5079,3044,2035,4438,641
2006,Rural,Mizoram,Other Crimes,Drug Offense,Male,31-45,2879,1660,1219,2112,767
2008,Urban,Bihar,Other Crimes,Cyber Crime,Male,18-30,3174,1224,1950,1648,1526
2004,Rural,Sikkim,Crime Against Men,Murder,Female,18-30,1678,1141,537,1485,193
2009,Rural,Goa,Crime Against Women,Dowry Deaths,Male,0-12,417,241,176,372,45
2006,Rural,Karnataka,Crime Against Women,Molestation,Male,13-17,9235,7968,1267,9061,174
2010,Urban,Madhya Pradesh,Property Crime,Arson,Female,0-12,3526,146,3380,2659,867
2008,Urban,Delhi,Crime Against Men,Robbery,Male,18-30,2700,1613,1087,2401,299
2007,Rural,Uttar Pradesh,Crime Against Women,Rape,Male,60+,7844,2855,4989,7811,33
2004,Rural,Mizoram,Property Crime,Arson,Male,0-12,2495,1489,1006,1867,628
2003,Rural,Tripura,Crime Against Men,Robbery,Male,60+,6606,2146,4460,5783,823
2003,Urban,Punjab,Crime Against Women,Dowry Deaths,Male,31-45,1604,860,744,956,648
2007,Urban,Maharashtra,Property Crime,Vandalism,Male,31-45,5586,4586,1000,4878,708
2002,Rural,Tripura,Crime Against Men,Robbery,Female,46-60,9532,378,9154,3521,6011
2002,Urban,Uttarakhand,Crime Against Women,Rape,Male,31-45,7570,4255,3315,5779,1791
2006,Urban,Telangana,Property Crime,Theft,Male,31-45,8139,5798,2341,7897,242
2006,Urban,Himachal Pradesh,Other Crimes,Drug Offense,Female,13-17,8808,6930,1878,7354,1454
2008,Rural,Meghalaya,Property Crime,Theft,Female,46-60,9998,2100,7898,2585,7413
2004,Rural,Haryana,Crime Against Men,Robbery,Female,31-45,3895,3331,564,3831,64
2009,Urban,Kerala,Crime Against Women,Domestic Violence,Male,13-17,2923,2759,164,2916,7
2002,Rural,Tamil Nadu,Crime Against Children,Kidnapping,Male,13-17,4306,2548,1758,3788,518
2001,Urban,Andhra Pradesh,Crime Against Children,Trafficking,Female,60+,1459,567,892,692,767
2008,Urban,Andhra Pradesh,Crime Against Children,Child Abuse,Female,13-17,5163,4844,319,5061,102
2004,Rural,Bihar,Crime Against Children,Trafficking,Male,0-12,8559,5299,3260,6264,2295
2004,Rural,Manipur,Crime Against Women,Molestation,Female,0-12,9016,659,8357,4932,4084
2001,Urban,Kerala,Crime Against Men,Extortion,Female,46-60,2920,2766,154,2839,81
2010,Rural,Karnataka,Other Crimes,Corruption,Male,13-17,1681,463,1218,974,707
2002,Rural,Rajasthan,Property Crime,Theft,Female,31-45,3221,1193,2028,1618,1603
2002,Rural,Karnataka,Other Crimes,Drug Offense,Male,60+,3488,1116,2372,3037,451
2009,Rural,Uttarakhand,Crime Against Men,Assault,Female,13-17,6534,421,6113,584,5950
2002,Rural,Meghalaya,Property Crime,Theft,Male,18-30,9057,15,9042,1730,7327
2003,Rural,Jharkhand,Crime Against Men,Murder,Male,60+,7566,760,6806,1756,5810
2010,Urban,Gujarat,Crime Against Men,Assault,Female,18-30,3428,3146,282,3402,26
2009,Rural,Karnataka,Crime Against Men,Extortion,Male,18-30,5227,4297,930,4798,429
2009,Rural,Telangana,Property Crime,Theft,Male,13-17,4926,1260,3666,1918,3008
2010,Urban,Andhra Pradesh,Other Crimes,Cyber Crime,Male,60+,1292,240,1052,718,574
2001,Urban,Chhattisgarh,Crime Against Men,Assault,Male,0-12,5959,1944,4015,4343,1616
2008,Urban,Assam,Crime Against Children,Kidnapping,Female,31-45,307,38,269,192,115
2002,Urban,Haryana,Crime Against Women,Domestic Violence,Male,0-12,3262,1614,1648,2337,925
2005,Urban,Assam,Crime Against Children,Trafficking,Male,18-30,253,144,109,160,93
2009,Rural,Meghalaya,Other Crimes,Corruption,Male,0-12,2905,2290,615,2469,436
2008,Urban,Goa,Crime Against Women,Dowry Deaths,Male,18-30,9469,2109,7360,7074,2395
2003,Urban,Sikkim,Crime Against Women,Molestation,Male,46-60,6711,460,6251,4323,2388
2005,Urban,Arunachal Pradesh,Property Crime,Burglary,Male,13-17,300,168,132,300,0
2005,Urban,Maharashtra,Crime Against Women,Molestation,Female,18-30,4989,2886,2103,3088,1901
2010,Urban,Arunachal Pradesh,Crime Against Women,Domestic Violence,Male,46-60,9238,8185,1053,8581,657
2002,Urban,Mizoram,Crime Against Children,Kidnapping,Male,60+,4127,2618,1509,2818,1309
2004,Rural,Karnataka,Crime Against Men,Extortion,Female,18-30,8309,4203,4106,5628,2681
2008,Rural,Manipur,Crime Against Children,Kidnapping,Male,60+,9129,4960,4169,6551,2578
2006,Urban,Bihar,Crime Against Women,Dowry Deaths,Female,18-30,2849,1420,1429,2353,496
2001,Rural,Jharkhand,Crime Against Women,Domestic Violence,Male,31-45,5701,3677,2024,4312,1389
2005,Rural,Himachal Pradesh,Other Crimes,Fraud,Male,13-17,8381,5169,3212,7630,751
2010,Rural,Kerala,Other Crimes,Fraud,Female,46-60,5335,5200,135,5310,25
2001,Urban,Nagaland,Other Crimes,Corruption,Female,31-45,1666,1637,29,1641,25
2001,Rural,Meghalaya,Crime Against Men,Murder,Female,0-12,5425,3814,1611,4350,1075
2006,Urban,Punjab,Crime Against Children,Kidnapping,Male,13-17,2260,2139,121,2248,12
2006,Urban,Nagaland,Property Crime,Burglary,Male,13-17,3193,1166,2027,3184,9
2003,Rural,Tripura,Crime Against Women,Domestic Violence,Female,60+,1054,855,199,919,135
2004,Urban,Arunachal Pradesh,Crime Against Children,Child Abuse,Male,0-12,3357,3162,195,3228,129
2008,Urban,Uttar Pradesh,Crime Against Children,Child Abuse,Male,60+,7547,5366,2181,6077,1470
2003,Rural,Odisha,Crime Against Children,Kidnapping,Male,31-45,3286,3212,74,3247,39
2001,Rural,Uttar Pradesh,Other Crimes,Drug Offense,Female,18-30,9789,6924,2865,6997,2792
2010,Rural,Kerala,Property Crime,Theft,Female,18-30,3959,1700,2259,3683,276
2004,Urban,Gujarat,Crime Against Women,Molestation,Female,13-17,1799,825,974,998,801
2009,Urban,Mizoram,Property Crime,Arson,Female,0-12,813,521,292,723,90
2006,Urban,Bihar,Property Crime,Theft,Female,18-30,554,295,259,512,42
2004,Rural,Gujarat,Crime Against Women,Molestation,Male,31-45,2063,1140,923,1501,562
2008,Rural,Uttarakhand,Crime Against Men,Robbery,Male,46-60,9221,2903,6318,5044,4177
2002,Rural,Gujarat,Other Crimes,Fraud,Female,46-60,5825,4682,1143,5643,182
2006,Urban,West Bengal,Crime Against Children,Trafficking,Male,0-12,5492,556,4936,1832,3660
2008,Rural,Tripura,Property Crime,Burglary,Female,46-60,101,43,58,59,42
2006,Urban,Assam,Other Crimes,Fraud,Female,0-12,939,873,66,939,0
2003,Urban,Delhi,Crime Against Men,Murder,Female,46-60,5396,4718,678,5235,161
2005,Urban,Karnataka,Property Crime,Theft,Male,0-12,4985,4676,309,4677,308
2007,Urban,Haryana,Property Crime,Burglary,Male,46-60,1696,136,1560,1237,459
2007,Rural,Himachal Pradesh,Crime Against Men,Assault,Male,13-17,2363,1242,1121,2063,300
2009,Urban,Mizoram,Crime Against Women,Molestation,Female,60+,7017,3754,3263,5295,1722
2004,Rural,Meghalaya,Crime Against Children,Trafficking,Female,60+,66,10,56,61,5
2004,Urban,Karnataka,Property Crime,Vandalism,Female,13-17,4191,2380,1811,2650,1541
2010,Rural,Chhattisgarh,Crime Against Men,Murder,Male,31-45,7558,5527,2031,5949,1609
2008,Rural,Maharashtra,Crime Against Men,Assault,Female,0-12,3972,3528,444,3897,75
2004,Urban,Goa,Crime Against Men,Assault,Male,13-17,8655,6463,2192,8600,55
2004,Rural,Nagaland,Property Crime,Arson,Male,31-45,467,259,208,439,28
2007,Urban,Himachal Pradesh,Crime Against Men,Robbery,Female,18-30,3821,486,3335,2056,1765
2002,Rural,Andhra Pradesh,Crime Against Men,Murder,Male,0-12,3969,2027,1942,3393,576
2008,Urban,Rajasthan,Crime Against Men,Robbery,Male,46-60,5864,5443,421,5736,128
2008,Rural,Andhra Pradesh,Crime Against Women,Domestic Violence,Male,60+,912,145,767,488,424
2002,Urban,Haryana,Crime Against Women,Dowry Deaths,Female,13-17,2776,1309,1467,1499,1277
2008,Urban,Bihar,Property Crime,Arson,Male,60+,4641,2790,1851,4109,532
2010,Rural,Delhi,Crime Against Women,Domestic Violence,Male,60+,4359,1603,2756,2627,1732
2007,Urban,Jharkhand,Crime Against Women,Domestic Violence,Male,31-45,8311,1908,6403,6543,1768
2005,Urban,Maharashtra,Other Crimes,Drug Offense,Male,18-30,8314,1083,7231,4250,4064
2004,Rural,Assam,Crime Against Children,Trafficking,Female,31-45,3187,467,2720,828,2359
2004,Urban,West Bengal,Crime Against Children,Kidnapping,Female,31-45,3587,715,2872,3294,293
2010,Rural,Chhattisgarh,Property Crime,Arson,Male,13-17,5926,5401,525,5491,435
2010,Urban,Kerala,Crime Against Men,Extortion,Male,60+,7588,127,7461,3538,4050
2001,Rural,Tamil Nadu,Crime Against Men,Assault,Female,60+,8520,4403,4117,8316,204
2001,Rural,West Bengal,Crime Against Children,Child Labor,Male,31-45,5839,3022,2817,3292,2547
2007,Rural,Arunachal Pradesh,Other Crimes,Corruption,Male,46-60,9921,9850,71,9894,27
2003,Rural,Uttar Pradesh,Other Crimes,Corruption,Male,18-30,5140,3210,1930,4683,457
2004,Rural,Haryana,Property Crime,Arson,Female,0-12,5726,1791,3935,3002,2724
2007,Urban,West Bengal,Other Crimes,Cyber Crime,Female,18-30,7418,3022,4396,5238,2180
2001,Urban,Tripura,Other Crimes,Fraud,Female,46-60,7589,1243,6346,3912,3677
2002,Urban,Telangana,Property Crime,Burglary,Male,60+,4244,2892,1352,3169,1075
2009,Rural,Kerala,Property Crime,Burglary,Male,60+,1836,1222,614,1233,603
2005,Rural,Tamil Nadu,Other Crimes,Drug Offense,Male,46-60,8020,7090,930,7988,32
2007,Urban,Rajasthan,Other Crimes,Fraud,Female,13-17,9058,5933,3125,6073,2985
2007,Urban,Mizoram,Crime Against Women,Rape,Male,60+,8485,4883,3602,8299,186
2009,Rural,Meghalaya,Crime Against Children,Kidnapping,Male,0-12,2880,2705,175,2850,30
2002,Urban,Tripura,Crime Against Men,Robbery,Female,0-12,1035,537,498,575,460
2010,Urban,Gujarat,Property Crime,Vandalism,Female,31-45,6154,3501,2653,5265,889
2008,Rural,Manipur,Crime Against Men,Robbery,Female,13-17,2481,1518,963,1520,961
2004,Rural,West Bengal,Property Crime,Vandalism,Female,31-45,6652,6500,152,6628,24
2006,Urban,Karnataka,Crime Against Children,Trafficking,Female,60+,8052,5240,2812,6036,2016
2006,Rural,Arunachal Pradesh,Crime Against Children,Child Labor,Male,46-60,5355,4851,504,5258,97
2002,Rural,Odisha,Property Crime,Burglary,Male,60+,3469,2526,943,3127,342
2001,Rural,Rajasthan,Property Crime,Vandalism,Male,18-30,6107,1072,5035,4766,1341
2004,Rural,Chhattisgarh,Crime Against Children,Kidnapping,Male,31-45,7123,6526,597,6885,238
2008,Rural,Rajasthan,Other Crimes,Drug Offense,Male,0-12,6557,576,5981,4521,2036
2007,Urban,Gujarat,Crime Against Men,Robbery,Male,13-17,9756,2558,7198,5427,4329
2010,Rural,Sikkim,Other Crimes,Fraud,Female,18-30,9551,7518,2033,9221,330
2009,Rural,Mizoram,Property Crime,Arson,Male,13-17,7195,551,6644,3559,3636
2009,Urban,Rajasthan,Crime Against Children,Child Abuse,Male,13-17,3049,2369,680,2793,256
2003,Rural,Jharkhand,Other Crimes,Drug Offense,Female,60+,7357,2475,4882,3268,4089
2009,Urban,Andhra Pradesh,Crime Against Men,Robbery,Male,0-12,1802,1524,278,1654,148
2008,Urban,Karnataka,Crime Against Men,Extortion,Female,60+,8864,8510,354,8537,327
2003,Rural,Mizoram,Crime Against Men,Assault,Female,13-17,1464,1007,457,1139,325
2008,Rural,Manipur,Crime Against Men,Assault,Male,13-17,986,622,364,949,37
2008,Urban,Himachal Pradesh,Property Crime,Arson,Female,18-30,906,167,739,200,706
2001,Rural,Karnataka,Crime Against Women,Domestic Violence,Female,0-12,6989,3737,3252,4857,2132
2006,Rural,Goa,Crime Against Men,Extortion,Male,31-45,7585,7278,307,7349,236
2007,Rural,Sikkim,Crime Against Children,Child Abuse,Male,13-17,5935,3215,2720,5886,49
2010,Rural,Maharashtra,Other Crimes,Fraud,Female,46-60,8089,5477,2612,5679,2410
2002,Rural,Punjab,Crime Against Children,Trafficking,Female,13-17,3696,1025,2671,1641,2055
2008,Rural,Meghalaya,Other Crimes,Corruption,Male,0-12,6243,181,6062,2259,3984
2009,Rural,Arunachal Pradesh,Other Crimes,Fraud,Female,13-17,6408,3220,3188,5018,1390
2001,Urban,Kerala,Other Crimes,Corruption,Female,13-17,3570,1919,1651,2030,1540
2001,Urban,Odisha,Crime Against Women,Domestic Violence,Female,31-45,9150,7600,1550,9058,92
2009,Rural,Andhra Pradesh,Property Crime,Vandalism,Male,60+,1404,1316,88,1341,63
2006,Urban,Sikkim,Other Crimes,Fraud,Female,31-45,7195,5296,1899,6474,721
2009,Rural,Himachal Pradesh,Property Crime,Burglary,Female,0-12,2852,2644,208,2774,78
2010,Urban,Goa,Property Crime,Arson,Male,46-60,2766,288,2478,1404,1362
2008,Rural,Madhya Pradesh,Other Crimes,Fraud,Male,13-17,7110,1297,5813,1595,5515
2005,Urban,Bihar,Crime Against Men,Murder,Female,13-17,6230,4694,1536,5918,312
2004,Urban,Rajasthan,Property Crime,Vandalism,Male,18-30,7084,5232,1852,6584,500
2008,Urban,Jharkhand,Property Crime,Vandalism,Female,18-30,9774,6987,2787,9368,406
2007,Urban,Tripura,Other Crimes,Cyber Crime,Male,60+,3022,2887,135,2898,124
2007,Rural,Jharkhand,Property Crime,Theft,Male,60+,9963,860,9103,2323,7640
2005,Rural,Punjab,Other Crimes,Cyber Crime,Male,46-60,4653,2669,1984,3904,749
2007,Rural,Madhya Pradesh,Crime Against Men,Assault,Male,18-30,472,155,317,244,228
2010,Urban,Manipur,Other Crimes,Drug Offense,Female,31-45,6420,3638,2782,4395,2025
2010,Rural,Tripura,Crime Against Children,Kidnapping,Female,60+,6059,5935,124,5948,111
2003,Rural,Rajasthan,Other Crimes,Fraud,Male,60+,69,11,58,37,32
2002,Rural,Jammu & Kashmir,Other Crimes,Fraud,Female,60+,5530,4244,1286,5032,498
2007,Urban,Nagaland,Property Crime,Arson,Male,60+,4513,845,3668,2988,1525
2006,Urban,Manipur,Crime Against Children,Child Abuse,Male,18-30,9305,734,8571,2064,7241
2002,Rural,Bihar,Other Crimes,Fraud,Male,13-17,1876,692,1184,925,951
2010,Rural,Kerala,Crime Against Children,Trafficking,Male,46-60,9546,8008,1538,9483,63
2006,Rural,Punjab,Other Crimes,Cyber Crime,Female,60+,9036,8674,362,8987,49
2003,Urban,Bihar,Other Crimes,Corruption,Female,31-45,4638,2670,1968,4542,96
2008,Urban,Rajasthan,Crime Against Women,Dowry Deaths,Male,0-12,5404,100,5304,2434,2970
2007,Rural,Assam,Crime Against Women,Rape,Male,60+,4693,3116,1577,4643,50
2002,Urban,West Bengal,Property Crime,Theft,Female,0-12,9607,5973,3634,7813,1794
2001,Rural,Gujarat,Crime Against Women,Molestation,Male,18-30,3516,2271,1245,3266,250
2002,Rural,Assam,Crime Against Children,Child Abuse,Male,60+,7037,6115,922,6571,466
2007,Rural,Telangana,Other Crimes,Cyber Crime,Male,31-45,8351,4794,3557,5383,2968
2006,Urban,Bihar,Crime Against Women,Domestic Violence,Female,31-45,4436,4086,350,4119,317
2002,Rural,Delhi,Other Crimes,Fraud,Male,31-45,9829,3169,6660,6448,3381
2008,Rural,Arunachal Pradesh,Crime Against Women,Rape,Male,46-60,3076,2601,475,2698,378
2009,Rural,Uttar Pradesh,Crime Against Children,Child Labor,Female,0-12,3310,911,2399,2880,430
2010,Urban,Uttarakhand,Other Crimes,Cyber Crime,Male,31-45,8012,5753,2259,6773,1239
2007,Urban,Uttarakhand,Crime Against Children,Child Labor,Female,60+,1956,1490,466,1888,68
2005,Rural,Jammu & Kashmir,Crime Against Children,Trafficking,Female,46-60,9667,902,8765,3081,6586
2006,Rural,Jharkhand,Property Crime,Vandalism,Male,18-30,5901,1841,4060,3492,2409
2008,Rural,Telangana,Property Crime,Vandalism,Female,60+,8282,3124,5158,4131,4151
2005,Rural,Haryana,Crime Against Women,Domestic Violence,Female,31-45,4043,1302,2741,3350,693
2002,Urban,Nagaland,Crime Against Children,Trafficking,Male,13-17,557,557,0,557,0
2007,Rural,Madhya Pradesh,Other Crimes,Corruption,Female,31-45,8273,5046,3227,8269,4
2004,Rural,Odisha,Crime Against Men,Extortion,Male,18-30,1330,983,347,1254,76
2009,Rural,Nagaland,Crime Against Men,Assault,Male,60+,7294,4298,2996,6854,440
2006,Urban,Kerala,Crime Against Children,Child Labor,Male,31-45,1910,939,971,1521,389
2004,Rural,Uttar Pradesh,Other Crimes,Corruption,Male,60+,5713,2676,3037,4116,1597
2007,Urban,Meghalaya,Crime Against Women,Rape,Female,13-17,3353,835,2518,3071,282
2004,Urban,Mizoram,Crime Against Women,Domestic Violence,Female,46-60,7851,7217,634,7756,95
2002,Rural,Sikkim,Crime Against Men,Extortion,Male,31-45,623,605,18,616,7
2006,Rural,Uttar Pradesh,Crime Against Women,Molestation,Female,31-45,4477,754,3723,3926,551
2009,Urban,Karnataka,Crime Against Women,Rape,Male,13-17,435,249,186,414,21
2008,Urban,Punjab,Other Crimes,Fraud,Male,46-60,8570,7900,670,8362,208
2002,Urban,Manipur,Other Crimes,Corruption,Male,31-45,8050,441,7609,2569,5481
2008,Urban,Chhattisgarh,Crime Against Children,Child Abuse,Male,13-17,2700,1284,1416,1330,1370
2009,Urban,Uttar Pradesh,Property Crime,Burglary,Female,13-17,6652,6606,46,6614,38
2001,Rural,Goa,Crime Against Children,Child Labor,Female,0-12,4050,1016,3034,3596,454
2006,Rural,Uttar Pradesh,Crime Against Children,Trafficking,Female,31-45,8705,4581,4124,6037,2668
2008,Urban,Assam,Crime Against Women,Dowry Deaths,Male,46-60,2968,1268,1700,1469,1499
2009,Rural,Delhi,Crime Against Men,Extortion,Female,46-60,439,22,417,263,176
2001,Rural,West Bengal,Crime Against Women,Rape,Male,46-60,3133,3080,53,3085,48
2004,Urban,Rajasthan,Crime Against Men,Murder,Female,46-60,2496,1811,685,2340,156
2010,Rural,Andhra Pradesh,Property Crime,Theft,Male,0-12,83,2,81,46,37
2002,Urban,Tamil Nadu,Crime Against Children,Child Abuse,Female,60+,6713,1828,4885,4452,2261
2001,Rural,Chhattisgarh,Crime Against Children,Child Abuse,Male,60+,5798,879,4919,3618,2180
2009,Urban,Jharkhand,Crime Against Children,Kidnapping,Female,60+,3375,1714,1661,3223,152
2002,Rural,Himachal Pradesh,Crime Against Children,Kidnapping,Female,60+,4176,1948,2228,3289,887
2007,Rural,Goa,Other Crimes,Drug Offense,Male,60+,1560,35,1525,730,830
2008,Rural,Assam,Crime Against Men,Robbery,Female,13-17,6092,5857,235,6086,6
2009,Rural,Uttarakhand,Other Crimes,Cyber Crime,Male,46-60,792,420,372,632,160
2008,Urban,Nagaland,Crime Against Children,Child Labor,Male,0-12,9604,2152,7452,9152,452
2007,Urban,Karnataka,Crime Against Children,Child Labor,Female,18-30,2468,40,2428,675,1793
2007,Urban,Meghalaya,Property Crime,Theft,Female,13-17,6084,2179,3905,3335,2749
2010,Urban,Jharkhand,Crime Against Children,Child Labor,Male,60+,7794,6891,903,7499,295
2009,Urban,Maharashtra,Other Crimes,Corruption,Male,0-12,2407,896,1511,1355,1052
2010,Urban,Manipur,Other Crimes,Drug Offense,Male,60+,2135,1892,243,2064,71
2008,Rural,Telangana,Crime Against Children,Child Abuse,Male,0-12,3982,1558,2424,3275,707
2007,Urban,Himachal Pradesh,Property Crime,Vandalism,Male,13-17,2381,292,2089,2373,8
2003,Rural,Uttarakhand,Other Crimes,Corruption,Male,0-12,2464,1280,1184,1685,779
2006,Urban,West Bengal,Property Crime,Theft,Male,13-17,2743,2290,453,2389,354
2005,Urban,Karnataka,Crime Against Men,Robbery,Male,31-45,8401,7281,1120,8108,293
2004,Rural,Assam,Crime Against Men,Robbery,Female,60+,6967,2374,4593,2882,4085
2001,Rural,Meghalaya,Crime Against Women,Dowry Deaths,Female,60+,1430,398,1032,421,1009
2008,Rural,Uttarakhand,Crime Against Children,Trafficking,Female,46-60,4084,3321,763,4040,44
2005,Rural,Goa,Crime Against Men,Robbery,Male,31-45,7088,712,6376,6454,634
2006,Rural,Gujarat,Other Crimes,Drug Offense,Male,0-12,9942,2325,7617,2600,7342
2001,Rural,Jharkhand,Other Crimes,Corruption,Female,60+,1342,130,1212,921,421
2010,Rural,West Bengal,Other Crimes,Corruption,Female,13-17,8282,2774,5508,7971,311
2003,Urban,Karnataka,Crime Against Women,Domestic Violence,Male,13-17,2431,186,2245,1014,1417
2009,Rural,Maharashtra,Property Crime,Theft,Female,18-30,3586,1128,2458,3351,235
2003,Rural,Kerala,Crime Against Women,Dowry Deaths,Male,13-17,5844,1950,3894,2737,3107
2004,Rural,Goa,Crime Against Children,Child Labor,Male,0-12,8124,5184,2940,7110,1014
2007,Urban,Kerala,Property Crime,Theft,Female,18-30,7326,6800,526,7038,288
2006,Rural,Tripura,Crime Against Men,Assault,Male,60+,7077,942,6135,3767,3310
2010,Urban,Manipur,Crime Against Women,Rape,Female,0-12,7188,5225,1963,6879,309
2005,Urban,Kerala,Other Crimes,Corruption,Female,31-45,8266,1197,7069,7783,483
2004,Rural,Maharashtra,Property Crime,Vandalism,Female,0-12,643,586,57,635,8
2010,Rural,Meghalaya,Crime Against Men,Murder,Male,46-60,7694,3109,4585,6147,1547
2007,Rural,Uttar Pradesh,Crime Against Children,Kidnapping,Female,46-60,1820,1487,333,1804,16
2003,Urban,Jammu & Kashmir,Crime Against Women,Domestic Violence,Female,18-30,5665,4604,1061,4894,771
2008,Urban,Tripura,Other Crimes,Cyber Crime,Female,60+,6825,1605,5220,3210,3615
2003,Rural,Mizoram,Crime Against Men,Extortion,Male,13-17,3473,2146,1327,2869,604
2006,Rural,Karnataka,Crime Against Women,Domestic Violence,Female,18-30,597,576,21,579,18
2006,Rural,West Bengal,Other Crimes,Fraud,Female,13-17,5887,1075,4812,2558,3329
2009,Urban,West Bengal,Other Crimes,Cyber Crime,Male,0-12,9337,1936,7401,4219,5118
2010,Rural,Goa,Other Crimes,Drug Offense,Female,18-30,2058,390,1668,642,1416
2007,Rural,Jharkhand,Other Crimes,Cyber Crime,Female,18-30,9452,8432,1020,8858,594
2001,Urban,West Bengal,Other Crimes,Drug Offense,Female,31-45,4606,3433,1173,3505,1101
2005,Rural,Delhi,Crime Against Women,Dowry Deaths,Female,60+,2794,1199,1595,1651,1143
2001,Rural,Goa,Crime Against Women,Molestation,Female,13-17,9950,2208,7742,6145,3805
2008,Rural,Assam,Crime Against Children,Child Abuse,Male,60+,7616,5945,1671,7003,613
2004,Rural,Assam,Crime Against Men,Assault,Male,60+,1691,656,1035,1533,158
2002,Urban,Rajasthan,Crime Against Women,Dowry Deaths,Male,46-60,8841,4564,4277,4813,4028
2002,Rural,Manipur,Other Crimes,Fraud,Female,46-60,3735,2325,1410,3465,270
2003,Urban,Manipur,Property Crime,Arson,Male,60+,9291,6521,2770,7258,2033
2009,Rural,Delhi,Crime Against Children,Child Labor,Male,31-45,250,218,32,224,26
2009,Urban,Manipur,Property Crime,Burglary,Female,13-17,6470,299,6171,1589,4881
2008,Rural,West Bengal,Other Crimes,Fraud,Male,31-45,5906,3299,2607,3849,2057
2004,Urban,West Bengal,Crime Against Men,Assault,Female,60+,2943,2033,910,2273,670
2006,Rural,Andhra Pradesh,Other Crimes,Cyber Crime,Male,13-17,2283,702,1581,1221,1062
2006,Rural,Tamil Nadu,Crime Against Children,Kidnapping,Male,13-17,1993,989,1004,1720,273
2009,Rural,Himachal Pradesh,Other Crimes,Cyber Crime,Female,0-12,5628,2605,3023,2889,2739
2006,Rural,Chhattisgarh,Crime Against Children,Child Abuse,Male,60+,9014,1680,7334,8806,208
2004,Urban,Punjab,Other Crimes,Corruption,Male,31-45,9075,3423,5652,4304,4771
2004,Urban,Meghalaya,Other Crimes,Corruption,Female,46-60,4543,2419,2124,4129,414
2006,Urban,Tamil Nadu,Crime Against Men,Murder,Male,60+,1082,193,889,274,808
2002,Urban,Goa,Property Crime,Arson,Male,13-17,4522,842,3680,2488,2034
2010,Rural,Arunachal Pradesh,Crime Against Men,Murder,Male,18-30,1302,325,977,543,759
2008,Rural,Kerala,Other Crimes,Fraud,Female,13-17,7939,4058,3881,6589,1350
2006,Urban,Arunachal Pradesh,Crime Against Women,Dowry Deaths,Male,60+,2351,299,2052,2119,232
2008,Rural,Rajasthan,Crime Against Women,Rape,Female,0-12,1868,1726,142,1740,128
2008,Urban,Goa,Property Crime,Vandalism,Female,46-60,9249,4118,5131,8346,903
2001,Rural,Assam,Crime Against Men,Robbery,Female,60+,8355,8159,196,8183,172
2010,Urban,Bihar,Property Crime,Theft,Female,46-60,1024,218,806,1010,14
2010,Urban,Jharkhand,Crime Against Women,Dowry Deaths,Male,13-17,2522,2505,17,2520,2
2009,Rural,Delhi,Other Crimes,Fraud,Female,46-60,6281,665,5616,5509,772
2001,Urban,Karnataka,Property Crime,Arson,Male,18-30,9870,1868,8002,4369,5501
2005,Rural,Manipur,Crime Against Children,Trafficking,Female,13-17,514,409,105,507,7
2001,Urban,Madhya Pradesh,Crime Against Children,Child Abuse,Male,18-30,8778,7794,984,8397,381
2003,Rural,Tripura,Crime Against Men,Robbery,Male,13-17,1382,486,896,916,466
2002,Rural,Telangana,Crime Against Women,Domestic Violence,Female,13-17,7004,579,6425,3622,3382
2003,Urban,Sikkim,Other Crimes,Cyber Crime,Male,31-45,9476,6790,2686,7548,1928
2002,Urban,West Bengal,Crime Against Women,Rape,Female,0-12,499,423,76,469,30
2004,Urban,Telangana,Other Crimes,Cyber Crime,Female,46-60,1466,1078,388,1322,144
2001,Rural,Haryana,Property Crime,Arson,Male,13-17,6031,5972,59,6012,19
2002,Urban,Nagaland,Crime Against Children,Child Abuse,Male,13-17,1728,60,1668,1519,209
2001,Urban,Gujarat,Crime Against Women,Dowry Deaths,Male,46-60,8722,2050,6672,8312,410
2009,Rural,Punjab,Crime Against Women,Molestation,Female,60+,7505,4395,3110,6305,1200
2006,Rural,Goa,Crime Against Women,Rape,Male,13-17,2925,1231,1694,2330,595
2009,Rural,Maharashtra,Crime Against Children,Child Labor,Male,18-30,1634,879,755,1231,403
2007,Urban,Uttar Pradesh,Crime Against Women,Rape,Male,31-45,2583,1985,598,2509,74
2006,Urban,Haryana,Crime Against Men,Extortion,Male,18-30,6538,4601,1937,4951,1587
2001,Rural,Himachal Pradesh,Crime Against Children,Child Abuse,Female,0-12,2086,1670,416,2027,59
2010,Rural,Tamil Nadu,Crime Against Children,Child Labor,Female,31-45,620,325,295,393,227
2006,Rural,Maharashtra,Crime Against Women,Domestic Violence,Male,18-30,346,267,79,324,22
2010,Urban,Karnataka,Other Crimes,Cyber Crime,Female,18-30,4216,1660,2556,3154,1062
2010,Urban,Gujarat,Crime Against Children,Child Labor,Male,13-17,3430,2142,1288,3079,351
2005,Rural,Goa,Crime Against Women,Dowry Deaths,Female,60+,5396,3023,2373,3152,2244
2006,Rural,Assam,Crime Against Children,Kidnapping,Female,46-60,1339,1216,123,1331,8
2004,Urban,Telangana,Other Crimes,Drug Offense,Female,31-45,3346,2773,573,3048,298
2002,Rural,Andhra Pradesh,Crime Against Women,Molestation,Female,31-45,9408,8591,817,8947,461
2007,Rural,Manipur,Property Crime,Burglary,Male,31-45,9470,5152,4318,9016,454
2005,Rural,Odisha,Other Crimes,Fraud,Female,13-17,9749,5363,4386,8352,1397
2001,Urban,Uttarakhand,Crime Against Men,Assault,Male,0-12,2166,1865,301,1914,252
2006,Urban,Odisha,Property Crime,Burglary,Male,31-45,8727,8162,565,8490,237
2010,Rural,Chhattisgarh,Crime Against Men,Assault,Male,46-60,4871,324,4547,2763,2108
2010,Urban,Telangana,Property Crime,Burglary,Male,0-12,4174,3011,1163,3825,349
2002,Urban,Nagaland,Other Crimes,Cyber Crime,Male,18-30,2371,2019,352,2129,242
2004,Rural,Jammu & Kashmir,Other Crimes,Cyber Crime,Female,18-30,70,9,61,54,16
2002,Rural,Bihar,Crime Against Men,Robbery,Male,46-60,3678,1798,1880,1853,1825
2005,Rural,Gujarat,Other Crimes,Cyber Crime,Male,46-60,3671,1705,1966,3035,636
2005,Rural,Gujarat,Property Crime,Burglary,Male,13-17,1208,304,904,1104,104
2007,Urban,Gujarat,Other Crimes,Cyber Crime,Male,0-12,5913,2533,3380,3376,2537
2007,Urban,Madhya Pradesh,Crime Against Men,Assault,Male,18-30,4561,1750,2811,4067,494
2005,Rural,Tamil Nadu,Crime Against Women,Rape,Male,31-45,926,311,615,719,207
2001,Rural,Mizoram,Crime Against Children,Child Abuse,Female,46-60,5005,3415,1590,3868,1137
2009,Urban,Delhi,Crime Against Children,Trafficking,Female,46-60,8043,3028,5015,5008,3035
2002,Urban,Rajasthan,Crime Against Children,Kidnapping,Female,60+,8807,54,8753,8328,479
2010,Rural,Delhi,Other Crimes,Fraud,Female,60+,7427,7321,106,7403,24
2003,Rural,Sikkim,Crime Against Children,Kidnapping,Male,0-12,7857,293,7564,4767,3090
2009,Rural,Tripura,Crime Against Children,Child Labor,Male,60+,6312,3114,3198,3892,2420
2002,Rural,Punjab,Crime Against Women,Molestation,Male,46-60,178,142,36,155,23
2007,Rural,Rajasthan,Crime Against Children,Kidnapping,Male,31-45,7706,2385,5321,5749,1957
2008,Rural,Meghalaya,Crime Against Women,Dowry Deaths,Male,60+,9464,3223,6241,7182,2282
2008,Urban,Rajasthan,Crime Against Men,Extortion,Male,0-12,378,158,220,353,25
2003,Urban,Madhya Pradesh,Crime Against Women,Domestic Violence,Male,46-60,8368,1316,7052,6852,1516
2007,Urban,Manipur,Property Crime,Burglary,Male,60+,8188,2213,5975,6437,1751
2002,Rural,Himachal Pradesh,Other Crimes,Corruption,Female,60+,3434,313,3121,1520,1914
2008,Rural,Arunachal Pradesh,Crime Against Children,Trafficking,Male,46-60,7412,5656,1756,7399,13
2009,Rural,Madhya Pradesh,Crime Against Men,Robbery,Female,13-17,8797,4746,4051,7840,957
2010,Rural,Himachal Pradesh,Crime Against Children,Child Abuse,Male,0-12,5279,1342,3937,4954,325
2004,Urban,Punjab,Other Crimes,Drug Offense,Female,31-45,8992,546,8446,627,8365
2001,Rural,Kerala,Crime Against Men,Assault,Female,46-60,1296,66,1230,208,1088
2009,Rural,Telangana,Crime Against Women,Rape,Female,13-17,9151,4056,5095,6605,2546
2005,Rural,Mizoram,Other Crimes,Drug Offense,Male,0-12,6183,1238,4945,5821,362
2009,Rural,Arunachal Pradesh,Property Crime,Theft,Female,18-30,5584,4911,673,5078,506
2006,Rural,Himachal Pradesh,Crime Against Women,Domestic Violence,Male,18-30,4423,88,4335,3892,531
2010,Urban,Mizoram,Other Crimes,Drug Offense,Male,13-17,9073,3387,5686,4664,4409
2003,Urban,Himachal Pradesh,Crime Against Men,Extortion,Male,13-17,6077,2103,3974,3471,2606
2004,Rural,Andhra Pradesh,Crime Against Men,Robbery,Female,18-30,9495,1074,8421,7152,2343
2005,Rural,Jammu & Kashmir,Crime Against Children,Kidnapping,Female,18-30,5575,3973,1602,5249,326
2010,Rural,West Bengal,Crime Against Men,Murder,Male,31-45,1751,226,1525,1661,90
2004,Urban,Gujarat,Crime Against Children,Child Labor,Male,13-17,9729,5327,4402,8540,1189
2003,Urban,Rajasthan,Other Crimes,Fraud,Female,13-17,8247,1796,6451,5824,2423
2009,Urban,Tamil Nadu,Crime Against Men,Murder,Female,31-45,6946,1964,4982,4622,2324
2006,Rural,Meghalaya,Crime Against Men,Robbery,Female,0-12,1427,74,1353,669,758
2004,Urban,Uttar Pradesh,Crime Against Men,Assault,Female,0-12,7499,2604,4895,3013,4486
2006,Urban,Tripura,Property Crime,Arson,Female,46-60,5468,1430,4038,2304,3164
2005,Rural,Sikkim,Crime Against Men,Assault,Male,46-60,408,47,361,327,81
2001,Urban,Himachal Pradesh,Property Crime,Vandalism,Female,31-45,5571,2264,3307,3477,2094
2003,Rural,Maharashtra,Other Crimes,Cyber Crime,Male,13-17,983,368,615,957,26
2003,Rural,Odisha,Property Crime,Burglary,Female,13-17,9883,5504,4379,6509,3374
2008,Rural,Andhra Pradesh,Crime Against Children,Trafficking,Male,18-30,6912,4429,2483,6888,24
2004,Rural,Uttarakhand,Property Crime,Theft,Female,60+,9886,1975,7911,8248,1638
2010,Rural,Karnataka,Crime Against Women,Rape,Female,13-17,57,0,57,47,10
2008,Rural,Uttar Pradesh,Other Crimes,Fraud,Female,31-45,2311,1041,1270,1490,821
2004,Urban,Gujarat,Crime Against Women,Domestic Violence,Male,0-12,4707,388,4319,474,4233
2003,Urban,Kerala,Crime Against Women,Dowry Deaths,Female,13-17,8996,3190,5806,6563,2433
2007,Rural,Goa,Crime Against Children,Child Labor,Female,0-12,9987,8689,1298,9225,762
2008,Urban,West Bengal,Other Crimes,Drug Offense,Female,46-60,9847,1403,8444,7732,2115
2006,Rural,Karnataka,Crime Against Men,Murder,Female,18-30,6488,2523,3965,4114,2374
2005,Rural,Rajasthan,Property Crime,Vandalism,Female,60+,6050,5812,238,5850,200
2002,Rural,Assam,Crime Against Men,Murder,Female,60+,134,127,7,128,6
2007,Rural,Telangana,Crime Against Children,Kidnapping,Male,0-12,7417,1693,5724,4853,2564
2005,Rural,Himachal Pradesh,Crime Against Women,Dowry Deaths,Female,0-12,5460,1009,4451,3892,1568
2003,Urban,Maharashtra,Other Crimes,Fraud,Female,18-30,7542,1731,5811,6467,1075
2006,Urban,Punjab,Property Crime,Burglary,Male,13-17,5014,3297,1717,4709,305
2003,Rural,Nagaland,Crime Against Women,Dowry Deaths,Female,18-30,7828,6902,926,7497,331
2004,Rural,Haryana,Other Crimes,Cyber Crime,Male,13-17,3795,1528,2267,2449,1346
2004,Urban,Jammu & Kashmir,Other Crimes,Drug Offense,Male,0-12,8742,2315,6427,4089,4653
2004,Rural,Andhra Pradesh,Crime Against Children,Child Abuse,Male,46-60,1024,573,451,792,232
2010,Rural,West Bengal,Crime Against Women,Molestation,Male,18-30,8268,4461,3807,7008,1260
2008,Rural,Bihar,Crime Against Men,Robbery,Female,18-30,5785,1113,4672,4535,1250
2008,Rural,Arunachal Pradesh,Crime Against Children,Trafficking,Female,0-12,8301,2095,6206,7414,887
2005,Rural,Delhi,Other Crimes,Drug Offense,Female,13-17,7812,1110,6702,5287,2525
2003,Rural,Mizoram,Other Crimes,Cyber Crime,Male,46-60,114,100,14,100,14
2004,Rural,Uttarakhand,Crime Against Women,Molestation,Female,13-17,4438,4044,394,4387,51
2009,Rural,Goa,Crime Against Women,Rape,Male,60+,8331,3132,5199,4056,4275
2004,Rural,Bihar,Crime Against Women,Molestation,Male,13-17,9519,6842,2677,9068,451
2004,Rural,Haryana,Crime Against Women,Dowry Deaths,Female,13-17,9398,1900,7498,6951,2447
2002,Rural,Telangana,Crime Against Women,Rape,Female,60+,7736,2511,5225,4885,2851
2006,Urban,Telangana,Other Crimes,Fraud,Male,31-45,2620,1919,701,2143,477
2004,Rural,Nagaland,Crime Against Children,Kidnapping,Female,13-17,8885,8251,634,8325,560
2003,Rural,Manipur,Crime Against Children,Kidnapping,Female,18-30,9362,3456,5906,7905,1457
2006,Urban,Delhi,Property Crime,Burglary,Male,31-45,9552,8814,738,9484,68
2004,Urban,Haryana,Crime Against Men,Murder,Female,13-17,965,316,649,395,570
2008,Rural,Maharashtra,Crime Against Men,Murder,Female,46-60,8845,5436,3409,7606,1239
2009,Rural,Arunachal Pradesh,Crime Against Women,Rape,Male,31-45,9855,8588,1267,9334,521
2001,Rural,Gujarat,Other Crimes,Drug Offense,Female,60+,3582,2622,960,2845,737
2002,Urban,Punjab,Crime Against Men,Extortion,Male,18-30,4691,2138,2553,2862,1829
2010,Urban,Uttarakhand,Crime Against Women,Rape,Female,46-60,9505,4164,5341,7401,2104
2002,Rural,Odisha,Other Crimes,Fraud,Male,60+,2749,1739,1010,1921,828
2001,Rural,Uttarakhand,Other Crimes,Drug Offense,Male,46-60,4148,2861,1287,3174,974
2001,Rural,Andhra Pradesh,Other Crimes,Fraud,Male,46-60,5049,4908,141,4913,136
2004,Rural,Odisha,Crime Against Men,Extortion,Male,18-30,3221,2299,922,2906,315
2003,Rural,Mizoram,Crime Against Women,Dowry Deaths,Female,13-17,8514,2134,6380,8005,509
2003,Urban,Assam,Other Crimes,Drug Offense,Female,46-60,8810,8800,10,8809,1
2004,Urban,Mizoram,Crime Against Men,Murder,Female,60+,4788,4373,415,4677,111
2003,Rural,Punjab,Crime Against Women,Molestation,Female,13-17,7592,758,6834,5521,2071
2006,Urban,Delhi,Other Crimes,Fraud,Male,13-17,7455,2596,4859,4939,2516
2007,Urban,Madhya Pradesh,Property Crime,Theft,Male,0-12,734,25,709,433,301
2002,Urban,Rajasthan,Crime Against Women,Dowry Deaths,Male,18-30,5376,2879,2497,5123,253
2003,Rural,Assam,Other Crimes,Fraud,Male,0-12,6676,1432,5244,2378,4298
2008,Rural,Andhra Pradesh,Crime Against Children,Kidnapping,Male,31-45,4562,3992,570,4319,243
2009,Urban,Andhra Pradesh,Crime Against Children,Trafficking,Male,18-30,314,41,273,242,72
2003,Rural,Arunachal Pradesh,Property Crime,Theft,Female,46-60,2835,2248,587,2794,41
2009,Urban,Punjab,Other Crimes,Fraud,Female,0-12,4830,4798,32,4814,16
2008,Rural,Madhya Pradesh,Crime Against Men,Robbery,Male,46-60,7491,3030,4461,3324,4167
2002,Urban,Delhi,Crime Against Women,Domestic Violence,Female,18-30,6231,5396,835,5873,358
2002,Urban,Andhra Pradesh,Property Crime,Theft,Male,0-12,6225,2781,3444,6217,8
2007,Urban,Arunachal Pradesh,Other Crimes,Drug Offense,Female,46-60,8217,2969,5248,3692,4525
2006,Rural,Kerala,Crime Against Children,Child Abuse,Male,0-12,2240,980,1260,1424,816
2007,Urban,Chhattisgarh,Other Crimes,Fraud,Male,60+,184,103,81,109,75
2008,Rural,Meghalaya,Crime Against Men,Extortion,Female,13-17,2586,76,2510,1769,817
2008,Rural,Odisha,Other Crimes,Fraud,Female,60+,5204,4839,365,5078,126
2003,Rural,Arunachal Pradesh,Property Crime,Arson,Male,0-12,1715,172,1543,271,1444
2010,Rural,Kerala,Crime Against Children,Trafficking,Female,46-60,1126,845,281,1081,45
2003,Rural,Madhya Pradesh,Property Crime,Burglary,Male,13-17,2868,563,2305,2556,312
2001,Rural,Himachal Pradesh,Crime Against Men,Assault,Male,60+,5157,3861,1296,4011,1146
2002,Rural,Jammu & Kashmir,Property Crime,Vandalism,Female,60+,6591,5363,1228,5836,755
2006,Urban,Sikkim,Other Crimes,Drug Offense,Male,18-30,9643,6430,3213,9104,539
2007,Rural,Himachal Pradesh,Crime Against Children,Child Labor,Female,31-45,1437,1407,30,1429,8
2002,Rural,Maharashtra,Crime Against Men,Assault,Female,18-30,5762,5205,557,5462,300
2004,Rural,Goa,Crime Against Children,Trafficking,Male,46-60,1835,1216,619,1253,582
2002,Rural,Andhra Pradesh,Crime Against Children,Kidnapping,Female,60+,9627,3755,5872,9417,210
2008,Urban,Goa,Crime Against Men,Murder,Female,13-17,6994,2964,4030,3660,3334
2003,Urban,Uttar Pradesh,Crime Against Men,Extortion,Female,46-60,7397,483,6914,5727,1670
2004,Urban,Punjab,Property Crime,Vandalism,Male,60+,9030,4920,4110,5163,3867
2005,Urban,Telangana,Crime Against Women,Molestation,Male,0-12,1811,1726,85,1729,82
2004,Urban,Punjab,Crime Against Women,Molestation,Female,13-17,2296,481,1815,1732,564
2001,Urban,Nagaland,Crime Against Men,Murder,Male,0-12,288,286,2,288,0
2003,Urban,Karnataka,Crime Against Men,Extortion,Female,18-30,1580,482,1098,917,663
2001,Rural,Delhi,Crime Against Women,Domestic Violence,Male,46-60,4513,528,3985,2694,1819
2001,Rural,West Bengal,Other Crimes,Corruption,Male,46-60,2491,832,1659,1400,1091
2007,Urban,Nagaland,Other Crimes,Drug Offense,Male,0-12,6530,299,6231,928,5602
2005,Urban,Meghalaya,Other Crimes,Drug Offense,Male,0-12,1737,700,1037,1683,54
2003,Rural,Himachal Pradesh,Other Crimes,Corruption,Female,31-45,3311,1142,2169,3237,74
2001,Rural,Jammu & Kashmir,Crime Against Men,Murder,Male,0-12,9682,2040,7642,9529,153
2008,Rural,Kerala,Other Crimes,Corruption,Male,60+,635,236,399,556,79
2001,Rural,Uttarakhand,Crime Against Men,Extortion,Male,46-60,9447,6533,2914,7670,1777
2003,Urban,Punjab,Crime Against Children,Child Labor,Male,0-12,6183,3979,2204,5705,478
2005,Rural,Haryana,Crime Against Children,Trafficking,Female,13-17,3437,2811,626,3217,220
2009,Urban,West Bengal,Property Crime,Vandalism,Male,31-45,6893,5631,1262,6203,690
2007,Rural,Gujarat,Crime Against Children,Child Labor,Male,0-12,6482,915,5567,5414,1068
2004,Urban,West Bengal,Crime Against Men,Murder,Male,0-12,4295,2232,2063,2861,1434
2004,Urban,Mizoram,Property Crime,Theft,Male,60+,3213,1966,1247,2384,829
2002,Rural,Jammu & Kashmir,Crime Against Men,Robbery,Male,60+,1031,41,990,548,483
2006,Rural,Haryana,Other Crimes,Fraud,Female,46-60,4445,4248,197,4317,128
2010,Rural,Odisha,Other Crimes,Drug Offense,Male,0-12,6398,3274,3124,5398,1000
2010,Rural,Telangana,Crime Against Men,Murder,Male,13-17,4758,4296,462,4573,185
2010,Rural,Karnataka,Crime Against Women,Molestation,Female,31-45,7522,1177,6345,6595,927
2003,Urban,Telangana,Property Crime,Theft,Female,13-17,528,233,295,521,7
2005,Rural,Uttar Pradesh,Other Crimes,Cyber Crime,Male,18-30,9929,4599,5330,8859,1070
2001,Urban,Himachal Pradesh,Crime Against Women,Dowry Deaths,Female,31-45,8454,4567,3887,6313,2141
2009,Urban,Rajasthan,Property Crime,Theft,Female,60+,6287,3749,2538,4693,1594
2006,Urban,Bihar,Property Crime,Burglary,Female,0-12,8660,3118,5542,5923,2737
2010,Rural,Madhya Pradesh,Crime Against Women,Rape,Female,0-12,1518,646,872,831,687
2003,Rural,Jammu & Kashmir,Other Crimes,Corruption,Male,0-12,7525,761,6764,6437,1088
2006,Urban,Himachal Pradesh,Crime Against Children,Child Abuse,Male,18-30,5949,5820,129,5936,13
2005,Rural,Arunachal Pradesh,Crime Against Children,Child Labor,Male,31-45,2051,350,1701,1562,489
2008,Rural,Himachal Pradesh,Other Crimes,Fraud,Female,13-17,5305,2272,3033,4956,349
2009,Rural,Nagaland,Property Crime,Arson,Male,0-12,5250,119,5131,460,4790
2007,Rural,Odisha,Crime Against Children,Child Labor,Female,60+,1365,664,701,1229,136
2005,Rural,Uttar Pradesh,Property Crime,Burglary,Male,0-12,1776,523,1253,546,1230
2008,Rural,West Bengal,Crime Against Men,Extortion,Female,46-60,7877,3329,4548,4406,3471
2005,Urban,Uttar Pradesh,Other Crimes,Cyber Crime,Male,60+,770,388,382,636,134
2008,Urban,Gujarat,Crime Against Children,Kidnapping,Male,60+,1681,296,1385,688,993
2002,Urban,Bihar,Property Crime,Vandalism,Male,18-30,9230,3580,5650,8089,1141
2004,Urban,Jharkhand,Crime Against Men,Extortion,Male,18-30,8019,2370,5649,4110,3909
2006,Urban,Nagaland,Crime Against Men,Robbery,Female,13-17,2425,704,1721,1254,1171
2006,Urban,Himachal Pradesh,Crime Against Children,Child Labor,Female,13-17,8613,5872,2741,8222,391
2009,Rural,Tamil Nadu,Crime Against Women,Rape,Male,31-45,2750,759,1991,2297,453
2002,Urban,Nagaland,Other Crimes,Cyber Crime,Female,0-12,4021,3883,138,4015,6
2010,Rural,Telangana,Crime Against Women,Molestation,Female,46-60,9581,6283,3298,9324,257
2010,Urban,Andhra Pradesh,Property Crime,Burglary,Male,46-60,1334,432,902,831,503
2007,Rural,Manipur,Property Crime,Arson,Female,18-30,1250,98,1152,1186,64
2002,Urban,Bihar,Crime Against Men,Extortion,Male,18-30,6296,5752,544,5930,366
2001,Rural,Meghalaya,Crime Against Children,Child Labor,Male,31-45,4321,2081,2240,4009,312
2006,Urban,Haryana,Other Crimes,Cyber Crime,Female,18-30,6021,512,5509,3079,2942
2008,Rural,Punjab,Other Crimes,Fraud,Female,60+,2215,657,1558,1047,1168
2002,Urban,Rajasthan,Property Crime,Arson,Female,0-12,6599,1916,4683,3423,3176
2009,Rural,Kerala,Crime Against Men,Murder,Male,60+,7354,5983,1371,7054,300
2003,Rural,Haryana,Other Crimes,Corruption,Male,60+,6383,5050,1333,5918,465
2006,Rural,Tripura,Crime Against Women,Rape,Female,13-17,804,584,220,647,157
2004,Rural,Himachal Pradesh,Crime Against Children,Child Abuse,Female,60+,2742,2065,677,2451,291
2009,Urban,Telangana,Other Crimes,Corruption,Male,18-30,238,127,111,189,49
2002,Urban,Mizoram,Property Crime,Burglary,Female,13-17,6595,1025,5570,2150,4445
2007,Urban,Haryana,Crime Against Men,Assault,Male,60+,5998,5406,592,5778,220
2003,Urban,Tripura,Crime Against Women,Molestation,Male,60+,4274,417,3857,4036,238
2004,Urban,Nagaland,Property Crime,Vandalism,Female,46-60,7373,6567,806,6927,446
2010,Rural,Telangana,Crime Against Children,Child Labor,Female,31-45,2573,420,2153,2016,557
2001,Urban,Mizoram,Other Crimes,Fraud,Male,46-60,8808,5558,3250,6128,2680
2001,Urban,Odisha,Property Crime,Arson,Female,13-17,9908,4969,4939,8324,1584
2002,Rural,Nagaland,Crime Against Men,Robbery,Female,0-12,8110,4652,3458,6585,1525
2009,Rural,Uttar Pradesh,Crime Against Children,Kidnapping,Female,31-45,909,483,426,527,382
2003,Rural,Haryana,Crime Against Men,Murder,Male,46-60,3381,264,3117,823,2558
2009,Urban,Mizoram,Other Crimes,Cyber Crime,Female,46-60,6093,4705,1388,5409,684
2007,Rural,Tamil Nadu,Crime Against Women,Dowry Deaths,Male,60+,5826,1375,4451,4597,1229
2008,Rural,Telangana,Property Crime,Arson,Female,46-60,7963,3641,4322,7588,375
2009,Rural,Nagaland,Crime Against Women,Dowry Deaths,Male,18-30,4510,1977,2533,2236,2274
2001,Urban,Gujarat,Other Crimes,Fraud,Female,0-12,4529,35,4494,396,4133
2002,Rural,Delhi,Crime Against Women,Domestic Violence,Female,31-45,3775,1202,2573,2982,793
2009,Rural,Andhra Pradesh,Other Crimes,Cyber Crime,Male,46-60,3263,106,3157,2868,395
2002,Rural,Delhi,Property Crime,Theft,Female,13-17,7678,5440,2238,6401,1277
2004,Urban,Karnataka,Property Crime,Arson,Female,18-30,6562,1544,5018,3372,3190
2009,Urban,Himachal Pradesh,Other Crimes,Corruption,Male,31-45,246,38,208,62,184
2008,Rural,Gujarat,Property Crime,Vandalism,Female,18-30,1046,585,461,788,258
2008,Rural,Haryana,Other Crimes,Drug Offense,Female,0-12,5495,2139,3356,5214,281
2005,Rural,Mizoram,Property Crime,Burglary,Male,46-60,4323,3804,519,4223,100
2005,Urban,Kerala,Property Crime,Theft,Male,46-60,5544,1420,4124,2355,3189
2001,Urban,Chhattisgarh,Other Crimes,Corruption,Female,46-60,8011,5058,2953,5612,2399
2007,Urban,Sikkim,Other Crimes,Cyber Crime,Female,18-30,6176,4983,1193,5251,925
2007,Urban,Meghalaya,Crime Against Men,Extortion,Male,0-12,4540,2514,2026,3515,1025
2001,Rural,Uttarakhand,Crime Against Women,Dowry Deaths,Male,18-30,8417,790,7627,3843,4574
2010,Rural,Sikkim,Property Crime,Vandalism,Male,31-45,3809,1719,2090,2254,1555
2004,Urban,Maharashtra,Property Crime,Burglary,Male,0-12,4701,3181,1520,3408,1293
2006,Urban,West Bengal,Other Crimes,Drug Offense,Female,46-60,2160,1365,795,1428,732
2002,Rural,Nagaland,Crime Against Women,Rape,Female,18-30,4917,4673,244,4729,188
2010,Rural,Chhattisgarh,Crime Against Women,Dowry Deaths,Female,60+,8060,985,7075,3706,4354
2002,Urban,Nagaland,Other Crimes,Drug Offense,Female,60+,8302,5814,2488,8191,111
2007,Rural,Goa,Crime Against Children,Child Abuse,Female,18-30,5766,3029,2737,5569,197
2009,Rural,Haryana,Crime Against Women,Dowry Deaths,Female,31-45,9512,3469,6043,8101,1411
2003,Urban,Mizoram,Other Crimes,Drug Offense,Male,46-60,2818,1238,1580,1353,1465
2007,Rural,Nagaland,Other Crimes,Drug Offense,Male,60+,2263,1015,1248,1092,1171
2004,Rural,Karnataka,Crime Against Women,Dowry Deaths,Female,31-45,3160,706,2454,1514,1646
2006,Urban,Himachal Pradesh,Property Crime,Burglary,Male,46-60,1415,65,1350,986,429
2001,Rural,Nagaland,Crime Against Children,Child Abuse,Male,13-17,1922,1697,225,1849,73
2008,Rural,Uttarakhand,Crime Against Men,Extortion,Female,31-45,8350,3998,4352,6796,1554
2002,Urban,Kerala,Crime Against Children,Trafficking,Male,31-45,5038,61,4977,131,4907
2004,Urban,Uttarakhand,Crime Against Children,Child Abuse,Male,60+,7630,7626,4,7626,4
2003,Rural,Jharkhand,Crime Against Men,Assault,Female,18-30,8183,7743,440,7818,365
2007,Rural,Maharashtra,Crime Against Men,Murder,Female,18-30,2450,789,1661,2235,215
2008,Urban,Karnataka,Crime Against Children,Child Abuse,Female,60+,5832,4653,1179,5585,247
2006,Urban,Meghalaya,Crime Against Children,Child Labor,Male,46-60,7096,5510,1586,6592,504
2002,Rural,Sikkim,Crime Against Women,Molestation,Female,0-12,6464,6288,176,6417,47
2008,Urban,Haryana,Property Crime,Burglary,Female,46-60,6395,1375,5020,4645,1750
2007,Urban,Haryana,Crime Against Children,Kidnapping,Female,18-30,5953,2999,2954,4626,1327
2004,Rural,Madhya Pradesh,Crime Against Children,Trafficking,Female,18-30,1629,1268,361,1290,339
2003,Rural,Nagaland,Crime Against Men,Murder,Female,46-60,7966,6102,1864,7914,52
2002,Urban,Madhya Pradesh,Crime Against Men,Assault,Female,18-30,1509,68,1441,1066,443
2002,Urban,Madhya Pradesh,Crime Against Children,Kidnapping,Male,60+,9554,2227,7327,8476,1078
2002,Rural,Chhattisgarh,Property Crime,Arson,Female,13-17,6984,5338,1646,6599,385
2010,Urban,Tripura,Crime Against Women,Domestic Violence,Male,18-30,7783,7157,626,7513,270
2007,Rural,Arunachal Pradesh,Crime Against Women,Molestation,Female,13-17,3852,1380,2472,1680,2172
2009,Urban,Rajasthan,Crime Against Children,Child Abuse,Male,13-17,8385,50,8335,656,7729
2008,Rural,Kerala,Property Crime,Vandalism,Female,0-12,643,404,239,554,89
2007,Rural,Tripura,Other Crimes,Corruption,Female,46-60,9213,4063,5150,6986,2227
2001,Rural,Telangana,Crime Against Children,Child Labor,Female,13-17,2678,469,2209,604,2074
2008,Rural,Chhattisgarh,Crime Against Women,Molestation,Female,0-12,5848,4670,1178,5623,225
2006,Rural,Odisha,Other Crimes,Drug Offense,Male,18-30,1226,426,800,1158,68
2007,Rural,Haryana,Property Crime,Vandalism,Female,18-30,965,591,374,922,43
2005,Rural,Tripura,Other Crimes,Fraud,Female,18-30,3066,599,2467,1856,1210
2006,Rural,Mizoram,Crime Against Men,Extortion,Male,60+,6229,2300,3929,4898,1331
2003,Rural,Karnataka,Crime Against Women,Dowry Deaths,Female,0-12,4819,447,4372,1458,3361
2001,Rural,Goa,Property Crime,Arson,Female,18-30,1514,1454,60,1501,13
2010,Urban,Odisha,Other Crimes,Fraud,Male,31-45,8953,5527,3426,8858,95
2003,Rural,Kerala,Crime Against Men,Murder,Male,31-45,3404,2838,566,2986,418
2005,Urban,Assam,Crime Against Children,Child Labor,Male,31-45,5311,124,5187,899,4412
2002,Urban,Rajasthan,Crime Against Women,Dowry Deaths,Female,18-30,3946,310,3636,1307,2639
2005,Rural,Tripura,Property Crime,Vandalism,Male,31-45,8380,4095,4285,6182,2198
2007,Urban,Madhya Pradesh,Property Crime,Vandalism,Male,0-12,1289,158,1131,1176,113
2003,Rural,Haryana,Other Crimes,Corruption,Male,46-60,3459,1708,1751,2567,892
2008,Urban,Madhya Pradesh,Property Crime,Arson,Male,18-30,9616,8801,815,8966,650
2003,Rural,Uttarakhand,Crime Against Women,Domestic Violence,Female,0-12,582,468,114,519,63
2007,Rural,Uttarakhand,Other Crimes,Drug Offense,Male,13-17,1585,314,1271,1335,250
2009,Rural,Jammu & Kashmir,Crime Against Men,Robbery,Male,18-30,3640,924,2716,1437,2203
2005,Rural,Goa,Crime Against Women,Domestic Violence,Female,60+,2819,2310,509,2796,23
2010,Rural,Madhya Pradesh,Crime Against Women,Dowry Deaths,Female,31-45,5465,3148,2317,4942,523
2008,Rural,Rajasthan,Crime Against Men,Assault,Male,13-17,9648,1780,7868,5883,3765
2008,Rural,Himachal Pradesh,Property Crime,Theft,Female,18-30,6172,901,5271,3082,3090
2001,Urban,Himachal Pradesh,Crime Against Men,Robbery,Female,0-12,9485,6101,3384,6638,2847
2006,Urban,Sikkim,Other Crimes,Fraud,Female,18-30,5655,3547,2108,4161,1494
2002,Rural,Odisha,Crime Against Men,Extortion,Male,13-17,7138,3115,4023,4399,2739
2003,Rural,Haryana,Crime Against Women,Domestic Violence,Male,31-45,715,672,43,673,42
2001,Urban,Madhya Pradesh,Crime Against Men,Assault,Female,46-60,1054,937,117,965,89
2008,Rural,Nagaland,Other Crimes,Cyber Crime,Female,60+,3301,31,3270,2985,316
2005,Urban,Bihar,Crime Against Women,Domestic Violence,Male,46-60,4713,1749,2964,4709,4
2003,Urban,Rajasthan,Other Crimes,Cyber Crime,Male,13-17,8972,2879,6093,7042,1930
2005,Urban,Bihar,Other Crimes,Corruption,Female,31-45,7396,7383,13,7385,11
2003,Rural,Jammu & Kashmir,Crime Against Women,Dowry Deaths,Male,60+,6170,2419,3751,2754,3416
2007,Urban,Manipur,Crime Against Women,Domestic Violence,Male,0-12,8073,2627,5446,7894,179
2009,Urban,Maharashtra,Property Crime,Theft,Male,46-60,6078,1739,4339,5987,91
2008,Urban,Sikkim,Crime Against Children,Kidnapping,Female,13-17,9870,7762,2108,8727,1143
2008,Urban,Rajasthan,Crime Against Children,Child Labor,Female,13-17,8752,1937,6815,5203,3549
2001,Rural,Uttar Pradesh,Crime Against Women,Domestic Violence,Female,60+,9317,7170,2147,8433,884
2002,Rural,Manipur,Crime Against Men,Extortion,Female,46-60,8209,2284,5925,5405,2804
2010,Rural,Jharkhand,Other Crimes,Corruption,Female,13-17,297,78,219,200,97
2003,Rural,Himachal Pradesh,Crime Against Men,Assault,Male,31-45,4307,3261,1046,3744,563
2001,Rural,Uttar Pradesh,Crime Against Men,Assault,Male,31-45,7387,6408,979,7386,1
2004,Rural,Karnataka,Crime Against Men,Assault,Male,0-12,6638,1916,4722,6375,263
2002,Rural,Mizoram,Crime Against Children,Kidnapping,Male,13-17,4146,988,3158,3863,283
2003,Urban,Tripura,Property Crime,Burglary,Male,13-17,6345,3931,2414,4001,2344
2006,Rural,Jharkhand,Property Crime,Theft,Male,13-17,1633,1197,436,1390,243
2002,Rural,Nagaland,Other Crimes,Drug Offense,Male,13-17,766,343,423,705,61
2008,Rural,Sikkim,Crime Against Women,Dowry Deaths,Male,13-17,3659,2752,907,3308,351
2006,Rural,Goa,Crime Against Men,Extortion,Female,31-45,4861,1685,3176,2165,2696
2010,Rural,Odisha,Crime Against Children,Child Labor,Male,13-17,256,40,216,193,63
2002,Urban,Haryana,Crime Against Children,Trafficking,Female,13-17,417,217,200,296,121
2010,Rural,Chhattisgarh,Crime Against Children,Child Labor,Male,46-60,2220,937,1283,1436,784
2007,Rural,Karnataka,Other Crimes,Fraud,Female,13-17,2023,531,1492,1400,623
2007,Rural,Arunachal Pradesh,Property Crime,Arson,Female,31-45,847,789,58,809,38
2005,Urban,Rajasthan,Crime Against Men,Murder,Male,46-60,4950,3831,1119,4638,312
2008,Urban,Odisha,Other Crimes,Drug Offense,Female,0-12,7852,7844,8,7844,8
2006,Urban,Jharkhand,Other Crimes,Drug Offense,Male,46-60,269,193,76,269,0
2010,Rural,Manipur,Crime Against Men,Robbery,Female,60+,4942,480,4462,4612,330
2001,Rural,Rajasthan,Property Crime,Theft,Male,18-30,1277,524,753,1063,214
2003,Rural,Tripura,Crime Against Children,Trafficking,Female,0-12,4348,999,3349,2297,2051
2003,Urban,Tripura,Property Crime,Theft,Female,31-45,7287,2084,5203,2796,4491
2010,Urban,Jammu & Kashmir,Crime Against Men,Assault,Male,13-17,3052,838,2214,1622,1430
2003,Urban,Tripura,Crime Against Children,Child Abuse,Female,13-17,2594,1622,972,2495,99
2003,Urban,Maharashtra,Crime Against Men,Extortion,Female,46-60,3194,706,2488,915,2279
2006,Rural,Uttar Pradesh,Property Crime,Theft,Male,60+,1382,170,1212,932,450
2005,Rural,Maharashtra,Crime Against Men,Assault,Female,46-60,4913,2231,2682,4035,878
2003,Urban,Tripura,Other Crimes,Cyber Crime,Male,46-60,1516,684,832,913,603
2005,Rural,Jharkhand,Crime Against Children,Child Abuse,Female,18-30,8966,6766,2200,8346,620
2006,Urban,Assam,Property Crime,Arson,Male,0-12,6191,6045,146,6108,83
2008,Urban,Goa,Other Crimes,Drug Offense,Male,18-30,5761,3985,1776,4076,1685
2010,Urban,Chhattisgarh,Crime Against Children,Kidnapping,Female,13-17,5158,4626,532,4776,382
2008,Rural,Haryana,Crime Against Children,Trafficking,Male,18-30,1448,869,579,1297,151
2007,Urban,Tamil Nadu,Crime Against Children,Kidnapping,Female,18-30,5165,4118,1047,4698,467
2008,Urban,Jharkhand,Crime Against Women,Domestic Violence,Male,18-30,3594,3067,527,3562,32
2001,Urban,Chhattisgarh,Crime Against Men,Extortion,Female,46-60,9581,6346,3235,7959,1622
2005,Urban,Odisha,Property Crime,Burglary,Female,46-60,9216,5326,3890,8391,825
2001,Urban,Manipur,Other Crimes,Drug Offense,Male,13-17,2806,1830,976,2115,691
2006,Urban,Tripura,Property Crime,Burglary,Female,18-30,9436,5043,4393,5591,3845
2001,Urban,Telangana,Other Crimes,Cyber Crime,Female,31-45,4143,1905,2238,2983,1160
2009,Rural,Haryana,Other Crimes,Cyber Crime,Female,13-17,2851,2377,474,2764,87
2008,Urban,Bihar,Crime Against Children,Trafficking,Female,0-12,8398,828,7570,4799,3599
2001,Urban,West Bengal,Other Crimes,Cyber Crime,Male,46-60,5685,794,4891,3769,1916
2006,Urban,Chhattisgarh,Crime Against Men,Extortion,Female,31-45,436,217,219,279,157
2010,Rural,Goa,Other Crimes,Drug Offense,Female,60+,8751,7004,1747,7538,1213
2010,Rural,Karnataka,Crime Against Women,Domestic Violence,Female,31-45,3131,432,2699,1620,1511
2001,Urban,Tamil Nadu,Property Crime,Burglary,Female,13-17,666,233,433,298,368
2002,Rural,Jammu & Kashmir,Crime Against Children,Trafficking,Female,13-17,127,18,109,89,38
2006,Urban,Telangana,Crime Against Children,Child Abuse,Male,13-17,1997,759,1238,1821,176
2008,Rural,Punjab,Property Crime,Arson,Female,31-45,2550,1428,1122,1484,1066
2008,Rural,Meghalaya,Crime Against Children,Child Labor,Female,18-30,7978,1060,6918,1366,6612
2004,Urban,Chhattisgarh,Crime Against Men,Robbery,Female,31-45,2428,1997,431,2053,375
2006,Rural,Arunachal Pradesh,Crime Against Women,Dowry Deaths,Female,46-60,5996,5155,841,5763,233
2005,Urban,Telangana,Crime Against Children,Child Labor,Male,13-17,7727,5544,2183,6409,1318
2002,Rural,Maharashtra,Crime Against Children,Child Labor,Female,31-45,9934,2770,7164,7777,2157
2003,Rural,Uttar Pradesh,Crime Against Men,Assault,Female,18-30,6302,2694,3608,3586,2716
2007,Urban,Odisha,Crime Against Men,Robbery,Male,46-60,5004,4800,204,4871,133
2008,Rural,Odisha,Crime Against Women,Domestic Violence,Female,0-12,1473,416,1057,785,688
2006,Urban,Jharkhand,Property Crime,Burglary,Male,0-12,7396,1879,5517,7326,70
2003,Rural,Haryana,Crime Against Men,Robbery,Male,18-30,1121,303,818,838,283
2008,Rural,Chhattisgarh,Crime Against Women,Molestation,Female,18-30,6854,2685,4169,5383,1471
2010,Rural,Jharkhand,Crime Against Children,Kidnapping,Female,31-45,1397,1157,240,1243,154
2007,Rural,Punjab,Crime Against Children,Kidnapping,Male,0-12,6401,1716,4685,4504,1897
2007,Rural,Meghalaya,Crime Against Women,Domestic Violence,Female,0-12,4371,3336,1035,4330,41
2001,Rural,Gujarat,Crime Against Women,Domestic Violence,Female,31-45,658,149,509,346,312
2005,Urban,Jammu & Kashmir,Crime Against Men,Robbery,Male,60+,9457,7103,2354,7154,2303
2001,Rural,Telangana,Crime Against Women,Domestic Violence,Female,31-45,1078,254,824,1034,44
2010,Urban,Uttar Pradesh,Property Crime,Theft,Female,13-17,1878,429,1449,1377,501
2005,Urban,Telangana,Property Crime,Arson,Female,13-17,6727,1444,5283,4066,2661
2010,Urban,Jammu & Kashmir,Property Crime,Vandalism,Female,46-60,2469,779,1690,963,1506
2005,Urban,Bihar,Property Crime,Burglary,Male,0-12,9192,2515,6677,8934,258
2003,Urban,Chhattisgarh,Crime Against Children,Trafficking,Male,60+,4492,164,4328,2220,2272
2006,Urban,Meghalaya,Crime Against Women,Rape,Female,0-12,1634,1385,249,1602,32
2004,Rural,Haryana,Crime Against Women,Molestation,Female,31-45,8267,1267,7000,1329,6938
2001,Rural,Odisha,Crime Against Women,Domestic Violence,Female,60+,8036,4789,3247,6471,1565
2009,Urban,Punjab,Crime Against Children,Child Abuse,Male,31-45,2742,362,2380,1889,853
2006,Urban,Arunachal Pradesh,Other Crimes,Drug Offense,Male,18-30,4301,4173,128,4229,72
2001,Urban,Andhra Pradesh,Crime Against Children,Trafficking,Female,60+,7570,3050,4520,6382,1188
2003,Rural,Odisha,Other Crimes,Drug Offense,Male,46-60,2438,966,1472,1516,922
2010,Rural,Goa,Crime Against Women,Molestation,Female,60+,9328,1122,8206,3126,6202
2010,Rural,Assam,Crime Against Men,Murder,Male,13-17,1863,716,1147,1532,331
2002,Urban,Uttarakhand,Property Crime,Vandalism,Male,60+,6689,3162,3527,6247,442
2005,Urban,Maharashtra,Crime Against Children,Child Labor,Female,46-60,7009,1894,5115,3963,3046
2009,Urban,Bihar,Other Crimes,Fraud,Male,18-30,3261,652,2609,1462,1799
2005,Urban,Mizoram,Crime Against Children,Child Abuse,Female,60+,5306,875,4431,4426,880
2004,Urban,Haryana,Property Crime,Burglary,Female,60+,8006,4456,3550,7320,686
2010,Urban,West Bengal,Crime Against Women,Dowry Deaths,Female,0-12,7175,6429,746,6994,181
2009,Rural,Arunachal Pradesh,Property Crime,Arson,Female,31-45,6067,2645,3422,4233,1834
2008,Rural,Madhya Pradesh,Property Crime,Burglary,Male,0-12,5435,2454,2981,3903,1532
2009,Urban,Kerala,Crime Against Women,Molestation,Female,31-45,2273,672,1601,1036,1237
2002,Urban,Jammu & Kashmir,Crime Against Women,Dowry Deaths,Male,0-12,7676,5145,2531,6234,1442
2003,Urban,Himachal Pradesh,Property Crime,Burglary,Female,31-45,1587,543,1044,636,951
2002,Rural,Madhya Pradesh,Other Crimes,Corruption,Female,0-12,4336,2901,1435,3571,765
2004,Rural,Himachal Pradesh,Property Crime,Theft,Male,0-12,4713,2863,1850,3742,971
2010,Rural,Uttarakhand,Property Crime,Theft,Male,31-45,58,26,32,55,3
2010,Rural,Delhi,Crime Against Children,Child Labor,Female,46-60,5321,1609,3712,2827,2494
2007,Rural,Uttar Pradesh,Crime Against Children,Kidnapping,Male,31-45,624,231,393,436,188
2006,Urban,Meghalaya,Crime Against Children,Child Labor,Female,18-30,7842,3221,4621,4129,3713
2003,Urban,Gujarat,Property Crime,Arson,Male,0-12,5698,3716,1982,3959,1739
2004,Urban,Maharashtra,Crime Against Children,Trafficking,Male,13-17,763,351,412,621,142
2006,Urban,Chhattisgarh,Property Crime,Burglary,Male,31-45,5363,636,4727,1773,3590
2004,Rural,Goa,Property Crime,Theft,Female,13-17,176,17,159,141,35
2009,Urban,Goa,Crime Against Women,Rape,Female,0-12,4583,2230,2353,4491,92
2007,Rural,Goa,Crime Against Children,Child Labor,Male,31-45,1429,861,568,875,554
2009,Rural,Gujarat,Property Crime,Arson,Female,18-30,5506,2435,3071,3709,1797
2006,Rural,Tripura,Property Crime,Burglary,Male,31-45,6530,1684,4846,2834,3696
2005,Urban,Goa,Other Crimes,Drug Offense,Female,31-45,5551,774,4777,2776,2775
2003,Rural,Gujarat,Other Crimes,Drug Offense,Female,31-45,8291,1792,6499,7517,774
2009,Urban,Uttarakhand,Crime Against Women,Molestation,Male,60+,6310,517,5793,2402,3908
2003,Rural,Manipur,Property Crime,Arson,Female,31-45,1895,58,1837,1321,574
2009,Urban,Delhi,Crime Against Children,Trafficking,Female,60+,929,830,99,926,3
2002,Rural,Telangana,Crime Against Children,Kidnapping,Female,60+,9364,58,9306,2088,7276
2002,Rural,Meghalaya,Property Crime,Theft,Male,0-12,7305,4696,2609,7244,61
2007,Rural,Goa,Crime Against Men,Robbery,Male,13-17,293,250,43,269,24
2007,Urban,Rajasthan,Crime Against Women,Rape,Female,31-45,5624,4873,751,5386,238
2009,Rural,Uttar Pradesh,Crime Against Men,Murder,Female,13-17,2792,1009,1783,1708,1084
2004,Urban,Odisha,Crime Against Women,Domestic Violence,Male,0-12,8521,4622,3899,6961,1560
2001,Rural,Mizoram,Property Crime,Vandalism,Male,31-45,3501,3157,344,3490,11
2005,Urban,Delhi,Crime Against Men,Extortion,Male,60+,5412,2228,3184,3466,1946
2009,Rural,Assam,Crime Against Children,Trafficking,Female,31-45,6344,5814,530,5872,472
2008,Urban,Chhattisgarh,Other Crimes,Drug Offense,Male,13-17,6154,3243,2911,3479,2675
2007,Rural,Kerala,Crime Against Men,Robbery,Male,31-45,7597,6982,615,7246,351
2005,Urban,Jammu & Kashmir,Other Crimes,Cyber Crime,Female,18-30,7214,2966,4248,4969,2245
2002,Urban,Gujarat,Crime Against Men,Robbery,Female,31-45,9837,6505,3332,7742,2095
2006,Urban,Gujarat,Other Crimes,Corruption,Male,18-30,6683,6561,122,6640,43
2009,Rural,Meghalaya,Crime Against Women,Rape,Female,0-12,9655,4994,4661,9115,540
2010,Urban,Madhya Pradesh,Crime Against Women,Domestic Violence,Male,13-17,7684,674,7010,3514,4170
2006,Urban,Jammu & Kashmir,Crime Against Women,Domestic Violence,Male,0-12,4531,1481,3050,2980,1551
2001,Rural,Tripura,Crime Against Men,Murder,Male,31-45,7734,5410,2324,6985,749
2007,Urban,Punjab,Crime Against Men,Assault,Male,46-60,1327,871,456,1076,251
2001,Rural,Bihar,Property Crime,Theft,Female,31-45,2449,387,2062,1006,1443
2007,Urban,Tamil Nadu,Other Crimes,Cyber Crime,Male,18-30,781,266,515,464,317
2007,Urban,Haryana,Other Crimes,Corruption,Female,46-60,7591,5657,1934,7488,103
2005,Rural,Bihar,Crime Against Children,Child Labor,Female,31-45,6741,2758,3983,4291,2450
2009,Rural,Chhattisgarh,Other Crimes,Corruption,Male,60+,9585,4147,5438,6639,2946
2010,Urban,Gujarat,Property Crime,Arson,Male,18-30,5102,2435,2667,3100,2002
2005,Rural,Rajasthan,Crime Against Women,Domestic Violence,Female,18-30,4565,62,4503,1951,2614
2004,Rural,Meghalaya,Crime Against Children,Trafficking,Female,46-60,2792,2228,564,2410,382
2001,Urban,Punjab,Crime Against Women,Dowry Deaths,Female,46-60,2287,315,1972,1930,357
2006,Rural,Nagaland,Property Crime,Burglary,Female,60+,5781,3013,2768,5462,319
2010,Urban,Chhattisgarh,Crime Against Children,Trafficking,Female,18-30,4083,587,3496,2760,1323
2002,Rural,Assam,Crime Against Children,Trafficking,Female,46-60,2791,368,2423,768,2023
2003,Urban,Delhi,Property Crime,Vandalism,Male,46-60,8114,3743,4371,4964,3150
2007,Urban,Rajasthan,Crime Against Children,Child Labor,Male,13-17,7612,6075,1537,7269,343
2010,Rural,Jammu & Kashmir,Crime Against Children,Child Abuse,Female,31-45,4293,3372,921,3375,918
2007,Rural,Uttar Pradesh,Crime Against Children,Kidnapping,Male,0-12,2189,819,1370,1698,491
2010,Rural,Sikkim,Other Crimes,Drug Offense,Male,13-17,8327,1980,6347,3902,4425
2004,Urban,Bihar,Other Crimes,Fraud,Female,46-60,2194,1311,883,2082,112
2004,Urban,Rajasthan,Property Crime,Arson,Male,31-45,247,109,138,152,95
2006,Urban,Arunachal Pradesh,Property Crime,Theft,Male,60+,1292,1247,45,1253,39
2005,Rural,Meghalaya,Crime Against Children,Child Labor,Male,13-17,6606,4287,2319,5591,1015
2010,Urban,Jammu & Kashmir,Property Crime,Arson,Male,0-12,546,107,439,390,156
2006,Urban,West Bengal,Other Crimes,Fraud,Male,46-60,9365,2656,6709,6372,2993
2005,Urban,Karnataka,Crime Against Women,Molestation,Female,31-45,6536,2449,4087,3975,2561
2006,Rural,Delhi,Other Crimes,Fraud,Female,60+,6999,3341,3658,5129,1870
2007,Urban,Karnataka,Property Crime,Burglary,Female,46-60,901,632,269,662,239
2003,Urban,Himachal Pradesh,Crime Against Women,Rape,Female,18-30,2120,922,1198,1290,830
2004,Urban,Jharkhand,Crime Against Women,Domestic Violence,Female,13-17,1226,235,991,1109,117
2009,Rural,Uttar Pradesh,Crime Against Women,Rape,Male,13-17,8681,5131,3550,7986,695
2006,Urban,Kerala,Crime Against Women,Molestation,Female,46-60,1714,1097,617,1230,484
2007,Rural,Bihar,Crime Against Men,Extortion,Male,18-30,5956,5728,228,5780,176
2006,Rural,Mizoram,Crime Against Women,Domestic Violence,Male,0-12,8643,3984,4659,8637,6
2010,Rural,Gujarat,Crime Against Children,Kidnapping,Female,60+,6626,1399,5227,2189,4437
2004,Urban,Jharkhand,Crime Against Men,Extortion,Female,31-45,3387,900,2487,2910,477
2003,Urban,Manipur,Crime Against Women,Molestation,Male,60+,3520,2318,1202,2542,978
2007,Urban,Madhya Pradesh,Other Crimes,Fraud,Male,18-30,1464,968,496,1394,70
2001,Urban,Uttarakhand,Other Crimes,Corruption,Male,0-12,1361,1198,163,1229,132
2006,Rural,Kerala,Crime Against Women,Domestic Violence,Female,46-60,6465,4317,2148,5013,1452
2004,Urban,Kerala,Crime Against Women,Domestic Violence,Male,60+,1805,241,1564,1185,620
2010,Rural,Chhattisgarh,Crime Against Men,Extortion,Female,0-12,7102,892,6210,3811,3291
2005,Urban,Telangana,Other Crimes,Drug Offense,Male,13-17,7362,6436,926,7355,7
2010,Rural,Rajasthan,Property Crime,Vandalism,Male,18-30,8674,8542,132,8568,106
2007,Urban,Madhya Pradesh,Property Crime,Vandalism,Female,18-30,8194,7617,577,7775,419
2006,Urban,Karnataka,Crime Against Women,Molestation,Female,31-45,5643,646,4997,3669,1974
2010,Urban,Chhattisgarh,Property Crime,Vandalism,Female,60+,6566,344,6222,4110,2456
2006,Urban,Tripura,Crime Against Women,Domestic Violence,Female,0-12,4365,2528,1837,2613,1752
2010,Urban,Rajasthan,Other Crimes,Drug Offense,Male,31-45,3543,463,3080,1395,2148
2002,Rural,Punjab,Crime Against Women,Molestation,Female,46-60,6456,5196,1260,6411,45
2009,Rural,Punjab,Property Crime,Theft,Female,0-12,8548,855,7693,1334,7214
2004,Urban,Odisha,Other Crimes,Cyber Crime,Female,18-30,500,314,186,493,7
2010,Rural,Sikkim,Property Crime,Arson,Male,31-45,4084,1036,3048,1787,2297
2009,Rural,Arunachal Pradesh,Crime Against Women,Rape,Female,13-17,880,797,83,850,30
2008,Urban,Punjab,Property Crime,Vandalism,Male,46-60,2499,881,1618,1651,848
2008,Rural,Tripura,Crime Against Men,Robbery,Male,13-17,9172,8827,345,8969,203
2009,Rural,Jharkhand,Crime Against Children,Kidnapping,Male,31-45,2737,1101,1636,2590,147
2002,Rural,Rajasthan,Crime Against Children,Kidnapping,Male,13-17,7886,3401,4485,5473,2413
2010,Rural,Goa,Crime Against Men,Robbery,Male,60+,4618,1098,3520,3728,890
2005,Urban,Karnataka,Other Crimes,Cyber Crime,Male,18-30,3308,2293,1015,2820,488
2010,Urban,Telangana,Crime Against Men,Extortion,Female,18-30,5468,761,4707,3718,1750
2007,Urban,Telangana,Crime Against Men,Murder,Female,60+,7140,2410,4730,4253,2887
2005,Urban,Haryana,Crime Against Children,Trafficking,Male,0-12,1414,720,694,1361,53
2007,Rural,Punjab,Other Crimes,Cyber Crime,Male,13-17,4304,3410,894,3691,613
2006,Urban,Jammu & Kashmir,Property Crime,Arson,Male,46-60,6900,2272,4628,5465,1435
2002,Urban,Nagaland,Other Crimes,Corruption,Male,18-30,1285,1029,256,1120,165
2010,Rural,Tripura,Crime Against Children,Kidnapping,Female,46-60,5780,5169,611,5621,159
2010,Urban,Mizoram,Crime Against Women,Domestic Violence,Female,46-60,7701,1874,5827,2581,5120
2003,Rural,Bihar,Other Crimes,Cyber Crime,Male,31-45,3549,696,2853,805,2744
2009,Urban,Telangana,Crime Against Men,Robbery,Male,18-30,6311,4482,1829,4726,1585
2002,Rural,Arunachal Pradesh,Property Crime,Vandalism,Female,0-12,5475,1555,3920,5465,10
2003,Urban,Mizoram,Crime Against Children,Kidnapping,Male,31-45,8656,6718,1938,6915,1741
2003,Urban,Uttar Pradesh,Property Crime,Vandalism,Female,60+,7951,421,7530,6123,1828
2001,Rural,Jharkhand,Crime Against Children,Kidnapping,Female,60+,4860,516,4344,893,3967
2005,Rural,Delhi,Crime Against Women,Molestation,Female,46-60,4884,3752,1132,4497,387
2001,Rural,Rajasthan,Crime Against Men,Assault,Female,18-30,6308,217,6091,1342,4966
2003,Rural,Bihar,Crime Against Children,Child Labor,Male,0-12,1381,828,553,883,498
2001,Urban,Nagaland,Crime Against Men,Assault,Female,13-17,2475,736,1739,2272,203
2004,Urban,Jharkhand,Crime Against Men,Assault,Female,13-17,2492,903,1589,1266,1226
2004,Rural,Telangana,Other Crimes,Corruption,Male,46-60,2898,2338,560,2370,528
2003,Urban,Karnataka,Crime Against Men,Robbery,Female,0-12,9359,8297,1062,8690,669
2010,Urban,Mizoram,Property Crime,Burglary,Female,60+,2486,1331,1155,1645,841
2010,Urban,Andhra Pradesh,Property Crime,Theft,Male,0-12,4811,4123,688,4716,95
2009,Rural,West Bengal,Crime Against Men,Extortion,Male,13-17,3755,1474,2281,2931,824
2003,Urban,Jammu & Kashmir,Crime Against Children,Kidnapping,Female,31-45,4306,2107,2199,4147,159
2001,Rural,Delhi,Crime Against Men,Extortion,Female,31-45,4190,1884,2306,3419,771
2006,Rural,Himachal Pradesh,Crime Against Men,Robbery,Female,18-30,7853,4444,3409,5363,2490
2001,Rural,Nagaland,Property Crime,Arson,Female,31-45,7476,3354,4122,6734,742
2001,Urban,Kerala,Crime Against Children,Child Labor,Female,46-60,746,726,20,726,20
2010,Urban,Haryana,Crime Against Men,Assault,Female,60+,3664,665,2999,1232,2432
2010,Rural,Arunachal Pradesh,Other Crimes,Cyber Crime,Male,0-12,4170,437,3733,1200,2970
2010,Rural,Andhra Pradesh,Other Crimes,Corruption,Female,46-60,6734,5754,980,6457,277
2002,Rural,Rajasthan,Crime Against Children,Child Labor,Male,18-30,9607,8699,908,9538,69
2008,Urban,Delhi,Crime Against Children,Child Labor,Male,46-60,4345,3732,613,4262,83
2008,Rural,Karnataka,Crime Against Men,Extortion,Male,0-12,3146,203,2943,982,2164
2008,Urban,Karnataka,Crime Against Men,Assault,Female,13-17,8357,6680,1677,7460,897
2010,Urban,Manipur,Crime Against Women,Rape,Female,13-17,1601,1046,555,1406,195
2004,Urban,Himachal Pradesh,Crime Against Men,Robbery,Male,13-17,2041,1365,676,1992,49
2002,Rural,Jharkhand,Property Crime,Burglary,Male,46-60,9381,261,9120,5159,4222
2004,Urban,Sikkim,Crime Against Men,Robbery,Male,0-12,7490,396,7094,5683,1807
2002,Rural,Gujarat,Other Crimes,Drug Offense,Male,0-12,2394,787,1607,1248,1146
2009,Rural,Kerala,Property Crime,Theft,Male,46-60,7097,2546,4551,2850,4247
2006,Urban,Maharashtra,Other Crimes,Cyber Crime,Male,60+,657,319,338,351,306
2002,Urban,Arunachal Pradesh,Crime Against Men,Robbery,Female,13-17,5499,340,5159,2838,2661
2008,Rural,Assam,Crime Against Men,Extortion,Female,18-30,2209,722,1487,1630,579
2005,Rural,Nagaland,Crime Against Men,Robbery,Female,60+,533,306,227,531,2
2007,Urban,Telangana,Crime Against Women,Dowry Deaths,Male,13-17,2810,2350,460,2502,308
2008,Rural,Uttar Pradesh,Property Crime,Vandalism,Female,60+,7882,1587,6295,3281,4601
2008,Rural,Bihar,Crime Against Women,Molestation,Male,0-12,177,127,50,152,25
2009,Rural,Odisha,Crime Against Men,Robbery,Male,18-30,5804,5347,457,5441,363
2001,Urban,Mizoram,Crime Against Women,Molestation,Male,13-17,1324,143,1181,952,372
2009,Rural,Maharashtra,Other Crimes,Fraud,Female,0-12,7536,4989,2547,7361,175
2005,Urban,Tamil Nadu,Property Crime,Theft,Female,60+,8027,7325,702,7765,262
2006,Rural,Kerala,Crime Against Children,Child Labor,Male,0-12,2968,2085,883,2243,725
2007,Urban,Jammu & Kashmir,Crime Against Children,Child Abuse,Female,13-17,659,86,573,367,292
2005,Rural,Telangana,Property Crime,Theft,Female,31-45,8140,2555,5585,6784,1356
2005,Rural,Andhra Pradesh,Crime Against Women,Molestation,Male,18-30,4500,3831,669,4128,372
2001,Rural,Telangana,Other Crimes,Drug Offense,Male,0-12,363,296,67,315,48
2001,Urban,Telangana,Crime Against Women,Domestic Violence,Male,13-17,67,36,31,53,14
2007,Urban,Tripura,Crime Against Men,Assault,Male,46-60,1181,582,599,1095,86
2007,Urban,Bihar,Crime Against Men,Extortion,Female,0-12,8677,3213,5464,4635,4042
2001,Urban,Rajasthan,Crime Against Men,Robbery,Male,13-17,8683,30,8653,8328,355
2006,Urban,Madhya Pradesh,Crime Against Children,Kidnapping,Female,18-30,2119,409,1710,2003,116
2009,Urban,Nagaland,Other Crimes,Corruption,Male,60+,3746,882,2864,1777,1969
2002,Rural,Himachal Pradesh,Crime Against Men,Extortion,Female,18-30,1617,890,727,946,671
2003,Urban,Mizoram,Property Crime,Burglary,Male,18-30,9807,8180,1627,9507,300
2007,Rural,Uttar Pradesh,Crime Against Women,Dowry Deaths,Female,0-12,4537,1069,3468,2662,1875
2001,Rural,Uttar Pradesh,Crime Against Men,Murder,Male,0-12,4296,2652,1644,3099,1197
2001,Rural,Tamil Nadu,Property Crime,Arson,Male,18-30,4695,2709,1986,3296,1399
2009,Rural,Mizoram,Crime Against Men,Robbery,Female,60+,1531,1190,341,1259,272
2001,Urban,Assam,Crime Against Children,Child Labor,Male,60+,508,178,330,198,310
2004,Rural,Karnataka,Property Crime,Arson,Male,60+,5006,229,4777,1854,3152
2006,Urban,Madhya Pradesh,Crime Against Children,Trafficking,Male,46-60,5845,1682,4163,3393,2452
2008,Urban,Uttarakhand,Crime Against Children,Child Abuse,Male,13-17,637,22,615,479,158
2010,Urban,Haryana,Crime Against Men,Assault,Female,60+,7704,1020,6684,3525,4179
2010,Urban,Manipur,Other Crimes,Cyber Crime,Female,0-12,1009,563,446,704,305
2001,Rural,Rajasthan,Crime Against Women,Dowry Deaths,Male,60+,2949,624,2325,1413,1536
2008,Urban,Delhi,Property Crime,Theft,Female,13-17,1147,899,248,1137,10
2001,Urban,West Bengal,Crime Against Men,Murder,Female,13-17,2394,1197,1197,1504,890
2004,Urban,Telangana,Crime Against Women,Dowry Deaths,Male,46-60,5617,190,5427,1478,4139
2006,Urban,Bihar,Crime Against Children,Trafficking,Male,13-17,595,125,470,175,420
2006,Urban,Manipur,Crime Against Women,Domestic Violence,Female,31-45,3466,2701,765,3320,146
2010,Rural,Rajasthan,Crime Against Women,Dowry Deaths,Male,0-12,8163,13,8150,982,7181
2006,Rural,Delhi,Crime Against Children,Kidnapping,Female,0-12,1030,340,690,1030,0
2009,Rural,Rajasthan,Crime Against Women,Dowry Deaths,Male,0-12,2972,2688,284,2741,231
2007,Rural,Uttar Pradesh,Other Crimes,Drug Offense,Female,60+,9737,352,9385,3083,6654
2008,Rural,Meghalaya,Crime Against Children,Trafficking,Male,60+,2046,1447,599,1705,341
2002,Rural,Gujarat,Property Crime,Burglary,Female,0-12,621,287,334,554,67
2002,Urban,Madhya Pradesh,Property Crime,Vandalism,Male,31-45,9487,7196,2291,9084,403
2010,Rural,Jharkhand,Crime Against Women,Rape,Male,18-30,4071,1517,2554,2841,1230
2008,Urban,Madhya Pradesh,Other Crimes,Corruption,Female,46-60,577,195,382,197,380
2009,Urban,Maharashtra,Property Crime,Burglary,Male,0-12,3573,1422,2151,2354,1219
2002,Urban,Kerala,Crime Against Women,Dowry Deaths,Male,60+,9077,8257,820,9067,10
2004,Rural,Meghalaya,Crime Against Children,Trafficking,Female,31-45,5048,1621,3427,1744,3304
2008,Rural,Meghalaya,Crime Against Men,Robbery,Male,31-45,6863,3103,3760,5729,1134
2006,Rural,Uttarakhand,Crime Against Men,Assault,Female,0-12,7183,822,6361,2353,4830
2008,Urban,Karnataka,Crime Against Men,Murder,Male,60+,8756,5323,3433,6304,2452
2006,Urban,Rajasthan,Property Crime,Burglary,Male,0-12,8814,8364,450,8467,347
2001,Urban,Nagaland,Crime Against Children,Trafficking,Male,18-30,1954,1211,743,1895,59
2010,Rural,Telangana,Crime Against Men,Murder,Female,0-12,1515,925,590,963,552
2010,Urban,Manipur,Property Crime,Vandalism,Female,0-12,8943,443,8500,5544,3399
2004,Rural,Goa,Crime Against Men,Assault,Female,13-17,6096,5319,777,5667,429
2007,Rural,Meghalaya,Crime Against Children,Child Abuse,Female,18-30,8860,3248,5612,4783,4077
2004,Urban,Chhattisgarh,Crime Against Children,Trafficking,Male,18-30,5304,3444,1860,4979,325
2007,Rural,Manipur,Property Crime,Theft,Female,31-45,8877,3710,5167,7263,1614
2008,Rural,Rajasthan,Crime Against Women,Molestation,Male,18-30,8650,1481,7169,3980,4670
2003,Urban,Andhra Pradesh,Other Crimes,Drug Offense,Female,31-45,7709,4147,3562,6624,1085
2004,Rural,Sikkim,Crime Against Children,Child Labor,Female,60+,9492,438,9054,5331,4161
2002,Urban,Chhattisgarh,Crime Against Children,Child Abuse,Male,13-17,2153,1421,732,1757,396
2010,Urban,Uttar Pradesh,Crime Against Children,Child Labor,Male,13-17,2548,642,1906,668,1880
2004,Rural,Uttar Pradesh,Crime Against Children,Kidnapping,Female,60+,1981,1493,488,1902,79
2007,Rural,Himachal Pradesh,Crime Against Children,Child Abuse,Male,31-45,3674,2282,1392,2310,1364
2009,Urban,Himachal Pradesh,Property Crime,Theft,Female,0-12,1479,1408,71,1474,5
2009,Urban,West Bengal,Property Crime,Burglary,Male,13-17,8011,1827,6184,2836,5175
2002,Urban,Nagaland,Other Crimes,Drug Offense,Male,13-17,6870,6840,30,6861,9
2001,Rural,Goa,Other Crimes,Cyber Crime,Male,0-12,9299,3498,5801,6041,3258
2007,Urban,Himachal Pradesh,Property Crime,Burglary,Female,60+,3463,826,2637,2467,996
2006,Rural,West Bengal,Other Crimes,Drug Offense,Male,46-60,5547,4777,770,5397,150
2006,Rural,Gujarat,Other Crimes,Drug Offense,Female,60+,1045,673,372,928,117
2006,Rural,Punjab,Property Crime,Vandalism,Male,13-17,7091,3101,3990,6904,187
2008,Urban,Gujarat,Property Crime,Vandalism,Male,46-60,2577,1705,872,1745,832
2006,Rural,Haryana,Crime Against Children,Kidnapping,Male,0-12,1573,1201,372,1392,181
2005,Urban,Karnataka,Crime Against Men,Extortion,Female,13-17,2959,1183,1776,2691,268
2010,Rural,Karnataka,Crime Against Men,Robbery,Male,60+,6480,437,6043,1184,5296
2010,Rural,Chhattisgarh,Crime Against Children,Child Abuse,Female,0-12,8036,3200,4836,7853,183
2002,Urban,Manipur,Crime Against Men,Robbery,Female,18-30,997,759,238,802,195
2002,Urban,Uttarakhand,Crime Against Children,Trafficking,Female,60+,9920,2805,7115,7562,2358
2006,Rural,Arunachal Pradesh,Property Crime,Burglary,Male,18-30,5758,1672,4086,2017,3741
2007,Rural,Andhra Pradesh,Other Crimes,Fraud,Female,46-60,3211,580,2631,2896,315
2008,Rural,Uttar Pradesh,Crime Against Children,Child Labor,Female,0-12,5780,871,4909,4550,1230
2002,Rural,Sikkim,Property Crime,Vandalism,Male,18-30,3552,1063,2489,1846,1706
2009,Rural,West Bengal,Crime Against Women,Rape,Female,60+,1267,927,340,1258,9
2006,Urban,Rajasthan,Other Crimes,Corruption,Male,60+,5750,4244,1506,5220,530
2003,Rural,Nagaland,Other Crimes,Cyber Crime,Female,46-60,704,319,385,438,266
2002,Urban,Arunachal Pradesh,Crime Against Women,Domestic Violence,Female,18-30,9089,4199,4890,5523,3566
2003,Rural,Bihar,Crime Against Children,Child Labor,Female,18-30,9540,802,8738,6252,3288
2001,Rural,Tamil Nadu,Property Crime,Burglary,Male,46-60,1423,9,1414,1177,246
2009,Urban,Odisha,Crime Against Children,Child Abuse,Female,13-17,3625,2419,1206,3011,614
2006,Urban,Goa,Crime Against Children,Trafficking,Female,0-12,4960,3263,1697,3619,1341
2002,Urban,Jammu & Kashmir,Crime Against Children,Kidnapping,Male,0-12,5073,625,4448,627,4446
2008,Urban,Jharkhand,Crime Against Children,Kidnapping,Male,13-17,7690,7279,411,7367,323
2002,Rural,Bihar,Crime Against Children,Kidnapping,Female,46-60,6506,1586,4920,3173,3333
2002,Urban,Meghalaya,Other Crimes,Corruption,Male,46-60,8100,2251,5849,5537,2563
2002,Rural,Chhattisgarh,Crime Against Men,Assault,Male,0-12,2201,159,2042,2196,5
2002,Rural,Bihar,Other Crimes,Drug Offense,Female,46-60,4719,433,4286,2937,1782
2005,Rural,Manipur,Property Crime,Burglary,Female,0-12,89,25,64,73,16
2008,Urban,Punjab,Crime Against Women,Domestic Violence,Female,0-12,9692,2742,6950,8608,1084
2009,Rural,Tripura,Crime Against Men,Extortion,Female,0-12,6392,2435,3957,2992,3400
2005,Urban,Telangana,Crime Against Women,Dowry Deaths,Female,13-17,6178,3402,2776,3742,2436
2002,Urban,Kerala,Property Crime,Burglary,Female,60+,8644,6950,1694,7406,1238
2008,Rural,Odisha,Crime Against Children,Child Abuse,Female,13-17,8134,1427,6707,2115,6019
2006,Urban,Punjab,Crime Against Children,Child Labor,Female,31-45,1111,393,718,539,572
2008,Rural,Andhra Pradesh,Crime Against Women,Dowry Deaths,Male,60+,5453,250,5203,2983,2470
2007,Rural,Himachal Pradesh,Crime Against Children,Trafficking,Male,18-30,3358,771,2587,1862,1496
2008,Rural,Uttarakhand,Crime Against Men,Murder,Female,18-30,445,429,16,435,10
2001,Urban,Meghalaya,Property Crime,Theft,Male,46-60,1987,452,1535,1349,638
2005,Urban,Telangana,Other Crimes,Cyber Crime,Female,18-30,7637,3936,3701,4960,2677
2010,Rural,Tamil Nadu,Crime Against Children,Kidnapping,Female,46-60,6862,1837,5025,3082,3780
2010,Rural,Assam,Property Crime,Burglary,Female,13-17,1812,77,1735,1340,472
2005,Rural,Punjab,Property Crime,Theft,Female,31-45,3640,2135,1505,2513,1127
2004,Rural,Assam,Property Crime,Arson,Female,31-45,8841,7083,1758,7907,934
2006,Urban,Meghalaya,Property Crime,Arson,Male,0-12,8649,3708,4941,5994,2655
2002,Rural,Maharashtra,Crime Against Men,Murder,Female,31-45,3780,1128,2652,3266,514
2010,Rural,Bihar,Crime Against Women,Rape,Male,13-17,8608,1531,7077,2217,6391
2006,Urban,Uttarakhand,Other Crimes,Corruption,Female,13-17,3126,1776,1350,3050,76
2007,Urban,Nagaland,Other Crimes,Fraud,Male,18-30,3501,3154,347,3485,16
2009,Rural,West Bengal,Property Crime,Theft,Female,18-30,8296,2560,5736,4191,4105
2008,Rural,Goa,Crime Against Women,Domestic Violence,Female,60+,4275,1547,2728,3019,1256
2005,Urban,Uttar Pradesh,Other Crimes,Fraud,Female,18-30,1735,1651,84,1735,0
2003,Urban,Assam,Crime Against Men,Robbery,Female,0-12,6100,2138,3962,4730,1370
2004,Rural,Odisha,Other Crimes,Drug Offense,Male,31-45,9444,3072,6372,3139,6305
2010,Rural,Karnataka,Other Crimes,Fraud,Male,31-45,5458,2520,2938,4581,877
2003,Urban,Arunachal Pradesh,Crime Against Men,Assault,Male,60+,5558,16,5542,4061,1497
2002,Urban,Bihar,Crime Against Children,Child Abuse,Female,60+,5020,2245,2775,3474,1546
2010,Rural,Uttarakhand,Crime Against Women,Domestic Violence,Female,46-60,2411,515,1896,1532,879
2006,Rural,Mizoram,Crime Against Women,Dowry Deaths,Female,60+,2709,1616,1093,2322,387
2005,Rural,Tamil Nadu,Property Crime,Vandalism,Male,46-60,1550,1508,42,1545,5
2002,Urban,Maharashtra,Other Crimes,Corruption,Male,46-60,3829,1629,2200,2583,1246
2001,Urban,Jharkhand,Other Crimes,Cyber Crime,Male,13-17,5215,2426,2789,4290,925
2004,Rural,Uttar Pradesh,Property Crime,Arson,Female,18-30,4495,308,4187,3880,615
2003,Urban,Madhya Pradesh,Crime Against Women,Dowry Deaths,Female,18-30,3222,3117,105,3199,23
2005,Rural,West Bengal,Crime Against Children,Trafficking,Male,13-17,4136,3886,250,4013,123
2003,Urban,Tamil Nadu,Property Crime,Arson,Female,46-60,2872,2259,613,2597,275
2010,Urban,Sikkim,Crime Against Men,Murder,Female,31-45,8185,3808,4377,7052,1133
2007,Urban,Kerala,Other Crimes,Fraud,Female,31-45,9642,3094,6548,4621,5021
2005,Rural,Assam,Crime Against Women,Dowry Deaths,Male,13-17,6763,3065,3698,4182,2581
2004,Urban,West Bengal,Property Crime,Burglary,Male,60+,8122,4302,3820,7833,289
2009,Urban,Telangana,Property Crime,Theft,Male,18-30,706,135,571,250,456
2006,Rural,Meghalaya,Crime Against Men,Robbery,Female,0-12,3653,1958,1695,2385,1268
2008,Rural,West Bengal,Property Crime,Vandalism,Female,13-17,9236,7850,1386,8791,445
2004,Rural,Punjab,Crime Against Children,Child Abuse,Female,18-30,8096,2433,5663,5416,2680
2006,Rural,Haryana,Property Crime,Theft,Female,0-12,7028,4459,2569,5211,1817
2005,Urban,Haryana,Crime Against Men,Extortion,Male,60+,9540,2289,7251,2880,6660
2003,Urban,West Bengal,Crime Against Women,Molestation,Female,46-60,4499,1498,3001,3062,1437
2009,Urban,Gujarat,Crime Against Women,Dowry Deaths,Female,46-60,811,682,129,750,61
2006,Urban,Telangana,Crime Against Children,Child Labor,Female,18-30,9255,6583,2672,7495,1760
2007,Rural,Himachal Pradesh,Property Crime,Vandalism,Male,0-12,6701,5541,1160,5841,860
2002,Urban,Gujarat,Other Crimes,Corruption,Male,46-60,5976,157,5819,249,5727
2005,Rural,Jharkhand,Crime Against Women,Rape,Female,46-60,8721,2265,6456,5328,3393
2002,Urban,Uttarakhand,Crime Against Women,Dowry Deaths,Female,31-45,9187,3420,5767,5866,3321
2010,Urban,West Bengal,Crime Against Men,Extortion,Female,46-60,7307,6464,843,6616,691
2007,Urban,Rajasthan,Crime Against Children,Trafficking,Male,0-12,245,158,87,225,20
2010,Rural,Telangana,Other Crimes,Drug Offense,Female,18-30,9957,6602,3355,6792,3165
2009,Urban,Uttarakhand,Crime Against Children,Child Labor,Female,18-30,5311,3798,1513,4412,899
2009,Urban,Jharkhand,Crime Against Women,Rape,Female,46-60,8052,3686,4366,3987,4065
2001,Rural,Chhattisgarh,Property Crime,Theft,Female,46-60,3326,680,2646,3311,15
2003,Urban,Rajasthan,Crime Against Men,Murder,Female,13-17,6200,5879,321,6163,37
2009,Urban,Meghalaya,Crime Against Children,Trafficking,Male,60+,4508,93,4415,2151,2357
2001,Rural,Mizoram,Crime Against Children,Trafficking,Female,0-12,6379,769,5610,3684,2695
2007,Urban,Chhattisgarh,Crime Against Children,Child Labor,Male,31-45,8282,712,7570,2621,5661
2007,Rural,Chhattisgarh,Crime Against Women,Domestic Violence,Female,46-60,6301,61,6240,5061,1240
2009,Urban,Rajasthan,Crime Against Children,Trafficking,Male,60+,9354,2074,7280,7102,2252
2002,Urban,Nagaland,Property Crime,Vandalism,Female,46-60,3050,2937,113,2976,74
2002,Rural,Uttar Pradesh,Crime Against Children,Child Labor,Female,18-30,7116,3204,3912,4513,2603
2009,Rural,West Bengal,Crime Against Men,Extortion,Female,46-60,4740,4046,694,4688,52
2008,Urban,Uttarakhand,Property Crime,Theft,Male,31-45,8442,240,8202,2417,6025
2010,Rural,Bihar,Crime Against Women,Domestic Violence,Male,46-60,2191,968,1223,1006,1185
2001,Rural,Arunachal Pradesh,Other Crimes,Fraud,Male,18-30,8275,3909,4366,6384,1891
2002,Rural,Maharashtra,Crime Against Children,Child Labor,Female,60+,7633,5295,2338,7272,361
2001,Rural,Tamil Nadu,Other Crimes,Cyber Crime,Female,18-30,2899,1795,1104,2089,810
2001,Urban,Nagaland,Crime Against Men,Murder,Female,46-60,4242,2574,1668,3227,1015
2009,Urban,Rajasthan,Crime Against Children,Kidnapping,Male,46-60,987,677,310,703,284
2004,Urban,Chhattisgarh,Crime Against Children,Child Abuse,Female,18-30,5221,1875,3346,4497,724
2002,Rural,Nagaland,Crime Against Men,Extortion,Female,18-30,7922,5819,2103,7318,604
2004,Rural,Punjab,Crime Against Women,Domestic Violence,Male,18-30,4912,132,4780,1917,2995
2010,Urban,Bihar,Crime Against Women,Domestic Violence,Female,18-30,1777,286,1491,817,960
2008,Urban,West Bengal,Property Crime,Vandalism,Female,0-12,7516,5211,2305,6838,678
2001,Urban,Punjab,Crime Against Children,Kidnapping,Female,60+,8190,6706,1484,8104,86
2008,Urban,Telangana,Crime Against Children,Kidnapping,Male,46-60,9990,9050,940,9093,897
2010,Rural,Haryana,Other Crimes,Corruption,Male,0-12,1721,640,1081,1361,360
2009,Urban,Bihar,Crime Against Men,Assault,Male,18-30,7240,4459,2781,5623,1617
2005,Rural,Chhattisgarh,Crime Against Women,Rape,Male,31-45,1534,1383,151,1481,53
2008,Urban,Haryana,Other Crimes,Corruption,Female,31-45,7047,4354,2693,4620,2427
2003,Rural,Odisha,Crime Against Men,Robbery,Male,13-17,2842,100,2742,2202,640
2004,Rural,Madhya Pradesh,Other Crimes,Fraud,Male,0-12,6152,743,5409,952,5200
2004,Urban,Assam,Other Crimes,Fraud,Female,0-12,6654,1294,5360,3850,2804
2010,Rural,West Bengal,Crime Against Children,Child Abuse,Female,18-30,6310,3390,2920,4439,1871
2010,Urban,Maharashtra,Other Crimes,Corruption,Male,18-30,3034,1473,1561,2928,106
2001,Rural,Punjab,Crime Against Children,Trafficking,Male,13-17,3594,2081,1513,2687,907
2008,Urban,Assam,Other Crimes,Drug Offense,Female,46-60,9475,6810,2665,8087,1388
2007,Urban,Bihar,Property Crime,Arson,Male,31-45,8640,8236,404,8540,100
2003,Urban,Haryana,Crime Against Men,Murder,Male,18-30,1916,445,1471,759,1157
2006,Rural,Tamil Nadu,Crime Against Men,Robbery,Male,13-17,7318,115,7203,2380,4938
2005,Urban,Andhra Pradesh,Crime Against Men,Robbery,Male,0-12,7890,7862,28,7871,19
2003,Urban,Madhya Pradesh,Crime Against Women,Molestation,Female,13-17,8059,77,7982,7592,467
2007,Urban,Kerala,Property Crime,Burglary,Female,13-17,3799,1906,1893,2689,1110
2010,Urban,Andhra Pradesh,Crime Against Children,Trafficking,Male,46-60,5156,3433,1723,4308,848
2002,Rural,Chhattisgarh,Other Crimes,Drug Offense,Female,18-30,3464,1062,2402,2307,1157
2008,Urban,Gujarat,Property Crime,Arson,Male,0-12,3952,65,3887,720,3232
2003,Rural,Kerala,Other Crimes,Cyber Crime,Male,0-12,1358,1171,187,1194,164
2010,Rural,Madhya Pradesh,Property Crime,Theft,Male,46-60,4668,1747,2921,4180,488
2006,Urban,Punjab,Crime Against Children,Trafficking,Male,13-17,3362,2494,868,2969,393
2006,Rural,Kerala,Other Crimes,Cyber Crime,Male,31-45,6286,1355,4931,2419,3867
2008,Rural,Arunachal Pradesh,Crime Against Men,Extortion,Female,31-45,127,70,57,96,31
2005,Urban,Andhra Pradesh,Crime Against Men,Extortion,Male,0-12,2093,1093,1000,1547,546
2006,Urban,Mizoram,Property Crime,Burglary,Male,31-45,2445,459,1986,1937,508
2001,Urban,Chhattisgarh,Property Crime,Theft,Male,31-45,9751,26,9725,8356,1395
2008,Rural,Uttar Pradesh,Crime Against Men,Robbery,Male,46-60,1769,434,1335,651,1118
2004,Urban,Assam,Crime Against Children,Child Labor,Female,31-45,7270,3187,4083,4313,2957
2003,Rural,Jammu & Kashmir,Other Crimes,Fraud,Female,13-17,1537,290,1247,911,626
2001,Urban,Sikkim,Property Crime,Arson,Male,60+,5662,1448,4214,5540,122
2001,Rural,Mizoram,Property Crime,Burglary,Male,13-17,1595,969,626,1010,585
2010,Urban,Jammu & Kashmir,Crime Against Children,Child Abuse,Male,60+,6644,4503,2141,6364,280
2006,Urban,Rajasthan,Crime Against Men,Robbery,Male,46-60,7658,4256,3402,6132,1526
2002,Urban,Assam,Crime Against Women,Molestation,Male,0-12,9391,1837,7554,9142,249
2003,Urban,Odisha,Crime Against Children,Child Labor,Male,60+,8378,8069,309,8175,203
2003,Rural,Karnataka,Other Crimes,Fraud,Male,0-12,8338,4153,4185,5876,2462
2004,Rural,Meghalaya,Crime Against Children,Trafficking,Male,0-12,6284,5322,962,5744,540
2007,Urban,Madhya Pradesh,Crime Against Men,Murder,Male,0-12,6357,5682,675,5786,571
2008,Urban,Mizoram,Crime Against Children,Child Labor,Male,13-17,8552,304,8248,2978,5574
2006,Urban,Haryana,Property Crime,Vandalism,Male,18-30,4897,44,4853,746,4151
2009,Rural,Arunachal Pradesh,Property Crime,Theft,Female,31-45,5312,2184,3128,4705,607
2003,Urban,Punjab,Property Crime,Burglary,Male,46-60,7678,4654,3024,6272,1406
2008,Urban,Manipur,Crime Against Men,Assault,Male,0-12,3879,2990,889,3796,83
2004,Rural,Meghalaya,Other Crimes,Corruption,Female,18-30,3975,2304,1671,2793,1182
2005,Urban,Andhra Pradesh,Crime Against Women,Dowry Deaths,Female,13-17,1433,1308,125,1349,84
2005,Urban,Assam,Crime Against Women,Rape,Male,31-45,7722,6202,1520,7513,209
2007,Rural,Madhya Pradesh,Property Crime,Burglary,Male,60+,1453,497,956,876,577
2005,Urban,Chhattisgarh,Crime Against Children,Kidnapping,Male,60+,7100,5346,1754,6192,908
2007,Rural,Punjab,Crime Against Men,Robbery,Female,60+,4108,204,3904,1311,2797
2003,Rural,Haryana,Crime Against Women,Dowry Deaths,Male,0-12,541,221,320,269,272
2004,Urban,Rajasthan,Crime Against Men,Extortion,Female,31-45,8633,1593,7040,5908,2725
2005,Rural,Sikkim,Crime Against Children,Kidnapping,Female,31-45,848,397,451,729,119
2006,Urban,Gujarat,Crime Against Children,Child Abuse,Male,31-45,630,388,242,527,103
2007,Urban,Jammu & Kashmir,Other Crimes,Corruption,Male,31-45,414,64,350,358,56
2005,Urban,Bihar,Property Crime,Theft,Male,0-12,1079,1035,44,1077,2
2004,Urban,Manipur,Other Crimes,Fraud,Male,18-30,1864,86,1778,1791,73
2010,Urban,Tripura,Other Crimes,Corruption,Male,0-12,4648,2562,2086,2887,1761
2006,Rural,Sikkim,Crime Against Men,Murder,Female,46-60,3493,870,2623,2066,1427
2006,Urban,Goa,Crime Against Children,Child Abuse,Female,60+,4314,4152,162,4157,157
2002,Rural,Nagaland,Other Crimes,Drug Offense,Female,0-12,6513,2197,4316,2500,4013
2010,Rural,Meghalaya,Property Crime,Vandalism,Male,31-45,6525,3893,2632,6315,210
2007,Urban,Rajasthan,Property Crime,Theft,Male,13-17,8146,685,7461,3543,4603
2009,Urban,Goa,Property Crime,Burglary,Male,31-45,5457,5158,299,5344,113
2005,Rural,Uttarakhand,Property Crime,Arson,Female,13-17,3247,220,3027,2517,730
2001,Urban,Sikkim,Crime Against Women,Molestation,Male,46-60,7111,2420,4691,4062,3049
2008,Urban,Manipur,Crime Against Women,Domestic Violence,Female,31-45,6610,1260,5350,4102,2508
2008,Rural,Odisha,Crime Against Women,Dowry Deaths,Female,60+,9578,1580,7998,3583,5995
2009,Urban,Punjab,Crime Against Women,Rape,Female,18-30,3702,3167,535,3459,243
2008,Urban,Mizoram,Other Crimes,Cyber Crime,Male,46-60,9806,4225,5581,6508,3298
2003,Urban,Andhra Pradesh,Property Crime,Vandalism,Female,0-12,1430,80,1350,132,1298
2001,Rural,Rajasthan,Crime Against Women,Rape,Female,13-17,5053,839,4214,1037,4016
2007,Urban,Jammu & Kashmir,Property Crime,Theft,Male,31-45,7905,3101,4804,4242,3663
2007,Rural,Haryana,Crime Against Women,Molestation,Male,13-17,3195,629,2566,775,2420
2001,Urban,Meghalaya,Property Crime,Burglary,Female,46-60,3497,2723,774,2929,568
2008,Rural,Bihar,Crime Against Children,Trafficking,Female,60+,1892,1744,148,1754,138
2005,Rural,West Bengal,Crime Against Children,Trafficking,Male,31-45,3865,1146,2719,1938,1927
2001,Urban,Chhattisgarh,Crime Against Men,Robbery,Male,18-30,4874,310,4564,4120,754
2003,Rural,West Bengal,Property Crime,Theft,Female,60+,7637,1519,6118,3005,4632
2007,Rural,Delhi,Property Crime,Vandalism,Female,13-17,501,227,274,362,139
2008,Rural,West Bengal,Crime Against Women,Rape,Female,13-17,6682,3100,3582,6331,351
2010,Urban,Meghalaya,Crime Against Children,Child Abuse,Male,13-17,6959,791,6168,2810,4149
2010,Rural,Jharkhand,Other Crimes,Drug Offense,Female,46-60,8482,4459,4023,5127,3355
2002,Rural,Assam,Crime Against Women,Rape,Female,18-30,9458,8189,1269,8453,1005
2009,Rural,Gujarat,Crime Against Women,Domestic Violence,Male,18-30,4152,72,4080,2681,1471
2001,Urban,Andhra Pradesh,Other Crimes,Drug Offense,Male,60+,4709,3150,1559,3925,784
2010,Rural,Karnataka,Crime Against Children,Child Labor,Male,60+,6406,1923,4483,2646,3760
2010,Urban,Punjab,Property Crime,Vandalism,Female,0-12,7553,2238,5315,3747,3806
2010,Rural,Mizoram,Other Crimes,Cyber Crime,Female,60+,6617,2158,4459,4842,1775
2005,Rural,Tripura,Crime Against Children,Child Abuse,Male,46-60,1790,1603,187,1623,167
2004,Urban,Meghalaya,Crime Against Men,Assault,Female,60+,7801,5440,2361,7035,766
2010,Rural,Rajasthan,Crime Against Men,Assault,Female,46-60,411,317,94,363,48
2006,Urban,Bihar,Crime Against Children,Child Abuse,Male,60+,3498,2608,890,2846,652
2004,Rural,Andhra Pradesh,Other Crimes,Fraud,Male,13-17,3530,1317,2213,2010,1520
2009,Rural,Rajasthan,Crime Against Children,Child Abuse,Female,31-45,478,95,383,410,68
2006,Rural,Karnataka,Crime Against Children,Child Abuse,Female,18-30,3107,2695,412,2903,204
2008,Urban,Uttarakhand,Crime Against Children,Child Labor,Female,31-45,5377,3413,1964,3637,1740
2003,Rural,Uttarakhand,Crime Against Men,Robbery,Male,0-12,4751,3125,1626,3891,860
2006,Rural,Haryana,Other Crimes,Drug Offense,Female,31-45,2808,2092,716,2651,157
2003,Rural,Haryana,Crime Against Women,Rape,Male,18-30,8184,4335,3849,7291,893
2009,Rural,Manipur,Property Crime,Arson,Male,13-17,9783,6500,3283,9780,3
2006,Rural,Tripura,Crime Against Men,Extortion,Female,31-45,5813,5575,238,5659,154
2008,Rural,Meghalaya,Crime Against Women,Molestation,Female,46-60,8768,6944,1824,7240,1528
2005,Rural,Uttarakhand,Crime Against Men,Robbery,Male,0-12,6180,2648,3532,4658,1522
2006,Rural,Maharashtra,Crime Against Children,Kidnapping,Female,46-60,1894,1800,94,1873,21
2002,Rural,Punjab,Crime Against Children,Kidnapping,Male,46-60,1078,363,715,417,661
2003,Urban,Telangana,Crime Against Women,Molestation,Male,46-60,1874,210,1664,462,1412
2003,Urban,Tamil Nadu,Crime Against Women,Domestic Violence,Female,18-30,2929,95,2834,1872,1057
2003,Urban,Odisha,Crime Against Women,Molestation,Female,0-12,211,209,2,210,1
2002,Rural,Telangana,Other Crimes,Cyber Crime,Male,18-30,2539,1891,648,2451,88
2004,Rural,Jammu & Kashmir,Property Crime,Theft,Male,13-17,3664,1466,2198,3218,446
2008,Rural,Gujarat,Crime Against Men,Assault,Female,18-30,3929,1386,2543,2176,1753
2001,Rural,Jammu & Kashmir,Crime Against Children,Trafficking,Male,18-30,685,628,57,669,16
2008,Urban,Telangana,Property Crime,Vandalism,Male,13-17,8988,7256,1732,8135,853
2010,Urban,Mizoram,Other Crimes,Cyber Crime,Female,18-30,4714,1829,2885,4657,57
2004,Rural,Arunachal Pradesh,Property Crime,Burglary,Female,13-17,299,251,48,252,47
2004,Rural,Himachal Pradesh,Property Crime,Theft,Male,13-17,3426,2555,871,2759,667
2010,Urban,Karnataka,Crime Against Children,Trafficking,Female,13-17,9143,1483,7660,3639,5504
2004,Rural,Meghalaya,Other Crimes,Corruption,Female,31-45,2532,673,1859,722,1810
2007,Urban,Sikkim,Crime Against Women,Dowry Deaths,Female,60+,4829,1477,3352,4121,708
2009,Urban,Himachal Pradesh,Property Crime,Burglary,Male,0-12,8142,3107,5035,7409,733
2007,Rural,Odisha,Crime Against Children,Child Labor,Female,31-45,5908,4505,1403,5321,587
2005,Urban,Uttar Pradesh,Property Crime,Arson,Male,46-60,1756,881,875,1397,359
2007,Urban,Tamil Nadu,Property Crime,Burglary,Male,18-30,1840,414,1426,556,1284
2003,Rural,Meghalaya,Crime Against Children,Kidnapping,Male,60+,578,310,268,366,212
2001,Urban,Meghalaya,Crime Against Men,Robbery,Female,60+,5619,5456,163,5574,45
2007,Urban,Rajasthan,Crime Against Men,Extortion,Female,18-30,1260,800,460,1033,227
2007,Rural,Telangana,Crime Against Men,Murder,Male,60+,9172,5962,3210,7704,1468
2004,Rural,Jammu & Kashmir,Property Crime,Theft,Male,60+,160,17,143,65,95
2003,Rural,Manipur,Crime Against Women,Domestic Violence,Female,18-30,8224,5360,2864,6695,1529
2001,Urban,Jammu & Kashmir,Crime Against Women,Domestic Violence,Female,31-45,6903,5513,1390,6561,342
2001,Urban,Goa,Crime Against Children,Child Labor,Male,0-12,9993,628,9365,2019,7974
2004,Rural,Sikkim,Crime Against Children,Trafficking,Female,46-60,8130,3762,4368,7549,581
2005,Urban,Haryana,Other Crimes,Drug Offense,Female,13-17,8839,6552,2287,7234,1605
2007,Urban,Sikkim,Property Crime,Burglary,Male,13-17,7110,6685,425,6775,335
2003,Urban,Tamil Nadu,Crime Against Women,Molestation,Male,60+,5397,1751,3646,2549,2848
2006,Urban,Sikkim,Crime Against Men,Robbery,Male,18-30,9605,113,9492,2605,7000
2007,Urban,Telangana,Other Crimes,Fraud,Male,18-30,890,429,461,819,71
2006,Rural,Punjab,Crime Against Men,Assault,Female,18-30,9772,8002,1770,8046,1726
2002,Urban,Kerala,Other Crimes,Corruption,Female,0-12,7536,2548,4988,7275,261
2010,Rural,Tripura,Property Crime,Vandalism,Female,31-45,5097,1350,3747,2376,2721
2010,Urban,Madhya Pradesh,Property Crime,Theft,Female,13-17,2413,11,2402,1349,1064
2008,Urban,Meghalaya,Crime Against Children,Trafficking,Male,31-45,4003,984,3019,2022,1981
2003,Rural,Chhattisgarh,Crime Against Men,Murder,Female,46-60,5756,4109,1647,5123,633
2009,Rural,Chhattisgarh,Crime Against Children,Child Labor,Male,46-60,3064,327,2737,1679,1385
2006,Urban,Delhi,Crime Against Children,Child Labor,Female,13-17,9804,392,9412,769,9035
2009,Urban,Madhya Pradesh,Crime Against Women,Molestation,Male,46-60,7925,3929,3996,5558,2367
2003,Urban,Bihar,Crime Against Women,Rape,Male,31-45,5036,2111,2925,3718,1318
2007,Urban,Goa,Crime Against Children,Child Abuse,Female,31-45,9444,1780,7664,8804,640
2007,Rural,Bihar,Property Crime,Burglary,Female,31-45,6741,3275,3466,6632,109
2007,Rural,Madhya Pradesh,Property Crime,Vandalism,Female,0-12,6267,2949,3318,3815,2452
2001,Rural,Chhattisgarh,Other Crimes,Cyber Crime,Female,60+,3210,2370,840,3003,207
2008,Rural,Rajasthan,Crime Against Children,Trafficking,Female,0-12,5908,2734,3174,3288,2620
2002,Rural,Mizoram,Other Crimes,Fraud,Male,18-30,6627,1273,5354,2608,4019
2006,Urban,Uttar Pradesh,Crime Against Children,Trafficking,Male,31-45,9140,5859,3281,8531,609
2008,Urban,Bihar,Property Crime,Arson,Male,31-45,2484,920,1564,1294,1190
2001,Urban,Nagaland,Crime Against Children,Trafficking,Male,31-45,7786,1567,6219,6703,1083
2007,Urban,Chhattisgarh,Crime Against Women,Domestic Violence,Male,60+,537,343,194,494,43
2010,Urban,Odisha,Property Crime,Arson,Female,60+,6338,6046,292,6088,250
2002,Rural,Rajasthan,Other Crimes,Drug Offense,Male,46-60,738,361,377,535,203
2005,Rural,Uttar Pradesh,Crime Against Children,Child Labor,Male,18-30,1518,129,1389,189,1329
2008,Rural,Andhra Pradesh,Crime Against Children,Child Abuse,Female,18-30,3530,585,2945,2426,1104
2005,Rural,Tripura,Crime Against Men,Murder,Female,46-60,7662,861,6801,5723,1939
2003,Urban,Rajasthan,Property Crime,Arson,Female,18-30,2915,310,2605,2267,648
2004,Urban,Gujarat,Other Crimes,Cyber Crime,Female,60+,8025,3735,4290,6327,1698
2008,Rural,West Bengal,Crime Against Men,Extortion,Female,31-45,8379,5407,2972,6324,2055
2007,Urban,Manipur,Crime Against Men,Assault,Female,60+,1893,1550,343,1580,313
2003,Rural,Tripura,Crime Against Children,Child Labor,Female,0-12,6572,157,6415,6354,218
2008,Rural,Andhra Pradesh,Other Crimes,Corruption,Male,60+,1785,421,1364,1464,321
2009,Urban,Uttarakhand,Crime Against Children,Child Labor,Male,18-30,1232,312,920,1118,114
2002,Rural,Mizoram,Crime Against Women,Dowry Deaths,Male,18-30,7663,2068,5595,5685,1978
2006,Urban,Gujarat,Crime Against Women,Domestic Violence,Female,46-60,3658,2814,844,3201,457
2007,Rural,Telangana,Crime Against Men,Extortion,Male,60+,4151,3822,329,4098,53
2002,Rural,West Bengal,Crime Against Children,Child Abuse,Female,18-30,2289,1930,359,2157,132
2008,Urban,Meghalaya,Crime Against Children,Kidnapping,Female,0-12,3449,336,3113,436,3013
2003,Urban,Assam,Crime Against Men,Assault,Male,46-60,7551,2362,5189,4955,2596
2009,Rural,Chhattisgarh,Crime Against Children,Trafficking,Male,46-60,6504,4114,2390,5527,977
2005,Rural,Manipur,Crime Against Men,Assault,Female,18-30,9807,4153,5654,6645,3162
2009,Urban,Rajasthan,Crime Against Men,Robbery,Male,46-60,3343,179,3164,1660,1683
2001,Urban,Uttar Pradesh,Crime Against Children,Kidnapping,Female,0-12,9371,2976,6395,3198,6173
2006,Rural,Madhya Pradesh,Crime Against Men,Robbery,Male,46-60,5352,4851,501,4971,381
2001,Urban,Tripura,Crime Against Children,Child Abuse,Female,31-45,9450,7044,2406,7186,2264
2009,Urban,Mizoram,Property Crime,Burglary,Female,46-60,2476,392,2084,2265,211
2002,Urban,Gujarat,Property Crime,Arson,Male,60+,8424,2074,6350,2809,5615
2003,Rural,Gujarat,Crime Against Women,Rape,Female,0-12,4133,1017,3116,1568,2565
2002,Rural,Uttarakhand,Crime Against Men,Robbery,Female,46-60,584,564,20,572,12
2010,Rural,Himachal Pradesh,Crime Against Children,Child Abuse,Female,31-45,1976,1604,372,1840,136
2003,Rural,Sikkim,Property Crime,Arson,Male,13-17,8363,7239,1124,8304,59
2004,Rural,Bihar,Crime Against Men,Assault,Male,0-12,2347,1141,1206,1169,1178
2003,Urban,Meghalaya,Crime Against Children,Child Labor,Female,18-30,998,738,260,981,17
2004,Rural,West Bengal,Crime Against Women,Molestation,Male,60+,7823,3027,4796,6082,1741
2010,Urban,Goa,Property Crime,Vandalism,Male,60+,2803,1770,1033,2289,514
2010,Urban,Tamil Nadu,Crime Against Women,Dowry Deaths,Male,46-60,8447,2669,5778,5642,2805
2003,Urban,Meghalaya,Other Crimes,Cyber Crime,Male,46-60,5918,3112,2806,5815,103
2008,Urban,Himachal Pradesh,Crime Against Men,Robbery,Female,46-60,4975,2924,2051,4904,71
2009,Rural,Andhra Pradesh,Other Crimes,Drug Offense,Female,31-45,3186,1687,1499,2663,523
2008,Rural,Odisha,Property Crime,Burglary,Female,46-60,1916,883,1033,1302,614
2002,Rural,Bihar,Crime Against Children,Child Labor,Male,0-12,3509,937,2572,2391,1118
2005,Rural,Jharkhand,Crime Against Women,Domestic Violence,Male,46-60,6636,2884,3752,3593,3043
2010,Urban,Telangana,Crime Against Children,Child Labor,Male,13-17,8782,5651,3131,6251,2531
2005,Rural,Haryana,Other Crimes,Drug Offense,Female,46-60,710,391,319,453,257
2007,Urban,Mizoram,Property Crime,Arson,Female,18-30,719,268,451,560,159
2002,Rural,Goa,Crime Against Women,Domestic Violence,Female,60+,8632,7404,1228,7410,1222
2009,Rural,Telangana,Crime Against Women,Molestation,Male,46-60,7213,4602,2611,6119,1094
2005,Rural,Haryana,Crime Against Men,Robbery,Male,46-60,8205,6765,1440,6993,1212
2006,Rural,Andhra Pradesh,Other Crimes,Fraud,Male,60+,5493,919,4574,5193,300
2008,Rural,Arunachal Pradesh,Crime Against Women,Dowry Deaths,Male,0-12,8844,2686,6158,5321,3523
2006,Urban,Jammu & Kashmir,Crime Against Women,Domestic Violence,Female,60+,115,27,88,65,50
2009,Urban,Bihar,Crime Against Children,Kidnapping,Male,60+,392,115,277,168,224
2004,Urban,Haryana,Crime Against Women,Dowry Deaths,Male,0-12,2555,2142,413,2262,293
2006,Rural,Jharkhand,Crime Against Children,Child Abuse,Female,0-12,879,618,261,676,203
2007,Urban,Jammu & Kashmir,Other Crimes,Fraud,Male,46-60,1868,1624,244,1661,207
2009,Urban,Rajasthan,Crime Against Children,Child Abuse,Male,13-17,4572,648,3924,4407,165
2003,Rural,Goa,Crime Against Women,Molestation,Female,18-30,8104,6962,1142,7563,541
2004,Urban,Delhi,Other Crimes,Corruption,Male,31-45,5729,3357,2372,4571,1158
2010,Rural,Andhra Pradesh,Crime Against Men,Assault,Male,46-60,2783,74,2709,1776,1007
2008,Rural,Arunachal Pradesh,Property Crime,Vandalism,Female,60+,6450,5064,1386,5437,1013
2009,Rural,Goa,Crime Against Women,Molestation,Male,46-60,1835,505,1330,1819,16
2010,Urban,Manipur,Crime Against Children,Child Labor,Male,31-45,8866,1814,7052,4592,4274
2010,Rural,Uttarakhand,Property Crime,Vandalism,Female,46-60,7172,4665,2507,6590,582
2006,Urban,Manipur,Property Crime,Theft,Male,13-17,7109,6280,829,6871,238
2008,Urban,Telangana,Property Crime,Arson,Female,0-12,6333,2519,3814,5802,531
2008,Rural,Karnataka,Other Crimes,Cyber Crime,Female,13-17,5898,1177,4721,2251,3647
2008,Rural,Mizoram,Other Crimes,Cyber Crime,Male,31-45,2024,426,1598,1081,943
2004,Urban,Jammu & Kashmir,Crime Against Men,Assault,Female,60+,1692,1493,199,1585,107
2008,Urban,Andhra Pradesh,Crime Against Men,Murder,Female,60+,6324,1704,4620,4551,1773
2006,Rural,Rajasthan,Crime Against Women,Domestic Violence,Male,31-45,7853,1813,6040,2677,5176
2004,Rural,Goa,Crime Against Men,Assault,Female,46-60,5903,4739,1164,4763,1140
2007,Rural,Jammu & Kashmir,Crime Against Children,Kidnapping,Male,60+,8498,7481,1017,7824,674
2007,Rural,Jammu & Kashmir,Crime Against Men,Robbery,Female,60+,6474,1471,5003,1692,4782
2006,Urban,Assam,Property Crime,Vandalism,Male,46-60,5287,2695,2592,4993,294
2010,Urban,Arunachal Pradesh,Other Crimes,Drug Offense,Female,60+,1405,1174,231,1330,75
2006,Urban,Chhattisgarh,Crime Against Children,Kidnapping,Male,31-45,5174,140,5034,2910,2264
2010,Rural,Andhra Pradesh,Crime Against Women,Domestic Violence,Male,60+,5815,2443,3372,5166,649
2006,Urban,Uttarakhand,Crime Against Children,Trafficking,Female,31-45,859,829,30,846,13
2009,Urban,Manipur,Property Crime,Burglary,Female,18-30,8763,6017,2746,7871,892
2004,Rural,Madhya Pradesh,Crime Against Men,Extortion,Female,18-30,6799,5119,1680,5788,1011
2007,Urban,Andhra Pradesh,Property Crime,Vandalism,Male,46-60,6625,916,5709,2096,4529
2001,Urban,Odisha,Crime Against Children,Child Labor,Male,46-60,1040,84,956,561,479
2008,Rural,Madhya Pradesh,Crime Against Children,Child Labor,Female,60+,1636,922,714,1410,226
2002,Urban,Kerala,Other Crimes,Drug Offense,Male,18-30,1793,1241,552,1414,379
2005,Rural,Odisha,Other Crimes,Cyber Crime,Male,60+,3122,1965,1157,2929,193
2002,Urban,Chhattisgarh,Crime Against Women,Molestation,Female,46-60,2998,263,2735,882,2116
2002,Urban,Uttar Pradesh,Crime Against Women,Domestic Violence,Male,46-60,6440,4174,2266,5002,1438
2009,Urban,Sikkim,Crime Against Men,Murder,Male,13-17,9150,5207,3943,8723,427
2007,Rural,Tamil Nadu,Other Crimes,Cyber Crime,Male,0-12,2386,884,1502,1768,618
2001,Rural,Punjab,Crime Against Men,Extortion,Male,13-17,9014,4110,4904,7515,1499
2008,Rural,Tamil Nadu,Property Crime,Vandalism,Female,31-45,3125,253,2872,1375,1750
2009,Rural,Punjab,Other Crimes,Fraud,Male,13-17,5609,1098,4511,4315,1294
2005,Urban,Arunachal Pradesh,Crime Against Women,Rape,Female,18-30,9352,1569,7783,9268,84
2007,Rural,Meghalaya,Crime Against Women,Rape,Male,0-12,6246,1926,4320,4216,2030
2005,Urban,Rajasthan,Crime Against Women,Domestic Violence,Female,31-45,5923,2331,3592,4430,1493
2008,Urban,Bihar,Crime Against Men,Murder,Male,13-17,338,294,44,333,5
2001,Urban,Jammu & Kashmir,Crime Against Men,Robbery,Female,18-30,9860,2089,7771,6890,2970
2002,Urban,Andhra Pradesh,Crime Against Children,Trafficking,Male,0-12,1838,362,1476,1719,119
2004,Rural,Tamil Nadu,Crime Against Women,Domestic Violence,Female,60+,5040,918,4122,3180,1860
2006,Rural,Tripura,Crime Against Children,Child Labor,Male,31-45,7711,4263,3448,7583,128
2002,Urban,Goa,Other Crimes,Corruption,Female,18-30,3610,2310,1300,2805,805
2005,Urban,West Bengal,Other Crimes,Drug Offense,Male,46-60,9390,821,8569,8171,1219
2001,Rural,Maharashtra,Other Crimes,Fraud,Female,60+,70,17,53,38,32
2005,Rural,Rajasthan,Other Crimes,Drug Offense,Female,13-17,1549,1446,103,1501,48
2007,Urban,Uttarakhand,Crime Against Children,Trafficking,Female,46-60,9808,3165,6643,7882,1926
2005,Urban,Uttar Pradesh,Crime Against Children,Child Abuse,Female,0-12,6391,769,5622,6355,36
2005,Urban,Mizoram,Property Crime,Burglary,Female,46-60,9258,1125,8133,3947,5311
2006,Urban,Goa,Crime Against Children,Child Abuse,Male,46-60,4631,12,4619,3790,841
2005,Urban,Sikkim,Crime Against Women,Molestation,Female,46-60,6301,3285,3016,4786,1515
2005,Urban,Goa,Other Crimes,Drug Offense,Male,60+,9028,4868,4160,5102,3926
2002,Rural,Nagaland,Crime Against Women,Dowry Deaths,Male,0-12,9316,225,9091,6678,2638
2009,Rural,Chhattisgarh,Crime Against Men,Robbery,Female,60+,2367,1679,688,2215,152
2006,Rural,Tripura,Crime Against Women,Dowry Deaths,Male,18-30,4312,555,3757,3421,891
2002,Urban,Himachal Pradesh,Property Crime,Vandalism,Male,18-30,613,77,536,495,118
2002,Urban,Jharkhand,Crime Against Men,Extortion,Female,31-45,3972,684,3288,2585,1387
2003,Urban,Goa,Property Crime,Arson,Female,18-30,2641,46,2595,1279,1362
2002,Urban,Tamil Nadu,Crime Against Men,Robbery,Female,60+,2687,1801,886,2263,424
2006,Urban,Manipur,Property Crime,Vandalism,Female,46-60,7437,6486,951,7236,201
2009,Urban,Himachal Pradesh,Property Crime,Arson,Female,18-30,6567,1129,5438,6217,350
2007,Rural,Sikkim,Other Crimes,Fraud,Female,0-12,2920,2233,687,2691,229
2010,Urban,Rajasthan,Other Crimes,Drug Offense,Female,18-30,8666,492,8174,3278,5388
2004,Rural,Odisha,Other Crimes,Corruption,Male,0-12,6041,5869,172,5944,97
2007,Urban,Uttar Pradesh,Crime Against Men,Robbery,Male,60+,4028,2170,1858,2591,1437
2005,Rural,Gujarat,Crime Against Men,Assault,Female,18-30,6829,6393,436,6698,131
2008,Urban,Tripura,Crime Against Men,Assault,Female,18-30,6809,4573,2236,5594,1215
2007,Rural,Haryana,Crime Against Children,Kidnapping,Female,46-60,5990,4605,1385,5522,468
2003,Urban,Madhya Pradesh,Crime Against Children,Kidnapping,Female,18-30,8233,2575,5658,3460,4773
2005,Rural,Maharashtra,Crime Against Children,Child Labor,Male,13-17,6290,1836,4454,5948,342
2006,Urban,Karnataka,Other Crimes,Fraud,Female,60+,8163,5172,2991,5271,2892
2001,Urban,Gujarat,Crime Against Women,Molestation,Female,60+,9493,7721,1772,9035,458
2007,Urban,Manipur,Property Crime,Theft,Male,46-60,378,266,112,365,13
2004,Rural,Rajasthan,Property Crime,Burglary,Male,0-12,7030,4684,2346,6786,244
2006,Urban,Telangana,Crime Against Men,Assault,Female,13-17,6344,829,5515,2321,4023
2006,Rural,Delhi,Crime Against Children,Child Abuse,Male,0-12,9432,8405,1027,8567,865
2006,Rural,Tripura,Other Crimes,Drug Offense,Male,46-60,2572,406,2166,1107,1465
2005,Urban,Odisha,Crime Against Men,Extortion,Male,18-30,2541,2068,473,2232,309
2006,Urban,Haryana,Property Crime,Arson,Female,18-30,7544,6827,717,7090,454
2007,Rural,Gujarat,Crime Against Men,Assault,Female,60+,6176,864,5312,5128,1048
2004,Urban,Uttar Pradesh,Crime Against Children,Child Labor,Female,46-60,7037,2404,4633,6178,859
2007,Rural,Maharashtra,Crime Against Men,Robbery,Male,31-45,4181,3860,321,4121,60
2005,Urban,Andhra Pradesh,Crime Against Children,Trafficking,Female,60+,6540,4748,1792,5972,568
2009,Rural,Meghalaya,Other Crimes,Corruption,Female,18-30,5199,341,4858,3783,1416
2002,Urban,Madhya Pradesh,Other Crimes,Fraud,Male,13-17,551,0,551,408,143
2001,Urban,Odisha,Other Crimes,Drug Offense,Female,46-60,6639,6638,1,6638,1
2008,Urban,Assam,Other Crimes,Fraud,Male,13-17,3623,3210,413,3485,138
2002,Urban,Tamil Nadu,Crime Against Men,Assault,Male,0-12,7425,1147,6278,1454,5971
2007,Urban,Karnataka,Crime Against Men,Robbery,Male,60+,4613,2637,1976,3469,1144
2005,Urban,Arunachal Pradesh,Crime Against Women,Molestation,Female,31-45,7496,1280,6216,1457,6039
2009,Urban,Odisha,Crime Against Women,Molestation,Female,0-12,1951,186,1765,1951,0
2008,Urban,Arunachal Pradesh,Crime Against Children,Child Abuse,Male,46-60,325,243,82,290,35
2005,Urban,Telangana,Crime Against Women,Molestation,Female,18-30,9939,6531,3408,7381,2558
2001,Rural,Chhattisgarh,Crime Against Women,Dowry Deaths,Male,18-30,1358,137,1221,215,1143
2006,Urban,Bihar,Crime Against Children,Child Labor,Male,13-17,2996,2961,35,2992,4
2005,Urban,Uttarakhand,Property Crime,Theft,Male,18-30,8820,758,8062,2200,6620
2009,Rural,Karnataka,Crime Against Women,Molestation,Female,18-30,1808,878,930,974,834
2005,Rural,Meghalaya,Crime Against Men,Murder,Female,0-12,3400,3253,147,3314,86
2004,Rural,Chhattisgarh,Other Crimes,Corruption,Female,18-30,3822,1671,2151,2205,1617
2004,Urban,Bihar,Other Crimes,Cyber Crime,Male,18-30,1416,78,1338,1389,27
2004,Rural,Madhya Pradesh,Crime Against Children,Trafficking,Male,31-45,3586,2520,1066,3039,547
2005,Urban,Punjab,Other Crimes,Drug Offense,Male,60+,1817,844,973,1562,255
2006,Rural,Uttar Pradesh,Crime Against Men,Assault,Female,60+,8191,633,7558,7522,669
2010,Rural,West Bengal,Other Crimes,Drug Offense,Female,13-17,6884,4944,1940,6207,677
2001,Rural,Tamil Nadu,Crime Against Women,Dowry Deaths,Female,0-12,3265,2784,481,2960,305
2002,Urban,Sikkim,Property Crime,Theft,Female,0-12,3920,2608,1312,3915,5
2004,Rural,Nagaland,Crime Against Children,Trafficking,Male,31-45,8797,3522,5275,6305,2492
2007,Urban,Punjab,Other Crimes,Corruption,Female,60+,104,34,70,70,34
2010,Rural,Himachal Pradesh,Property Crime,Vandalism,Male,46-60,5204,2160,3044,4691,513
2007,Rural,Uttarakhand,Other Crimes,Corruption,Male,60+,5322,1307,4015,4720,602
2006,Urban,Mizoram,Crime Against Women,Rape,Female,0-12,8213,2459,5754,2680,5533
2006,Rural,Assam,Crime Against Women,Domestic Violence,Female,46-60,4239,1944,2295,2480,1759
2004,Rural,Jammu & Kashmir,Other Crimes,Cyber Crime,Female,31-45,945,777,168,857,88
2007,Rural,Andhra Pradesh,Property Crime,Burglary,Female,13-17,3894,3773,121,3800,94
2003,Rural,Rajasthan,Other Crimes,Fraud,Female,13-17,6366,3576,2790,3822,2544
2009,Urban,Telangana,Crime Against Men,Robbery,Female,0-12,4884,1156,3728,2839,2045
2008,Rural,Himachal Pradesh,Crime Against Men,Assault,Female,31-45,2185,294,1891,750,1435
2001,Rural,Gujarat,Crime Against Women,Domestic Violence,Female,60+,2524,1651,873,1839,685
2010,Urban,Tamil Nadu,Crime Against Men,Extortion,Female,31-45,2487,1745,742,1984,503
2007,Rural,Kerala,Property Crime,Theft,Male,13-17,2066,175,1891,2016,50
2009,Rural,Telangana,Other Crimes,Corruption,Male,0-12,2012,644,1368,1263,749
2009,Rural,Telangana,Crime Against Children,Trafficking,Male,46-60,5684,1754,3930,3015,2669
2009,Rural,Goa,Crime Against Women,Rape,Female,46-60,1944,943,1001,1034,910
2005,Urban,Sikkim,Other Crimes,Fraud,Female,31-45,4600,425,4175,1853,2747
2003,Urban,Kerala,Crime Against Children,Kidnapping,Female,60+,1855,1604,251,1839,16
2006,Urban,Punjab,Other Crimes,Drug Offense,Male,18-30,9503,536,8967,9389,114
2010,Urban,Andhra Pradesh,Other Crimes,Cyber Crime,Male,46-60,3785,586,3199,2346,1439
2008,Rural,Meghalaya,Other Crimes,Corruption,Male,18-30,2005,1120,885,1322,683
2001,Rural,Assam,Crime Against Children,Kidnapping,Male,0-12,9214,5036,4178,9108,106
2007,Urban,Uttarakhand,Crime Against Men,Robbery,Male,31-45,4844,2861,1983,4500,344
2004,Urban,Uttar Pradesh,Other Crimes,Fraud,Male,60+,8068,5944,2124,7877,191
2002,Rural,Uttar Pradesh,Property Crime,Burglary,Female,31-45,2664,947,1717,1886,778
2001,Urban,Telangana,Crime Against Children,Child Abuse,Male,60+,1170,818,352,1124,46
2005,Urban,West Bengal,Other Crimes,Fraud,Male,0-12,9809,2768,7041,6414,3395
2007,Urban,Tamil Nadu,Crime Against Children,Trafficking,Male,0-12,3674,619,3055,670,3004
2006,Urban,Uttarakhand,Property Crime,Theft,Female,18-30,161,146,15,157,4
2006,Rural,Jammu & Kashmir,Other Crimes,Corruption,Female,18-30,1105,708,397,1032,73
2001,Urban,Kerala,Other Crimes,Corruption,Female,0-12,2095,574,1521,1704,391
2010,Rural,Tripura,Crime Against Children,Child Abuse,Female,13-17,7688,6476,1212,6492,1196
2002,Urban,Jharkhand,Property Crime,Burglary,Male,0-12,4334,1865,2469,2363,1971
2007,Rural,Maharashtra,Other Crimes,Corruption,Male,31-45,1032,837,195,910,122
2007,Rural,Chhattisgarh,Other Crimes,Drug Offense,Male,60+,2241,1593,648,1783,458
2002,Urban,Arunachal Pradesh,Crime Against Children,Kidnapping,Male,60+,7082,4306,2776,6109,973
2004,Rural,Manipur,Crime Against Men,Robbery,Male,46-60,3551,853,2698,2866,685
2010,Urban,Chhattisgarh,Crime Against Children,Trafficking,Male,31-45,962,719,243,816,146
2009,Urban,Manipur,Other Crimes,Cyber Crime,Male,13-17,9686,2639,7047,8399,1287
2001,Urban,Tamil Nadu,Crime Against Children,Trafficking,Female,0-12,7073,2412,4661,4527,2546
2006,Rural,Tamil Nadu,Other Crimes,Drug Offense,Female,0-12,4305,1662,2643,1878,2427
2008,Urban,Maharashtra,Crime Against Women,Rape,Female,60+,9662,1135,8527,8715,947
2007,Rural,Sikkim,Crime Against Men,Assault,Male,60+,7441,6408,1033,7345,96
2004,Urban,Assam,Property Crime,Vandalism,Male,18-30,7487,1862,5625,3548,3939
2004,Urban,Andhra Pradesh,Crime Against Women,Dowry Deaths,Male,0-12,4280,3950,330,3952,328
2010,Urban,Goa,Other Crimes,Cyber Crime,Female,46-60,4850,4003,847,4594,256
2002,Rural,Andhra Pradesh,Property Crime,Burglary,Male,0-12,506,6,500,50,456
2003,Urban,Manipur,Other Crimes,Cyber Crime,Female,0-12,5352,321,5031,2115,3237
2009,Urban,Punjab,Other Crimes,Fraud,Male,13-17,8490,2390,6100,8383,107
2001,Rural,Tripura,Crime Against Children,Child Labor,Male,18-30,8136,2988,5148,5292,2844
2005,Urban,Sikkim,Other Crimes,Fraud,Male,18-30,8579,8160,419,8509,70
2009,Rural,Rajasthan,Crime Against Children,Kidnapping,Male,31-45,7798,6655,1143,7524,274
2004,Urban,Kerala,Crime Against Men,Assault,Male,31-45,3378,2883,495,3139,239
2002,Rural,Uttar Pradesh,Crime Against Children,Trafficking,Male,0-12,4893,3267,1626,4079,814
2008,Rural,Tamil Nadu,Crime Against Women,Molestation,Female,31-45,2327,1877,450,1920,407
2001,Rural,Bihar,Crime Against Men,Extortion,Male,0-12,9693,8707,986,8760,933
2008,Rural,Mizoram,Property Crime,Theft,Male,60+,6175,3306,2869,4630,1545
2002,Rural,Kerala,Crime Against Women,Rape,Male,31-45,5380,809,4571,4511,869
2007,Rural,Mizoram,Other Crimes,Fraud,Female,13-17,1247,457,790,958,289
2004,Urban,Odisha,Other Crimes,Fraud,Female,46-60,1522,379,1143,1152,370
2006,Rural,Mizoram,Other Crimes,Fraud,Female,0-12,8497,7944,553,8338,159
2001,Rural,Chhattisgarh,Other Crimes,Fraud,Male,31-45,6521,2383,4138,5667,854
2006,Rural,West Bengal,Crime Against Children,Child Labor,Female,60+,6503,4760,1743,5637,866
2009,Urban,Rajasthan,Crime Against Women,Domestic Violence,Male,13-17,6427,575,5852,5653,774
2008,Rural,Bihar,Property Crime,Theft,Male,46-60,2718,2718,0,2718,0
2001,Rural,Jharkhand,Property Crime,Burglary,Male,60+,8880,4118,4762,5412,3468
2009,Urban,Manipur,Property Crime,Vandalism,Male,18-30,8759,2347,6412,7068,1691
2009,Rural,Punjab,Crime Against Women,Molestation,Female,0-12,657,44,613,138,519
2008,Rural,Madhya Pradesh,Crime Against Men,Assault,Female,0-12,8329,5298,3031,8252,77
2007,Urban,Uttar Pradesh,Crime Against Men,Robbery,Male,0-12,8933,7877,1056,8616,317
2006,Rural,Chhattisgarh,Crime Against Children,Child Labor,Male,18-30,9197,388,8809,5872,3325
2010,Rural,Jharkhand,Crime Against Men,Robbery,Male,13-17,3957,1591,2366,2349,1608
2001,Urban,Arunachal Pradesh,Crime Against Men,Extortion,Female,60+,4899,252,4647,1670,3229
2005,Urban,Tripura,Property Crime,Arson,Female,46-60,2679,1763,916,2676,3
2008,Rural,Chhattisgarh,Property Crime,Arson,Male,46-60,5525,3487,2038,4090,1435
2007,Rural,Madhya Pradesh,Other Crimes,Drug Offense,Female,18-30,61,49,12,60,1
2008,Urban,Himachal Pradesh,Crime Against Men,Assault,Female,31-45,7873,5458,2415,7661,212
2007,Urban,Punjab,Crime Against Women,Dowry Deaths,Female,0-12,4122,681,3441,1266,2856
2001,Rural,Punjab,Crime Against Women,Dowry Deaths,Male,18-30,3997,3097,900,3723,274
2005,Rural,West Bengal,Crime Against Children,Child Labor,Male,46-60,4723,1140,3583,3022,1701
2003,Urban,Haryana,Property Crime,Arson,Female,13-17,1786,272,1514,656,1130
2005,Urban,Uttarakhand,Property Crime,Theft,Male,13-17,4200,1989,2211,4157,43
2004,Rural,Sikkim,Crime Against Women,Dowry Deaths,Female,31-45,9050,4995,4055,8664,386
2003,Urban,Jharkhand,Crime Against Men,Murder,Male,13-17,2900,2446,454,2622,278
2002,Rural,Mizoram,Crime Against Men,Extortion,Male,18-30,6477,46,6431,4180,2297
2001,Urban,Telangana,Other Crimes,Fraud,Female,0-12,1545,4,1541,1255,290
2004,Rural,Madhya Pradesh,Other Crimes,Corruption,Female,31-45,3737,593,3144,2496,1241
2003,Rural,Delhi,Other Crimes,Drug Offense,Female,46-60,2313,1561,752,1716,597
2006,Urban,Madhya Pradesh,Crime Against Children,Child Abuse,Male,31-45,6491,4308,2183,6158,333
2001,Urban,Goa,Other Crimes,Drug Offense,Female,46-60,795,503,292,628,167
2003,Rural,Andhra Pradesh,Property Crime,Burglary,Female,18-30,3014,1122,1892,2075,939
2005,Rural,Jharkhand,Crime Against Women,Dowry Deaths,Female,18-30,1098,42,1056,71,1027
2007,Urban,Madhya Pradesh,Property Crime,Theft,Male,13-17,7538,2983,4555,3784,3754
2009,Urban,Uttarakhand,Property Crime,Burglary,Male,18-30,512,149,363,500,12
2001,Rural,Telangana,Crime Against Women,Molestation,Female,46-60,6257,3614,2643,5475,782
2006,Rural,Uttar Pradesh,Other Crimes,Cyber Crime,Female,18-30,2199,800,1399,1341,858
2010,Rural,Rajasthan,Property Crime,Burglary,Female,13-17,6061,4994,1067,5591,470
2004,Rural,Uttar Pradesh,Other Crimes,Drug Offense,Female,13-17,4466,4386,80,4398,68
2009,Urban,Goa,Crime Against Men,Extortion,Female,18-30,2209,615,1594,1089,1120
2005,Rural,Odisha,Crime Against Women,Rape,Female,31-45,9298,1377,7921,6423,2875
2002,Urban,Telangana,Crime Against Men,Extortion,Male,31-45,7720,4525,3195,6776,944
2007,Urban,Bihar,Other Crimes,Cyber Crime,Male,60+,1322,520,802,676,646
2006,Urban,Bihar,Other Crimes,Cyber Crime,Female,18-30,8565,3924,4641,5591,2974
2010,Rural,Karnataka,Other Crimes,Cyber Crime,Male,18-30,8967,1465,7502,5657,3310
2005,Urban,Madhya Pradesh,Crime Against Children,Trafficking,Male,46-60,4458,3816,642,3872,586
2010,Rural,Andhra Pradesh,Crime Against Women,Dowry Deaths,Female,46-60,4917,2686,2231,3020,1897
2007,Urban,Haryana,Crime Against Children,Trafficking,Female,31-45,7345,4336,3009,5953,1392
2006,Rural,Andhra Pradesh,Crime Against Children,Child Labor,Female,31-45,8659,5230,3429,7620,1039
2008,Rural,Maharashtra,Crime Against Men,Extortion,Female,18-30,7489,6153,1336,6536,953
2010,Rural,Telangana,Crime Against Children,Child Labor,Male,18-30,942,547,395,614,328
2007,Rural,West Bengal,Property Crime,Burglary,Male,46-60,7352,6509,843,6874,478
2010,Urban,Madhya Pradesh,Crime Against Children,Child Abuse,Female,31-45,260,258,2,260,0
2008,Rural,Rajasthan,Crime Against Men,Robbery,Male,0-12,3170,1880,1290,2297,873
2010,Urban,Delhi,Crime Against Men,Assault,Male,60+,6014,1666,4348,1857,4157
2010,Urban,Punjab,Other Crimes,Cyber Crime,Female,18-30,5499,1945,3554,5069,430
2007,Urban,Maharashtra,Property Crime,Theft,Male,60+,5318,185,5133,2151,3167
2003,Urban,Maharashtra,Crime Against Women,Molestation,Male,46-60,3710,1653,2057,2709,1001
2008,Rural,Madhya Pradesh,Crime Against Children,Child Labor,Female,0-12,8133,5710,2423,5738,2395
2006,Rural,Nagaland,Crime Against Men,Extortion,Male,18-30,1923,1311,612,1538,385
2006,Rural,Tripura,Property Crime,Vandalism,Male,31-45,8886,4997,3889,6190,2696
2006,Urban,Delhi,Crime Against Men,Murder,Female,60+,4728,2311,2417,3363,1365
2010,Rural,Nagaland,Crime Against Women,Dowry Deaths,Male,60+,186,99,87,102,84
2001,Urban,Jammu & Kashmir,Crime Against Men,Robbery,Male,0-12,7813,7732,81,7794,19
2006,Rural,Karnataka,Other Crimes,Fraud,Male,46-60,9543,827,8716,6994,2549
2007,Urban,Bihar,Other Crimes,Corruption,Male,18-30,7664,6695,969,7154,510
2006,Urban,Punjab,Other Crimes,Fraud,Male,18-30,3212,2449,763,3057,155
2001,Rural,Gujarat,Crime Against Men,Robbery,Female,60+,2734,921,1813,2311,423
2004,Rural,Tripura,Other Crimes,Drug Offense,Female,18-30,94,89,5,92,2
2004,Rural,Meghalaya,Property Crime,Theft,Male,18-30,4313,2427,1886,2934,1379
2004,Urban,Uttar Pradesh,Other Crimes,Corruption,Male,31-45,3079,692,2387,3077,2
2010,Urban,Telangana,Crime Against Women,Molestation,Male,18-30,3688,898,2790,2064,1624
2003,Urban,Jammu & Kashmir,Other Crimes,Corruption,Female,13-17,9805,2689,7116,8025,1780
2009,Urban,Nagaland,Crime Against Men,Murder,Female,46-60,3772,871,2901,3541,231
2010,Rural,Maharashtra,Crime Against Women,Rape,Male,31-45,1531,259,1272,891,640
2007,Urban,Rajasthan,Property Crime,Vandalism,Female,31-45,3362,1370,1992,1826,1536
2007,Urban,Sikkim,Other Crimes,Drug Offense,Male,31-45,3629,2563,1066,3594,35
2003,Rural,Arunachal Pradesh,Property Crime,Arson,Male,0-12,7470,4023,3447,7000,470
2008,Rural,Maharashtra,Other Crimes,Fraud,Male,0-12,1378,617,761,760,618
2007,Urban,Sikkim,Property Crime,Vandalism,Male,0-12,4199,2004,2195,3523,676
2001,Urban,Meghalaya,Crime Against Women,Rape,Female,31-45,8378,3125,5253,6551,1827
2006,Rural,Andhra Pradesh,Crime Against Women,Molestation,Female,46-60,1402,253,1149,893,509
2002,Rural,Rajasthan,Crime Against Women,Rape,Male,18-30,892,597,295,603,289
2003,Rural,Odisha,Crime Against Women,Molestation,Male,31-45,5822,2208,3614,5466,356
2002,Urban,Karnataka,Crime Against Children,Child Abuse,Male,13-17,347,197,150,262,85
2010,Rural,Andhra Pradesh,Other Crimes,Cyber Crime,Female,31-45,4615,2969,1646,3955,660
2002,Urban,Manipur,Property Crime,Theft,Female,31-45,1430,526,904,705,725
2004,Rural,Himachal Pradesh,Crime Against Men,Robbery,Male,31-45,1565,1485,80,1529,36
2003,Urban,Manipur,Crime Against Men,Murder,Male,31-45,6083,2531,3552,5629,454
2007,Rural,Madhya Pradesh,Crime Against Women,Dowry Deaths,Female,31-45,8762,2613,6149,8243,519
2004,Urban,Andhra Pradesh,Crime Against Women,Molestation,Female,60+,1249,255,994,1031,218
2010,Urban,Delhi,Crime Against Children,Kidnapping,Female,46-60,836,670,166,779,57
2006,Rural,Jharkhand,Property Crime,Theft,Female,46-60,3643,3626,17,3642,1
2005,Urban,Madhya Pradesh,Other Crimes,Cyber Crime,Female,60+,6465,5713,752,5825,640
2005,Rural,Meghalaya,Crime Against Men,Extortion,Male,13-17,9873,295,9578,9001,872
2009,Rural,Uttar Pradesh,Other Crimes,Fraud,Male,31-45,8138,1918,6220,7169,969
2003,Urban,Meghalaya,Other Crimes,Cyber Crime,Female,18-30,1308,1163,145,1172,136
2004,Rural,Odisha,Property Crime,Theft,Female,31-45,3774,853,2921,3477,297
2006,Urban,Kerala,Other Crimes,Corruption,Female,0-12,1130,497,633,812,318
2002,Rural,Chhattisgarh,Crime Against Men,Assault,Female,46-60,8534,3172,5362,3513,5021
2008,Rural,Punjab,Other Crimes,Corruption,Female,31-45,1988,36,1952,1932,56
2005,Rural,Tamil Nadu,Crime Against Women,Rape,Female,0-12,1211,348,863,920,291
2009,Rural,Karnataka,Crime Against Women,Rape,Male,60+,8499,1794,6705,3016,5483
2004,Urban,Rajasthan,Other Crimes,Cyber Crime,Female,13-17,2774,1966,808,2483,291
2010,Urban,Sikkim,Property Crime,Vandalism,Female,0-12,8827,6738,2089,8769,58
2008,Urban,Manipur,Property Crime,Burglary,Female,60+,4666,3450,1216,3495,1171
2003,Rural,Arunachal Pradesh,Crime Against Women,Domestic Violence,Female,46-60,9740,4384,5356,7639,2101
2003,Rural,Jharkhand,Property Crime,Arson,Male,0-12,5693,1585,4108,3970,1723
2001,Rural,Rajasthan,Property Crime,Arson,Female,13-17,4648,1185,3463,4023,625
2004,Urban,Mizoram,Property Crime,Theft,Male,0-12,1784,58,1726,195,1589
2005,Rural,West Bengal,Property Crime,Vandalism,Female,13-17,3736,1293,2443,2530,1206
2007,Rural,Delhi,Crime Against Women,Molestation,Female,13-17,9407,1760,7647,2972,6435
2001,Urban,Kerala,Crime Against Women,Rape,Male,31-45,660,659,1,659,1
2005,Urban,Punjab,Crime Against Children,Child Labor,Female,46-60,3910,877,3033,2841,1069
2008,Rural,Arunachal Pradesh,Crime Against Children,Child Abuse,Female,60+,2530,119,2411,813,1717
2010,Rural,Jammu & Kashmir,Property Crime,Theft,Male,60+,9428,1856,7572,4213,5215
2007,Urban,Gujarat,Crime Against Men,Extortion,Male,18-30,4199,1696,2503,3580,619
2009,Rural,Goa,Crime Against Children,Child Abuse,Female,13-17,3581,3456,125,3476,105
2004,Rural,Tamil Nadu,Crime Against Children,Kidnapping,Female,18-30,2983,953,2030,1980,1003
2002,Rural,Karnataka,Crime Against Children,Kidnapping,Female,0-12,441,347,94,391,50
2006,Urban,Rajasthan,Crime Against Women,Molestation,Female,0-12,6575,1036,5539,2329,4246
2010,Rural,Odisha,Property Crime,Theft,Male,46-60,1052,509,543,583,469
2005,Urban,Maharashtra,Crime Against Men,Assault,Female,31-45,1045,886,159,897,148
2010,Urban,Rajasthan,Other Crimes,Cyber Crime,Female,46-60,3849,2874,975,3261,588
2008,Urban,Sikkim,Crime Against Men,Robbery,Female,13-17,6638,2424,4214,6630,8
2003,Urban,Maharashtra,Crime Against Children,Child Abuse,Male,46-60,5865,3606,2259,5804,61
2004,Urban,Uttar Pradesh,Crime Against Children,Child Labor,Male,60+,5849,3153,2696,4227,1622
2002,Rural,Manipur,Crime Against Men,Robbery,Male,31-45,5386,1762,3624,3639,1747
2004,Urban,Chhattisgarh,Other Crimes,Fraud,Female,31-45,9271,2950,6321,5601,3670
2002,Urban,Kerala,Crime Against Children,Child Abuse,Male,13-17,3731,3173,558,3717,14
2009,Urban,Chhattisgarh,Crime Against Children,Child Abuse,Male,46-60,2076,484,1592,1639,437
2003,Urban,Mizoram,Property Crime,Theft,Female,13-17,7239,808,6431,5390,1849
2007,Rural,Jammu & Kashmir,Crime Against Men,Assault,Male,18-30,6328,3060,3268,3678,2650
2009,Rural,Jammu & Kashmir,Crime Against Children,Child Abuse,Male,18-30,4068,2627,1441,3595,473
2006,Urban,Uttar Pradesh,Crime Against Men,Murder,Male,31-45,6057,556,5501,2696,3361
2001,Urban,Chhattisgarh,Crime Against Women,Molestation,Male,46-60,727,462,265,526,201
2009,Rural,Haryana,Crime Against Men,Extortion,Male,0-12,9983,3914,6069,6105,3878
2010,Urban,Sikkim,Crime Against Children,Trafficking,Female,46-60,6914,3745,3169,5966,948
2006,Rural,Jharkhand,Property Crime,Arson,Female,60+,4888,254,4634,1155,3733
2008,Urban,Uttarakhand,Crime Against Children,Trafficking,Male,13-17,7141,5894,1247,6245,896
2006,Urban,Himachal Pradesh,Crime Against Women,Domestic Violence,Female,18-30,7836,794,7042,2748,5088
2009,Urban,Mizoram,Crime Against Children,Kidnapping,Male,13-17,3596,181,3415,2982,614
2006,Rural,Uttar Pradesh,Crime Against Men,Murder,Male,0-12,2067,632,1435,849,1218
2001,Rural,Uttar Pradesh,Crime Against Men,Murder,Female,13-17,4527,493,4034,2658,1869
2009,Rural,Bihar,Crime Against Children,Child Labor,Male,13-17,5812,3259,2553,3858,1954
2009,Urban,Goa,Other Crimes,Cyber Crime,Female,0-12,6245,2110,4135,2702,3543
2001,Rural,Manipur,Crime Against Women,Molestation,Male,31-45,1711,776,935,1388,323
2002,Rural,Arunachal Pradesh,Other Crimes,Drug Offense,Male,13-17,4281,1385,2896,3670,611
2009,Urban,Telangana,Crime Against Children,Trafficking,Male,18-30,7425,6457,968,6942,483
2003,Rural,Madhya Pradesh,Property Crime,Arson,Female,46-60,72,68,4,70,2
2010,Rural,Uttar Pradesh,Other Crimes,Corruption,Male,60+,8885,2619,6266,4990,3895
2001,Rural,Rajasthan,Crime Against Children,Trafficking,Female,13-17,9214,1319,7895,7671,1543
2009,Rural,Gujarat,Crime Against Children,Kidnapping,Male,18-30,9181,216,8965,7679,1502
2002,Rural,Uttar Pradesh,Property Crime,Burglary,Female,13-17,5612,3851,1761,4917,695
2009,Rural,Himachal Pradesh,Crime Against Men,Assault,Female,13-17,6477,1526,4951,1840,4637
2005,Rural,Mizoram,Crime Against Children,Trafficking,Male,18-30,9200,6353,2847,8775,425
2005,Urban,Bihar,Crime Against Men,Assault,Female,18-30,2465,1840,625,2129,336
2008,Urban,Delhi,Crime Against Children,Child Labor,Female,18-30,7923,7132,791,7839,84
2005,Urban,Himachal Pradesh,Crime Against Women,Domestic Violence,Male,31-45,8923,2068,6855,5638,3285
2010,Urban,Punjab,Property Crime,Arson,Male,13-17,847,641,206,784,63
2010,Rural,Himachal Pradesh,Property Crime,Arson,Female,46-60,2325,1789,536,2297,28
2004,Urban,Arunachal Pradesh,Property Crime,Arson,Female,0-12,3819,1246,2573,1416,2403
2008,Rural,Goa,Other Crimes,Corruption,Male,46-60,5192,4511,681,4769,423
2002,Rural,Assam,Other Crimes,Cyber Crime,Female,60+,9325,1394,7931,4867,4458
2003,Rural,Telangana,Other Crimes,Corruption,Female,46-60,303,232,71,270,33
2006,Rural,Uttar Pradesh,Crime Against Children,Kidnapping,Female,60+,1654,491,1163,1452,202
2006,Rural,Uttarakhand,Crime Against Men,Robbery,Female,0-12,3089,2110,979,2625,464
2002,Rural,Tripura,Crime Against Women,Dowry Deaths,Female,31-45,4590,1112,3478,2455,2135
2009,Urban,Delhi,Other Crimes,Fraud,Female,13-17,7770,7424,346,7760,10
2009,Rural,Meghalaya,Crime Against Children,Child Labor,Male,0-12,6168,94,6074,231,5937
2002,Rural,Nagaland,Crime Against Men,Assault,Female,0-12,1242,844,398,912,330
2002,Urban,Goa,Crime Against Men,Robbery,Female,46-60,679,388,291,544,135
2010,Rural,Nagaland,Crime Against Women,Molestation,Female,31-45,1167,1129,38,1157,10
2004,Rural,Nagaland,Crime Against Women,Dowry Deaths,Female,13-17,4071,1472,2599,3830,241
2004,Urban,Uttarakhand,Crime Against Children,Child Abuse,Female,13-17,1773,777,996,1371,402
2001,Urban,Delhi,Crime Against Women,Dowry Deaths,Female,46-60,7028,5199,1829,6811,217
2006,Rural,Telangana,Crime Against Children,Trafficking,Female,18-30,4661,3270,1391,3329,1332
2003,Urban,Delhi,Crime Against Men,Assault,Male,13-17,6998,6832,166,6886,112
2004,Rural,Arunachal Pradesh,Crime Against Children,Child Abuse,Male,60+,5894,5353,541,5358,536
2001,Rural,Delhi,Crime Against Men,Murder,Male,13-17,8297,7734,563,7880,417
2002,Urban,Andhra Pradesh,Other Crimes,Fraud,Male,46-60,716,656,60,689,27
2001,Rural,Kerala,Crime Against Children,Trafficking,Female,60+,8407,5286,3121,5623,2784
2009,Rural,Uttar Pradesh,Other Crimes,Cyber Crime,Female,0-12,1639,1349,290,1416,223
2008,Urban,Jammu & Kashmir,Property Crime,Arson,Female,0-12,875,842,33,846,29
2002,Rural,Maharashtra,Other Crimes,Fraud,Male,60+,4765,3761,1004,3897,868
2006,Urban,Maharashtra,Crime Against Children,Child Abuse,Male,46-60,2093,746,1347,1476,617
2003,Urban,Delhi,Crime Against Men,Assault,Male,60+,9136,1420,7716,5897,3239
2010,Rural,Maharashtra,Crime Against Women,Dowry Deaths,Female,18-30,1029,82,947,685,344
2007,Rural,West Bengal,Crime Against Women,Domestic Violence,Female,31-45,3283,2651,632,3274,9
2009,Rural,Punjab,Other Crimes,Fraud,Female,13-17,4093,475,3618,2126,1967
2009,Urban,Sikkim,Property Crime,Burglary,Male,60+,540,39,501,400,140
2005,Rural,Bihar,Crime Against Women,Domestic Violence,Female,31-45,9052,1484,7568,7439,1613
2007,Rural,Gujarat,Other Crimes,Drug Offense,Female,13-17,5053,1237,3816,3067,1986
2008,Urban,Bihar,Crime Against Men,Assault,Female,13-17,7858,1822,6036,2660,5198
2010,Rural,Tamil Nadu,Crime Against Men,Assault,Female,18-30,462,199,263,456,6
2009,Urban,Uttar Pradesh,Other Crimes,Corruption,Female,31-45,8749,237,8512,437,8312
2007,Rural,Odisha,Other Crimes,Drug Offense,Female,46-60,171,171,0,171,0
2005,Rural,Maharashtra,Crime Against Children,Child Abuse,Female,18-30,2961,1766,1195,2248,713
2010,Rural,Himachal Pradesh,Crime Against Men,Assault,Male,60+,7316,1880,5436,3552,3764
2005,Urban,Chhattisgarh,Crime Against Men,Extortion,Female,46-60,6674,6473,201,6591,83
2010,Rural,Uttar Pradesh,Other Crimes,Drug Offense,Female,13-17,1111,651,460,669,442
2008,Urban,Delhi,Property Crime,Arson,Male,46-60,8500,2053,6447,6413,2087
2004,Urban,Andhra Pradesh,Other Crimes,Fraud,Female,13-17,7549,6955,594,7024,525
2002,Urban,Gujarat,Property Crime,Vandalism,Female,0-12,3543,1400,2143,2445,1098
2010,Urban,Jammu & Kashmir,Crime Against Men,Robbery,Male,46-60,7105,2930,4175,4829,2276
2010,Rural,Rajasthan,Crime Against Men,Robbery,Female,31-45,5385,3262,2123,5378,7
2004,Rural,Manipur,Other Crimes,Cyber Crime,Female,60+,1320,980,340,1176,144
2003,Urban,Manipur,Crime Against Children,Child Labor,Male,13-17,409,31,378,103,306
2002,Urban,Tamil Nadu,Other Crimes,Fraud,Male,31-45,9523,5706,3817,7134,2389
2001,Rural,Kerala,Crime Against Men,Robbery,Male,46-60,3718,2819,899,3357,361
2010,Rural,Himachal Pradesh,Property Crime,Burglary,Male,60+,1520,732,788,1496,24
2005,Rural,Delhi,Property Crime,Arson,Female,31-45,8349,2482,5867,4737,3612
2010,Rural,Haryana,Property Crime,Arson,Female,0-12,8897,7027,1870,7223,1674
2005,Rural,Assam,Property Crime,Vandalism,Female,60+,6963,6871,92,6952,11
2002,Rural,West Bengal,Other Crimes,Corruption,Male,0-12,6228,314,5914,4134,2094
2007,Rural,Tamil Nadu,Crime Against Women,Molestation,Female,0-12,1982,1327,655,1526,456
2007,Urban,Punjab,Crime Against Children,Kidnapping,Female,0-12,3850,3635,215,3782,68
2004,Urban,Punjab,Crime Against Men,Assault,Male,0-12,4589,750,3839,958,3631
2002,Urban,Uttarakhand,Crime Against Women,Domestic Violence,Male,31-45,5619,4472,1147,4962,657
2003,Rural,Delhi,Property Crime,Arson,Male,60+,1810,130,1680,530,1280
2005,Rural,Delhi,Property Crime,Theft,Female,0-12,4854,1955,2899,3040,1814
2005,Urban,Manipur,Crime Against Men,Robbery,Male,13-17,129,107,22,111,18
2009,Rural,Karnataka,Other Crimes,Drug Offense,Female,18-30,4649,2261,2388,3793,856
2001,Urban,Tripura,Other Crimes,Corruption,Male,31-45,4780,3272,1508,3598,1182
2008,Rural,Arunachal Pradesh,Crime Against Children,Child Abuse,Male,46-60,3040,1479,1561,1783,1257
2006,Rural,Goa,Crime Against Women,Dowry Deaths,Female,60+,137,51,86,69,68
2010,Urban,Maharashtra,Property Crime,Vandalism,Male,13-17,6402,1245,5157,5867,535
2006,Urban,Kerala,Crime Against Women,Domestic Violence,Male,13-17,4150,128,4022,3339,811
2001,Urban,Jammu & Kashmir,Crime Against Men,Extortion,Female,0-12,7519,5820,1699,6207,1312
2009,Rural,Assam,Crime Against Children,Child Labor,Female,13-17,1570,435,1135,655,915
2006,Urban,Mizoram,Property Crime,Theft,Male,13-17,4102,3401,701,3612,490
2008,Urban,Uttarakhand,Property Crime,Theft,Male,13-17,79,1,78,78,1
2004,Rural,Odisha,Other Crimes,Corruption,Male,60+,2086,519,1567,909,1177
2006,Rural,Mizoram,Property Crime,Vandalism,Female,0-12,2526,1163,1363,2098,428
2006,Urban,Goa,Crime Against Women,Domestic Violence,Female,18-30,6171,2147,4024,2292,3879
2008,Urban,Karnataka,Crime Against Men,Murder,Male,18-30,8461,5766,2695,7516,945
2002,Rural,Madhya Pradesh,Crime Against Women,Molestation,Male,0-12,5761,593,5168,2604,3157
2001,Urban,Odisha,Crime Against Women,Molestation,Female,60+,2218,2092,126,2122,96
2006,Rural,Rajasthan,Crime Against Children,Kidnapping,Female,31-45,795,131,664,267,528
2001,Rural,West Bengal,Crime Against Children,Kidnapping,Male,0-12,9154,966,8188,6423,2731
2004,Rural,Chhattisgarh,Property Crime,Arson,Female,0-12,122,36,86,37,85
2010,Urban,Kerala,Other Crimes,Fraud,Female,31-45,5946,5278,668,5527,419
2005,Rural,Uttarakhand,Crime Against Women,Domestic Violence,Male,18-30,453,110,343,446,7
2007,Urban,Maharashtra,Crime Against Children,Trafficking,Male,60+,2027,1750,277,1813,214
2001,Urban,Tripura,Crime Against Women,Rape,Male,31-45,8778,6361,2417,8587,191
2008,Urban,Rajasthan,Property Crime,Burglary,Female,18-30,3574,1898,1676,2899,675
2008,Rural,Karnataka,Crime Against Children,Child Abuse,Male,60+,6322,3377,2945,3438,2884
2006,Rural,Jammu & Kashmir,Property Crime,Burglary,Female,31-45,8098,4216,3882,6662,1436
2006,Rural,Chhattisgarh,Crime Against Children,Trafficking,Male,60+,7108,5836,1272,6411,697
2010,Rural,Maharashtra,Crime Against Women,Domestic Violence,Female,13-17,6606,3490,3116,4688,1918
2007,Rural,Arunachal Pradesh,Crime Against Men,Assault,Female,46-60,4248,2406,1842,2777,1471
2007,Rural,Telangana,Crime Against Men,Assault,Male,0-12,4059,1296,2763,2391,1668
2006,Urban,Gujarat,Crime Against Men,Robbery,Female,0-12,176,131,45,136,40
2008,Rural,Tripura,Other Crimes,Fraud,Female,13-17,4519,758,3761,1637,2882
2004,Rural,Karnataka,Other Crimes,Corruption,Female,60+,3146,1395,1751,2589,557
2003,Urban,Mizoram,Property Crime,Burglary,Female,13-17,5479,5463,16,5477,2
2001,Urban,Meghalaya,Crime Against Women,Domestic Violence,Male,46-60,2207,1093,1114,1553,654
2002,Urban,Mizoram,Property Crime,Theft,Female,31-45,3358,2661,697,2872,486
2003,Rural,Rajasthan,Crime Against Women,Rape,Female,13-17,5994,4436,1558,4463,1531
2010,Urban,Tripura,Property Crime,Burglary,Female,13-17,3049,1050,1999,2926,123
2008,Urban,Goa,Other Crimes,Cyber Crime,Female,0-12,9608,1691,7917,3430,6178
2010,Rural,Odisha,Other Crimes,Corruption,Female,18-30,3388,2675,713,3107,281
2007,Urban,Tripura,Crime Against Women,Rape,Male,60+,882,482,400,540,342
2004,Urban,West Bengal,Crime Against Children,Child Abuse,Male,18-30,8805,6821,1984,7718,1087
2002,Urban,Delhi,Crime Against Children,Child Abuse,Male,60+,7475,6722,753,7373,102
2002,Rural,Karnataka,Property Crime,Vandalism,Male,60+,5159,3094,2065,4511,648
2007,Rural,Manipur,Crime Against Children,Child Abuse,Male,13-17,1989,870,1119,1617,372
2005,Rural,Mizoram,Crime Against Children,Child Labor,Female,0-12,5967,2066,3901,3998,1969
2002,Urban,Himachal Pradesh,Other Crimes,Fraud,Male,46-60,2831,2157,674,2208,623
2004,Rural,Gujarat,Crime Against Children,Child Abuse,Male,60+,6890,5856,1034,6572,318
2006,Rural,Odisha,Other Crimes,Drug Offense,Male,31-45,2713,746,1967,2157,556
2004,Urban,Maharashtra,Property Crime,Burglary,Female,31-45,8982,8436,546,8645,337
2002,Rural,Maharashtra,Crime Against Children,Child Abuse,Male,60+,2154,1426,728,1709,445
2003,Rural,Rajasthan,Crime Against Women,Dowry Deaths,Male,0-12,1553,829,724,1325,228
2005,Urban,Tamil Nadu,Crime Against Children,Child Abuse,Male,46-60,4691,2018,2673,2439,2252
2006,Rural,Gujarat,Other Crimes,Corruption,Male,46-60,8428,1588,6840,5012,3416
2008,Urban,Haryana,Property Crime,Theft,Male,31-45,9547,5259,4288,7507,2040
2003,Urban,Madhya Pradesh,Crime Against Women,Rape,Female,13-17,2646,1768,878,2423,223
2001,Rural,Bihar,Crime Against Men,Murder,Male,31-45,1600,442,1158,1445,155
2004,Rural,Gujarat,Property Crime,Vandalism,Female,13-17,1576,203,1373,1245,331
2008,Rural,Karnataka,Other Crimes,Fraud,Female,31-45,6660,3062,3598,6348,312
2004,Urban,Kerala,Crime Against Men,Robbery,Female,31-45,4168,3601,567,3894,274
2007,Urban,Madhya Pradesh,Other Crimes,Cyber Crime,Female,60+,93,81,12,85,8
2008,Urban,Jharkhand,Crime Against Men,Murder,Female,18-30,2887,658,2229,1524,1363
2006,Rural,Tamil Nadu,Property Crime,Vandalism,Male,0-12,942,149,793,661,281
2008,Rural,Himachal Pradesh,Other Crimes,Cyber Crime,Female,18-30,6711,5778,933,6007,704
2008,Rural,Manipur,Other Crimes,Corruption,Male,46-60,9222,6530,2692,7580,1642
2008,Rural,Kerala,Other Crimes,Drug Offense,Female,18-30,9925,1930,7995,7733,2192
2006,Rural,Tripura,Crime Against Men,Robbery,Female,31-45,8752,1589,7163,7228,1524
2007,Urban,Uttar Pradesh,Crime Against Men,Assault,Female,46-60,8369,5112,3257,7623,746
2001,Rural,Andhra Pradesh,Crime Against Men,Murder,Male,18-30,1551,198,1353,1070,481
2002,Urban,Delhi,Other Crimes,Drug Offense,Female,18-30,9009,6137,2872,8661,348
2003,Rural,Andhra Pradesh,Crime Against Children,Child Abuse,Male,13-17,7530,1287,6243,6548,982
2010,Rural,Rajasthan,Crime Against Women,Dowry Deaths,Male,60+,3006,2958,48,2985,21
2003,Rural,Delhi,Property Crime,Vandalism,Male,60+,5381,412,4969,4215,1166
2001,Rural,Bihar,Other Crimes,Cyber Crime,Male,46-60,4787,2411,2376,3366,1421
2004,Urban,Uttarakhand,Crime Against Children,Trafficking,Female,13-17,5025,3653,1372,4183,842
2005,Urban,Andhra Pradesh,Crime Against Men,Assault,Male,31-45,3646,945,2701,2011,1635
2007,Rural,Punjab,Crime Against Women,Molestation,Male,31-45,8957,428,8529,7771,1186
2003,Rural,Manipur,Property Crime,Burglary,Male,13-17,2597,2222,375,2441,156
2008,Urban,Manipur,Other Crimes,Drug Offense,Male,60+,8071,6948,1123,7431,640
2005,Rural,Kerala,Crime Against Men,Robbery,Female,0-12,9523,8227,1296,8710,813
2004,Rural,Himachal Pradesh,Property Crime,Vandalism,Female,0-12,1931,210,1721,1887,44
2007,Rural,Punjab,Other Crimes,Corruption,Male,60+,9780,977,8803,5311,4469
2010,Urban,Maharashtra,Property Crime,Theft,Female,60+,5674,2273,3401,2817,2857
2009,Rural,Haryana,Crime Against Men,Assault,Female,13-17,4861,4567,294,4568,293
2008,Urban,Nagaland,Other Crimes,Corruption,Male,31-45,5826,3106,2720,5385,441
2007,Rural,Haryana,Property Crime,Vandalism,Male,46-60,6056,3233,2823,3980,2076
2002,Urban,Maharashtra,Property Crime,Burglary,Male,0-12,5847,2164,3683,2194,3653
2009,Rural,Andhra Pradesh,Crime Against Children,Child Abuse,Male,31-45,2941,2604,337,2820,121
2004,Rural,Tamil Nadu,Other Crimes,Corruption,Female,46-60,1308,1017,291,1138,170
2009,Urban,Goa,Crime Against Children,Trafficking,Male,0-12,6623,4967,1656,6142,481
2003,Urban,Arunachal Pradesh,Other Crimes,Corruption,Female,0-12,5227,2299,2928,4296,931
2003,Urban,Manipur,Crime Against Women,Rape,Male,31-45,9237,7483,1754,8822,415
2010,Rural,Karnataka,Crime Against Women,Domestic Violence,Male,31-45,6519,1216,5303,6017,502
2005,Rural,Jharkhand,Crime Against Men,Assault,Male,46-60,8285,4335,3950,7146,1139
2005,Rural,Karnataka,Crime Against Men,Murder,Male,60+,2635,2242,393,2381,254
2010,Rural,Mizoram,Crime Against Men,Murder,Female,0-12,4708,347,4361,1349,3359
2007,Rural,Kerala,Crime Against Men,Assault,Male,13-17,3513,387,3126,973,2540
2010,Urban,Tamil Nadu,Crime Against Children,Child Abuse,Male,0-12,7876,5520,2356,5656,2220
2002,Urban,Jharkhand,Crime Against Women,Rape,Male,31-45,8693,1793,6900,3220,5473
2008,Urban,Sikkim,Other Crimes,Corruption,Male,46-60,7483,4315,3168,6375,1108
2010,Rural,Jammu & Kashmir,Crime Against Women,Rape,Male,13-17,5937,5039,898,5744,193
2007,Rural,Meghalaya,Crime Against Women,Domestic Violence,Male,31-45,1175,561,614,694,481
2008,Rural,Jharkhand,Other Crimes,Cyber Crime,Male,18-30,9279,8321,958,9103,176
2010,Urban,Chhattisgarh,Crime Against Women,Domestic Violence,Male,0-12,2401,661,1740,1294,1107
2001,Urban,Bihar,Crime Against Men,Assault,Female,13-17,218,181,37,200,18
2008,Rural,Telangana,Other Crimes,Fraud,Male,46-60,3434,1973,1461,2675,759
2007,Urban,Assam,Property Crime,Vandalism,Male,13-17,6768,5839,929,6355,413
2004,Urban,Manipur,Property Crime,Arson,Female,13-17,7026,7016,10,7019,7
2004,Urban,Assam,Crime Against Women,Domestic Violence,Female,46-60,8698,7761,937,8288,410
2002,Rural,Tamil Nadu,Other Crimes,Cyber Crime,Male,46-60,6374,308,6066,3383,2991
2002,Urban,Jharkhand,Other Crimes,Cyber Crime,Male,0-12,1296,166,1130,802,494
2009,Rural,Sikkim,Property Crime,Theft,Male,46-60,4522,817,3705,3232,1290
2009,Urban,Himachal Pradesh,Property Crime,Arson,Female,46-60,5602,746,4856,1902,3700
2010,Urban,Bihar,Crime Against Women,Dowry Deaths,Female,0-12,3443,1679,1764,2454,989
2001,Urban,Telangana,Crime Against Men,Extortion,Male,13-17,3431,1412,2019,3052,379
2003,Urban,Bihar,Other Crimes,Corruption,Female,60+,6868,2615,4253,2687,4181
2008,Rural,Rajasthan,Crime Against Women,Dowry Deaths,Male,46-60,8903,7798,1105,8842,61
2006,Rural,Gujarat,Crime Against Children,Trafficking,Female,31-45,6341,2936,3405,5367,974
2001,Urban,Manipur,Crime Against Children,Trafficking,Male,18-30,6859,5283,1576,6815,44
2010,Urban,Odisha,Crime Against Children,Trafficking,Female,46-60,1504,1096,408,1140,364
2007,Rural,Rajasthan,Property Crime,Vandalism,Male,18-30,921,97,824,213,708
2005,Urban,Meghalaya,Other Crimes,Cyber Crime,Male,18-30,6613,3486,3127,3933,2680
2010,Urban,Punjab,Crime Against Men,Extortion,Female,46-60,6527,4927,1600,5660,867
2006,Urban,Tripura,Property Crime,Burglary,Female,60+,75,29,46,52,23
2005,Urban,Kerala,Crime Against Men,Assault,Male,31-45,7436,2259,5177,6552,884
2002,Urban,Uttar Pradesh,Crime Against Men,Extortion,Female,60+,9288,4117,5171,4691,4597
2003,Rural,Rajasthan,Crime Against Children,Child Abuse,Female,13-17,3622,1657,1965,2408,1214
2002,Urban,Manipur,Property Crime,Arson,Male,31-45,2961,54,2907,929,2032
2007,Urban,Chhattisgarh,Other Crimes,Cyber Crime,Female,31-45,5662,505,5157,1092,4570
2002,Urban,Goa,Other Crimes,Drug Offense,Male,13-17,4356,3921,435,4122,234
2002,Rural,Odisha,Other Crimes,Cyber Crime,Male,0-12,910,707,203,766,144
2002,Urban,Uttarakhand,Crime Against Women,Dowry Deaths,Male,18-30,9547,9313,234,9392,155
2009,Urban,Haryana,Crime Against Men,Assault,Female,13-17,3327,648,2679,984,2343
2006,Rural,Delhi,Other Crimes,Corruption,Female,0-12,1091,829,262,868,223
2005,Urban,Uttar Pradesh,Crime Against Children,Trafficking,Female,13-17,6961,2536,4425,6492,469
2004,Urban,Telangana,Other Crimes,Fraud,Female,31-45,8183,1727,6456,7225,958
2001,Urban,Tripura,Crime Against Children,Child Labor,Female,18-30,4944,2148,2796,2593,2351
2006,Rural,Uttarakhand,Crime Against Men,Extortion,Female,13-17,9162,8797,365,8934,228
2007,Urban,Tamil Nadu,Crime Against Men,Extortion,Male,0-12,5853,5436,417,5556,297
2006,Rural,Uttarakhand,Other Crimes,Drug Offense,Male,31-45,6459,3805,2654,4029,2430
2010,Urban,West Bengal,Crime Against Men,Murder,Male,18-30,4264,1131,3133,2194,2070
2010,Urban,Sikkim,Crime Against Men,Murder,Male,0-12,5804,892,4912,2627,3177
2010,Urban,Karnataka,Other Crimes,Drug Offense,Male,31-45,3031,753,2278,2847,184
2007,Rural,Uttar Pradesh,Crime Against Women,Domestic Violence,Male,46-60,3124,3055,69,3067,57
2005,Rural,Andhra Pradesh,Crime Against Women,Molestation,Male,60+,5141,3713,1428,3888,1253
2010,Urban,Karnataka,Crime Against Children,Kidnapping,Female,46-60,8914,5106,3808,6808,2106
2005,Urban,Jammu & Kashmir,Property Crime,Vandalism,Female,46-60,5112,3088,2024,4552,560
2008,Urban,Uttarakhand,Crime Against Children,Child Abuse,Male,0-12,8237,558,7679,1942,6295
2010,Rural,Chhattisgarh,Property Crime,Theft,Female,31-45,6408,5906,502,5919,489
2003,Rural,Goa,Crime Against Women,Rape,Male,13-17,8937,444,8493,2629,6308
2007,Urban,Jammu & Kashmir,Crime Against Men,Murder,Male,13-17,6676,2716,3960,5205,1471
2001,Urban,Karnataka,Crime Against Children,Child Abuse,Female,60+,1384,1084,300,1258,126
2001,Rural,Tripura,Crime Against Women,Dowry Deaths,Female,0-12,2639,2346,293,2358,281
2004,Rural,Bihar,Property Crime,Theft,Female,0-12,1125,228,897,800,325
2003,Urban,Uttarakhand,Crime Against Children,Child Labor,Female,0-12,6274,5785,489,5867,407
2003,Urban,West Bengal,Property Crime,Burglary,Male,18-30,6745,4686,2059,6660,85
2010,Urban,Gujarat,Other Crimes,Drug Offense,Female,60+,3464,837,2627,1711,1753
2007,Rural,Arunachal Pradesh,Crime Against Children,Kidnapping,Male,13-17,9205,552,8653,9019,186
2002,Urban,Uttar Pradesh,Crime Against Children,Child Abuse,Male,46-60,3893,1822,2071,2180,1713
2005,Urban,Kerala,Crime Against Women,Molestation,Male,46-60,1493,752,741,1096,397
2010,Urban,Bihar,Crime Against Women,Dowry Deaths,Female,31-45,7547,5406,2141,6581,966
2003,Urban,Chhattisgarh,Property Crime,Vandalism,Female,31-45,6667,5702,965,6241,426
2005,Urban,Uttarakhand,Crime Against Children,Child Labor,Male,18-30,8991,68,8923,4276,4715
2005,Rural,Uttarakhand,Other Crimes,Drug Offense,Male,31-45,4471,3810,661,4061,410
2008,Rural,Maharashtra,Crime Against Women,Rape,Male,46-60,5939,935,5004,5282,657
2009,Urban,Chhattisgarh,Crime Against Children,Trafficking,Female,18-30,1905,1826,79,1847,58
2002,Urban,Punjab,Property Crime,Vandalism,Female,46-60,2705,2516,189,2609,96
2005,Rural,Haryana,Crime Against Children,Trafficking,Female,0-12,7108,1571,5537,5144,1964
2004,Rural,Sikkim,Other Crimes,Corruption,Male,13-17,5262,4213,1049,4674,588
2010,Urban,Sikkim,Property Crime,Vandalism,Female,18-30,9210,4904,4306,7481,1729
2002,Urban,Tamil Nadu,Crime Against Women,Dowry Deaths,Male,46-60,1851,334,1517,1196,655
2008,Urban,Maharashtra,Crime Against Men,Robbery,Male,0-12,773,499,274,569,204
2007,Urban,Arunachal Pradesh,Crime Against Children,Kidnapping,Male,13-17,3675,2259,1416,3373,302
2007,Rural,Bihar,Crime Against Men,Murder,Female,31-45,7929,7717,212,7833,96
2001,Urban,Uttarakhand,Property Crime,Theft,Female,0-12,2130,1815,315,2103,27
2008,Urban,Maharashtra,Crime Against Children,Kidnapping,Male,13-17,8948,8843,105,8939,9
2004,Rural,Maharashtra,Crime Against Women,Molestation,Female,0-12,6111,176,5935,4853,1258
2002,Rural,Odisha,Other Crimes,Cyber Crime,Male,31-45,3714,2992,722,3188,526
2003,Rural,Manipur,Property Crime,Burglary,Male,46-60,2807,907,1900,1360,1447
2002,Rural,Uttarakhand,Property Crime,Theft,Female,46-60,9724,7276,2448,9208,516
2007,Urban,Nagaland,Crime Against Children,Child Labor,Male,31-45,248,189,59,212,36
2007,Rural,Delhi,Crime Against Children,Child Abuse,Female,13-17,7095,261,6834,1090,6005
2001,Urban,Maharashtra,Crime Against Children,Child Labor,Male,0-12,8412,7945,467,8295,117
2005,Urban,Himachal Pradesh,Property Crime,Arson,Female,60+,7560,4793,2767,7384,176
2004,Urban,Maharashtra,Crime Against Women,Dowry Deaths,Male,46-60,5085,3206,1879,3346,1739
2005,Rural,Tripura,Crime Against Children,Trafficking,Female,18-30,2534,2215,319,2399,135
2002,Rural,Meghalaya,Crime Against Men,Murder,Male,46-60,3262,841,2421,930,2332
2001,Rural,Gujarat,Crime Against Children,Child Abuse,Male,46-60,7045,3247,3798,6333,712
2006,Rural,Kerala,Crime Against Women,Domestic Violence,Male,0-12,5795,151,5644,2063,3732
2004,Urban,Gujarat,Other Crimes,Corruption,Male,18-30,4269,1573,2696,1827,2442
2002,Urban,Meghalaya,Crime Against Women,Rape,Female,13-17,3654,1262,2392,2796,858
2001,Urban,Maharashtra,Crime Against Children,Child Abuse,Male,0-12,7111,5251,1860,6996,115
2001,Rural,Arunachal Pradesh,Other Crimes,Cyber Crime,Male,13-17,3131,3032,99,3095,36
2005,Rural,Rajasthan,Other Crimes,Cyber Crime,Male,60+,1390,1319,71,1372,18
2007,Rural,Jammu & Kashmir,Crime Against Men,Murder,Male,60+,2719,1764,955,2226,493
2008,Urban,Odisha,Crime Against Men,Murder,Male,60+,6706,3550,3156,3572,3134
2005,Rural,Uttarakhand,Crime Against Women,Domestic Violence,Male,18-30,250,141,109,230,20
2008,Rural,Assam,Other Crimes,Corruption,Female,0-12,4806,2440,2366,4018,788
2005,Rural,Himachal Pradesh,Crime Against Children,Child Labor,Male,18-30,9365,1228,8137,5083,4282
2008,Rural,Jharkhand,Crime Against Children,Kidnapping,Female,60+,3296,2744,552,3260,36
2002,Rural,Assam,Other Crimes,Cyber Crime,Female,18-30,224,191,33,213,11
2004,Urban,Arunachal Pradesh,Crime Against Men,Murder,Male,18-30,8417,8362,55,8416,1
2002,Rural,Odisha,Crime Against Children,Trafficking,Male,18-30,1527,1099,428,1282,245
2007,Urban,Chhattisgarh,Property Crime,Vandalism,Male,13-17,8334,4559,3775,6905,1429
2004,Rural,Odisha,Crime Against Women,Dowry Deaths,Female,18-30,4712,3839,873,4114,598
2001,Rural,Karnataka,Other Crimes,Cyber Crime,Male,13-17,583,282,301,467,116
2010,Rural,Bihar,Crime Against Women,Dowry Deaths,Male,31-45,1819,814,1005,1608,211
2009,Rural,Andhra Pradesh,Crime Against Women,Domestic Violence,Male,31-45,866,289,577,326,540
2005,Rural,Haryana,Crime Against Women,Molestation,Female,0-12,8632,4060,4572,5099,3533
2010,Rural,Telangana,Property Crime,Arson,Female,31-45,5993,1219,4774,3538,2455
2008,Urban,Tripura,Other Crimes,Corruption,Male,31-45,3913,265,3648,2922,991
2009,Urban,Tamil Nadu,Property Crime,Burglary,Male,31-45,1448,805,643,1227,221
2005,Urban,Jammu & Kashmir,Crime Against Men,Extortion,Female,18-30,8940,5122,3818,6951,1989
2003,Rural,Assam,Crime Against Women,Molestation,Female,46-60,2998,739,2259,1627,1371
2007,Urban,Telangana,Crime Against Women,Domestic Violence,Female,13-17,5505,1271,4234,4736,769
2007,Urban,Arunachal Pradesh,Crime Against Men,Assault,Female,31-45,8680,7364,1316,8042,638
2010,Urban,Andhra Pradesh,Other Crimes,Corruption,Female,0-12,360,200,160,234,126
2003,Rural,Rajasthan,Crime Against Children,Child Abuse,Male,13-17,2003,1339,664,1694,309
2010,Rural,Punjab,Other Crimes,Drug Offense,Male,60+,5315,1412,3903,3370,1945
2002,Urban,Uttar Pradesh,Crime Against Children,Trafficking,Male,0-12,4858,2177,2681,3550,1308
2001,Urban,Jharkhand,Other Crimes,Corruption,Female,0-12,2888,1756,1132,2456,432
2002,Urban,Maharashtra,Crime Against Children,Child Abuse,Male,31-45,2260,1660,600,1938,322
2003,Urban,Uttarakhand,Other Crimes,Corruption,Male,60+,1031,995,36,999,32
2007,Urban,Rajasthan,Crime Against Men,Extortion,Male,13-17,8181,6514,1667,7703,478
2006,Urban,Karnataka,Crime Against Women,Molestation,Female,60+,803,316,487,696,107
2005,Rural,Tripura,Other Crimes,Drug Offense,Male,46-60,7341,6082,1259,6526,815
2006,Urban,Goa,Crime Against Women,Rape,Male,31-45,2788,135,2653,1400,1388
2007,Rural,Telangana,Crime Against Children,Child Abuse,Male,0-12,7286,2105,5181,3791,3495
2003,Rural,Nagaland,Property Crime,Burglary,Female,46-60,9398,970,8428,8644,754
2003,Rural,Tripura,Property Crime,Burglary,Male,13-17,9682,1709,7973,3118,6564
2005,Rural,Madhya Pradesh,Crime Against Children,Child Labor,Male,18-30,6995,4653,2342,5022,1973
2005,Rural,Karnataka,Crime Against Children,Child Labor,Male,18-30,3930,181,3749,2871,1059
2002,Rural,Chhattisgarh,Crime Against Men,Murder,Female,60+,6254,2507,3747,3307,2947
2007,Rural,Manipur,Crime Against Children,Child Abuse,Male,46-60,1682,567,1115,746,936
2001,Urban,Nagaland,Crime Against Men,Robbery,Male,46-60,2275,135,2140,777,1498
2003,Rural,Manipur,Crime Against Women,Rape,Female,13-17,1640,738,902,1475,165
2001,Urban,Manipur,Crime Against Women,Molestation,Male,46-60,5357,5030,327,5068,289
2006,Urban,Assam,Property Crime,Vandalism,Female,18-30,979,762,217,919,60
2001,Rural,Punjab,Crime Against Children,Child Abuse,Male,0-12,3634,335,3299,3007,627
2009,Rural,Gujarat,Crime Against Men,Murder,Female,0-12,577,307,270,505,72
2009,Urban,West Bengal,Other Crimes,Corruption,Female,60+,3134,1890,1244,2036,1098
2004,Rural,Sikkim,Crime Against Children,Child Abuse,Male,31-45,4045,3245,800,3560,485
2010,Rural,Delhi,Property Crime,Theft,Female,0-12,5029,698,4331,768,4261
2005,Rural,Goa,Crime Against Men,Assault,Male,0-12,2168,387,1781,1119,1049
2006,Rural,Tripura,Crime Against Women,Dowry Deaths,Male,46-60,4130,2082,2048,2787,1343
2004,Urban,Arunachal Pradesh,Crime Against Men,Robbery,Male,13-17,4318,3925,393,4212,106
2002,Rural,Tripura,Property Crime,Vandalism,Male,13-17,9958,7811,2147,9910,48
2008,Urban,Kerala,Other Crimes,Fraud,Male,0-12,9479,8324,1155,9421,58
2007,Rural,Rajasthan,Crime Against Women,Molestation,Male,60+,4169,3763,406,4084,85
2005,Rural,Meghalaya,Property Crime,Theft,Female,46-60,4454,144,4310,3275,1179
2002,Rural,Gujarat,Crime Against Children,Child Abuse,Male,13-17,4607,3740,867,4180,427
2010,Rural,Uttar Pradesh,Other Crimes,Cyber Crime,Male,13-17,5668,57,5611,560,5108
2001,Rural,Madhya Pradesh,Crime Against Women,Domestic Violence,Female,18-30,6670,5943,727,6037,633
2008,Rural,Jharkhand,Crime Against Men,Robbery,Female,0-12,8340,537,7803,4284,4056
2008,Rural,Uttarakhand,Other Crimes,Drug Offense,Male,0-12,3691,360,3331,948,2743
2004,Rural,Nagaland,Crime Against Children,Trafficking,Female,60+,449,87,362,300,149
2007,Urban,Maharashtra,Crime Against Children,Trafficking,Male,46-60,8197,1325,6872,4187,4010
2006,Rural,Meghalaya,Crime Against Children,Child Labor,Male,18-30,4818,3323,1495,4074,744
2005,Urban,West Bengal,Property Crime,Arson,Female,46-60,6161,6141,20,6158,3
2008,Urban,Arunachal Pradesh,Other Crimes,Drug Offense,Male,31-45,125,120,5,123,2
2010,Rural,Arunachal Pradesh,Crime Against Men,Assault,Male,60+,203,31,172,66,137
2004,Urban,Madhya Pradesh,Crime Against Men,Robbery,Male,46-60,6961,5355,1606,5895,1066
2004,Urban,Uttarakhand,Other Crimes,Drug Offense,Female,46-60,4775,4485,290,4532,243
2005,Rural,Delhi,Crime Against Women,Dowry Deaths,Male,0-12,4525,3772,753,4244,281
2001,Urban,Kerala,Property Crime,Theft,Male,13-17,4577,1727,2850,2280,2297
2008,Rural,Madhya Pradesh,Crime Against Men,Assault,Female,31-45,1826,1225,601,1358,468
2002,Urban,Karnataka,Crime Against Children,Child Abuse,Male,31-45,69,16,53,55,14
2004,Urban,Rajasthan,Crime Against Women,Domestic Violence,Male,18-30,9760,414,9346,9674,86
2006,Urban,Meghalaya,Crime Against Men,Extortion,Male,60+,9979,9032,947,9226,753
2005,Urban,Rajasthan,Other Crimes,Corruption,Male,0-12,5748,3932,1816,4738,1010
2010,Rural,Maharashtra,Crime Against Children,Child Labor,Female,46-60,6302,2644,3658,5867,435
2001,Rural,Jammu & Kashmir,Crime Against Women,Dowry Deaths,Male,31-45,8544,1067,7477,5136,3408
2008,Urban,Manipur,Other Crimes,Drug Offense,Female,18-30,6545,1275,5270,2542,4003
2002,Rural,West Bengal,Property Crime,Theft,Female,46-60,7422,2833,4589,5063,2359
2004,Urban,Himachal Pradesh,Crime Against Women,Domestic Violence,Male,60+,1669,814,855,869,800
2005,Rural,Haryana,Crime Against Women,Dowry Deaths,Female,0-12,336,243,93,253,83
2009,Urban,Punjab,Crime Against Children,Child Labor,Female,60+,2817,2119,698,2378,439
2003,Rural,Uttarakhand,Crime Against Women,Dowry Deaths,Male,18-30,88,35,53,55,33
2001,Urban,Delhi,Property Crime,Theft,Male,13-17,9352,5457,3895,5488,3864
2009,Urban,Meghalaya,Crime Against Children,Child Labor,Male,60+,3367,975,2392,3252,115
2010,Urban,Mizoram,Property Crime,Arson,Male,60+,7213,5838,1375,6877,336
2001,Rural,Nagaland,Crime Against Children,Child Abuse,Female,18-30,6043,3117,2926,4617,1426
2009,Rural,Telangana,Crime Against Children,Child Labor,Female,46-60,7195,6882,313,7011,184
2008,Rural,Chhattisgarh,Crime Against Men,Murder,Female,18-30,1925,191,1734,1300,625
2010,Rural,Nagaland,Crime Against Women,Molestation,Male,13-17,7737,1556,6181,6574,1163
2009,Rural,Rajasthan,Crime Against Children,Child Abuse,Male,18-30,7690,7516,174,7601,89
2005,Urban,Uttarakhand,Other Crimes,Fraud,Male,18-30,6767,14,6753,941,5826
2005,Rural,Karnataka,Crime Against Women,Molestation,Male,31-45,2150,1851,299,1960,190
2002,Urban,Tamil Nadu,Other Crimes,Corruption,Female,13-17,3822,1367,2455,2984,838
2007,Rural,Tripura,Crime Against Children,Kidnapping,Male,31-45,8875,1658,7217,8773,102
2005,Rural,Mizoram,Crime Against Children,Child Abuse,Female,0-12,9863,9069,794,9790,73
2006,Urban,Himachal Pradesh,Property Crime,Vandalism,Female,31-45,8701,7860,841,8411,290
2008,Urban,Delhi,Crime Against Children,Child Labor,Female,46-60,4671,128,4543,3654,1017
2005,Rural,Gujarat,Property Crime,Theft,Female,18-30,445,287,158,330,115
2009,Urban,Kerala,Crime Against Women,Rape,Female,0-12,1277,310,967,644,633
2001,Rural,Madhya Pradesh,Property Crime,Theft,Female,13-17,6852,1017,5835,1962,4890
2002,Rural,Telangana,Crime Against Men,Robbery,Male,18-30,3490,3322,168,3346,144
2005,Rural,Kerala,Other Crimes,Fraud,Female,18-30,9626,2929,6697,6072,3554
2006,Rural,Kerala,Other Crimes,Fraud,Male,60+,3552,1743,1809,2570,982
2005,Rural,Nagaland,Crime Against Men,Murder,Female,46-60,1077,74,1003,662,415
2007,Rural,West Bengal,Crime Against Children,Child Abuse,Male,0-12,5265,3987,1278,4537,728
2005,Urban,Himachal Pradesh,Crime Against Women,Dowry Deaths,Female,31-45,504,226,278,380,124
2003,Rural,Goa,Crime Against Children,Child Labor,Male,31-45,274,227,47,231,43
2006,Urban,Kerala,Other Crimes,Corruption,Male,31-45,67,7,60,25,42
2006,Rural,Jammu & Kashmir,Property Crime,Vandalism,Female,46-60,7751,2932,4819,4029,3722
2004,Urban,Delhi,Other Crimes,Corruption,Male,13-17,2909,2849,60,2909,0
2008,Urban,Punjab,Other Crimes,Corruption,Female,46-60,7565,5712,1853,6908,657
2006,Rural,Arunachal Pradesh,Property Crime,Arson,Female,18-30,7284,6889,395,7169,115
2003,Rural,Uttar Pradesh,Crime Against Children,Child Abuse,Male,18-30,1954,1211,743,1403,551
2010,Urban,Mizoram,Crime Against Women,Domestic Violence,Male,46-60,2658,611,2047,1026,1632
2010,Rural,Karnataka,Crime Against Children,Kidnapping,Female,60+,3095,2313,782,3000,95
2005,Urban,Assam,Crime Against Children,Child Abuse,Male,60+,8081,3444,4637,7846,235
2005,Urban,Madhya Pradesh,Crime Against Men,Assault,Male,13-17,5934,975,4959,4741,1193
2006,Urban,Meghalaya,Crime Against Women,Domestic Violence,Male,13-17,1585,143,1442,965,620
2004,Urban,Delhi,Crime Against Women,Domestic Violence,Male,46-60,7928,7737,191,7817,111
2009,Urban,Jharkhand,Crime Against Women,Molestation,Male,46-60,4785,2792,1993,3564,1221
2006,Urban,West Bengal,Property Crime,Vandalism,Male,18-30,2572,75,2497,892,1680
2001,Rural,Madhya Pradesh,Crime Against Men,Robbery,Female,46-60,7772,1893,5879,1944,5828
2005,Urban,Kerala,Property Crime,Arson,Female,46-60,2331,797,1534,1780,551
2007,Rural,Manipur,Crime Against Men,Robbery,Female,18-30,8191,6877,1314,7752,439
2006,Urban,Manipur,Property Crime,Vandalism,Male,31-45,3845,2091,1754,2428,1417
2001,Urban,Karnataka,Crime Against Children,Child Abuse,Male,0-12,7856,4995,2861,5329,2527
2006,Rural,Nagaland,Crime Against Children,Child Labor,Female,60+,1612,1179,433,1427,185
2004,Rural,Manipur,Property Crime,Theft,Male,46-60,9569,5947,3622,9548,21
2008,Urban,Madhya Pradesh,Other Crimes,Corruption,Male,0-12,8667,7617,1050,8605,62
2003,Urban,Uttarakhand,Other Crimes,Corruption,Female,46-60,1775,817,958,841,934
2008,Urban,Goa,Crime Against Children,Trafficking,Female,60+,7732,1228,6504,5241,2491
2010,Urban,Himachal Pradesh,Crime Against Women,Molestation,Female,0-12,1498,307,1191,407,1091
2003,Rural,Arunachal Pradesh,Crime Against Women,Domestic Violence,Male,31-45,3765,1798,1967,3005,760
2005,Rural,Jammu & Kashmir,Property Crime,Arson,Female,13-17,946,816,130,893,53
2010,Rural,Meghalaya,Property Crime,Theft,Male,46-60,5470,621,4849,1956,3514
2010,Urban,Andhra Pradesh,Crime Against Men,Extortion,Female,18-30,633,125,508,308,325
2005,Rural,Manipur,Crime Against Women,Domestic Violence,Female,18-30,4562,553,4009,2880,1682
2008,Urban,Tamil Nadu,Crime Against Men,Extortion,Female,46-60,265,191,74,193,72
2007,Rural,Haryana,Crime Against Children,Kidnapping,Male,60+,6594,4615,1979,5915,679
2006,Rural,Telangana,Crime Against Women,Rape,Female,18-30,1545,755,790,921,624
2006,Urban,Maharashtra,Crime Against Children,Child Abuse,Female,46-60,3853,1898,1955,3814,39
2002,Urban,Maharashtra,Crime Against Women,Rape,Female,60+,2773,495,2278,2567,206
2001,Rural,Jharkhand,Property Crime,Theft,Female,60+,4686,4088,598,4154,532
2005,Urban,Rajasthan,Crime Against Children,Trafficking,Male,60+,1224,1117,107,1218,6
2007,Urban,Himachal Pradesh,Property Crime,Arson,Female,46-60,5987,1205,4782,3371,2616
2001,Urban,West Bengal,Property Crime,Vandalism,Male,46-60,9730,418,9312,9287,443
2008,Rural,Gujarat,Crime Against Children,Child Labor,Male,13-17,8957,8788,169,8818,139
2006,Urban,Manipur,Property Crime,Vandalism,Male,46-60,6201,3501,2700,4402,1799
2010,Rural,Andhra Pradesh,Crime Against Women,Dowry Deaths,Male,13-17,6330,6167,163,6174,156
2002,Rural,Tripura,Crime Against Women,Dowry Deaths,Female,46-60,4586,786,3800,1697,2889
2001,Urban,Maharashtra,Property Crime,Theft,Female,46-60,9102,4036,5066,8320,782
2008,Rural,Bihar,Crime Against Men,Murder,Female,31-45,4248,1681,2567,2119,2129
2008,Urban,Jharkhand,Crime Against Men,Robbery,Male,18-30,9629,9043,586,9196,433
2003,Urban,Bihar,Crime Against Men,Assault,Male,18-30,2626,2275,351,2404,222
2008,Rural,Goa,Property Crime,Arson,Female,60+,530,95,435,261,269
2003,Rural,Assam,Crime Against Men,Assault,Female,60+,3889,1432,2457,1736,2153
2009,Urban,Andhra Pradesh,Other Crimes,Corruption,Male,13-17,552,297,255,375,177
2009,Rural,Himachal Pradesh,Property Crime,Vandalism,Female,18-30,7613,6986,627,7097,516
2005,Rural,Jammu & Kashmir,Property Crime,Vandalism,Male,60+,8552,5664,2888,7176,1376
2010,Urban,Kerala,Crime Against Children,Kidnapping,Female,60+,4168,3960,208,3963,205
2001,Rural,Karnataka,Other Crimes,Drug Offense,Female,18-30,6971,2152,4819,3512,3459
2007,Rural,Uttarakhand,Crime Against Children,Kidnapping,Male,13-17,424,323,101,398,26
2009,Urban,Goa,Crime Against Children,Kidnapping,Female,13-17,1564,1042,522,1271,293
2008,Rural,Mizoram,Property Crime,Arson,Female,18-30,1044,765,279,835,209
2005,Rural,Madhya Pradesh,Crime Against Men,Extortion,Male,46-60,955,39,916,121,834
2001,Urban,Himachal Pradesh,Crime Against Children,Child Labor,Female,0-12,7896,2481,5415,5580,2316
2003,Rural,Uttarakhand,Crime Against Children,Child Labor,Female,0-12,319,160,159,186,133
2008,Urban,West Bengal,Crime Against Women,Domestic Violence,Female,0-12,4663,3371,1292,4134,529
2010,Urban,Karnataka,Crime Against Men,Robbery,Female,60+,1915,863,1052,1020,895
2002,Urban,Uttar Pradesh,Property Crime,Burglary,Male,46-60,1640,512,1128,1189,451
2008,Rural,Odisha,Other Crimes,Corruption,Male,46-60,1612,1563,49,1592,20
2004,Urban,Rajasthan,Property Crime,Burglary,Female,18-30,4124,4072,52,4094,30
2010,Urban,Tamil Nadu,Crime Against Men,Murder,Female,13-17,8700,3020,5680,5406,3294
2007,Urban,Madhya Pradesh,Crime Against Children,Child Labor,Female,18-30,3640,713,2927,2175,1465
2004,Rural,Telangana,Other Crimes,Drug Offense,Male,13-17,95,58,37,69,26
2005,Rural,Jammu & Kashmir,Crime Against Women,Molestation,Male,46-60,2002,482,1520,1626,376
2006,Rural,Punjab,Crime Against Children,Trafficking,Male,60+,9188,469,8719,6837,2351
2001,Rural,Punjab,Crime Against Men,Robbery,Male,60+,5939,529,5410,718,5221
2005,Rural,Meghalaya,Crime Against Men,Assault,Female,46-60,3921,852,3069,947,2974
2005,Rural,Andhra Pradesh,Crime Against Women,Domestic Violence,Female,13-17,7402,5685,1717,7220,182
2004,Rural,Delhi,Crime Against Women,Dowry Deaths,Male,31-45,6844,1277,5567,4506,2338
2001,Urban,Tripura,Property Crime,Burglary,Male,31-45,2695,633,2062,1909,786
2002,Urban,Punjab,Crime Against Men,Assault,Female,18-30,9373,8964,409,9266,107
2001,Rural,Jharkhand,Property Crime,Burglary,Female,60+,162,44,118,47,115
2009,Rural,Mizoram,Crime Against Women,Rape,Female,0-12,9408,3366,6042,7929,1479
2006,Urban,Himachal Pradesh,Crime Against Men,Extortion,Male,46-60,7464,5090,2374,6877,587
2005,Rural,Tripura,Other Crimes,Fraud,Female,60+,2015,233,1782,1249,766
2009,Rural,Arunachal Pradesh,Property Crime,Arson,Male,18-30,6676,4881,1795,5822,854
2009,Urban,Gujarat,Other Crimes,Cyber Crime,Female,31-45,4599,2277,2322,2423,2176
2002,Urban,Himachal Pradesh,Crime Against Men,Murder,Female,18-30,1468,1121,347,1257,211
2002,Rural,Gujarat,Property Crime,Theft,Male,0-12,4596,4254,342,4582,14
2009,Urban,Delhi,Crime Against Children,Child Labor,Male,46-60,6954,3376,3578,5359,1595
2003,Urban,Manipur,Crime Against Men,Assault,Male,46-60,1023,254,769,262,761
2009,Rural,Tripura,Crime Against Children,Child Abuse,Male,0-12,1445,255,1190,1416,29
2006,Urban,Meghalaya,Other Crimes,Corruption,Male,18-30,204,79,125,204,0
2004,Urban,Andhra Pradesh,Crime Against Men,Assault,Female,18-30,8812,3754,5058,4547,4265
2009,Rural,Himachal Pradesh,Property Crime,Burglary,Female,60+,6423,4535,1888,5074,1349
2010,Rural,Jammu & Kashmir,Property Crime,Burglary,Female,60+,4045,3311,734,3719,326
2004,Rural,Manipur,Other Crimes,Drug Offense,Female,46-60,4038,565,3473,3769,269
2006,Urban,Tamil Nadu,Crime Against Men,Extortion,Male,46-60,6995,1210,5785,3136,3859
2002,Rural,Bihar,Crime Against Men,Robbery,Male,13-17,3761,1702,2059,3143,618
2001,Rural,Haryana,Crime Against Men,Robbery,Female,18-30,265,146,119,265,0
2002,Rural,Maharashtra,Other Crimes,Cyber Crime,Female,60+,7856,5217,2639,7383,473
2001,Rural,Goa,Property Crime,Burglary,Male,60+,231,109,122,126,105
2002,Urban,Rajasthan,Crime Against Women,Dowry Deaths,Male,13-17,7811,3083,4728,6172,1639
2007,Urban,Jammu & Kashmir,Crime Against Men,Murder,Female,18-30,6909,4228,2681,5160,1749
2009,Urban,Meghalaya,Crime Against Women,Rape,Male,60+,4765,3157,1608,4199,566
2005,Urban,Madhya Pradesh,Crime Against Men,Assault,Female,46-60,2742,2694,48,2707,35
2004,Urban,Uttar Pradesh,Crime Against Children,Trafficking,Male,0-12,1689,719,970,1117,572
2004,Rural,West Bengal,Crime Against Children,Child Labor,Female,13-17,3800,1981,1819,2596,1204
2006,Rural,Goa,Property Crime,Arson,Male,60+,1627,613,1014,1057,570
2001,Urban,Karnataka,Property Crime,Theft,Female,60+,630,158,472,559,71
2006,Rural,Chhattisgarh,Property Crime,Theft,Female,0-12,3257,676,2581,1691,1566
2002,Rural,Karnataka,Crime Against Women,Dowry Deaths,Female,31-45,7761,6659,1102,7231,530
2001,Rural,Jharkhand,Crime Against Men,Murder,Male,60+,5842,674,5168,3788,2054
2006,Rural,Nagaland,Crime Against Men,Murder,Female,18-30,5366,1378,3988,4658,708
2009,Urban,Gujarat,Property Crime,Vandalism,Male,46-60,3277,2488,789,3173,104
2005,Urban,Andhra Pradesh,Other Crimes,Drug Offense,Female,0-12,9631,1454,8177,8780,851
2007,Rural,West Bengal,Property Crime,Vandalism,Female,0-12,5020,990,4030,3423,1597
2006,Rural,Meghalaya,Crime Against Women,Rape,Female,18-30,4812,723,4089,3682,1130
2001,Rural,Delhi,Crime Against Men,Murder,Male,0-12,7965,4665,3300,7351,614
2008,Urban,Punjab,Other Crimes,Cyber Crime,Male,31-45,9376,8677,699,9152,224
2010,Urban,Karnataka,Crime Against Children,Kidnapping,Male,18-30,8400,3416,4984,6754,1646
2002,Rural,Goa,Crime Against Children,Child Labor,Male,31-45,1064,813,251,818,246
2002,Urban,Kerala,Property Crime,Theft,Male,60+,3331,2019,1312,3224,107
2006,Urban,Tripura,Other Crimes,Cyber Crime,Female,46-60,5861,4942,919,5342,519
2006,Urban,Rajasthan,Crime Against Children,Trafficking,Male,60+,8965,6584,2381,7646,1319
2003,Urban,Goa,Property Crime,Vandalism,Male,31-45,1997,792,1205,1218,779
2008,Urban,Gujarat,Property Crime,Arson,Male,31-45,67,29,38,64,3
2005,Urban,Arunachal Pradesh,Crime Against Women,Rape,Male,18-30,4120,223,3897,1618,2502
2009,Rural,Jharkhand,Property Crime,Burglary,Female,13-17,1154,403,751,763,391
2003,Rural,Madhya Pradesh,Crime Against Men,Assault,Female,31-45,1695,79,1616,812,883
2006,Rural,Andhra Pradesh,Other Crimes,Fraud,Male,60+,7591,901,6690,6327,1264
2007,Urban,Himachal Pradesh,Crime Against Men,Extortion,Male,0-12,5950,4492,1458,5804,146
2009,Rural,Haryana,Property Crime,Theft,Female,31-45,1985,1603,382,1941,44
2003,Urban,Andhra Pradesh,Crime Against Women,Domestic Violence,Male,18-30,4884,3348,1536,4781,103
2010,Rural,Haryana,Property Crime,Vandalism,Male,0-12,5443,2665,2778,3896,1547
2001,Rural,Goa,Crime Against Children,Kidnapping,Female,13-17,7209,4415,2794,6546,663
2003,Urban,Nagaland,Other Crimes,Cyber Crime,Female,0-12,1581,1487,94,1558,23
2007,Rural,Haryana,Crime Against Men,Murder,Male,18-30,7434,6111,1323,6704,730
2006,Urban,Manipur,Other Crimes,Drug Offense,Male,60+,443,327,116,334,109
2004,Rural,Odisha,Crime Against Children,Child Abuse,Male,0-12,5086,2099,2987,2716,2370
2007,Rural,Tripura,Crime Against Children,Trafficking,Male,13-17,2592,2064,528,2544,48
2005,Rural,Gujarat,Crime Against Children,Trafficking,Female,31-45,4472,768,3704,4306,166
2009,Urban,Tripura,Other Crimes,Fraud,Female,13-17,1286,558,728,653,633
2010,Rural,Rajasthan,Crime Against Children,Trafficking,Female,13-17,8851,7542,1309,8402,449
2002,Urban,Goa,Other Crimes,Cyber Crime,Female,0-12,1695,593,1102,877,818
2007,Rural,Mizoram,Crime Against Women,Domestic Violence,Male,0-12,1146,87,1059,1020,126
2005,Urban,Andhra Pradesh,Crime Against Children,Trafficking,Female,13-17,3679,3599,80,3612,67
2001,Urban,Meghalaya,Other Crimes,Drug Offense,Female,0-12,2832,705,2127,2145,687
2007,Urban,Assam,Crime Against Children,Trafficking,Female,0-12,8396,6393,2003,7775,621
2003,Rural,Mizoram,Crime Against Children,Kidnapping,Female,18-30,880,243,637,783,97
2003,Rural,Kerala,Crime Against Men,Robbery,Male,31-45,3802,2730,1072,2786,1016
2008,Urban,Himachal Pradesh,Property Crime,Theft,Female,13-17,5638,2280,3358,4034,1604
2010,Rural,Bihar,Property Crime,Vandalism,Male,0-12,4059,249,3810,1140,2919
2010,Rural,Goa,Property Crime,Burglary,Female,31-45,640,43,597,151,489
2007,Urban,Tripura,Other Crimes,Corruption,Female,60+,7174,4175,2999,6395,779
2010,Rural,Delhi,Crime Against Men,Extortion,Male,18-30,9937,9262,675,9419,518
2007,Urban,Mizoram,Property Crime,Vandalism,Male,60+,835,580,255,677,158
2010,Rural,Assam,Crime Against Men,Extortion,Female,31-45,4307,1931,2376,4144,163
2009,Urban,Himachal Pradesh,Crime Against Men,Robbery,Female,0-12,8417,2973,5444,5147,3270
2009,Urban,Jharkhand,Crime Against Men,Murder,Male,13-17,6672,6647,25,6666,6
2009,Rural,Andhra Pradesh,Crime Against Women,Molestation,Female,0-12,3198,1300,1898,2478,720
2002,Rural,Sikkim,Crime Against Women,Molestation,Female,31-45,4992,1232,3760,2928,2064
2007,Rural,Goa,Property Crime,Theft,Female,60+,5271,5121,150,5212,59
2006,Rural,Nagaland,Property Crime,Arson,Female,18-30,3099,1564,1535,2402,697
2003,Rural,Uttar Pradesh,Other Crimes,Fraud,Female,18-30,9245,9028,217,9239,6
2010,Rural,Jharkhand,Crime Against Women,Dowry Deaths,Male,0-12,4064,2609,1455,2819,1245
2006,Rural,Karnataka,Crime Against Women,Rape,Male,18-30,9233,3245,5988,8436,797
2008,Urban,Uttarakhand,Other Crimes,Fraud,Male,60+,1757,870,887,1449,308
2003,Rural,Madhya Pradesh,Crime Against Children,Kidnapping,Male,13-17,5967,4273,1694,5230,737
2001,Urban,Madhya Pradesh,Other Crimes,Cyber Crime,Female,18-30,6316,1720,4596,4801,1515
2004,Rural,Meghalaya,Other Crimes,Cyber Crime,Male,46-60,5629,3440,2189,5278,351
2001,Rural,Andhra Pradesh,Other Crimes,Fraud,Female,31-45,9661,7845,1816,8776,885
2009,Rural,Punjab,Other Crimes,Drug Offense,Female,46-60,5158,1813,3345,2741,2417
2009,Urban,Gujarat,Other Crimes,Fraud,Female,31-45,8696,4737,3959,6940,1756
2005,Urban,Uttarakhand,Other Crimes,Drug Offense,Male,13-17,2292,2090,202,2216,76
2003,Urban,Assam,Other Crimes,Corruption,Male,46-60,3071,2368,703,2609,462
2006,Rural,Delhi,Crime Against Men,Assault,Male,13-17,1589,1144,445,1280,309
2001,Urban,Tamil Nadu,Crime Against Men,Extortion,Female,18-30,205,79,126,104,101
2001,Urban,Jharkhand,Crime Against Women,Dowry Deaths,Male,60+,5513,4960,553,5424,89
2005,Rural,Assam,Crime Against Women,Molestation,Male,31-45,9599,2162,7437,3840,5759
2002,Urban,Jammu & Kashmir,Crime Against Men,Robbery,Male,0-12,6303,1610,4693,2963,3340
2002,Rural,Arunachal Pradesh,Crime Against Men,Murder,Female,46-60,6309,5739,570,5912,397
2001,Rural,Andhra Pradesh,Other Crimes,Corruption,Male,31-45,9108,5839,3269,7902,1206
2007,Urban,Andhra Pradesh,Crime Against Women,Domestic Violence,Female,46-60,621,137,484,287,334
2005,Urban,Tamil Nadu,Property Crime,Burglary,Female,60+,932,435,497,923,9
2008,Urban,Uttarakhand,Crime Against Women,Dowry Deaths,Male,46-60,8352,4382,3970,5951,2401
2006,Urban,Meghalaya,Property Crime,Vandalism,Male,13-17,1145,506,639,554,591
2001,Urban,Uttarakhand,Property Crime,Burglary,Male,46-60,1533,764,769,1136,397
2006,Urban,Delhi,Crime Against Women,Rape,Male,60+,1056,900,156,916,140
2008,Urban,Maharashtra,Crime Against Children,Child Labor,Male,46-60,736,387,349,435,301
2010,Urban,Punjab,Crime Against Women,Molestation,Male,60+,7115,2991,4124,6543,572
2002,Rural,Jammu & Kashmir,Other Crimes,Cyber Crime,Male,46-60,5754,4441,1313,4838,916
2003,Urban,Nagaland,Property Crime,Theft,Male,46-60,7175,1040,6135,2830,4345
2001,Urban,Maharashtra,Crime Against Women,Dowry Deaths,Female,13-17,6765,4905,1860,6308,457
2003,Urban,Jammu & Kashmir,Crime Against Women,Rape,Female,18-30,6475,4844,1631,5371,1104
2006,Rural,Manipur,Crime Against Women,Domestic Violence,Female,31-45,3695,1564,2131,1592,2103
2004,Rural,Manipur,Other Crimes,Drug Offense,Male,46-60,3691,2623,1068,2774,917
2003,Urban,Uttarakhand,Property Crime,Burglary,Female,31-45,6413,5852,561,6162,251
2006,Urban,Madhya Pradesh,Crime Against Men,Robbery,Female,18-30,9620,3210,6410,9293,327
2005,Rural,Karnataka,Other Crimes,Fraud,Male,13-17,5023,939,4084,2394,2629
2010,Urban,Bihar,Crime Against Men,Assault,Female,13-17,2955,970,1985,2666,289
2003,Urban,Telangana,Property Crime,Burglary,Female,31-45,8717,7409,1308,8566,151
2001,Urban,Madhya Pradesh,Property Crime,Theft,Female,31-45,581,145,436,487,94
2003,Urban,Arunachal Pradesh,Other Crimes,Fraud,Female,46-60,3805,1090,2715,2634,1171
2009,Rural,Delhi,Crime Against Women,Domestic Violence,Male,0-12,9676,2901,6775,9535,141
2008,Rural,Chhattisgarh,Other Crimes,Corruption,Male,31-45,963,806,157,945,18
2001,Urban,Maharashtra,Crime Against Women,Molestation,Male,46-60,9524,618,8906,4203,5321
2008,Rural,Tamil Nadu,Other Crimes,Corruption,Female,18-30,9177,5729,3448,8377,800
2002,Rural,Sikkim,Crime Against Men,Robbery,Female,13-17,4243,178,4065,1782,2461
2010,Urban,Assam,Crime Against Men,Extortion,Male,13-17,1734,1128,606,1521,213
2003,Rural,Tamil Nadu,Crime Against Men,Extortion,Female,0-12,9565,4297,5268,4923,4642
2007,Urban,Tripura,Other Crimes,Cyber Crime,Male,46-60,4835,2104,2731,2656,2179
2001,Urban,Rajasthan,Crime Against Men,Extortion,Female,18-30,7415,514,6901,1090,6325
2009,Rural,Gujarat,Crime Against Women,Molestation,Male,46-60,2690,2628,62,2671,19
2002,Urban,Uttar Pradesh,Crime Against Women,Rape,Female,46-60,5251,236,5015,4261,990
2007,Urban,Uttar Pradesh,Other Crimes,Cyber Crime,Female,46-60,6676,1307,5369,4174,2502
2005,Urban,Sikkim,Crime Against Children,Kidnapping,Female,13-17,9438,7975,1463,8293,1145
2009,Rural,West Bengal,Crime Against Women,Dowry Deaths,Male,46-60,9534,3404,6130,5728,3806
2001,Urban,Haryana,Crime Against Men,Murder,Female,31-45,9783,9541,242,9752,31
2008,Urban,Arunachal Pradesh,Property Crime,Theft,Female,18-30,2426,1083,1343,1587,839
2010,Rural,Uttar Pradesh,Crime Against Women,Rape,Female,31-45,4478,1330,3148,2461,2017
2005,Rural,Himachal Pradesh,Crime Against Children,Child Abuse,Female,31-45,1846,372,1474,1198,648
2002,Rural,Uttar Pradesh,Other Crimes,Cyber Crime,Female,46-60,6637,3334,3303,4671,1966
2002,Rural,Kerala,Other Crimes,Corruption,Male,0-12,4992,3527,1465,4498,494
2002,Rural,Bihar,Crime Against Men,Extortion,Male,31-45,626,74,552,617,9
2002,Rural,Andhra Pradesh,Crime Against Men,Extortion,Female,13-17,5657,2915,2742,3493,2164
2007,Rural,Uttarakhand,Property Crime,Arson,Male,31-45,3747,3590,157,3716,31
2002,Rural,Jammu & Kashmir,Crime Against Children,Trafficking,Female,13-17,7129,1165,5964,4418,2711
2001,Rural,Tripura,Crime Against Men,Murder,Female,60+,167,77,90,103,64
2004,Urban,Jammu & Kashmir,Crime Against Men,Robbery,Male,60+,3072,1392,1680,1427,1645
2009,Urban,Meghalaya,Crime Against Women,Molestation,Male,46-60,7745,3927,3818,5454,2291
2005,Urban,Uttarakhand,Crime Against Women,Domestic Violence,Female,60+,6733,1017,5716,5375,1358
2004,Rural,Karnataka,Other Crimes,Corruption,Female,0-12,8871,3908,4963,7113,1758
2006,Rural,Kerala,Crime Against Men,Murder,Female,13-17,7653,69,7584,6821,832
2008,Urban,Assam,Property Crime,Theft,Female,13-17,3929,2727,1202,3043,886
2007,Urban,Uttar Pradesh,Crime Against Children,Child Abuse,Female,13-17,9518,8786,732,9376,142
2003,Urban,Odisha,Crime Against Men,Extortion,Female,18-30,5521,3051,2470,3110,2411
2001,Urban,Odisha,Crime Against Children,Kidnapping,Male,18-30,415,294,121,366,49
2005,Rural,Uttarakhand,Other Crimes,Cyber Crime,Male,46-60,4815,1935,2880,3399,1416
2010,Urban,Meghalaya,Crime Against Children,Child Abuse,Female,0-12,3693,1680,2013,3053,640
2004,Urban,Jammu & Kashmir,Property Crime,Arson,Female,60+,3784,2820,964,3497,287
2009,Urban,Maharashtra,Crime Against Women,Molestation,Male,46-60,9531,3868,5663,6132,3399
2007,Rural,Meghalaya,Other Crimes,Cyber Crime,Male,18-30,9748,4697,5051,7610,2138
2006,Rural,Sikkim,Property Crime,Vandalism,Female,31-45,1015,38,977,60,955
2003,Urban,Telangana,Crime Against Men,Murder,Male,31-45,6472,1575,4897,2906,3566
2005,Rural,Assam,Property Crime,Vandalism,Male,18-30,9957,7025,2932,7390,2567
2003,Rural,Madhya Pradesh,Other Crimes,Cyber Crime,Female,18-30,3829,3207,622,3543,286
2009,Rural,Karnataka,Crime Against Women,Dowry Deaths,Male,18-30,9385,2997,6388,8345,1040
2001,Urban,Punjab,Crime Against Men,Assault,Female,46-60,5548,4266,1282,4419,1129
2010,Urban,Goa,Crime Against Children,Child Abuse,Female,31-45,7446,1274,6172,4009,3437
2005,Urban,Tripura,Crime Against Women,Dowry Deaths,Male,0-12,976,286,690,768,208
2010,Urban,Jharkhand,Crime Against Children,Child Abuse,Male,13-17,5262,2685,2577,3327,1935
2001,Rural,Sikkim,Property Crime,Arson,Male,60+,1240,424,816,1103,137
2001,Rural,Rajasthan,Crime Against Children,Kidnapping,Female,31-45,3524,2070,1454,2396,1128
2010,Urban,Tamil Nadu,Other Crimes,Fraud,Male,31-45,3336,3235,101,3308,28
2005,Urban,Jharkhand,Crime Against Children,Child Abuse,Female,18-30,3171,2825,346,2920,251
2003,Rural,Nagaland,Crime Against Men,Murder,Female,31-45,7247,6868,379,6933,314
2003,Rural,Telangana,Other Crimes,Fraud,Female,60+,9827,5730,4097,8540,1287
2009,Urban,Karnataka,Property Crime,Theft,Female,60+,4089,2126,1963,3678,411
2004,Urban,Tamil Nadu,Crime Against Children,Trafficking,Male,18-30,9713,4483,5230,7411,2302
2001,Rural,Tamil Nadu,Other Crimes,Drug Offense,Male,31-45,7404,1694,5710,6567,837
2004,Rural,Karnataka,Property Crime,Vandalism,Female,0-12,5638,5580,58,5622,16
2004,Urban,Tripura,Crime Against Women,Dowry Deaths,Male,18-30,5230,4386,844,5066,164
2004,Rural,Karnataka,Other Crimes,Fraud,Female,31-45,3257,2787,470,3138,119
2009,Rural,Odisha,Crime Against Women,Domestic Violence,Female,46-60,4598,2379,2219,3580,1018
2005,Urban,Sikkim,Crime Against Men,Extortion,Male,60+,3286,1215,2071,1309,1977
2006,Rural,Chhattisgarh,Crime Against Women,Rape,Female,31-45,2306,2001,305,2177,129
2002,Rural,Arunachal Pradesh,Crime Against Children,Child Labor,Female,46-60,670,65,605,539,131
2010,Urban,Rajasthan,Property Crime,Burglary,Male,18-30,3890,3560,330,3703,187
2006,Urban,Meghalaya,Property Crime,Theft,Male,60+,6025,846,5179,2618,3407
2003,Urban,Maharashtra,Crime Against Children,Trafficking,Male,13-17,8517,1389,7128,4763,3754
2005,Rural,Meghalaya,Crime Against Men,Extortion,Female,46-60,5436,3864,1572,4670,766
2008,Rural,Telangana,Property Crime,Arson,Male,13-17,1690,998,692,1335,355
2006,Rural,Kerala,Crime Against Men,Extortion,Female,60+,4706,1332,3374,2654,2052
2007,Urban,Nagaland,Other Crimes,Cyber Crime,Female,60+,9033,8213,820,8453,580
2009,Rural,Madhya Pradesh,Crime Against Men,Assault,Male,13-17,2176,269,1907,1168,1008
2006,Rural,Karnataka,Crime Against Women,Domestic Violence,Female,0-12,712,453,259,702,10
2005,Rural,Delhi,Crime Against Children,Trafficking,Female,46-60,6665,6000,665,6387,278
2006,Urban,Maharashtra,Crime Against Men,Murder,Male,46-60,5480,1348,4132,4055,1425
2001,Rural,Telangana,Crime Against Children,Child Labor,Female,31-45,4755,1448,3307,3342,1413
2001,Urban,Maharashtra,Other Crimes,Fraud,Male,31-45,3687,71,3616,1517,2170
2004,Rural,Gujarat,Property Crime,Arson,Male,60+,8366,749,7617,7393,973
2002,Urban,Delhi,Crime Against Children,Trafficking,Female,18-30,216,141,75,141,75
2010,Rural,Punjab,Crime Against Men,Robbery,Female,60+,8785,2213,6572,7573,1212
2008,Urban,Kerala,Crime Against Women,Rape,Male,18-30,6949,4510,2439,5559,1390
2008,Urban,Odisha,Crime Against Children,Kidnapping,Male,13-17,3676,2866,810,3615,61
2007,Rural,Gujarat,Crime Against Men,Extortion,Male,18-30,9940,8062,1878,8277,1663
2007,Rural,Karnataka,Crime Against Men,Extortion,Male,31-45,1912,1781,131,1895,17
2002,Urban,Karnataka,Other Crimes,Cyber Crime,Female,60+,6832,1581,5251,2705,4127
2010,Urban,Manipur,Crime Against Children,Trafficking,Female,31-45,7992,7004,988,7027,965
2009,Rural,Sikkim,Crime Against Children,Trafficking,Female,13-17,1666,1626,40,1657,9
2006,Rural,Haryana,Crime Against Women,Domestic Violence,Female,13-17,7095,6947,148,7007,88
2003,Urban,Delhi,Crime Against Children,Child Abuse,Female,46-60,4024,3666,358,3787,237
2010,Rural,Himachal Pradesh,Crime Against Men,Murder,Female,31-45,9344,2229,7115,8640,704
2009,Urban,Karnataka,Crime Against Women,Domestic Violence,Female,18-30,8347,1115,7232,2841,5506
2008,Rural,Uttarakhand,Crime Against Children,Trafficking,Female,18-30,6919,1651,5268,2378,4541
2002,Rural,Uttarakhand,Property Crime,Arson,Female,31-45,8170,5067,3103,6344,1826
2008,Rural,Mizoram,Property Crime,Arson,Male,0-12,2938,1098,1840,1178,1760
2009,Rural,Arunachal Pradesh,Property Crime,Arson,Female,31-45,2780,947,1833,2224,556
2007,Urban,West Bengal,Crime Against Women,Dowry Deaths,Female,46-60,2067,1874,193,1947,120
2007,Rural,Jharkhand,Other Crimes,Cyber Crime,Female,46-60,5037,1664,3373,4135,902
2003,Rural,Haryana,Crime Against Children,Child Labor,Male,18-30,3979,843,3136,988,2991
2009,Urban,Tripura,Property Crime,Vandalism,Female,46-60,2732,446,2286,2185,547
2004,Rural,Goa,Crime Against Men,Robbery,Female,0-12,9995,7892,2103,8691,1304
2004,Rural,Arunachal Pradesh,Crime Against Children,Child Labor,Female,60+,4056,2049,2007,2128,1928
2006,Rural,Chhattisgarh,Crime Against Women,Rape,Male,0-12,6301,2363,3938,4018,2283
2008,Rural,Meghalaya,Crime Against Women,Rape,Female,60+,9625,5752,3873,7379,2246
2001,Urban,Uttar Pradesh,Property Crime,Burglary,Female,13-17,4236,2011,2225,2037,2199
2008,Urban,Sikkim,Property Crime,Vandalism,Female,46-60,4733,428,4305,2341,2392
2002,Rural,Mizoram,Other Crimes,Fraud,Female,60+,6549,5474,1075,5804,745
2002,Rural,Bihar,Crime Against Men,Extortion,Male,0-12,6359,2798,3561,4227,2132
2008,Rural,Gujarat,Property Crime,Burglary,Female,31-45,6396,4412,1984,4709,1687
2007,Rural,Rajasthan,Property Crime,Arson,Female,46-60,7192,4858,2334,5108,2084
2009,Urban,Telangana,Property Crime,Burglary,Male,31-45,4382,2852,1530,4143,239
2004,Urban,Karnataka,Crime Against Men,Robbery,Female,46-60,2243,1973,270,2160,83
2001,Rural,Punjab,Property Crime,Vandalism,Female,18-30,4591,3128,1463,3306,1285
2004,Urban,Odisha,Other Crimes,Drug Offense,Male,31-45,8286,7305,981,8038,248
2010,Urban,Arunachal Pradesh,Crime Against Men,Murder,Female,46-60,3861,223,3638,919,2942
2004,Urban,Uttarakhand,Crime Against Women,Molestation,Female,31-45,3531,2691,840,3496,35
2008,Rural,Chhattisgarh,Crime Against Men,Assault,Female,60+,9866,6437,3429,7659,2207
2009,Urban,Tamil Nadu,Crime Against Women,Dowry Deaths,Female,60+,6626,3333,3293,6108,518
2007,Urban,West Bengal,Crime Against Children,Child Abuse,Female,31-45,6066,284,5782,4364,1702
2007,Rural,Telangana,Crime Against Children,Child Labor,Male,13-17,8832,7791,1041,8759,73
2008,Rural,Uttar Pradesh,Crime Against Children,Kidnapping,Male,18-30,5329,2039,3290,2859,2470
2004,Rural,Sikkim,Property Crime,Vandalism,Male,46-60,4165,407,3758,1234,2931
2007,Urban,Arunachal Pradesh,Property Crime,Vandalism,Female,0-12,3788,757,3031,2907,881
2009,Urban,Jammu & Kashmir,Crime Against Children,Child Abuse,Female,60+,5546,4287,1259,4749,797
2007,Rural,Maharashtra,Crime Against Men,Assault,Male,18-30,4546,1206,3340,2469,2077
2003,Urban,Uttarakhand,Crime Against Men,Robbery,Male,13-17,8462,7195,1267,7776,686
2002,Urban,Himachal Pradesh,Other Crimes,Corruption,Female,13-17,3547,1182,2365,3431,116
2004,Urban,Himachal Pradesh,Crime Against Children,Child Abuse,Male,0-12,3598,964,2634,3201,397
2005,Rural,Tamil Nadu,Crime Against Women,Domestic Violence,Female,13-17,123,81,42,121,2
2009,Rural,West Bengal,Crime Against Women,Domestic Violence,Male,13-17,6054,4605,1449,4622,1432
2003,Rural,Goa,Other Crimes,Drug Offense,Male,60+,3894,3186,708,3692,202
2008,Urban,Arunachal Pradesh,Property Crime,Arson,Male,31-45,5597,4856,741,5445,152
2005,Urban,Chhattisgarh,Crime Against Men,Assault,Female,31-45,2883,1456,1427,2380,503
2001,Urban,Nagaland,Crime Against Women,Dowry Deaths,Male,13-17,4690,679,4011,2254,2436
2008,Rural,Andhra Pradesh,Crime Against Men,Robbery,Female,46-60,2057,761,1296,969,1088
2001,Urban,Assam,Crime Against Men,Robbery,Female,46-60,2817,109,2708,892,1925
2003,Urban,Punjab,Crime Against Women,Molestation,Male,46-60,4801,2357,2444,2507,2294
2007,Urban,Uttar Pradesh,Crime Against Men,Robbery,Male,60+,1266,121,1145,926,340
2007,Urban,Arunachal Pradesh,Crime Against Men,Robbery,Female,60+,9774,9659,115,9756,18
2001,Rural,Rajasthan,Crime Against Children,Trafficking,Male,31-45,52,44,8,48,4
2001,Rural,Tripura,Property Crime,Vandalism,Female,13-17,6313,2807,3506,6098,215
2001,Rural,Rajasthan,Other Crimes,Drug Offense,Female,0-12,4853,2760,2093,3307,1546
2008,Urban,Telangana,Property Crime,Theft,Female,0-12,6556,4603,1953,5196,1360
2004,Rural,Jharkhand,Crime Against Men,Assault,Male,46-60,9324,6500,2824,8119,1205
2001,Urban,Sikkim,Crime Against Men,Robbery,Female,0-12,2858,994,1864,1054,1804
2001,Rural,Bihar,Crime Against Men,Assault,Female,13-17,8866,5518,3348,6220,2646
2001,Rural,Odisha,Property Crime,Arson,Female,18-30,8882,8380,502,8584,298
2008,Urban,Telangana,Other Crimes,Fraud,Male,13-17,6337,4625,1712,5669,668
2005,Rural,Himachal Pradesh,Crime Against Men,Robbery,Female,0-12,650,192,458,523,127
2007,Urban,Mizoram,Other Crimes,Fraud,Male,31-45,5420,626,4794,4128,1292
2008,Rural,Odisha,Property Crime,Arson,Female,60+,4007,2627,1380,3743,264
2005,Rural,Chhattisgarh,Crime Against Children,Child Abuse,Male,13-17,5273,4524,749,4664,609
2009,Urban,Uttar Pradesh,Crime Against Children,Child Labor,Male,13-17,4063,1131,2932,1721,2342
2001,Rural,Telangana,Crime Against Children,Trafficking,Male,46-60,2603,253,2350,2401,202
2010,Rural,Goa,Crime Against Children,Child Abuse,Male,13-17,1569,1126,443,1211,358
2010,Urban,Kerala,Crime Against Women,Rape,Male,46-60,2937,927,2010,1722,1215
2009,Urban,Sikkim,Crime Against Women,Molestation,Female,60+,5850,1252,4598,3027,2823
2002,Rural,Meghalaya,Property Crime,Arson,Female,13-17,6196,1088,5108,5601,595
2007,Rural,Punjab,Crime Against Men,Extortion,Female,31-45,1125,624,501,1000,125
2009,Urban,Mizoram,Property Crime,Theft,Female,31-45,3724,3130,594,3461,263
2001,Urban,Jammu & Kashmir,Crime Against Women,Rape,Male,18-30,8077,528,7549,2948,5129
2003,Urban,Mizoram,Other Crimes,Fraud,Female,46-60,9819,2268,7551,9321,498
2009,Rural,Uttar Pradesh,Property Crime,Arson,Female,46-60,6194,2780,3414,2859,3335
2007,Rural,Jammu & Kashmir,Crime Against Women,Molestation,Female,13-17,7510,3428,4082,6250,1260
2009,Urban,Rajasthan,Property Crime,Arson,Female,18-30,6306,4188,2118,5145,1161
2004,Rural,Karnataka,Property Crime,Theft,Male,0-12,8100,6884,1216,7173,927
2009,Urban,Gujarat,Other Crimes,Drug Offense,Female,13-17,2949,19,2930,210,2739
2005,Rural,Haryana,Other Crimes,Cyber Crime,Female,60+,745,241,504,453,292
2002,Rural,Arunachal Pradesh,Other Crimes,Corruption,Female,18-30,1111,408,703,677,434
2004,Urban,Arunachal Pradesh,Crime Against Men,Extortion,Male,46-60,2260,827,1433,1367,893
2001,Rural,Madhya Pradesh,Property Crime,Arson,Female,60+,8728,39,8689,5758,2970
2002,Urban,Assam,Other Crimes,Drug Offense,Male,60+,8810,322,8488,2263,6547
2008,Urban,Manipur,Crime Against Men,Robbery,Male,13-17,6710,5876,834,6235,475
2010,Rural,Andhra Pradesh,Crime Against Men,Extortion,Male,0-12,8174,1106,7068,6972,1202
2005,Rural,Punjab,Property Crime,Arson,Male,46-60,913,631,282,831,82
2010,Urban,Nagaland,Crime Against Children,Kidnapping,Female,13-17,4838,1869,2969,3857,981
2010,Urban,Delhi,Crime Against Men,Assault,Male,0-12,5374,4754,620,5004,370
2008,Rural,Manipur,Crime Against Children,Trafficking,Female,13-17,2021,733,1288,1661,360
2002,Rural,Meghalaya,Crime Against Men,Assault,Female,0-12,8183,3691,4492,7945,238
2008,Urban,Jharkhand,Crime Against Children,Child Abuse,Male,18-30,7433,5027,2406,5522,1911
2006,Rural,Karnataka,Crime Against Women,Rape,Male,0-12,7630,6707,923,6812,818
2004,Rural,Nagaland,Other Crimes,Corruption,Female,60+,3088,2419,669,2819,269
2006,Urban,Telangana,Crime Against Women,Molestation,Male,60+,1585,515,1070,1239,346
2001,Rural,Maharashtra,Crime Against Women,Dowry Deaths,Female,31-45,6855,5763,1092,6091,764
2008,Rural,Goa,Crime Against Men,Extortion,Female,60+,5999,3817,2182,5739,260
2003,Rural,Arunachal Pradesh,Other Crimes,Drug Offense,Male,60+,5847,1293,4554,4563,1284
2005,Urban,Madhya Pradesh,Crime Against Women,Molestation,Male,60+,852,551,301,563,289
2002,Rural,Haryana,Crime Against Women,Molestation,Male,46-60,8130,1791,6339,5581,2549
2007,Rural,Assam,Other Crimes,Fraud,Female,60+,928,787,141,806,122
2005,Urban,Uttar Pradesh,Property Crime,Burglary,Male,60+,7577,4611,2966,6770,807
2007,Rural,Jharkhand,Crime Against Children,Child Labor,Female,18-30,9278,4487,4791,8511,767
2005,Rural,Tripura,Other Crimes,Cyber Crime,Female,60+,6304,3042,3262,3444,2860
2001,Rural,Rajasthan,Property Crime,Theft,Female,46-60,4480,1224,3256,2507,1973
2010,Urban,Rajasthan,Property Crime,Burglary,Female,31-45,5539,4040,1499,4910,629
2006,Rural,Jharkhand,Other Crimes,Fraud,Female,18-30,53,51,2,52,1
2006,Urban,Goa,Crime Against Women,Rape,Female,13-17,5959,2209,3750,2422,3537
2004,Urban,West Bengal,Crime Against Children,Child Abuse,Female,31-45,990,219,771,572,418
2010,Rural,Jharkhand,Other Crimes,Corruption,Male,0-12,4140,3958,182,4037,103
2010,Urban,Sikkim,Crime Against Women,Dowry Deaths,Male,13-17,9527,2738,6789,9380,147
2003,Rural,Punjab,Property Crime,Vandalism,Male,60+,2906,2509,397,2752,154
2005,Rural,Meghalaya,Crime Against Men,Robbery,Female,0-12,7642,3614,4028,6371,1271
2002,Rural,Delhi,Other Crimes,Cyber Crime,Male,60+,9643,9607,36,9624,19
2002,Urban,Bihar,Crime Against Women,Domestic Violence,Female,13-17,7313,5424,1889,5470,1843
2008,Urban,Karnataka,Crime Against Men,Assault,Male,0-12,4290,2719,1571,3129,1161
2005,Urban,Chhattisgarh,Crime Against Men,Extortion,Male,31-45,5246,4660,586,4922,324
2009,Urban,Sikkim,Crime Against Children,Child Abuse,Male,0-12,8977,7750,1227,8580,397
2008,Urban,Kerala,Crime Against Men,Assault,Male,60+,4478,4171,307,4326,152
2005,Rural,Odisha,Other Crimes,Cyber Crime,Female,60+,2199,731,1468,1824,375
2008,Rural,Gujarat,Crime Against Men,Murder,Male,0-12,4294,898,3396,2688,1606
2009,Rural,Andhra Pradesh,Crime Against Women,Domestic Violence,Female,18-30,8693,5858,2835,6393,2300
2008,Urban,Goa,Crime Against Children,Trafficking,Male,60+,1061,194,867,642,419
2005,Rural,Punjab,Crime Against Women,Dowry Deaths,Male,60+,6734,3790,2944,6446,288
2010,Rural,Andhra Pradesh,Crime Against Women,Molestation,Female,0-12,4668,1546,3122,1763,2905
2009,Rural,Manipur,Crime Against Men,Murder,Female,31-45,220,197,23,212,8
2008,Urban,Punjab,Crime Against Children,Kidnapping,Female,60+,8457,3294,5163,5721,2736
2008,Rural,Gujarat,Other Crimes,Corruption,Female,60+,1394,786,608,981,413
2010,Rural,West Bengal,Property Crime,Vandalism,Female,13-17,2502,2142,360,2377,125
2002,Rural,Jammu & Kashmir,Crime Against Women,Domestic Violence,Female,13-17,1939,1541,398,1774,165
2004,Urban,Assam,Crime Against Men,Robbery,Female,13-17,7627,5161,2466,7320,307
2005,Urban,Arunachal Pradesh,Crime Against Women,Domestic Violence,Male,46-60,1518,405,1113,726,792
2001,Rural,Tripura,Other Crimes,Cyber Crime,Male,0-12,7722,6956,766,7586,136
2009,Rural,Uttarakhand,Other Crimes,Fraud,Female,0-12,7150,2220,4930,2312,4838
2001,Urban,Maharashtra,Property Crime,Burglary,Female,18-30,5793,5008,785,5423,370
2004,Rural,Tamil Nadu,Crime Against Women,Rape,Male,18-30,2972,2706,266,2916,56
2004,Urban,Tamil Nadu,Crime Against Women,Dowry Deaths,Male,31-45,2172,1056,1116,1684,488
2009,Urban,Assam,Crime Against Men,Assault,Female,18-30,5546,3783,1763,4025,1521
2009,Rural,Telangana,Other Crimes,Drug Offense,Female,18-30,1734,1366,368,1695,39
2003,Rural,Mizoram,Crime Against Women,Rape,Female,60+,2120,973,1147,2109,11
2004,Rural,Nagaland,Other Crimes,Cyber Crime,Male,18-30,1347,1153,194,1182,165
2008,Urban,Odisha,Crime Against Women,Domestic Violence,Female,31-45,9894,4994,4900,9587,307
2002,Urban,Nagaland,Property Crime,Vandalism,Male,60+,880,526,354,567,313
2008,Urban,Chhattisgarh,Crime Against Women,Domestic Violence,Female,60+,1412,1225,187,1362,50
2007,Urban,Jharkhand,Other Crimes,Fraud,Female,46-60,5416,1597,3819,5041,375
2007,Urban,West Bengal,Crime Against Women,Domestic Violence,Female,60+,3398,2901,497,3250,148
2010,Rural,Maharashtra,Other Crimes,Corruption,Female,31-45,4829,2439,2390,2861,1968
2002,Rural,Mizoram,Crime Against Men,Robbery,Male,18-30,9143,5455,3688,7687,1456
2003,Urban,Arunachal Pradesh,Crime Against Children,Child Abuse,Female,13-17,4800,270,4530,3693,1107
2009,Urban,Andhra Pradesh,Other Crimes,Drug Offense,Male,18-30,4691,2284,2407,4581,110
2009,Urban,Jammu & Kashmir,Other Crimes,Drug Offense,Male,60+,6803,5379,1424,5484,1319
2004,Rural,Gujarat,Crime Against Women,Domestic Violence,Female,60+,2887,2034,853,2383,504
2007,Urban,Chhattisgarh,Other Crimes,Corruption,Male,60+,6567,3746,2821,5904,663
2009,Urban,Maharashtra,Other Crimes,Cyber Crime,Female,60+,4801,205,4596,3900,901
2005,Rural,Rajasthan,Crime Against Women,Molestation,Male,0-12,6283,1044,5239,5411,872
2009,Rural,Haryana,Crime Against Children,Child Abuse,Male,46-60,8774,677,8097,7256,1518
2005,Urban,Odisha,Property Crime,Vandalism,Female,31-45,3312,808,2504,2896,416
2010,Rural,Meghalaya,Crime Against Men,Robbery,Female,60+,819,680,139,753,66
2005,Urban,Kerala,Other Crimes,Cyber Crime,Male,60+,3905,3861,44,3865,40
2007,Urban,Mizoram,Property Crime,Theft,Female,46-60,8909,7429,1480,7920,989
2008,Urban,Bihar,Crime Against Men,Murder,Male,0-12,7873,3844,4029,5180,2693
2001,Urban,Telangana,Crime Against Women,Domestic Violence,Female,31-45,1988,646,1342,899,1089
2001,Urban,Karnataka,Other Crimes,Corruption,Female,0-12,2054,165,1889,187,1867
2006,Urban,Madhya Pradesh,Crime Against Men,Robbery,Male,0-12,142,58,84,141,1
2005,Rural,Maharashtra,Property Crime,Burglary,Male,31-45,1230,930,300,973,257
2003,Rural,Goa,Crime Against Children,Child Labor,Female,18-30,8337,5148,3189,7561,776
2003,Rural,Telangana,Other Crimes,Drug Offense,Female,18-30,2465,1289,1176,1387,1078
2003,Urban,Odisha,Crime Against Children,Trafficking,Male,13-17,3793,613,3180,1951,1842
2001,Urban,Mizoram,Crime Against Men,Robbery,Male,46-60,8780,5073,3707,6652,2128
2004,Rural,Gujarat,Other Crimes,Corruption,Female,60+,224,77,147,150,74
2002,Urban,Nagaland,Crime Against Children,Trafficking,Female,46-60,8709,7808,901,8337,372
2009,Rural,Meghalaya,Crime Against Men,Extortion,Male,46-60,4141,1269,2872,2309,1832
2008,Urban,Maharashtra,Crime Against Men,Robbery,Male,18-30,5869,805,5064,2261,3608
2010,Rural,Uttar Pradesh,Crime Against Women,Molestation,Male,13-17,6407,3518,2889,4115,2292
2004,Urban,Jammu & Kashmir,Crime Against Children,Trafficking,Female,18-30,3454,2342,1112,3277,177
2009,Urban,Karnataka,Crime Against Women,Molestation,Male,18-30,1226,363,863,1170,56
2002,Rural,Sikkim,Crime Against Children,Trafficking,Female,13-17,9320,7039,2281,7953,1367
2005,Rural,Madhya Pradesh,Property Crime,Arson,Female,60+,7424,4641,2783,6886,538
2004,Urban,Jharkhand,Crime Against Men,Robbery,Female,60+,2760,2440,320,2585,175
2003,Rural,Goa,Property Crime,Burglary,Male,13-17,3357,1528,1829,2325,1032
2001,Rural,West Bengal,Crime Against Women,Domestic Violence,Female,60+,9370,4148,5222,4253,5117
2010,Rural,Sikkim,Crime Against Men,Extortion,Male,13-17,9362,3384,5978,7605,1757
2003,Rural,Mizoram,Other Crimes,Fraud,Male,31-45,5135,1719,3416,4877,258
2001,Urban,Goa,Property Crime,Vandalism,Female,13-17,3663,2983,680,3135,528
2001,Urban,Himachal Pradesh,Crime Against Children,Child Abuse,Female,0-12,8904,5207,3697,6890,2014
2009,Urban,Mizoram,Crime Against Children,Child Labor,Male,0-12,7085,178,6907,609,6476
2005,Rural,Andhra Pradesh,Crime Against Children,Trafficking,Female,18-30,1168,197,971,933,235
2006,Urban,Maharashtra,Crime Against Children,Trafficking,Female,46-60,8309,5494,2815,6925,1384
2001,Rural,Meghalaya,Crime Against Children,Child Labor,Male,0-12,2783,52,2731,2226,557
2009,Urban,Gujarat,Property Crime,Vandalism,Male,13-17,6362,189,6173,2597,3765
2005,Rural,Chhattisgarh,Property Crime,Vandalism,Male,13-17,337,86,251,275,62
2002,Urban,Haryana,Crime Against Men,Robbery,Female,31-45,7845,852,6993,2596,5249
2005,Urban,Uttar Pradesh,Crime Against Women,Domestic Violence,Male,13-17,9521,3304,6217,5107,4414
2003,Urban,Arunachal Pradesh,Crime Against Men,Assault,Female,60+,242,144,98,163,79
2008,Rural,West Bengal,Crime Against Men,Extortion,Male,46-60,741,250,491,513,228
2004,Rural,West Bengal,Crime Against Children,Trafficking,Female,46-60,4745,3941,804,4567,178
2007,Urban,Odisha,Other Crimes,Corruption,Male,31-45,1971,610,1361,698,1273
2001,Urban,Himachal Pradesh,Other Crimes,Cyber Crime,Male,18-30,596,196,400,389,207
2007,Urban,Kerala,Other Crimes,Drug Offense,Male,31-45,8141,3274,4867,6737,1404
2010,Urban,West Bengal,Crime Against Women,Molestation,Female,0-12,1538,985,553,1100,438
2004,Rural,Gujarat,Other Crimes,Cyber Crime,Female,18-30,1347,1011,336,1122,225
2009,Urban,Delhi,Crime Against Women,Molestation,Female,60+,7379,1038,6341,2500,4879
2001,Urban,Jammu & Kashmir,Other Crimes,Drug Offense,Female,18-30,5872,5655,217,5790,82
2010,Urban,Jammu & Kashmir,Property Crime,Arson,Male,31-45,3007,1877,1130,2421,586
2003,Urban,Tamil Nadu,Crime Against Children,Child Labor,Female,60+,9285,5895,3390,6672,2613
2007,Urban,Maharashtra,Crime Against Women,Rape,Male,31-45,3441,2284,1157,3008,433
2008,Urban,Gujarat,Other Crimes,Fraud,Female,60+,1423,1259,164,1269,154
2002,Urban,Uttarakhand,Crime Against Men,Assault,Male,13-17,3280,2352,928,3158,122
2003,Urban,Sikkim,Crime Against Men,Robbery,Male,46-60,9205,6125,3080,7548,1657
2008,Urban,Manipur,Crime Against Children,Child Labor,Male,31-45,9651,1663,7988,7097,2554
2007,Urban,Bihar,Crime Against Men,Murder,Male,46-60,9923,3182,6741,4807,5116
2001,Urban,Haryana,Crime Against Women,Dowry Deaths,Male,31-45,5856,3877,1979,4416,1440
2004,Rural,Kerala,Crime Against Women,Molestation,Male,31-45,8424,1515,6909,4321,4103
2010,Rural,West Bengal,Crime Against Women,Dowry Deaths,Male,13-17,8318,4336,3982,4687,3631
2003,Urban,Tripura,Crime Against Women,Rape,Male,18-30,5967,3628,2339,4574,1393
2010,Rural,Maharashtra,Crime Against Men,Assault,Female,13-17,2255,1050,1205,1767,488
2005,Urban,Andhra Pradesh,Crime Against Men,Assault,Female,31-45,5478,57,5421,4701,777
2001,Urban,Gujarat,Property Crime,Burglary,Male,46-60,4051,3751,300,3994,57
2009,Urban,Chhattisgarh,Crime Against Children,Trafficking,Male,31-45,9422,6171,3251,8414,1008
2008,Urban,Sikkim,Property Crime,Arson,Male,13-17,8361,6061,2300,6645,1716
2004,Urban,Jammu & Kashmir,Property Crime,Theft,Male,31-45,2783,2614,169,2730,53
2004,Rural,Manipur,Property Crime,Arson,Male,18-30,3611,61,3550,795,2816
2010,Urban,Assam,Other Crimes,Drug Offense,Female,18-30,3464,302,3162,1184,2280
2006,Rural,Bihar,Crime Against Men,Assault,Female,13-17,3238,1353,1885,2486,752
2004,Rural,Andhra Pradesh,Other Crimes,Drug Offense,Female,18-30,8613,948,7665,6124,2489
2009,Rural,Delhi,Crime Against Women,Rape,Female,46-60,6311,4850,1461,5211,1100
2009,Urban,Sikkim,Other Crimes,Fraud,Male,18-30,1303,1145,158,1261,42
2005,Rural,Karnataka,Property Crime,Vandalism,Female,13-17,7692,4332,3360,7544,148
2003,Rural,Bihar,Other Crimes,Cyber Crime,Male,46-60,2362,657,1705,2069,293
2008,Rural,Rajasthan,Crime Against Children,Kidnapping,Male,18-30,3054,2972,82,3048,6
2005,Urban,Punjab,Crime Against Women,Domestic Violence,Male,31-45,1733,664,1069,1006,727
2001,Urban,Telangana,Crime Against Women,Domestic Violence,Male,60+,8323,8194,129,8284,39
2008,Urban,Tripura,Other Crimes,Fraud,Male,60+,8112,2977,5135,5911,2201
2003,Urban,Telangana,Crime Against Women,Domestic Violence,Male,18-30,9986,5611,4375,8814,1172
2006,Rural,Tamil Nadu,Crime Against Men,Robbery,Female,31-45,7849,3091,4758,5594,2255
2002,Rural,Uttarakhand,Crime Against Women,Rape,Female,0-12,3069,2334,735,2979,90
2010,Urban,Gujarat,Other Crimes,Cyber Crime,Male,31-45,8169,8137,32,8147,22
2008,Urban,Himachal Pradesh,Other Crimes,Drug Offense,Male,46-60,9419,1595,7824,8053,1366
2001,Rural,Karnataka,Crime Against Women,Molestation,Female,60+,9031,2121,6910,6816,2215
2001,Rural,Andhra Pradesh,Crime Against Men,Murder,Female,46-60,3896,994,2902,3054,842
2009,Rural,Madhya Pradesh,Property Crime,Theft,Male,0-12,2903,1628,1275,2850,53
2006,Urban,Odisha,Crime Against Men,Robbery,Male,18-30,1881,1686,195,1832,49
2005,Urban,Gujarat,Crime Against Men,Murder,Female,46-60,3712,2079,1633,3689,23
2004,Rural,Telangana,Other Crimes,Cyber Crime,Male,31-45,8590,7935,655,8508,82
2009,Urban,Tripura,Crime Against Children,Child Labor,Male,18-30,6202,1390,4812,2938,3264
2008,Urban,Nagaland,Crime Against Children,Child Labor,Female,13-17,3355,894,2461,1283,2072
2005,Rural,Mizoram,Other Crimes,Corruption,Male,31-45,4340,3864,476,4302,38
2002,Rural,Delhi,Other Crimes,Cyber Crime,Male,0-12,5823,1675,4148,1716,4107
2006,Urban,Uttar Pradesh,Crime Against Children,Child Labor,Female,31-45,1625,1455,170,1613,12
2008,Rural,Telangana,Crime Against Men,Extortion,Male,60+,1001,556,445,917,84
2006,Rural,Arunachal Pradesh,Crime Against Children,Child Abuse,Male,31-45,4956,1324,3632,2436,2520
2010,Rural,Bihar,Crime Against Children,Trafficking,Male,18-30,5240,1161,4079,4825,415
2010,Rural,Kerala,Property Crime,Theft,Male,60+,3433,2933,500,3112,321
2009,Rural,Goa,Crime Against Women,Molestation,Female,18-30,2459,2293,166,2352,107
2003,Rural,Jammu & Kashmir,Crime Against Women,Domestic Violence,Male,46-60,9452,8611,841,9189,263
2006,Urban,Rajasthan,Crime Against Men,Murder,Male,18-30,4267,333,3934,2244,2023
2002,Urban,Maharashtra,Crime Against Children,Trafficking,Male,31-45,5826,1144,4682,4712,1114
2008,Urban,Uttarakhand,Crime Against Women,Rape,Female,46-60,7485,3511,3974,4265,3220
2006,Rural,Maharashtra,Property Crime,Vandalism,Female,60+,5991,5128,863,5255,736
2002,Urban,Assam,Property Crime,Theft,Male,0-12,6054,5674,380,5767,287
2006,Urban,Uttar Pradesh,Crime Against Women,Rape,Male,13-17,6757,3103,3654,3795,2962
2001,Urban,Tamil Nadu,Crime Against Women,Dowry Deaths,Male,46-60,5739,2748,2991,4565,1174
2001,Urban,Mizoram,Other Crimes,Cyber Crime,Female,31-45,2260,907,1353,1303,957
2009,Rural,Chhattisgarh,Property Crime,Vandalism,Male,60+,708,625,83,689,19
2006,Rural,Odisha,Crime Against Men,Murder,Female,31-45,3854,2289,1565,3817,37
2009,Urban,Delhi,Crime Against Men,Murder,Female,0-12,7402,495,6907,6378,1024
2007,Urban,Bihar,Crime Against Children,Child Labor,Male,13-17,2780,2438,342,2759,21
2009,Rural,Sikkim,Other Crimes,Corruption,Male,31-45,5216,3024,2192,4325,891
2005,Rural,Himachal Pradesh,Other Crimes,Drug Offense,Female,0-12,9108,5981,3127,9039,69
2005,Rural,Jharkhand,Crime Against Children,Kidnapping,Male,0-12,7002,2187,4815,4332,2670
2009,Rural,Jharkhand,Crime Against Women,Molestation,Male,31-45,549,9,540,166,383
2009,Urban,Punjab,Property Crime,Vandalism,Male,60+,4014,1396,2618,2430,1584
2008,Urban,Manipur,Crime Against Women,Rape,Male,31-45,4358,440,3918,2313,2045
2003,Rural,Himachal Pradesh,Crime Against Men,Robbery,Female,46-60,4461,3294,1167,3496,965
2008,Rural,Haryana,Crime Against Women,Dowry Deaths,Female,0-12,4861,968,3893,2638,2223
2010,Urban,Jharkhand,Crime Against Women,Molestation,Female,18-30,481,129,352,166,315
2002,Rural,Tripura,Crime Against Children,Trafficking,Male,31-45,6622,3490,3132,4077,2545
2007,Rural,Madhya Pradesh,Other Crimes,Drug Offense,Male,60+,5224,1562,3662,1804,3420
2007,Rural,Maharashtra,Crime Against Women,Rape,Male,46-60,157,99,58,136,21
2001,Rural,Tripura,Crime Against Men,Assault,Male,13-17,8252,7469,783,7589,663
2001,Rural,Punjab,Crime Against Men,Assault,Female,46-60,2064,608,1456,1065,999
2005,Urban,Uttarakhand,Other Crimes,Fraud,Female,0-12,8636,6684,1952,7979,657
2006,Rural,Tamil Nadu,Crime Against Women,Molestation,Male,18-30,2979,261,2718,2192,787
2009,Urban,Madhya Pradesh,Crime Against Women,Domestic Violence,Female,60+,6559,4899,1660,5855,704
2001,Rural,Rajasthan,Crime Against Men,Murder,Male,31-45,7828,4331,3497,7582,246
2001,Rural,Himachal Pradesh,Property Crime,Burglary,Female,31-45,7764,3837,3927,5995,1769
2002,Urban,Delhi,Crime Against Women,Molestation,Female,46-60,2199,966,1233,1035,1164
2009,Rural,Nagaland,Crime Against Children,Child Abuse,Female,18-30,8249,5052,3197,6876,1373
2008,Urban,Nagaland,Crime Against Men,Assault,Female,60+,5156,1273,3883,4697,459
2010,Rural,Karnataka,Crime Against Children,Trafficking,Male,31-45,883,819,64,854,29
2002,Rural,Punjab,Property Crime,Vandalism,Female,0-12,1414,1068,346,1235,179
2008,Rural,Assam,Crime Against Men,Assault,Male,60+,4085,1410,2675,2482,1603
2002,Rural,Maharashtra,Crime Against Children,Child Labor,Female,0-12,6935,4013,2922,4029,2906
2010,Rural,Meghalaya,Crime Against Children,Trafficking,Male,0-12,753,44,709,653,100
2008,Urban,Himachal Pradesh,Crime Against Women,Molestation,Female,0-12,9157,6544,2613,6634,2523
2004,Rural,Andhra Pradesh,Property Crime,Arson,Female,0-12,6266,3876,2390,5212,1054
2010,Urban,Kerala,Property Crime,Arson,Female,46-60,4217,367,3850,2730,1487
2001,Urban,Maharashtra,Property Crime,Theft,Male,60+,6796,5813,983,6671,125
2001,Rural,Tamil Nadu,Crime Against Men,Robbery,Female,60+,6163,6049,114,6095,68
2009,Urban,Tripura,Crime Against Children,Trafficking,Male,18-30,9666,3120,6546,5308,4358
2004,Urban,Tamil Nadu,Crime Against Women,Rape,Male,13-17,3221,485,2736,1670,1551
2002,Urban,Chhattisgarh,Other Crimes,Fraud,Female,60+,9774,3956,5818,5210,4564
2003,Urban,Assam,Crime Against Men,Extortion,Male,0-12,4395,3231,1164,3391,1004
2001,Urban,Bihar,Crime Against Women,Dowry Deaths,Female,46-60,5428,1233,4195,5225,203
2005,Rural,Manipur,Crime Against Children,Child Labor,Female,60+,5195,1228,3967,4789,406
2008,Urban,Gujarat,Crime Against Women,Dowry Deaths,Female,13-17,385,85,300,304,81
2001,Rural,Assam,Crime Against Women,Dowry Deaths,Female,0-12,1172,354,818,1136,36
2003,Rural,Tamil Nadu,Crime Against Children,Child Abuse,Female,60+,6966,4920,2046,5604,1362
2007,Rural,Maharashtra,Crime Against Women,Molestation,Female,31-45,2101,1823,278,1894,207
2005,Urban,Maharashtra,Other Crimes,Fraud,Male,60+,7168,4192,2976,5403,1765
2010,Rural,Assam,Crime Against Children,Child Labor,Female,46-60,2065,2062,3,2063,2
2004,Rural,Uttarakhand,Crime Against Women,Molestation,Male,60+,1928,360,1568,1036,892
2010,Urban,Assam,Property Crime,Arson,Female,46-60,4033,359,3674,1084,2949
2001,Urban,Kerala,Crime Against Women,Molestation,Male,0-12,5145,3053,2092,4395,750
2002,Rural,Mizoram,Crime Against Children,Kidnapping,Male,13-17,5648,5044,604,5210,438
2010,Rural,Himachal Pradesh,Property Crime,Vandalism,Female,46-60,7970,5788,2182,7422,548
2008,Rural,Odisha,Crime Against Women,Molestation,Female,13-17,5809,205,5604,5434,375
2006,Urban,Punjab,Other Crimes,Corruption,Female,0-12,5296,2905,2391,3860,1436
2002,Rural,Uttar Pradesh,Other Crimes,Cyber Crime,Female,60+,2866,729,2137,2791,75
2002,Rural,Chhattisgarh,Crime Against Children,Child Labor,Female,18-30,9269,6170,3099,8868,401
2002,Urban,Telangana,Crime Against Men,Assault,Male,46-60,9825,1127,8698,4422,5403
2002,Urban,Punjab,Crime Against Men,Assault,Male,31-45,729,222,507,532,197
2001,Urban,Sikkim,Crime Against Children,Child Labor,Female,60+,5503,1151,4352,2830,2673
2004,Rural,Odisha,Crime Against Men,Robbery,Male,46-60,6339,2141,4198,4661,1678
2005,Urban,Jharkhand,Crime Against Women,Domestic Violence,Male,46-60,4758,4319,439,4667,91
2006,Urban,Madhya Pradesh,Crime Against Children,Child Labor,Female,31-45,1405,288,1117,513,892
2004,Urban,Chhattisgarh,Property Crime,Burglary,Female,60+,496,301,195,313,183
2006,Urban,Gujarat,Crime Against Women,Rape,Male,60+,2317,1067,1250,1520,797
2001,Rural,Madhya Pradesh,Crime Against Women,Molestation,Male,60+,9555,937,8618,1805,7750
2006,Rural,Uttarakhand,Crime Against Women,Molestation,Female,18-30,74,32,42,37,37
2007,Urban,Punjab,Crime Against Women,Rape,Female,18-30,9457,645,8812,7271,2186
2004,Urban,Assam,Property Crime,Burglary,Female,13-17,7768,1577,6191,1932,5836
2004,Urban,Kerala,Other Crimes,Drug Offense,Male,18-30,6942,4449,2493,6255,687
2008,Urban,Delhi,Property Crime,Arson,Male,0-12,5081,287,4794,4347,734
2009,Rural,Chhattisgarh,Crime Against Men,Robbery,Female,0-12,7969,3777,4192,7353,616
2010,Urban,Telangana,Crime Against Children,Trafficking,Female,13-17,208,143,65,202,6
2001,Urban,Madhya Pradesh,Crime Against Children,Child Abuse,Male,46-60,2741,169,2572,1023,1718
2005,Rural,Goa,Crime Against Men,Robbery,Male,31-45,9864,2367,7497,7291,2573
2002,Urban,Karnataka,Crime Against Women,Rape,Male,18-30,7027,1778,5249,5581,1446
2002,Rural,Nagaland,Crime Against Men,Murder,Male,0-12,6194,3599,2595,4849,1345
2007,Urban,Tamil Nadu,Other Crimes,Corruption,Female,46-60,8074,5020,3054,7435,639
2003,Rural,Chhattisgarh,Crime Against Men,Assault,Female,18-30,1859,1732,127,1837,22
2008,Urban,Tripura,Crime Against Men,Robbery,Male,0-12,4396,189,4207,3025,1371
2001,Urban,Bihar,Property Crime,Theft,Male,60+,4326,805,3521,1209,3117
2007,Rural,Meghalaya,Crime Against Women,Molestation,Female,46-60,9817,5900,3917,5931,3886
2010,Rural,Telangana,Other Crimes,Corruption,Female,18-30,7656,5728,1928,5773,1883
2001,Urban,Uttarakhand,Crime Against Men,Robbery,Female,18-30,860,579,281,591,269
2002,Urban,Haryana,Crime Against Children,Kidnapping,Female,46-60,2366,1570,796,1718,648
2010,Rural,Uttarakhand,Property Crime,Theft,Female,18-30,2972,1340,1632,1784,1188
2001,Urban,Karnataka,Property Crime,Arson,Female,46-60,9561,1807,7754,4653,4908
2002,Rural,Meghalaya,Property Crime,Theft,Female,60+,4313,2185,2128,3266,1047
2002,Rural,Tripura,Crime Against Children,Kidnapping,Female,18-30,9389,7363,2026,8003,1386
2007,Urban,Karnataka,Other Crimes,Drug Offense,Female,0-12,2754,782,1972,2690,64
2001,Rural,Gujarat,Crime Against Women,Molestation,Male,0-12,6055,1232,4823,4752,1303
2004,Urban,Delhi,Property Crime,Burglary,Male,0-12,8300,6582,1718,7396,904
2009,Rural,Punjab,Crime Against Women,Rape,Female,13-17,7546,4149,3397,5327,2219
2010,Rural,Andhra Pradesh,Crime Against Women,Dowry Deaths,Female,60+,6772,1160,5612,1946,4826
2007,Urban,Gujarat,Crime Against Children,Child Labor,Male,13-17,9684,6349,3335,9422,262
2001,Urban,West Bengal,Other Crimes,Corruption,Male,18-30,4249,3957,292,4134,115
2004,Urban,West Bengal,Crime Against Men,Assault,Male,0-12,8166,1899,6267,6376,1790
2006,Rural,Haryana,Crime Against Women,Molestation,Female,13-17,2802,2615,187,2656,146
2004,Rural,Punjab,Crime Against Women,Rape,Female,18-30,4182,2839,1343,3536,646
2001,Rural,Telangana,Property Crime,Theft,Female,60+,3939,3746,193,3827,112
2008,Rural,Arunachal Pradesh,Other Crimes,Drug Offense,Male,0-12,2858,2148,710,2638,220
2006,Urban,Meghalaya,Crime Against Women,Molestation,Male,13-17,3407,3239,168,3244,163
2001,Rural,Himachal Pradesh,Crime Against Women,Molestation,Male,0-12,5615,1040,4575,4526,1089
2010,Urban,Tripura,Property Crime,Theft,Male,0-12,6143,1672,4471,1952,4191
2003,Rural,Arunachal Pradesh,Crime Against Men,Murder,Female,60+,7734,6461,1273,6838,896
2002,Urban,Andhra Pradesh,Crime Against Men,Assault,Female,13-17,4336,2962,1374,3741,595
2002,Urban,Himachal Pradesh,Crime Against Men,Murder,Female,0-12,6513,6230,283,6393,120
2010,Urban,Haryana,Crime Against Women,Domestic Violence,Male,46-60,8700,6873,1827,6892,1808
2007,Rural,Gujarat,Crime Against Women,Dowry Deaths,Female,13-17,1765,473,1292,1477,288
2009,Urban,Odisha,Crime Against Children,Child Labor,Female,0-12,8106,1610,6496,4953,3153
2003,Urban,Himachal Pradesh,Other Crimes,Fraud,Female,0-12,5271,2804,2467,3936,1335
2008,Urban,Punjab,Crime Against Women,Dowry Deaths,Female,13-17,8545,7433,1112,7447,1098
2005,Urban,Arunachal Pradesh,Property Crime,Arson,Male,46-60,6125,6106,19,6121,4
2008,Rural,Gujarat,Crime Against Men,Extortion,Female,31-45,9570,2543,7027,6846,2724
2003,Rural,Sikkim,Crime Against Men,Assault,Female,46-60,9341,4846,4495,7996,1345
2007,Rural,Madhya Pradesh,Crime Against Men,Assault,Female,18-30,3883,2364,1519,2710,1173
2002,Rural,Rajasthan,Property Crime,Arson,Female,31-45,6591,1711,4880,2566,4025
2010,Rural,Tripura,Crime Against Men,Murder,Female,13-17,3505,2219,1286,2345,1160
2008,Rural,Telangana,Other Crimes,Drug Offense,Female,46-60,1430,700,730,1419,11
2005,Rural,Assam,Property Crime,Arson,Male,18-30,1474,1250,224,1436,38
2001,Urban,Odisha,Crime Against Children,Trafficking,Male,46-60,9319,2557,6762,5683,3636
2006,Urban,Assam,Property Crime,Theft,Female,0-12,5346,1136,4210,4870,476
2006,Rural,Madhya Pradesh,Property Crime,Burglary,Male,0-12,9163,99,9064,4895,4268
2005,Rural,Jammu & Kashmir,Other Crimes,Cyber Crime,Male,31-45,1290,109,1181,347,943
2008,Urban,Assam,Crime Against Children,Kidnapping,Male,13-17,9695,2981,6714,5766,3929
2010,Urban,Kerala,Crime Against Children,Trafficking,Male,13-17,1238,930,308,969,269
2008,Urban,Uttarakhand,Crime Against Women,Dowry Deaths,Male,31-45,1188,769,419,884,304
2008,Urban,Tamil Nadu,Crime Against Women,Domestic Violence,Female,13-17,9007,1987,7020,5574,3433
2002,Urban,Karnataka,Property Crime,Burglary,Female,31-45,9397,7258,2139,8142,1255
2003,Urban,Karnataka,Crime Against Children,Child Abuse,Male,46-60,5727,3679,2048,4550,1177
2007,Rural,Madhya Pradesh,Crime Against Children,Child Abuse,Female,46-60,5714,3032,2682,4835,879
2007,Rural,Nagaland,Crime Against Men,Murder,Male,13-17,5933,110,5823,5798,135
2006,Rural,Manipur,Crime Against Women,Rape,Female,18-30,7418,3029,4389,5601,1817
2009,Rural,Arunachal Pradesh,Crime Against Men,Robbery,Male,60+,6654,2631,4023,5241,1413
2006,Urban,Gujarat,Crime Against Men,Robbery,Male,60+,5351,3765,1586,4216,1135
2010,Urban,Jharkhand,Crime Against Men,Murder,Female,46-60,7483,4691,2792,6664,819
2001,Urban,Uttarakhand,Crime Against Children,Child Labor,Female,31-45,8514,3103,5411,4902,3612
2010,Rural,Arunachal Pradesh,Other Crimes,Corruption,Male,31-45,4165,1431,2734,2767,1398
2006,Urban,Tamil Nadu,Crime Against Men,Assault,Female,46-60,73,34,39,44,29
2007,Rural,Assam,Other Crimes,Cyber Crime,Male,13-17,7393,2139,5254,5530,1863
2001,Urban,Bihar,Crime Against Children,Trafficking,Female,46-60,9556,9224,332,9454,102
2006,Rural,Rajasthan,Other Crimes,Corruption,Male,60+,8867,22,8845,6165,2702
2001,Rural,Arunachal Pradesh,Other Crimes,Fraud,Male,13-17,4985,2442,2543,3409,1576
2010,Urban,Chhattisgarh,Crime Against Women,Domestic Violence,Male,18-30,8742,2125,6617,4629,4113
2005,Urban,Kerala,Crime Against Children,Child Abuse,Male,0-12,850,294,556,385,465
2008,Urban,Himachal Pradesh,Other Crimes,Fraud,Male,60+,4397,4150,247,4381,16
2004,Urban,Odisha,Other Crimes,Fraud,Female,46-60,2030,223,1807,2027,3
2001,Rural,Rajasthan,Property Crime,Burglary,Male,46-60,3815,2725,1090,3585,230
2008,Rural,Himachal Pradesh,Crime Against Women,Domestic Violence,Female,60+,1858,474,1384,558,1300
2007,Rural,Andhra Pradesh,Other Crimes,Cyber Crime,Female,60+,7351,1411,5940,5315,2036
2006,Urban,Meghalaya,Other Crimes,Cyber Crime,Male,18-30,9942,5976,3966,9001,941
2005,Urban,Tamil Nadu,Crime Against Men,Murder,Male,31-45,9362,2580,6782,9059,303
2001,Urban,West Bengal,Crime Against Men,Murder,Female,13-17,1448,1350,98,1433,15
2010,Urban,Assam,Crime Against Children,Child Labor,Male,13-17,3279,2245,1034,2678,601
2009,Urban,Sikkim,Crime Against Men,Murder,Female,60+,582,303,279,344,238
2008,Urban,Karnataka,Other Crimes,Cyber Crime,Male,13-17,1329,917,412,1107,222
2003,Urban,Tamil Nadu,Other Crimes,Cyber Crime,Female,18-30,3216,441,2775,3155,61
2008,Urban,Tamil Nadu,Crime Against Children,Trafficking,Female,0-12,1995,1197,798,1407,588
2007,Rural,West Bengal,Property Crime,Theft,Female,60+,7231,688,6543,4107,3124
2008,Urban,Bihar,Property Crime,Burglary,Female,31-45,2130,1038,1092,1761,369
2001,Rural,Himachal Pradesh,Crime Against Women,Molestation,Male,18-30,5547,3664,1883,5348,199
2002,Urban,Arunachal Pradesh,Crime Against Women,Rape,Female,0-12,8605,5097,3508,6798,1807
2007,Urban,Andhra Pradesh,Crime Against Children,Child Labor,Female,0-12,7964,6007,1957,7261,703
2009,Rural,Bihar,Property Crime,Burglary,Male,13-17,5259,2606,2653,3720,1539
2006,Rural,Tamil Nadu,Crime Against Children,Child Labor,Female,31-45,2957,290,2667,2097,860
2006,Rural,Delhi,Crime Against Children,Child Abuse,Female,13-17,7868,1574,6294,2718,5150
2010,Rural,Karnataka,Property Crime,Arson,Male,31-45,5315,3530,1785,4376,939
2003,Rural,Sikkim,Crime Against Women,Domestic Violence,Male,46-60,9638,7667,1971,9196,442
2002,Rural,Karnataka,Crime Against Women,Molestation,Female,0-12,5256,1122,4134,1610,3646
2006,Urban,Mizoram,Crime Against Children,Child Labor,Male,13-17,7512,225,7287,1445,6067
2008,Urban,Jammu & Kashmir,Crime Against Men,Robbery,Female,13-17,1144,342,802,472,672
2006,Rural,Haryana,Crime Against Women,Rape,Male,0-12,2511,2248,263,2316,195
2010,Rural,Haryana,Other Crimes,Fraud,Female,18-30,6472,1215,5257,1253,5219
2005,Urban,Delhi,Crime Against Men,Assault,Female,46-60,168,107,61,153,15
2009,Rural,Uttarakhand,Other Crimes,Cyber Crime,Female,31-45,2489,1223,1266,1318,1171
2004,Urban,Madhya Pradesh,Property Crime,Vandalism,Female,31-45,6362,1943,4419,3724,2638
2005,Urban,Manipur,Crime Against Men,Robbery,Female,0-12,2396,795,1601,1541,855
2010,Urban,Rajasthan,Crime Against Men,Assault,Female,13-17,1678,52,1626,1273,405
2009,Rural,West Bengal,Crime Against Children,Child Abuse,Male,46-60,7099,1810,5289,6517,582
2010,Rural,Sikkim,Property Crime,Vandalism,Female,31-45,5612,3670,1942,4055,1557
2006,Rural,Assam,Crime Against Men,Robbery,Female,60+,9675,5973,3702,7201,2474
2002,Urban,Nagaland,Other Crimes,Cyber Crime,Female,0-12,9699,7960,1739,8876,823
2001,Rural,Tamil Nadu,Other Crimes,Fraud,Male,18-30,1534,1369,165,1490,44
2005,Urban,Goa,Crime Against Women,Rape,Male,46-60,6423,177,6246,254,6169
2003,Urban,Madhya Pradesh,Crime Against Men,Robbery,Male,31-45,7086,3325,3761,5353,1733
2003,Rural,Odisha,Crime Against Children,Trafficking,Female,60+,8230,3502,4728,7686,544
2007,Urban,Telangana,Crime Against Women,Domestic Violence,Female,18-30,689,465,224,647,42
2003,Rural,Telangana,Crime Against Children,Trafficking,Female,46-60,5700,2625,3075,4350,1350
2008,Rural,Haryana,Crime Against Women,Molestation,Female,0-12,4484,3113,1371,4234,250
2008,Rural,Kerala,Property Crime,Arson,Male,31-45,8374,98,8276,6601,1773
2005,Rural,Chhattisgarh,Crime Against Women,Molestation,Female,0-12,4255,2566,1689,2667,1588
2009,Urban,Chhattisgarh,Property Crime,Burglary,Female,0-12,77,13,64,28,49
2001,Urban,Sikkim,Crime Against Men,Murder,Male,46-60,1075,976,99,1038,37
2006,Rural,Andhra Pradesh,Other Crimes,Corruption,Male,18-30,2533,1346,1187,2359,174
2003,Urban,Telangana,Other Crimes,Fraud,Male,0-12,1512,1091,421,1193,319
2004,Urban,Tamil Nadu,Property Crime,Theft,Male,0-12,9501,1683,7818,5061,4440
2006,Rural,Jammu & Kashmir,Crime Against Women,Dowry Deaths,Male,13-17,539,423,116,528,11
2005,Urban,Jammu & Kashmir,Property Crime,Theft,Male,46-60,5428,1903,3525,3446,1982
2008,Rural,Nagaland,Crime Against Men,Robbery,Male,46-60,4341,2235,2106,3808,533
2010,Urban,Kerala,Crime Against Women,Dowry Deaths,Male,18-30,5602,5501,101,5577,25
2001,Urban,Arunachal Pradesh,Crime Against Men,Robbery,Female,60+,1767,664,1103,835,932
2006,Urban,Sikkim,Crime Against Women,Domestic Violence,Male,60+,1405,277,1128,1044,361
2003,Urban,Karnataka,Property Crime,Vandalism,Female,31-45,7218,1351,5867,2797,4421
2007,Urban,Delhi,Other Crimes,Cyber Crime,Male,60+,4427,2983,1444,4202,225
2009,Urban,Karnataka,Crime Against Children,Child Labor,Female,46-60,4486,477,4009,3933,553
2005,Urban,Jharkhand,Other Crimes,Drug Offense,Female,46-60,5302,3307,1995,3834,1468
2009,Urban,Tripura,Property Crime,Theft,Male,13-17,9211,6771,2440,8541,670
2004,Urban,Uttarakhand,Crime Against Women,Rape,Female,13-17,8900,6544,2356,7761,1139
2009,Rural,Rajasthan,Property Crime,Burglary,Female,60+,347,134,213,273,74
2003,Urban,Rajasthan,Crime Against Men,Assault,Female,60+,7346,3618,3728,4112,3234
2008,Rural,Bihar,Crime Against Children,Kidnapping,Female,46-60,8824,7073,1751,8720,104
2007,Rural,Tamil Nadu,Property Crime,Theft,Female,60+,6438,2144,4294,4215,2223
2006,Urban,Meghalaya,Property Crime,Burglary,Female,13-17,116,95,21,114,2
2009,Rural,Jammu & Kashmir,Crime Against Men,Assault,Female,0-12,3412,3399,13,3409,3
2005,Urban,Andhra Pradesh,Crime Against Children,Kidnapping,Female,0-12,4787,2406,2381,2525,2262
2003,Rural,Andhra Pradesh,Crime Against Women,Molestation,Male,60+,590,360,230,585,5
2005,Rural,Madhya Pradesh,Other Crimes,Corruption,Male,31-45,7519,353,7166,1985,5534
2006,Rural,Karnataka,Other Crimes,Corruption,Female,60+,6406,4353,2053,5203,1203
2001,Rural,Bihar,Crime Against Women,Domestic Violence,Male,60+,8288,6043,2245,6337,1951
2005,Urban,Arunachal Pradesh,Crime Against Women,Molestation,Female,46-60,9684,8526,1158,8851,833
2004,Rural,Delhi,Crime Against Women,Rape,Female,0-12,2831,2349,482,2449,382
2001,Rural,Tamil Nadu,Crime Against Women,Molestation,Female,18-30,7149,5282,1867,6935,214
2009,Rural,Goa,Crime Against Women,Molestation,Male,13-17,67,59,8,66,1
2002,Rural,West Bengal,Crime Against Women,Molestation,Female,60+,8535,3515,5020,4621,3914
2007,Urban,Manipur,Other Crimes,Corruption,Female,13-17,9073,1888,7185,4471,4602
2003,Urban,Telangana,Crime Against Men,Extortion,Female,0-12,927,879,48,919,8
2004,Rural,Delhi,Crime Against Children,Child Abuse,Female,13-17,2935,833,2102,2486,449
2005,Urban,Kerala,Property Crime,Vandalism,Female,13-17,196,55,141,117,79
2007,Urban,Gujarat,Crime Against Women,Rape,Male,46-60,4358,1501,2857,2316,2042
2009,Urban,West Bengal,Crime Against Women,Rape,Female,13-17,1486,1220,266,1453,33
2010,Urban,Nagaland,Crime Against Men,Robbery,Male,46-60,8258,1834,6424,3692,4566
2007,Rural,Gujarat,Other Crimes,Drug Offense,Female,46-60,737,181,556,217,520
2008,Rural,Karnataka,Crime Against Women,Dowry Deaths,Female,60+,5291,5199,92,5263,28
2005,Urban,Tripura,Other Crimes,Fraud,Male,0-12,9194,5129,4065,7051,2143
2009,Urban,Himachal Pradesh,Crime Against Women,Domestic Violence,Male,60+,6041,2097,3944,5285,756
2006,Rural,Arunachal Pradesh,Property Crime,Vandalism,Male,31-45,2650,396,2254,2200,450
2007,Urban,Madhya Pradesh,Property Crime,Arson,Female,0-12,2879,283,2596,800,2079
2002,Rural,Punjab,Crime Against Women,Dowry Deaths,Male,31-45,2862,40,2822,949,1913
2005,Rural,Haryana,Crime Against Women,Rape,Female,46-60,2985,805,2180,1448,1537
2007,Urban,West Bengal,Crime Against Men,Assault,Female,18-30,7310,5948,1362,6135,1175
2008,Urban,Sikkim,Other Crimes,Fraud,Male,46-60,8862,3922,4940,7125,1737
2002,Rural,Sikkim,Property Crime,Burglary,Female,46-60,1834,1379,455,1693,141
2002,Rural,Arunachal Pradesh,Property Crime,Theft,Male,31-45,7527,128,7399,5947,1580
2004,Urban,Meghalaya,Crime Against Women,Molestation,Female,60+,5950,1935,4015,3694,2256
2006,Urban,Himachal Pradesh,Property Crime,Burglary,Female,46-60,7541,6008,1533,7499,42
2007,Urban,Bihar,Crime Against Men,Murder,Female,46-60,7207,6851,356,7147,60
2005,Urban,Jammu & Kashmir,Crime Against Men,Murder,Male,31-45,1615,989,626,1554,61
2004,Urban,Goa,Other Crimes,Drug Offense,Male,13-17,5570,1149,4421,5479,91
2003,Rural,Jammu & Kashmir,Other Crimes,Fraud,Male,0-12,5545,535,5010,1905,3640
2006,Rural,Tamil Nadu,Crime Against Children,Child Abuse,Female,13-17,1486,553,933,1120,366
2007,Urban,Manipur,Crime Against Men,Murder,Female,31-45,5005,687,4318,2955,2050
2008,Urban,Karnataka,Crime Against Men,Robbery,Female,46-60,1849,297,1552,678,1171
2005,Rural,Andhra Pradesh,Crime Against Men,Robbery,Male,60+,6090,4256,1834,4640,1450
2009,Rural,Maharashtra,Other Crimes,Cyber Crime,Male,31-45,1695,551,1144,626,1069
2010,Rural,Haryana,Crime Against Women,Dowry Deaths,Female,31-45,9009,8028,981,8617,392
2009,Rural,Chhattisgarh,Other Crimes,Corruption,Female,60+,4746,14,4732,1535,3211
2009,Rural,Haryana,Crime Against Children,Child Labor,Male,46-60,1162,163,999,487,675
2008,Urban,West Bengal,Crime Against Women,Molestation,Male,31-45,831,606,225,666,165
2003,Urban,Rajasthan,Crime Against Men,Robbery,Female,18-30,2486,2308,178,2472,14
2009,Rural,Rajasthan,Other Crimes,Corruption,Female,60+,3992,3160,832,3810,182
2002,Urban,Jharkhand,Crime Against Women,Domestic Violence,Female,13-17,7800,161,7639,3669,4131
2010,Urban,Himachal Pradesh,Crime Against Children,Trafficking,Male,0-12,3287,2836,451,3198,89
2002,Urban,Mizoram,Crime Against Women,Molestation,Female,60+,9421,4389,5032,5214,4207
2002,Rural,Assam,Crime Against Children,Kidnapping,Female,60+,3439,380,3059,1739,1700
2006,Urban,Bihar,Crime Against Women,Molestation,Male,31-45,1621,1502,119,1570,51
2001,Urban,Jharkhand,Crime Against Men,Robbery,Male,46-60,8543,1953,6590,4210,4333
2006,Urban,West Bengal,Other Crimes,Fraud,Male,46-60,3895,3231,664,3776,119
2002,Urban,Goa,Crime Against Men,Extortion,Male,60+,618,22,596,99,519
2008,Rural,Chhattisgarh,Crime Against Children,Child Labor,Male,0-12,9272,4624,4648,8919,353
2001,Urban,Odisha,Other Crimes,Drug Offense,Female,31-45,3465,3249,216,3310,155
2010,Urban,Jharkhand,Other Crimes,Drug Offense,Female,31-45,2620,1635,985,2311,309
2007,Urban,Gujarat,Crime Against Children,Kidnapping,Male,0-12,1853,957,896,1119,734
2001,Urban,Madhya Pradesh,Property Crime,Vandalism,Female,31-45,3792,3471,321,3535,257
2002,Rural,Sikkim,Crime Against Women,Molestation,Female,0-12,7118,4934,2184,6901,217
2010,Rural,Maharashtra,Property Crime,Arson,Female,13-17,6262,4355,1907,4452,1810
2007,Rural,Nagaland,Crime Against Women,Rape,Male,31-45,8937,7687,1250,7908,1029
2009,Rural,Arunachal Pradesh,Crime Against Men,Extortion,Male,46-60,1825,74,1751,557,1268
2004,Rural,Madhya Pradesh,Property Crime,Theft,Male,13-17,3918,2163,1755,2407,1511
2010,Urban,Odisha,Crime Against Children,Trafficking,Female,0-12,6980,3045,3935,3712,3268
2010,Rural,Uttar Pradesh,Property Crime,Theft,Female,13-17,2505,1732,773,2285,220
2002,Urban,Chhattisgarh,Property Crime,Arson,Female,46-60,7849,1653,6196,2175,5674
2003,Rural,Jammu & Kashmir,Crime Against Women,Dowry Deaths,Female,0-12,3004,2168,836,2577,427
2007,Rural,Gujarat,Crime Against Women,Dowry Deaths,Female,0-12,7954,5967,1987,7654,300
2002,Urban,Jharkhand,Crime Against Women,Domestic Violence,Female,0-12,7915,2889,5026,6149,1766
2006,Rural,Tamil Nadu,Property Crime,Theft,Male,13-17,9876,2167,7709,4000,5876
2008,Urban,Telangana,Other Crimes,Drug Offense,Male,46-60,6594,3467,3127,4334,2260
2010,Urban,Mizoram,Crime Against Women,Domestic Violence,Male,0-12,8176,4471,3705,7863,313
2003,Urban,Odisha,Crime Against Women,Dowry Deaths,Male,18-30,5435,2053,3382,5284,151
2008,Rural,Telangana,Crime Against Men,Robbery,Male,0-12,3867,1345,2522,1674,2193
2001,Urban,Chhattisgarh,Crime Against Women,Domestic Violence,Male,0-12,5821,1654,4167,5817,4
2004,Rural,Tripura,Other Crimes,Drug Offense,Male,18-30,7911,3801,4110,4168,3743
2006,Urban,Maharashtra,Crime Against Women,Dowry Deaths,Female,0-12,7799,2466,5333,4690,3109
2010,Rural,Mizoram,Crime Against Women,Dowry Deaths,Female,46-60,6190,2673,3517,4183,2007
2002,Urban,Rajasthan,Crime Against Children,Child Abuse,Female,0-12,2248,2077,171,2156,92
2001,Rural,Rajasthan,Other Crimes,Fraud,Male,18-30,8195,1245,6950,6714,1481
2009,Urban,Punjab,Property Crime,Arson,Male,18-30,9921,6421,3500,9376,545
2001,Rural,Manipur,Other Crimes,Fraud,Male,46-60,5904,3062,2842,5184,720
2010,Urban,Karnataka,Property Crime,Arson,Female,46-60,5681,3600,2081,5334,347
2002,Rural,Maharashtra,Crime Against Men,Extortion,Female,46-60,2708,1125,1583,1388,1320
2009,Rural,Punjab,Crime Against Men,Assault,Female,18-30,8160,1867,6293,1928,6232
2010,Rural,Chhattisgarh,Crime Against Children,Kidnapping,Male,31-45,5633,362,5271,1619,4014
2010,Rural,Chhattisgarh,Crime Against Men,Robbery,Male,60+,9849,4617,5232,7105,2744
2004,Urban,Delhi,Property Crime,Theft,Male,60+,8980,8577,403,8953,27
2009,Rural,Telangana,Property Crime,Arson,Male,46-60,8767,4049,4718,6410,2357
2009,Urban,Himachal Pradesh,Crime Against Men,Extortion,Male,31-45,5716,1950,3766,4126,1590
2001,Urban,Chhattisgarh,Crime Against Children,Trafficking,Female,60+,7352,3814,3538,6347,1005
2008,Rural,Himachal Pradesh,Crime Against Children,Child Abuse,Female,46-60,6204,3634,2570,4160,2044
2008,Rural,Karnataka,Property Crime,Arson,Female,13-17,77,35,42,37,40
2007,Urban,Manipur,Crime Against Women,Molestation,Male,46-60,1373,1028,345,1224,149
2003,Urban,Goa,Property Crime,Vandalism,Male,18-30,7689,720,6969,1633,6056
2003,Urban,Uttar Pradesh,Other Crimes,Corruption,Female,31-45,2613,414,2199,2548,65
2008,Rural,Gujarat,Crime Against Children,Child Labor,Female,31-45,5905,3657,2248,5420,485
2007,Urban,Rajasthan,Crime Against Children,Trafficking,Female,13-17,7850,1072,6778,3698,4152
2009,Urban,Haryana,Crime Against Men,Extortion,Male,60+,4029,2243,1786,3329,700
2007,Rural,Telangana,Crime Against Children,Kidnapping,Female,60+,7294,368,6926,6445,849
2007,Rural,Haryana,Other Crimes,Cyber Crime,Male,46-60,5349,5328,21,5330,19
2009,Rural,Karnataka,Property Crime,Arson,Female,18-30,1978,1076,902,1805,173
2006,Urban,Goa,Other Crimes,Drug Offense,Male,0-12,490,362,128,389,101
2002,Rural,Himachal Pradesh,Other Crimes,Corruption,Male,0-12,755,55,700,514,241
2006,Rural,Telangana,Other Crimes,Cyber Crime,Female,31-45,2975,1097,1878,1818,1157
2007,Urban,Telangana,Crime Against Men,Robbery,Male,46-60,985,788,197,938,47
2003,Urban,Punjab,Other Crimes,Fraud,Female,13-17,3166,3030,136,3149,17
2002,Urban,Arunachal Pradesh,Property Crime,Burglary,Female,13-17,3068,2980,88,3055,13
2007,Rural,Uttarakhand,Crime Against Children,Kidnapping,Female,46-60,888,807,81,857,31
2004,Rural,Haryana,Crime Against Children,Trafficking,Female,18-30,2223,825,1398,924,1299
2004,Urban,Himachal Pradesh,Other Crimes,Fraud,Female,13-17,4474,314,4160,4274,200
2003,Rural,Meghalaya,Crime Against Women,Rape,Female,31-45,5384,3090,2294,4934,450
2003,Urban,Jharkhand,Crime Against Men,Robbery,Female,0-12,9660,7178,2482,8165,1495
2003,Rural,Nagaland,Other Crimes,Drug Offense,Female,13-17,5807,933,4874,5051,756
2009,Urban,Uttar Pradesh,Property Crime,Arson,Female,13-17,6791,2201,4590,5590,1201
2007,Rural,Sikkim,Property Crime,Theft,Male,60+,934,146,788,176,758
2004,Rural,Bihar,Other Crimes,Fraud,Male,31-45,8538,7936,602,8300,238
2009,Urban,Kerala,Other Crimes,Cyber Crime,Male,46-60,1475,443,1032,520,955
2006,Urban,Uttar Pradesh,Crime Against Men,Murder,Male,0-12,9902,7449,2453,8496,1406
2001,Urban,Gujarat,Crime Against Men,Murder,Female,18-30,8684,327,8357,2251,6433
2002,Urban,Maharashtra,Crime Against Women,Domestic Violence,Male,18-30,5778,3461,2317,5077,701
2001,Urban,Bihar,Property Crime,Burglary,Male,46-60,1396,1162,234,1330,66
2003,Rural,Bihar,Crime Against Men,Robbery,Female,18-30,2029,1872,157,1898,131
2005,Urban,Meghalaya,Crime Against Men,Robbery,Male,31-45,4838,213,4625,2390,2448
2004,Rural,Jharkhand,Crime Against Men,Murder,Male,60+,4058,2374,1684,3405,653
2007,Urban,Uttar Pradesh,Other Crimes,Corruption,Male,18-30,6074,2398,3676,5833,241
2003,Rural,Haryana,Property Crime,Burglary,Male,0-12,7134,2260,4874,4169,2965
2007,Rural,Uttar Pradesh,Crime Against Children,Trafficking,Male,0-12,259,175,84,251,8
2006,Urban,Uttarakhand,Other Crimes,Cyber Crime,Female,60+,3697,1620,2077,2523,1174
2007,Urban,Karnataka,Property Crime,Arson,Male,0-12,179,104,75,153,26
2007,Rural,Madhya Pradesh,Property Crime,Theft,Female,18-30,9446,9401,45,9430,16
2009,Urban,Goa,Property Crime,Vandalism,Male,31-45,8533,5894,2639,7493,1040
2001,Urban,Uttar Pradesh,Crime Against Women,Molestation,Male,46-60,9543,8065,1478,8912,631
2001,Urban,Meghalaya,Crime Against Children,Child Abuse,Male,13-17,2608,1720,888,1751,857
2006,Urban,Manipur,Crime Against Men,Extortion,Male,31-45,7241,1009,6232,4739,2502
2003,Rural,Bihar,Other Crimes,Cyber Crime,Male,13-17,4780,2793,1987,3102,1678
2005,Urban,Karnataka,Crime Against Women,Domestic Violence,Female,18-30,824,519,305,523,301
2007,Rural,Uttar Pradesh,Crime Against Children,Kidnapping,Male,18-30,4553,2025,2528,2485,2068
2009,Urban,Nagaland,Other Crimes,Cyber Crime,Female,46-60,1862,1406,456,1634,228
2005,Urban,Uttar Pradesh,Crime Against Men,Robbery,Male,31-45,1660,1364,296,1431,229
2009,Rural,Manipur,Property Crime,Vandalism,Male,46-60,8778,7211,1567,8204,574
2010,Urban,Bihar,Crime Against Women,Domestic Violence,Female,46-60,2293,824,1469,1218,1075
2009,Rural,Uttarakhand,Crime Against Women,Rape,Female,13-17,6985,4045,2940,5734,1251
2002,Urban,Maharashtra,Crime Against Men,Murder,Male,46-60,3753,2999,754,3539,214
2004,Rural,Karnataka,Crime Against Women,Dowry Deaths,Female,13-17,5113,3570,1543,4612,501
2001,Urban,Karnataka,Other Crimes,Cyber Crime,Female,0-12,9948,3560,6388,5984,3964
2003,Rural,Karnataka,Property Crime,Arson,Male,0-12,227,71,156,134,93
2001,Urban,Meghalaya,Crime Against Men,Extortion,Male,0-12,7417,635,6782,5814,1603
2008,Urban,Assam,Other Crimes,Fraud,Male,46-60,339,266,73,292,47
2001,Rural,Uttarakhand,Other Crimes,Drug Offense,Male,0-12,1538,284,1254,1487,51
2009,Urban,Nagaland,Crime Against Children,Child Labor,Male,18-30,615,198,417,615,0
2010,Rural,Uttarakhand,Property Crime,Arson,Male,46-60,9866,2447,7419,7307,2559
2006,Rural,Nagaland,Crime Against Children,Kidnapping,Male,0-12,7693,3007,4686,6328,1365
2004,Rural,Haryana,Property Crime,Burglary,Male,18-30,9701,5493,4208,9043,658
2004,Rural,Kerala,Crime Against Women,Rape,Male,60+,4828,2684,2144,4662,166
2001,Urban,Chhattisgarh,Crime Against Men,Extortion,Female,13-17,6270,5945,325,6060,210
2005,Urban,Gujarat,Crime Against Women,Dowry Deaths,Male,18-30,1220,1060,160,1203,17
2001,Urban,Haryana,Property Crime,Vandalism,Male,46-60,6095,153,5942,1670,4425
2005,Urban,Bihar,Property Crime,Arson,Female,0-12,9732,8037,1695,8379,1353
2009,Rural,Arunachal Pradesh,Property Crime,Vandalism,Female,0-12,1492,1105,387,1386,106
2002,Rural,Kerala,Crime Against Women,Domestic Violence,Male,0-12,2831,1629,1202,1908,923
2005,Rural,Haryana,Crime Against Men,Assault,Male,13-17,4963,4357,606,4667,296
2007,Rural,Odisha,Crime Against Women,Domestic Violence,Female,18-30,5717,3563,2154,3877,1840
2001,Urban,West Bengal,Other Crimes,Cyber Crime,Male,60+,5979,5391,588,5492,487
2010,Urban,Tamil Nadu,Crime Against Children,Kidnapping,Female,31-45,58,33,25,52,6
2008,Urban,Bihar,Crime Against Men,Murder,Male,13-17,2454,26,2428,2174,280
2001,Urban,Maharashtra,Other Crimes,Cyber Crime,Male,0-12,3344,2202,1142,2455,889
2002,Rural,Kerala,Crime Against Men,Extortion,Male,18-30,7570,3175,4395,5405,2165
2010,Rural,Delhi,Property Crime,Vandalism,Male,0-12,376,175,201,227,149
2001,Rural,Uttarakhand,Crime Against Men,Extortion,Female,60+,8677,8187,490,8627,50
2004,Urban,Nagaland,Property Crime,Vandalism,Male,60+,7803,7356,447,7390,413
2009,Urban,Punjab,Property Crime,Vandalism,Female,46-60,684,555,129,638,46
2008,Urban,Punjab,Other Crimes,Corruption,Female,60+,2864,1676,1188,2673,191
2010,Rural,Gujarat,Property Crime,Theft,Male,60+,1691,380,1311,1626,65
2005,Rural,Tamil Nadu,Crime Against Women,Rape,Female,60+,2548,1921,627,2488,60
2003,Rural,Delhi,Crime Against Men,Murder,Male,0-12,6425,333,6092,3243,3182
2003,Urban,Delhi,Crime Against Children,Child Labor,Male,31-45,8493,6401,2092,6880,1613
2005,Urban,Uttar Pradesh,Property Crime,Vandalism,Female,46-60,2357,121,2236,1045,1312
2003,Rural,Nagaland,Crime Against Women,Molestation,Male,13-17,228,220,8,224,4
2006,Rural,Uttarakhand,Crime Against Women,Dowry Deaths,Female,31-45,2379,820,1559,2000,379
2007,Rural,Uttarakhand,Crime Against Men,Extortion,Female,46-60,2193,906,1287,1546,647
2003,Urban,Sikkim,Other Crimes,Corruption,Female,60+,9362,6188,3174,8237,1125
2002,Rural,Arunachal Pradesh,Crime Against Men,Assault,Female,31-45,531,495,36,507,24
2003,Rural,Uttarakhand,Crime Against Women,Molestation,Male,13-17,579,2,577,49,530
2004,Urban,Nagaland,Crime Against Women,Rape,Male,31-45,3177,1537,1640,1977,1200
2003,Urban,Nagaland,Crime Against Children,Kidnapping,Female,60+,3786,1136,2650,1340,2446
2009,Urban,Chhattisgarh,Crime Against Children,Child Labor,Male,0-12,1353,1211,142,1293,60
2010,Urban,Mizoram,Crime Against Women,Rape,Male,0-12,859,102,757,363,496
2005,Urban,Tamil Nadu,Property Crime,Theft,Female,46-60,962,637,325,911,51
2005,Rural,Tamil Nadu,Crime Against Men,Murder,Male,0-12,6719,2573,4146,6500,219
2007,Rural,Uttarakhand,Crime Against Children,Child Labor,Male,18-30,6150,2526,3624,5380,770
2007,Rural,Telangana,Other Crimes,Fraud,Female,18-30,2812,26,2786,645,2167
2009,Rural,Madhya Pradesh,Other Crimes,Fraud,Male,18-30,7407,541,6866,2828,4579
2002,Rural,Sikkim,Other Crimes,Drug Offense,Female,18-30,5439,273,5166,2619,2820
2002,Urban,Tripura,Crime Against Men,Extortion,Male,13-17,1431,129,1302,859,572
2008,Rural,Manipur,Property Crime,Burglary,Male,13-17,8739,4350,4389,7055,1684
2004,Rural,Tripura,Crime Against Men,Extortion,Female,60+,2469,1978,491,2082,387
2005,Rural,West Bengal,Crime Against Children,Child Labor,Male,13-17,7372,1785,5587,3011,4361
2002,Urban,Odisha,Crime Against Women,Dowry Deaths,Male,46-60,2741,1097,1644,1367,1374
2008,Urban,Arunachal Pradesh,Other Crimes,Drug Offense,Male,13-17,4311,2428,1883,2524,1787
2005,Urban,Delhi,Other Crimes,Drug Offense,Male,18-30,6152,5511,641,5681,471
2003,Rural,Gujarat,Crime Against Children,Trafficking,Female,18-30,800,761,39,795,5
2010,Urban,Delhi,Property Crime,Arson,Female,13-17,7136,5167,1969,6675,461
2009,Rural,Odisha,Crime Against Children,Child Abuse,Male,13-17,9456,802,8654,3608,5848
2009,Urban,Mizoram,Other Crimes,Cyber Crime,Female,13-17,9917,674,9243,3465,6452
2005,Rural,Assam,Crime Against Children,Child Abuse,Male,46-60,2044,1011,1033,1165,879
2009,Rural,Sikkim,Crime Against Men,Extortion,Male,18-30,5258,2101,3157,2709,2549
2008,Urban,Odisha,Crime Against Children,Child Labor,Male,13-17,2731,396,2335,2104,627
2007,Urban,Jammu & Kashmir,Other Crimes,Corruption,Female,0-12,3267,1662,1605,2284,983
2005,Rural,Nagaland,Crime Against Men,Murder,Female,13-17,8247,6040,2207,7209,1038
2002,Rural,Punjab,Crime Against Men,Assault,Female,46-60,3722,3001,721,3031,691
2005,Rural,Rajasthan,Property Crime,Arson,Female,13-17,5349,3831,1518,4033,1316
2001,Rural,Manipur,Other Crimes,Corruption,Female,60+,8944,6105,2839,8384,560
2005,Rural,Maharashtra,Crime Against Men,Robbery,Male,13-17,8648,2441,6207,7345,1303
2010,Rural,Madhya Pradesh,Crime Against Children,Trafficking,Female,46-60,2853,1381,1472,2394,459
2008,Rural,West Bengal,Crime Against Children,Kidnapping,Male,0-12,6222,2922,3300,5111,1111
2006,Rural,Punjab,Other Crimes,Fraud,Male,18-30,7693,4404,3289,6237,1456
2009,Rural,Goa,Crime Against Women,Dowry Deaths,Female,13-17,6056,2812,3244,5859,197
2007,Urban,Odisha,Property Crime,Arson,Male,13-17,7083,5778,1305,6799,284
2009,Urban,Uttar Pradesh,Other Crimes,Cyber Crime,Male,46-60,7694,2768,4926,5337,2357
2008,Rural,Gujarat,Crime Against Women,Rape,Female,31-45,961,413,548,616,345
2002,Rural,Punjab,Crime Against Men,Robbery,Female,46-60,3323,2549,774,3238,85
2001,Rural,Maharashtra,Other Crimes,Corruption,Male,60+,4293,839,3454,3779,514
2003,Rural,Arunachal Pradesh,Crime Against Men,Extortion,Male,46-60,7295,6724,571,7026,269
2009,Urban,Himachal Pradesh,Crime Against Children,Trafficking,Female,13-17,1467,718,749,1178,289
2010,Urban,Rajasthan,Property Crime,Arson,Female,46-60,3819,1085,2734,1217,2602
2010,Rural,Haryana,Crime Against Men,Extortion,Female,13-17,3544,15,3529,3516,28
2010,Urban,West Bengal,Property Crime,Arson,Female,13-17,6447,285,6162,3216,3231
2002,Urban,Mizoram,Other Crimes,Fraud,Male,18-30,7456,6043,1413,6219,1237
2003,Rural,Sikkim,Other Crimes,Drug Offense,Male,0-12,9048,5961,3087,6981,2067
2009,Rural,Uttar Pradesh,Crime Against Women,Rape,Male,46-60,8274,3033,5241,8133,141
2010,Rural,Bihar,Crime Against Children,Kidnapping,Female,18-30,1635,1092,543,1201,434
2007,Rural,Mizoram,Crime Against Children,Trafficking,Female,13-17,1923,843,1080,1372,551
2008,Rural,Manipur,Other Crimes,Cyber Crime,Male,0-12,1396,1304,92,1320,76
2008,Rural,Jammu & Kashmir,Other Crimes,Cyber Crime,Male,0-12,7834,7492,342,7798,36
2008,Rural,Andhra Pradesh,Crime Against Men,Extortion,Female,13-17,494,393,101,424,70
2006,Rural,Nagaland,Crime Against Women,Rape,Female,46-60,8387,6385,2002,7100,1287
2002,Rural,Tripura,Crime Against Women,Domestic Violence,Male,60+,6609,5124,1485,5160,1449
2010,Rural,Manipur,Crime Against Women,Dowry Deaths,Female,18-30,1695,397,1298,916,779
2007,Urban,Bihar,Property Crime,Theft,Female,31-45,1673,336,1337,597,1076
2001,Rural,Manipur,Crime Against Men,Assault,Female,13-17,8554,5457,3097,7193,1361
2004,Rural,Bihar,Other Crimes,Cyber Crime,Male,46-60,6536,601,5935,5785,751
2006,Urban,Tamil Nadu,Crime Against Women,Dowry Deaths,Female,13-17,5684,2006,3678,3673,2011
2008,Urban,Meghalaya,Crime Against Women,Domestic Violence,Female,18-30,5009,4609,400,4978,31
2004,Rural,Nagaland,Crime Against Men,Murder,Male,0-12,1026,109,917,111,915
2005,Rural,Bihar,Crime Against Children,Child Labor,Female,0-12,7439,1615,5824,2888,4551
2006,Urban,Punjab,Crime Against Children,Child Labor,Female,0-12,5455,622,4833,2854,2601
2002,Rural,Gujarat,Crime Against Women,Molestation,Female,0-12,3197,930,2267,2539,658
2008,Rural,Assam,Other Crimes,Cyber Crime,Female,18-30,3766,2978,788,3208,558
2001,Rural,Haryana,Other Crimes,Drug Offense,Male,0-12,5957,4625,1332,5129,828
2002,Rural,Sikkim,Other Crimes,Cyber Crime,Female,18-30,7814,1758,6056,3518,4296
2007,Urban,Uttar Pradesh,Crime Against Men,Robbery,Male,18-30,8434,490,7944,869,7565
2008,Rural,Jharkhand,Crime Against Children,Kidnapping,Female,13-17,3207,1737,1470,1852,1355
2001,Rural,Uttar Pradesh,Crime Against Women,Rape,Female,13-17,2100,1495,605,1637,463
2008,Rural,Mizoram,Crime Against Children,Child Labor,Female,31-45,6529,6468,61,6490,39
2007,Rural,Mizoram,Property Crime,Arson,Female,46-60,4590,1164,3426,4211,379
2005,Rural,Karnataka,Crime Against Women,Rape,Female,18-30,8433,3045,5388,5816,2617
2003,Urban,Tamil Nadu,Crime Against Children,Child Labor,Male,60+,64,35,29,39,25
2004,Rural,Chhattisgarh,Other Crimes,Corruption,Male,13-17,1818,1715,103,1778,40
2002,Urban,Mizoram,Other Crimes,Cyber Crime,Female,13-17,9010,1182,7828,4597,4413
2001,Urban,Jharkhand,Crime Against Women,Rape,Female,18-30,5600,3153,2447,4060,1540
2003,Rural,Assam,Property Crime,Burglary,Female,46-60,3463,1347,2116,2339,1124
2005,Rural,Karnataka,Other Crimes,Drug Offense,Female,18-30,5428,4564,864,4957,471
2006,Rural,Jharkhand,Crime Against Children,Child Abuse,Female,31-45,3317,1416,1901,1801,1516
2008,Urban,Rajasthan,Property Crime,Arson,Female,31-45,599,168,431,543,56
2001,Urban,Tamil Nadu,Property Crime,Theft,Male,13-17,91,27,64,89,2
2002,Urban,Tamil Nadu,Crime Against Women,Rape,Female,46-60,946,351,595,768,178
2010,Urban,Delhi,Crime Against Women,Domestic Violence,Female,46-60,6342,805,5537,3515,2827
2010,Rural,Mizoram,Property Crime,Vandalism,Male,18-30,3160,1267,1893,1821,1339
2002,Urban,Uttar Pradesh,Crime Against Children,Trafficking,Female,46-60,4784,3886,898,3938,846
2004,Rural,Arunachal Pradesh,Crime Against Children,Child Abuse,Male,0-12,7446,1049,6397,7237,209
2004,Rural,Odisha,Other Crimes,Fraud,Male,46-60,5789,664,5125,2564,3225
2009,Urban,Meghalaya,Crime Against Women,Rape,Male,18-30,7441,2093,5348,2962,4479
2010,Rural,Tripura,Crime Against Children,Trafficking,Female,46-60,701,341,360,602,99
2006,Urban,West Bengal,Crime Against Men,Robbery,Female,13-17,7290,4345,2945,6115,1175
2008,Urban,Andhra Pradesh,Crime Against Men,Robbery,Male,31-45,3561,948,2613,2648,913
2001,Rural,Delhi,Property Crime,Theft,Male,18-30,550,152,398,503,47
2010,Urban,Mizoram,Other Crimes,Cyber Crime,Female,13-17,9110,7816,1294,8744,366
2006,Rural,Nagaland,Crime Against Children,Kidnapping,Female,46-60,5485,4962,523,5483,2
2004,Rural,West Bengal,Crime Against Men,Assault,Male,46-60,7161,4340,2821,6061,1100
2002,Urban,Bihar,Other Crimes,Cyber Crime,Male,13-17,3795,1707,2088,2872,923
2006,Urban,Haryana,Other Crimes,Cyber Crime,Male,18-30,3984,448,3536,3563,421
2004,Urban,Haryana,Crime Against Women,Dowry Deaths,Male,46-60,8777,6969,1808,8079,698
2005,Urban,Odisha,Property Crime,Vandalism,Male,0-12,3661,2700,961,3406,255
2010,Rural,Sikkim,Crime Against Children,Child Abuse,Male,31-45,7603,3324,4279,3464,4139
2008,Rural,Assam,Property Crime,Vandalism,Male,46-60,8299,676,7623,7586,713
2005,Urban,Andhra Pradesh,Crime Against Women,Dowry Deaths,Female,31-45,4181,118,4063,344,3837
2004,Rural,Haryana,Crime Against Women,Dowry Deaths,Female,18-30,3077,1962,1115,2705,372
2002,Urban,Andhra Pradesh,Property Crime,Burglary,Male,31-45,8244,2535,5709,3621,4623
2005,Urban,Himachal Pradesh,Property Crime,Arson,Male,18-30,756,423,333,703,53
2003,Rural,Nagaland,Crime Against Men,Assault,Male,60+,8111,7104,1007,7159,952
2007,Urban,Himachal Pradesh,Crime Against Women,Rape,Female,60+,4243,2214,2029,4109,134
2008,Rural,Haryana,Other Crimes,Fraud,Male,31-45,521,512,9,519,2
2002,Urban,Sikkim,Crime Against Children,Kidnapping,Female,60+,9828,4105,5723,9475,353
2008,Rural,Delhi,Other Crimes,Drug Offense,Female,13-17,5524,1797,3727,4915,609
2007,Urban,Assam,Other Crimes,Drug Offense,Male,0-12,4911,3309,1602,4338,573
2003,Rural,Kerala,Crime Against Women,Molestation,Female,0-12,9958,2486,7472,3794,6164
2003,Urban,Uttarakhand,Crime Against Children,Kidnapping,Female,46-60,2958,881,2077,1778,1180
2008,Rural,Manipur,Crime Against Men,Murder,Female,13-17,8419,6905,1514,7951,468
2007,Urban,Odisha,Crime Against Men,Murder,Female,0-12,5218,678,4540,3008,2210
2009,Urban,Rajasthan,Property Crime,Theft,Female,60+,4383,3169,1214,4268,115
2009,Rural,Maharashtra,Crime Against Men,Assault,Male,0-12,3361,1177,2184,1248,2113
2008,Urban,Rajasthan,Other Crimes,Cyber Crime,Male,46-60,1927,1586,341,1590,337
2010,Rural,Tripura,Crime Against Children,Trafficking,Male,46-60,8737,1264,7473,4381,4356
2001,Rural,Manipur,Crime Against Men,Murder,Female,0-12,6926,3416,3510,4789,2137
2006,Rural,Jammu & Kashmir,Crime Against Children,Child Abuse,Male,60+,4006,838,3168,3891,115
2005,Rural,Delhi,Crime Against Women,Dowry Deaths,Female,60+,7876,6385,1491,7302,574
2003,Urban,West Bengal,Crime Against Children,Child Labor,Male,46-60,2178,712,1466,846,1332
2009,Urban,Meghalaya,Crime Against Women,Dowry Deaths,Female,13-17,5128,4447,681,4786,342
2005,Urban,Manipur,Property Crime,Arson,Female,60+,6224,886,5338,1838,4386
2004,Rural,Kerala,Crime Against Women,Dowry Deaths,Female,13-17,2791,2285,506,2710,81
2004,Rural,Goa,Property Crime,Arson,Female,31-45,8001,5900,2101,6062,1939
2008,Rural,Karnataka,Crime Against Men,Assault,Female,18-30,6143,4644,1499,5258,885
2001,Rural,Uttarakhand,Other Crimes,Fraud,Male,18-30,7779,4280,3499,7564,215
2006,Rural,Maharashtra,Crime Against Children,Kidnapping,Male,60+,4398,2766,1632,3047,1351
2010,Urban,Karnataka,Crime Against Men,Murder,Female,0-12,1435,1339,96,1434,1
2005,Rural,Chhattisgarh,Crime Against Children,Child Labor,Male,46-60,2884,352,2532,1750,1134
2004,Rural,Karnataka,Property Crime,Vandalism,Male,46-60,1938,1861,77,1864,74
2010,Rural,Bihar,Crime Against Women,Dowry Deaths,Female,31-45,1998,640,1358,761,1237
2004,Urban,Arunachal Pradesh,Crime Against Men,Murder,Male,13-17,9682,4619,5063,5691,3991
2002,Urban,Arunachal Pradesh,Crime Against Men,Extortion,Female,46-60,9749,7255,2494,8799,950
2004,Urban,Delhi,Crime Against Children,Trafficking,Female,18-30,5387,1367,4020,2261,3126
2005,Rural,Tamil Nadu,Other Crimes,Cyber Crime,Female,60+,9221,6928,2293,8851,370
2005,Urban,Tripura,Crime Against Children,Child Abuse,Male,18-30,4188,2600,1588,3558,630
2010,Urban,Karnataka,Property Crime,Vandalism,Female,60+,7875,6650,1225,7039,836
2003,Rural,Nagaland,Crime Against Women,Rape,Female,46-60,107,82,25,97,10
2003,Urban,Sikkim,Crime Against Men,Murder,Female,0-12,7425,1244,6181,2022,5403
2008,Urban,Gujarat,Crime Against Women,Molestation,Female,0-12,7927,5108,2819,5849,2078
2006,Urban,Haryana,Crime Against Men,Murder,Male,60+,4202,2261,1941,3715,487
2003,Urban,Himachal Pradesh,Crime Against Children,Child Labor,Female,0-12,6778,5464,1314,5973,805
2001,Urban,Rajasthan,Property Crime,Burglary,Female,0-12,6193,4289,1904,4561,1632
2003,Urban,Maharashtra,Crime Against Children,Child Labor,Female,31-45,8847,4211,4636,6715,2132
2008,Rural,Maharashtra,Other Crimes,Drug Offense,Female,18-30,9162,4295,4867,6123,3039
2001,Urban,Punjab,Other Crimes,Corruption,Male,60+,6565,4047,2518,4910,1655
2008,Rural,Andhra Pradesh,Other Crimes,Cyber Crime,Female,60+,8175,5535,2640,6273,1902
2007,Rural,Tripura,Other Crimes,Drug Offense,Male,18-30,5131,2676,2455,4091,1040
2010,Urban,Nagaland,Crime Against Men,Robbery,Female,46-60,8443,1757,6686,6770,1673
2010,Urban,Tripura,Crime Against Men,Murder,Male,18-30,7615,4152,3463,4841,2774
2008,Rural,Bihar,Crime Against Children,Child Abuse,Female,60+,7896,974,6922,6322,1574
2005,Urban,West Bengal,Crime Against Children,Child Labor,Male,31-45,4538,183,4355,499,4039
2001,Rural,West Bengal,Crime Against Men,Assault,Male,31-45,6652,731,5921,2618,4034
2009,Rural,Uttarakhand,Crime Against Men,Murder,Male,46-60,7151,3681,3470,3799,3352
2006,Urban,Telangana,Crime Against Women,Domestic Violence,Male,60+,170,42,128,113,57
2001,Rural,Karnataka,Other Crimes,Cyber Crime,Female,46-60,8157,5410,2747,7026,1131
2010,Urban,Meghalaya,Crime Against Men,Extortion,Female,60+,7382,6546,836,6982,400
2001,Rural,Meghalaya,Crime Against Women,Domestic Violence,Female,46-60,9566,2868,6698,3540,6026
2001,Urban,Sikkim,Other Crimes,Cyber Crime,Female,13-17,8163,972,7191,6808,1355
2006,Rural,Chhattisgarh,Crime Against Women,Domestic Violence,Male,18-30,8012,1773,6239,6777,1235
2006,Urban,Jharkhand,Crime Against Women,Molestation,Female,60+,2615,1399,1216,2246,369
2003,Urban,Manipur,Crime Against Men,Assault,Male,31-45,2723,896,1827,2570,153
2008,Urban,Rajasthan,Other Crimes,Cyber Crime,Male,46-60,7651,3950,3701,7184,467
2010,Rural,Goa,Crime Against Children,Child Abuse,Male,60+,3877,615,3262,1573,2304
2001,Urban,Madhya Pradesh,Crime Against Men,Extortion,Female,13-17,5527,1447,4080,1479,4048
2003,Rural,Bihar,Crime Against Women,Rape,Male,31-45,958,739,219,901,57
2003,Rural,Tamil Nadu,Crime Against Children,Trafficking,Female,60+,882,839,43,847,35
2006,Rural,Uttarakhand,Crime Against Women,Domestic Violence,Female,46-60,4933,3439,1494,4251,682
2004,Rural,Maharashtra,Crime Against Children,Kidnapping,Female,0-12,2218,1786,432,1945,273
2010,Rural,Delhi,Crime Against Men,Robbery,Female,18-30,7275,6752,523,7143,132
2003,Rural,Odisha,Crime Against Women,Domestic Violence,Female,0-12,8598,1341,7257,6219,2379
2006,Rural,Meghalaya,Crime Against Children,Kidnapping,Female,0-12,6281,5682,599,6115,166
2008,Rural,Uttar Pradesh,Crime Against Men,Murder,Female,46-60,2944,921,2023,2121,823
2003,Urban,Gujarat,Other Crimes,Drug Offense,Female,60+,2341,1841,500,2111,230
2001,Rural,Punjab,Crime Against Men,Extortion,Female,46-60,5245,3835,1410,4045,1200
2009,Rural,Gujarat,Property Crime,Burglary,Male,60+,2928,1567,1361,1949,979
2004,Urban,Mizoram,Crime Against Men,Assault,Female,60+,7186,6934,252,7012,174
2002,Rural,Mizoram,Crime Against Children,Trafficking,Male,46-60,9844,9297,547,9633,211
2003,Urban,Madhya Pradesh,Property Crime,Arson,Female,0-12,2461,2321,140,2334,127
2002,Urban,Goa,Other Crimes,Fraud,Male,13-17,1290,1203,87,1253,37
2003,Urban,Punjab,Property Crime,Theft,Female,18-30,3890,365,3525,2905,985
2006,Rural,Kerala,Other Crimes,Corruption,Male,18-30,7568,7230,338,7520,48
2003,Rural,Bihar,Crime Against Women,Rape,Female,13-17,1496,560,936,977,519
2002,Urban,Sikkim,Crime Against Men,Robbery,Male,46-60,4482,440,4042,1981,2501
2007,Rural,Jharkhand,Other Crimes,Corruption,Female,31-45,4148,646,3502,937,3211
2006,Urban,Haryana,Crime Against Men,Extortion,Female,60+,7348,4500,2848,5369,1979
2001,Rural,Assam,Property Crime,Vandalism,Female,60+,4797,4627,170,4764,33
2008,Rural,Gujarat,Crime Against Children,Kidnapping,Male,18-30,4344,3187,1157,3293,1051
2009,Urban,Tripura,Crime Against Men,Murder,Male,31-45,2068,1122,946,1728,340
2001,Rural,Chhattisgarh,Crime Against Women,Molestation,Female,60+,8021,944,7077,1240,6781
2001,Rural,Uttarakhand,Other Crimes,Drug Offense,Male,60+,4659,1527,3132,1755,2904
2003,Urban,Delhi,Property Crime,Theft,Female,60+,5873,2778,3095,2913,2960
2004,Urban,Goa,Crime Against Children,Child Abuse,Female,18-30,1768,739,1029,744,1024
2008,Rural,Sikkim,Other Crimes,Fraud,Female,31-45,602,482,120,486,116
2010,Urban,West Bengal,Other Crimes,Cyber Crime,Male,60+,6494,4656,1838,5419,1075
2008,Rural,Nagaland,Other Crimes,Fraud,Female,60+,5193,4846,347,4871,322
2002,Rural,Tamil Nadu,Crime Against Men,Robbery,Female,13-17,299,140,159,156,143
2009,Rural,Mizoram,Crime Against Men,Robbery,Male,0-12,4821,2625,2196,3678,1143
2004,Urban,Arunachal Pradesh,Property Crime,Theft,Female,31-45,8102,7622,480,7685,417
2003,Urban,West Bengal,Crime Against Men,Robbery,Female,46-60,6691,1847,4844,6302,389
2006,Rural,Uttar Pradesh,Crime Against Men,Murder,Male,13-17,3560,2037,1523,3254,306
2002,Rural,Bihar,Crime Against Women,Rape,Female,31-45,6933,2397,4536,5722,1211
2009,Rural,Haryana,Other Crimes,Cyber Crime,Male,13-17,4971,4183,788,4623,348
2008,Urban,Delhi,Crime Against Men,Robbery,Male,46-60,476,353,123,462,14
2002,Urban,Odisha,Property Crime,Vandalism,Female,18-30,900,60,840,505,395
2007,Urban,Jammu & Kashmir,Property Crime,Burglary,Male,31-45,8527,3379,5148,3624,4903
2006,Rural,Odisha,Other Crimes,Cyber Crime,Female,60+,7155,523,6632,4760,2395
2007,Rural,West Bengal,Property Crime,Burglary,Female,31-45,3162,2001,1161,2531,631
2008,Rural,Odisha,Crime Against Men,Extortion,Male,31-45,8165,5651,2514,7984,181
2005,Urban,Madhya Pradesh,Crime Against Children,Trafficking,Female,18-30,4143,991,3152,1792,2351
2007,Urban,Maharashtra,Property Crime,Burglary,Female,60+,8636,5095,3541,7120,1516
2001,Rural,Mizoram,Other Crimes,Corruption,Male,60+,5349,917,4432,2021,3328
2007,Rural,Odisha,Crime Against Men,Robbery,Male,0-12,1758,686,1072,1429,329
2010,Rural,Andhra Pradesh,Crime Against Men,Assault,Female,0-12,4318,1305,3013,4111,207
2001,Rural,Goa,Crime Against Women,Molestation,Male,18-30,9283,1628,7655,5136,4147
2006,Rural,Rajasthan,Crime Against Children,Kidnapping,Female,31-45,8145,2607,5538,7504,641
2010,Rural,Assam,Property Crime,Arson,Male,46-60,9540,1748,7792,2054,7486
2009,Urban,Uttarakhand,Other Crimes,Drug Offense,Male,46-60,3252,645,2607,1897,1355
2006,Urban,Karnataka,Property Crime,Arson,Female,0-12,8989,923,8066,4272,4717
2009,Rural,Jammu & Kashmir,Property Crime,Arson,Male,18-30,6709,175,6534,5668,1041
2001,Urban,Kerala,Property Crime,Vandalism,Male,31-45,9358,95,9263,5414,3944
2010,Urban,Andhra Pradesh,Crime Against Men,Extortion,Female,0-12,8798,6785,2013,8162,636
2010,Urban,Gujarat,Crime Against Children,Trafficking,Male,31-45,1595,369,1226,990,605
2008,Urban,Karnataka,Crime Against Women,Dowry Deaths,Female,18-30,6493,3948,2545,6024,469
2007,Urban,Rajasthan,Crime Against Women,Rape,Male,0-12,8919,4242,4677,7774,1145
2007,Urban,Telangana,Property Crime,Theft,Male,13-17,4628,2357,2271,2890,1738
2002,Rural,Telangana,Property Crime,Arson,Male,0-12,8439,4988,3451,6432,2007
2008,Rural,West Bengal,Crime Against Men,Assault,Female,18-30,7841,4790,3051,5288,2553
2005,Urban,Goa,Crime Against Women,Molestation,Female,0-12,5710,3842,1868,4782,928
2008,Urban,Tripura,Crime Against Women,Rape,Female,18-30,6204,4960,1244,5547,657
2005,Urban,Delhi,Property Crime,Vandalism,Male,46-60,2219,1170,1049,1866,353
2009,Urban,Bihar,Crime Against Women,Dowry Deaths,Male,60+,6445,5213,1232,5757,688
2009,Urban,Assam,Crime Against Men,Murder,Female,60+,498,494,4,496,2
2002,Rural,Bihar,Property Crime,Arson,Male,31-45,800,112,688,610,190
2002,Urban,Nagaland,Other Crimes,Fraud,Male,0-12,8695,2814,5881,8276,419
2010,Urban,Kerala,Other Crimes,Cyber Crime,Male,18-30,9956,6188,3768,7736,2220
2009,Rural,Himachal Pradesh,Crime Against Children,Child Abuse,Male,60+,1427,1219,208,1359,68
2007,Urban,Himachal Pradesh,Property Crime,Vandalism,Female,46-60,2925,2536,389,2879,46
2008,Rural,Assam,Crime Against Children,Child Abuse,Female,0-12,3130,1874,1256,2786,344
2010,Rural,Kerala,Crime Against Men,Assault,Male,13-17,7321,7269,52,7285,36
2009,Urban,Karnataka,Crime Against Women,Molestation,Female,18-30,3423,1641,1782,2548,875
2001,Urban,Kerala,Crime Against Children,Kidnapping,Male,13-17,4741,2944,1797,3193,1548
2004,Urban,West Bengal,Crime Against Women,Molestation,Male,18-30,8025,3578,4447,6331,1694
2008,Urban,Assam,Crime Against Men,Robbery,Female,31-45,1743,846,897,1197,546
2010,Urban,Assam,Crime Against Men,Extortion,Female,31-45,7431,427,7004,2697,4734
2004,Urban,Madhya Pradesh,Other Crimes,Cyber Crime,Female,0-12,3333,2305,1028,3307,26
2006,Urban,Mizoram,Crime Against Men,Murder,Male,13-17,242,69,173,178,64
2002,Urban,Arunachal Pradesh,Property Crime,Arson,Male,31-45,7141,1392,5749,4565,2576
2010,Rural,Sikkim,Other Crimes,Cyber Crime,Female,0-12,2504,1288,1216,1382,1122
2001,Rural,West Bengal,Crime Against Women,Domestic Violence,Female,13-17,4905,852,4053,905,4000
2006,Rural,Odisha,Crime Against Children,Child Abuse,Female,0-12,2189,1676,513,2103,86
2005,Rural,Tripura,Crime Against Women,Rape,Male,0-12,8881,5080,3801,5192,3689
2004,Rural,Uttarakhand,Crime Against Women,Domestic Violence,Female,46-60,1474,789,685,1069,405
2003,Urban,Rajasthan,Other Crimes,Drug Offense,Male,46-60,8051,6573,1478,7742,309
2009,Rural,Karnataka,Crime Against Women,Dowry Deaths,Female,60+,8132,3450,4682,7385,747
2004,Urban,Telangana,Crime Against Women,Molestation,Male,46-60,8605,8549,56,8585,20
2004,Rural,Tamil Nadu,Crime Against Women,Dowry Deaths,Female,13-17,3076,651,2425,2238,838
2007,Urban,Assam,Property Crime,Burglary,Male,0-12,5663,1551,4112,5498,165
2003,Rural,Delhi,Crime Against Children,Trafficking,Male,0-12,8291,4275,4016,7015,1276
2001,Rural,Himachal Pradesh,Crime Against Children,Trafficking,Male,0-12,1506,662,844,1115,391
2003,Rural,Odisha,Property Crime,Arson,Female,46-60,7989,1381,6608,1757,6232
2001,Rural,Madhya Pradesh,Crime Against Women,Molestation,Male,46-60,4744,2595,2149,2676,2068
2002,Rural,Assam,Property Crime,Theft,Female,0-12,3024,886,2138,2779,245
2002,Urban,Odisha,Other Crimes,Corruption,Male,60+,6977,2344,4633,3925,3052
2005,Urban,Uttarakhand,Crime Against Children,Child Labor,Female,0-12,5621,2795,2826,3259,2362
2004,Rural,Karnataka,Crime Against Men,Assault,Female,31-45,6401,4442,1959,5261,1140
2003,Urban,Tamil Nadu,Crime Against Children,Kidnapping,Male,60+,2384,1827,557,2041,343
2009,Urban,Jammu & Kashmir,Property Crime,Theft,Female,46-60,2609,1705,904,2155,454
2006,Rural,Meghalaya,Crime Against Women,Domestic Violence,Male,18-30,5387,4150,1237,4489,898
2007,Rural,Chhattisgarh,Crime Against Women,Rape,Male,46-60,6766,2104,4662,3714,3052
2001,Urban,Jammu & Kashmir,Crime Against Children,Child Labor,Male,18-30,709,118,591,345,364
2008,Urban,Meghalaya,Crime Against Women,Dowry Deaths,Female,60+,5435,556,4879,3295,2140
2010,Urban,West Bengal,Property Crime,Vandalism,Female,31-45,184,139,45,139,45
2010,Urban,Sikkim,Crime Against Men,Assault,Female,46-60,2722,938,1784,1293,1429
2003,Rural,Odisha,Property Crime,Arson,Female,60+,4692,2902,1790,3965,727
2001,Urban,Arunachal Pradesh,Property Crime,Burglary,Male,13-17,2141,829,1312,1359,782
2001,Rural,Karnataka,Crime Against Children,Child Labor,Male,13-17,7604,5567,2037,5607,1997
2009,Urban,Chhattisgarh,Crime Against Women,Domestic Violence,Male,13-17,7368,6169,1199,6582,786
2001,Urban,Arunachal Pradesh,Property Crime,Vandalism,Male,46-60,7764,5562,2202,5731,2033
2010,Urban,Tripura,Crime Against Men,Extortion,Female,31-45,2505,1178,1327,1866,639
2003,Urban,Haryana,Other Crimes,Fraud,Female,60+,4896,2524,2372,4458,438
2006,Urban,Telangana,Crime Against Men,Extortion,Male,31-45,620,513,107,580,40
2006,Rural,Assam,Property Crime,Arson,Female,31-45,7524,6571,953,6755,769
2004,Rural,Sikkim,Crime Against Children,Kidnapping,Male,18-30,7074,2619,4455,4389,2685
2006,Urban,Himachal Pradesh,Crime Against Men,Robbery,Male,46-60,4008,2068,1940,2525,1483
2008,Rural,Tamil Nadu,Crime Against Women,Dowry Deaths,Male,60+,2175,970,1205,1580,595
2010,Rural,Karnataka,Property Crime,Theft,Male,13-17,3501,1355,2146,1666,1835
2003,Urban,Meghalaya,Other Crimes,Drug Offense,Male,46-60,1113,27,1086,772,341
2005,Rural,Arunachal Pradesh,Property Crime,Arson,Male,60+,2652,108,2544,1216,1436
2010,Urban,Uttar Pradesh,Crime Against Children,Child Abuse,Male,13-17,3609,1357,2252,3299,310
2005,Urban,Andhra Pradesh,Crime Against Women,Rape,Male,60+,2504,1513,991,1637,867
2008,Rural,Gujarat,Crime Against Women,Rape,Female,31-45,7828,6604,1224,7364,464
2009,Urban,Madhya Pradesh,Property Crime,Burglary,Female,60+,1564,223,1341,850,714
2006,Urban,Rajasthan,Crime Against Children,Child Abuse,Male,13-17,5627,631,4996,2820,2807
2006,Rural,Rajasthan,Property Crime,Arson,Male,46-60,273,142,131,226,47
2010,Urban,Sikkim,Crime Against Women,Molestation,Male,46-60,7125,5729,1396,6146,979
2003,Rural,Arunachal Pradesh,Crime Against Women,Dowry Deaths,Male,60+,409,162,247,211,198
2005,Urban,Mizoram,Crime Against Women,Rape,Female,0-12,524,400,124,408,116
2002,Rural,Nagaland,Crime Against Women,Domestic Violence,Female,46-60,1500,1391,109,1499,1
2003,Rural,Nagaland,Crime Against Children,Child Abuse,Male,18-30,874,40,834,691,183
2008,Rural,West Bengal,Crime Against Women,Molestation,Female,18-30,3339,3257,82,3294,45
2008,Urban,Kerala,Crime Against Men,Extortion,Male,60+,545,165,380,292,253
2008,Rural,Punjab,Other Crimes,Corruption,Male,46-60,5244,974,4270,2907,2337
2007,Urban,Andhra Pradesh,Other Crimes,Fraud,Male,60+,3206,2511,695,2538,668
2002,Rural,Telangana,Other Crimes,Fraud,Male,18-30,732,112,620,533,199
2001,Urban,Delhi,Crime Against Children,Trafficking,Female,13-17,6866,3791,3075,4443,2423
2010,Urban,Karnataka,Property Crime,Vandalism,Female,46-60,9259,2334,6925,7872,1387
2005,Rural,Andhra Pradesh,Other Crimes,Drug Offense,Female,46-60,6457,4499,1958,6213,244
2008,Rural,Telangana,Other Crimes,Cyber Crime,Male,13-17,1429,1160,269,1207,222
2004,Rural,Goa,Crime Against Children,Trafficking,Female,60+,3346,749,2597,3169,177
2009,Urban,Gujarat,Property Crime,Arson,Female,31-45,4262,3503,759,3872,390
2005,Urban,Tripura,Other Crimes,Cyber Crime,Male,13-17,2570,583,1987,879,1691
2008,Rural,Odisha,Crime Against Children,Child Abuse,Female,60+,1707,333,1374,1396,311
2007,Urban,Meghalaya,Crime Against Women,Rape,Male,46-60,7322,4180,3142,7009,313
2006,Urban,Uttar Pradesh,Crime Against Women,Rape,Male,0-12,7774,5465,2309,5466,2308
2010,Rural,Andhra Pradesh,Crime Against Children,Trafficking,Male,18-30,8395,565,7830,5758,2637
2001,Rural,Chhattisgarh,Other Crimes,Cyber Crime,Male,60+,7587,855,6732,3048,4539
2004,Urban,Sikkim,Crime Against Children,Child Abuse,Male,13-17,4163,640,3523,3480,683
2003,Rural,Chhattisgarh,Other Crimes,Cyber Crime,Female,46-60,2883,710,2173,834,2049
2009,Rural,Andhra Pradesh,Other Crimes,Cyber Crime,Female,31-45,7628,707,6921,3415,4213
2002,Rural,Punjab,Crime Against Women,Domestic Violence,Male,31-45,1917,1392,525,1400,517
2005,Rural,Uttarakhand,Crime Against Men,Robbery,Female,18-30,2469,1550,919,1860,609
2001,Rural,Mizoram,Other Crimes,Fraud,Female,60+,9246,1413,7833,2828,6418
2009,Rural,Telangana,Crime Against Children,Child Abuse,Female,60+,982,496,486,534,448
2010,Rural,Nagaland,Crime Against Women,Domestic Violence,Female,0-12,7389,2530,4859,3178,4211
2002,Urban,Haryana,Other Crimes,Corruption,Female,46-60,4646,3029,1617,4473,173
2006,Urban,West Bengal,Other Crimes,Corruption,Female,46-60,6223,4057,2166,5459,764
2006,Rural,Uttarakhand,Other Crimes,Drug Offense,Male,0-12,4692,3711,981,3789,903
2008,Urban,Bihar,Other Crimes,Fraud,Male,0-12,4719,551,4168,2717,2002
2005,Urban,Meghalaya,Crime Against Children,Kidnapping,Male,31-45,3923,2564,1359,3441,482
2006,Rural,Gujarat,Other Crimes,Fraud,Male,60+,1784,656,1128,1393,391
2003,Rural,Rajasthan,Other Crimes,Fraud,Male,60+,6883,6134,749,6700,183
2002,Urban,Sikkim,Property Crime,Arson,Female,60+,6961,1464,5497,6338,623
2010,Rural,Madhya Pradesh,Other Crimes,Corruption,Male,18-30,9769,5908,3861,7691,2078
2003,Urban,Chhattisgarh,Crime Against Children,Child Abuse,Male,60+,6264,3247,3017,4604,1660
2007,Rural,Jammu & Kashmir,Other Crimes,Cyber Crime,Female,46-60,9328,8969,359,8983,345
2001,Urban,Tripura,Crime Against Children,Child Abuse,Female,13-17,5434,4776,658,4984,450
2004,Rural,Punjab,Crime Against Men,Murder,Female,46-60,7108,4364,2744,5639,1469
2003,Rural,Goa,Crime Against Men,Extortion,Male,0-12,6844,1754,5090,2653,4191
2003,Rural,Meghalaya,Crime Against Women,Rape,Female,46-60,3060,148,2912,1031,2029
2006,Urban,Manipur,Other Crimes,Cyber Crime,Male,46-60,9272,7441,1831,9084,188
2005,Rural,Manipur,Property Crime,Arson,Female,31-45,5969,3706,2263,5667,302
2003,Urban,Goa,Crime Against Men,Murder,Female,0-12,3379,2159,1220,3350,29
2005,Urban,Mizoram,Property Crime,Arson,Female,60+,1812,796,1016,1085,727
2002,Rural,Uttarakhand,Crime Against Women,Dowry Deaths,Male,0-12,8635,1413,7222,4915,3720
2002,Rural,West Bengal,Property Crime,Vandalism,Male,13-17,6767,817,5950,2006,4761
2010,Rural,Mizoram,Crime Against Children,Trafficking,Female,31-45,7352,893,6459,4836,2516
2001,Urban,Karnataka,Other Crimes,Cyber Crime,Female,18-30,687,573,114,613,74
2008,Rural,Telangana,Other Crimes,Drug Offense,Male,46-60,1162,915,247,1119,43
2010,Urban,Delhi,Property Crime,Vandalism,Female,18-30,4571,4158,413,4321,250
2005,Urban,Gujarat,Crime Against Children,Trafficking,Male,0-12,7785,7634,151,7634,151
2004,Rural,Mizoram,Crime Against Men,Robbery,Female,13-17,312,300,12,312,0
2007,Urban,Delhi,Crime Against Women,Dowry Deaths,Male,13-17,6668,3460,3208,6306,362
2001,Rural,Kerala,Crime Against Women,Dowry Deaths,Male,46-60,7842,6223,1619,7655,187
2009,Urban,Karnataka,Crime Against Women,Molestation,Male,31-45,7312,4746,2566,7237,75
2008,Rural,Madhya Pradesh,Crime Against Men,Robbery,Female,0-12,3980,2958,1022,3808,172
2004,Urban,Jammu & Kashmir,Other Crimes,Cyber Crime,Male,13-17,5868,2870,2998,4409,1459
2004,Rural,Gujarat,Property Crime,Arson,Male,31-45,5657,3122,2535,5073,584
2002,Urban,Chhattisgarh,Other Crimes,Drug Offense,Male,60+,4521,554,3967,2470,2051
2009,Urban,Goa,Other Crimes,Corruption,Male,46-60,9709,4052,5657,8726,983
2002,Urban,Karnataka,Crime Against Children,Child Abuse,Female,46-60,8304,3642,4662,5119,3185
2002,Rural,West Bengal,Crime Against Women,Dowry Deaths,Female,13-17,2200,1944,256,2014,186
2006,Rural,Rajasthan,Other Crimes,Fraud,Female,31-45,5877,1951,3926,4943,934
2004,Rural,Chhattisgarh,Crime Against Women,Domestic Violence,Female,60+,8504,7820,684,8206,298
2006,Rural,Maharashtra,Crime Against Women,Dowry Deaths,Male,18-30,6808,4593,2215,6352,456
2010,Urban,Madhya Pradesh,Other Crimes,Drug Offense,Male,31-45,2479,850,1629,1068,1411
2004,Rural,Haryana,Crime Against Men,Robbery,Female,13-17,9243,6545,2698,7717,1526
2002,Rural,Jammu & Kashmir,Property Crime,Theft,Male,13-17,7270,4567,2703,5671,1599
2010,Urban,Haryana,Crime Against Women,Domestic Violence,Male,13-17,9769,4886,4883,8922,847
2001,Urban,Jammu & Kashmir,Crime Against Children,Kidnapping,Male,18-30,3927,2364,1563,3214,713
2001,Urban,Meghalaya,Property Crime,Arson,Female,13-17,1628,1370,258,1403,225
2010,Rural,Chhattisgarh,Crime Against Men,Murder,Male,60+,6251,1391,4860,4114,2137
2005,Rural,Odisha,Crime Against Children,Child Abuse,Female,60+,3609,1993,1616,2644,965
2008,Urban,Karnataka,Crime Against Men,Murder,Female,46-60,7725,5895,1830,6126,1599
2009,Rural,Haryana,Crime Against Women,Dowry Deaths,Male,31-45,6785,5365,1420,6245,540
2004,Rural,West Bengal,Crime Against Children,Kidnapping,Male,46-60,791,310,481,495,296
2001,Rural,Telangana,Crime Against Men,Extortion,Male,13-17,2925,1216,1709,2193,732
2010,Urban,Kerala,Crime Against Women,Domestic Violence,Female,46-60,5073,1883,3190,5066,7
2006,Urban,Jharkhand,Crime Against Women,Rape,Male,13-17,7384,5514,1870,6457,927
2006,Urban,Delhi,Crime Against Men,Extortion,Male,31-45,2288,318,1970,354,1934
2004,Rural,Tripura,Crime Against Children,Child Labor,Male,31-45,5431,4761,670,5249,182
2010,Rural,Gujarat,Crime Against Children,Kidnapping,Male,13-17,5866,4529,1337,5828,38
2005,Rural,Goa,Crime Against Women,Molestation,Female,13-17,4875,2077,2798,4692,183
2007,Urban,Odisha,Crime Against Men,Robbery,Male,0-12,529,462,67,503,26
2003,Urban,Madhya Pradesh,Property Crime,Arson,Male,18-30,2638,1676,962,1780,858
2007,Rural,Nagaland,Crime Against Children,Child Labor,Male,46-60,1212,775,437,982,230
2002,Rural,Tamil Nadu,Crime Against Children,Child Labor,Female,18-30,1845,1212,633,1635,210
2010,Urban,Uttar Pradesh,Crime Against Men,Extortion,Female,46-60,3821,558,3263,3576,245
2008,Rural,Haryana,Other Crimes,Cyber Crime,Male,46-60,1211,272,939,614,597
2007,Rural,West Bengal,Crime Against Children,Trafficking,Male,46-60,989,242,747,825,164
2006,Rural,Andhra Pradesh,Crime Against Women,Rape,Male,0-12,3589,1770,1819,3524,65
2009,Urban,Delhi,Property Crime,Vandalism,Female,18-30,4826,950,3876,4746,80
2006,Rural,Chhattisgarh,Crime Against Men,Robbery,Female,18-30,8788,2768,6020,5128,3660
2003,Rural,Sikkim,Other Crimes,Fraud,Male,46-60,7397,6786,611,7316,81
2010,Urban,Goa,Crime Against Women,Rape,Male,46-60,5604,97,5507,5483,121
2003,Urban,Andhra Pradesh,Property Crime,Burglary,Male,31-45,3599,265,3334,345,3254
2009,Urban,Madhya Pradesh,Other Crimes,Drug Offense,Female,18-30,2210,1766,444,1913,297
2001,Rural,Andhra Pradesh,Other Crimes,Fraud,Male,0-12,7649,6633,1016,6986,663
2006,Rural,Maharashtra,Crime Against Men,Extortion,Female,46-60,3289,493,2796,1412,1877
2002,Urban,Haryana,Crime Against Men,Extortion,Female,18-30,4798,4129,669,4218,580
2004,Urban,Telangana,Crime Against Women,Domestic Violence,Male,60+,800,678,122,707,93
2008,Rural,West Bengal,Other Crimes,Drug Offense,Female,18-30,4616,3503,1113,3929,687
2002,Rural,Gujarat,Crime Against Men,Murder,Male,13-17,9232,7431,1801,9085,147
2003,Rural,Meghalaya,Property Crime,Arson,Male,0-12,4614,1718,2896,3800,814
2004,Urban,Tamil Nadu,Other Crimes,Cyber Crime,Male,18-30,3837,2397,1440,2696,1141
2010,Rural,Arunachal Pradesh,Property Crime,Burglary,Female,46-60,5858,1216,4642,2372,3486
2002,Urban,Odisha,Crime Against Women,Dowry Deaths,Male,13-17,6030,1191,4839,1659,4371
2009,Rural,Jharkhand,Property Crime,Vandalism,Female,60+,9786,1836,7950,6809,2977
2007,Urban,Bihar,Other Crimes,Drug Offense,Female,46-60,1822,1112,710,1571,251
2010,Rural,Manipur,Other Crimes,Cyber Crime,Female,0-12,3578,279,3299,3526,52
2007,Urban,West Bengal,Other Crimes,Drug Offense,Female,60+,5702,1333,4369,4109,1593
2006,Rural,Manipur,Property Crime,Theft,Female,31-45,5449,1515,3934,4104,1345
2007,Urban,West Bengal,Crime Against Women,Dowry Deaths,Male,46-60,4597,1183,3414,1890,2707
2007,Urban,Punjab,Crime Against Children,Trafficking,Female,31-45,6722,3359,3363,3546,3176
2007,Rural,Kerala,Crime Against Women,Domestic Violence,Male,0-12,6918,5569,1349,6292,626
2009,Rural,Kerala,Crime Against Men,Extortion,Male,0-12,1257,465,792,962,295
2004,Rural,Maharashtra,Crime Against Children,Child Labor,Female,13-17,2183,1679,504,1830,353
2007,Urban,Chhattisgarh,Crime Against Men,Extortion,Female,46-60,239,218,21,222,17
2001,Rural,Tripura,Crime Against Men,Extortion,Female,18-30,1573,354,1219,1440,133
2009,Urban,Haryana,Crime Against Men,Assault,Female,31-45,9433,3788,5645,8341,1092
2006,Urban,Maharashtra,Crime Against Children,Trafficking,Male,13-17,145,38,107,96,49
2002,Urban,Madhya Pradesh,Other Crimes,Cyber Crime,Male,0-12,5051,2141,2910,3128,1923
2008,Rural,Telangana,Crime Against Children,Child Labor,Male,31-45,2800,2603,197,2653,147
2009,Urban,Sikkim,Crime Against Men,Robbery,Female,13-17,677,165,512,634,43
2008,Urban,Chhattisgarh,Crime Against Men,Murder,Male,31-45,5785,4927,858,5576,209
2002,Urban,Arunachal Pradesh,Crime Against Women,Dowry Deaths,Male,18-30,5992,5248,744,5692,300
2007,Urban,Maharashtra,Crime Against Men,Murder,Male,0-12,5851,205,5646,1751,4100
2003,Urban,Arunachal Pradesh,Property Crime,Arson,Female,18-30,1969,779,1190,1139,830
2005,Rural,Nagaland,Crime Against Children,Kidnapping,Male,0-12,3312,287,3025,2483,829
2006,Rural,Tripura,Crime Against Men,Murder,Female,46-60,6245,6141,104,6185,60
2001,Urban,Andhra Pradesh,Crime Against Women,Dowry Deaths,Female,46-60,7602,6212,1390,6964,638
2006,Urban,Assam,Crime Against Men,Extortion,Male,60+,9734,2235,7499,9526,208
2010,Rural,Uttar Pradesh,Other Crimes,Corruption,Male,46-60,2363,627,1736,1242,1121
2008,Rural,Delhi,Property Crime,Burglary,Male,31-45,7507,3785,3722,5482,2025
2005,Urban,Odisha,Crime Against Men,Murder,Male,60+,7342,1383,5959,5218,2124
2007,Rural,Mizoram,Property Crime,Theft,Female,46-60,3056,503,2553,2537,519
2002,Rural,Rajasthan,Crime Against Men,Murder,Male,0-12,3451,1167,2284,1214,2237
2007,Urban,Meghalaya,Property Crime,Burglary,Female,13-17,4729,3820,909,4699,30
2006,Rural,Gujarat,Crime Against Women,Dowry Deaths,Male,31-45,9554,4354,5200,9378,176
2002,Urban,Madhya Pradesh,Crime Against Children,Child Labor,Female,18-30,262,75,187,140,122
2007,Urban,Tripura,Property Crime,Theft,Male,60+,4321,3876,445,3992,329
2007,Urban,Meghalaya,Crime Against Women,Molestation,Female,0-12,3191,2512,679,3113,78
2003,Urban,Meghalaya,Other Crimes,Drug Offense,Male,46-60,4137,2859,1278,3150,987
2008,Rural,Karnataka,Crime Against Men,Assault,Male,18-30,3172,1437,1735,2594,578
2003,Rural,Kerala,Crime Against Women,Domestic Violence,Female,0-12,8546,6646,1900,6853,1693
2002,Urban,Bihar,Crime Against Men,Robbery,Female,31-45,2477,1466,1011,2004,473
2010,Urban,Arunachal Pradesh,Other Crimes,Corruption,Male,13-17,8592,3062,5530,7711,881
2001,Urban,Assam,Other Crimes,Drug Offense,Male,31-45,3907,1065,2842,1833,2074
2003,Urban,Bihar,Crime Against Women,Domestic Violence,Female,13-17,2273,677,1596,2245,28
2010,Rural,Kerala,Property Crime,Burglary,Male,13-17,3958,2479,1479,3706,252
2003,Urban,Nagaland,Crime Against Women,Dowry Deaths,Female,0-12,9598,8972,626,9385,213
2001,Urban,Uttar Pradesh,Crime Against Men,Assault,Male,46-60,9752,4361,5391,5086,4666
2009,Rural,Nagaland,Property Crime,Theft,Male,18-30,2763,2228,535,2373,390
2002,Urban,Odisha,Property Crime,Burglary,Male,60+,6089,5386,703,5780,309
2006,Urban,Andhra Pradesh,Property Crime,Theft,Male,18-30,8881,6754,2127,8053,828
2004,Urban,Sikkim,Crime Against Children,Child Abuse,Female,60+,8444,515,7929,8270,174
2006,Rural,Odisha,Crime Against Children,Child Labor,Male,60+,9619,84,9535,2710,6909
2002,Urban,Tamil Nadu,Crime Against Men,Extortion,Female,31-45,3444,2329,1115,3440,4
2007,Rural,Madhya Pradesh,Crime Against Women,Rape,Male,60+,9142,7570,1572,8906,236
2001,Rural,Telangana,Crime Against Children,Kidnapping,Male,31-45,1652,1593,59,1640,12
2003,Rural,Tripura,Crime Against Women,Dowry Deaths,Female,0-12,2656,246,2410,1294,1362
2002,Rural,Bihar,Crime Against Men,Extortion,Male,0-12,8908,8313,595,8576,332
2003,Rural,Andhra Pradesh,Crime Against Women,Domestic Violence,Female,18-30,6847,5066,1781,5386,1461
2010,Urban,Karnataka,Crime Against Children,Child Abuse,Male,46-60,2103,502,1601,1708,395
2008,Urban,Haryana,Crime Against Men,Robbery,Male,0-12,1142,239,903,271,871
2001,Rural,Kerala,Crime Against Children,Trafficking,Male,0-12,1077,489,588,866,211
2006,Rural,Tripura,Crime Against Children,Child Labor,Male,13-17,9597,2827,6770,2971,6626
2007,Urban,Uttar Pradesh,Crime Against Men,Robbery,Female,13-17,4952,3000,1952,4080,872
2004,Rural,Gujarat,Crime Against Men,Murder,Male,31-45,6016,2832,3184,4657,1359
2006,Urban,Kerala,Crime Against Children,Child Abuse,Male,13-17,6524,5289,1235,5725,799
2003,Urban,Uttarakhand,Other Crimes,Fraud,Male,0-12,6356,4867,1489,6229,127
2006,Urban,Andhra Pradesh,Crime Against Men,Murder,Female,18-30,3418,931,2487,1932,1486
2004,Rural,Kerala,Crime Against Women,Domestic Violence,Female,18-30,5777,4966,811,5631,146
2009,Rural,Goa,Crime Against Children,Kidnapping,Male,0-12,7834,1629,6205,5470,2364
2007,Urban,Chhattisgarh,Property Crime,Vandalism,Female,60+,6387,311,6076,1468,4919
2010,Urban,Sikkim,Crime Against Children,Kidnapping,Male,18-30,3905,784,3121,3497,408
2001,Urban,Assam,Crime Against Men,Robbery,Male,60+,7359,899,6460,3768,3591
2002,Rural,Uttar Pradesh,Crime Against Men,Assault,Female,46-60,5541,5210,331,5280,261
2008,Rural,Haryana,Crime Against Women,Domestic Violence,Male,31-45,2718,2081,637,2199,519
2007,Rural,Jharkhand,Other Crimes,Drug Offense,Female,46-60,5235,4065,1170,5175,60
2006,Rural,Jharkhand,Property Crime,Burglary,Male,0-12,7846,2238,5608,7461,385
2003,Rural,Andhra Pradesh,Property Crime,Theft,Male,46-60,7817,4959,2858,5043,2774
2003,Urban,Arunachal Pradesh,Crime Against Children,Child Labor,Male,18-30,2194,902,1292,1893,301
2009,Urban,Rajasthan,Crime Against Men,Murder,Male,0-12,4763,223,4540,1727,3036
2009,Rural,Uttar Pradesh,Crime Against Women,Domestic Violence,Male,31-45,1217,1137,80,1159,58
2005,Urban,Mizoram,Crime Against Women,Molestation,Male,18-30,9001,7589,1412,8669,332
2006,Urban,Tamil Nadu,Crime Against Children,Kidnapping,Female,18-30,8092,5318,2774,5830,2262
2008,Urban,Gujarat,Crime Against Women,Domestic Violence,Female,18-30,6594,6486,108,6522,72
2001,Urban,Rajasthan,Property Crime,Theft,Male,31-45,9459,4019,5440,4635,4824
2009,Urban,Nagaland,Crime Against Children,Child Labor,Female,46-60,4441,4389,52,4429,12
2005,Urban,Mizoram,Other Crimes,Drug Offense,Male,18-30,1605,199,1406,569,1036
2001,Urban,Goa,Other Crimes,Cyber Crime,Male,46-60,5929,2106,3823,3964,1965
2004,Urban,Tripura,Other Crimes,Drug Offense,Female,18-30,7045,2699,4346,5473,1572
2008,Urban,Haryana,Crime Against Men,Murder,Male,13-17,2642,232,2410,2627,15
2001,Rural,Odisha,Crime Against Women,Molestation,Female,18-30,4766,948,3818,4238,528
2008,Urban,Punjab,Other Crimes,Cyber Crime,Female,0-12,9826,7720,2106,9632,194
2004,Urban,Karnataka,Property Crime,Vandalism,Male,60+,7718,5316,2402,5538,2180
2006,Rural,Andhra Pradesh,Crime Against Men,Extortion,Male,0-12,3922,1697,2225,2479,1443
2001,Urban,Himachal Pradesh,Crime Against Women,Molestation,Female,18-30,341,67,274,82,259
2001,Rural,Mizoram,Other Crimes,Fraud,Male,46-60,5861,2635,3226,2832,3029
2001,Urban,Bihar,Crime Against Children,Kidnapping,Female,0-12,7294,2331,4963,3722,3572
2001,Urban,Nagaland,Other Crimes,Fraud,Male,46-60,598,193,405,338,260
2006,Urban,Tamil Nadu,Crime Against Children,Child Abuse,Female,46-60,5804,787,5017,787,5017
2007,Urban,Karnataka,Crime Against Men,Robbery,Male,31-45,6375,5414,961,5896,479
2008,Rural,Rajasthan,Crime Against Children,Child Labor,Male,46-60,7514,1705,5809,4810,2704
2006,Rural,Rajasthan,Crime Against Men,Assault,Male,31-45,5429,1989,3440,4548,881
2007,Urban,Jammu & Kashmir,Crime Against Men,Robbery,Female,18-30,7027,2213,4814,5828,1199
2002,Rural,Mizoram,Crime Against Women,Rape,Female,60+,1075,877,198,1028,47
2008,Rural,Odisha,Crime Against Women,Dowry Deaths,Female,31-45,7013,5487,1526,6858,155
2010,Urban,Punjab,Other Crimes,Corruption,Female,18-30,262,49,213,147,115
2005,Rural,Uttar Pradesh,Property Crime,Burglary,Male,0-12,3248,1990,1258,2461,787
2009,Urban,Himachal Pradesh,Crime Against Women,Molestation,Female,60+,6606,2312,4294,3549,3057
2002,Rural,Tripura,Property Crime,Vandalism,Male,13-17,2424,1471,953,2086,338
2001,Rural,Assam,Crime Against Women,Domestic Violence,Female,0-12,957,248,709,513,444
2003,Urban,Manipur,Crime Against Children,Child Labor,Female,13-17,1160,874,286,971,189
2010,Urban,Assam,Other Crimes,Corruption,Female,0-12,1375,1345,30,1368,7
2006,Urban,Punjab,Crime Against Men,Assault,Male,60+,9321,7406,1915,8382,939
2003,Urban,Mizoram,Crime Against Children,Kidnapping,Female,13-17,3076,2659,417,2978,98
2003,Rural,Mizoram,Other Crimes,Drug Offense,Male,46-60,5425,3820,1605,5362,63
2008,Rural,Arunachal Pradesh,Other Crimes,Drug Offense,Female,46-60,8685,5387,3298,6127,2558
2004,Rural,Odisha,Crime Against Women,Molestation,Male,31-45,2211,1443,768,2075,136
2007,Urban,Assam,Other Crimes,Corruption,Female,31-45,9062,1427,7635,5206,3856
2006,Urban,Rajasthan,Crime Against Children,Kidnapping,Male,0-12,3143,1926,1217,2792,351
2010,Rural,Arunachal Pradesh,Crime Against Children,Kidnapping,Female,46-60,2770,335,2435,693,2077
2001,Urban,Tripura,Crime Against Men,Robbery,Male,13-17,684,595,89,644,40
2010,Rural,Meghalaya,Crime Against Women,Dowry Deaths,Female,18-30,7512,6062,1450,6763,749
2007,Urban,Haryana,Crime Against Women,Rape,Male,60+,2436,1333,1103,2327,109
2006,Urban,Manipur,Other Crimes,Fraud,Male,0-12,1089,956,133,974,115
2004,Urban,Bihar,Other Crimes,Cyber Crime,Male,60+,4490,632,3858,4282,208
2006,Urban,Kerala,Property Crime,Vandalism,Male,18-30,5201,170,5031,1450,3751
2003,Rural,Maharashtra,Other Crimes,Corruption,Male,31-45,384,234,150,275,109
2003,Rural,Meghalaya,Property Crime,Vandalism,Male,46-60,5618,4879,739,4913,705
2005,Rural,Manipur,Crime Against Children,Trafficking,Female,60+,7705,5276,2429,6563,1142
2008,Urban,Jammu & Kashmir,Property Crime,Vandalism,Female,13-17,1691,1395,296,1612,79
2005,Urban,Jharkhand,Other Crimes,Fraud,Male,46-60,1422,421,1001,761,661
2002,Rural,Kerala,Other Crimes,Corruption,Female,60+,2871,1382,1489,2578,293
2006,Urban,Haryana,Crime Against Men,Murder,Female,46-60,9340,991,8349,8422,918
2010,Urban,Nagaland,Crime Against Men,Assault,Female,46-60,8929,2702,6227,6867,2062
2005,Urban,Madhya Pradesh,Property Crime,Theft,Male,18-30,6473,2755,3718,5874,599
2002,Rural,Kerala,Other Crimes,Corruption,Male,31-45,8355,7190,1165,7338,1017
2005,Rural,Andhra Pradesh,Other Crimes,Drug Offense,Male,60+,5202,2283,2919,3373,1829
2009,Rural,Haryana,Crime Against Women,Rape,Female,60+,1268,274,994,691,577
2003,Urban,Haryana,Crime Against Men,Robbery,Female,0-12,1645,534,1111,771,874
2009,Urban,Manipur,Property Crime,Burglary,Male,0-12,5557,5317,240,5557,0
2010,Rural,Kerala,Property Crime,Vandalism,Male,60+,5742,415,5327,1057,4685
2010,Rural,Manipur,Crime Against Men,Murder,Female,31-45,4746,314,4432,3733,1013
2009,Urban,Uttarakhand,Property Crime,Vandalism,Male,60+,3296,2034,1262,2293,1003
2007,Rural,Karnataka,Crime Against Women,Rape,Male,31-45,1819,740,1079,1447,372
2001,Rural,Sikkim,Crime Against Men,Murder,Female,31-45,7041,4613,2428,5873,1168
2005,Urban,Haryana,Crime Against Women,Dowry Deaths,Female,13-17,8620,1506,7114,4723,3897
2001,Rural,Sikkim,Crime Against Children,Child Labor,Female,60+,1579,328,1251,1263,316
2009,Urban,Gujarat,Other Crimes,Fraud,Female,46-60,1861,1642,219,1655,206
2006,Rural,Jammu & Kashmir,Other Crimes,Drug Offense,Male,60+,7912,4665,3247,5537,2375
2006,Urban,Tamil Nadu,Crime Against Women,Domestic Violence,Male,46-60,2251,665,1586,1949,302
2007,Urban,Uttar Pradesh,Crime Against Women,Dowry Deaths,Female,0-12,977,210,767,569,408
2003,Urban,Jharkhand,Other Crimes,Cyber Crime,Female,18-30,2216,1573,643,1665,551
2003,Urban,Odisha,Crime Against Children,Child Labor,Female,13-17,62,52,10,57,5
2002,Urban,Manipur,Crime Against Children,Child Abuse,Female,18-30,9402,8963,439,9070,332
2001,Urban,Karnataka,Crime Against Men,Murder,Male,13-17,3166,1134,2032,2259,907
2002,Rural,Odisha,Property Crime,Arson,Female,60+,6591,299,6292,3470,3121
2002,Rural,Mizoram,Property Crime,Theft,Female,60+,5690,4316,1374,5646,44
2009,Rural,Punjab,Crime Against Men,Assault,Female,0-12,832,713,119,780,52
2008,Urban,West Bengal,Property Crime,Burglary,Female,0-12,5228,4004,1224,4867,361
2001,Rural,Arunachal Pradesh,Crime Against Women,Dowry Deaths,Female,0-12,5036,1835,3201,3424,1612
2006,Rural,Andhra Pradesh,Crime Against Men,Extortion,Female,13-17,8842,818,8024,7552,1290
2009,Urban,West Bengal,Crime Against Men,Assault,Female,46-60,5617,240,5377,3212,2405
2005,Urban,Uttarakhand,Other Crimes,Drug Offense,Female,13-17,6165,1950,4215,4216,1949
2009,Urban,Sikkim,Other Crimes,Fraud,Female,0-12,6348,5813,535,6190,158
2004,Rural,Telangana,Property Crime,Vandalism,Female,18-30,1757,891,866,1460,297
2008,Urban,Sikkim,Property Crime,Burglary,Female,0-12,9664,5981,3683,8276,1388
2007,Urban,Punjab,Crime Against Women,Rape,Male,46-60,6638,4702,1936,4809,1829
2009,Rural,Uttarakhand,Crime Against Men,Extortion,Male,0-12,9517,7274,2243,7311,2206
2007,Urban,Rajasthan,Crime Against Men,Extortion,Female,0-12,1574,1179,395,1347,227
2010,Rural,Manipur,Other Crimes,Drug Offense,Male,13-17,7843,3119,4724,4594,3249
2009,Urban,Odisha,Crime Against Women,Rape,Female,60+,6891,4344,2547,4439,2452
2007,Rural,Rajasthan,Crime Against Men,Murder,Male,60+,1219,497,722,1045,174
2008,Urban,Uttar Pradesh,Crime Against Children,Kidnapping,Female,46-60,3878,2475,1403,2540,1338
2007,Rural,Maharashtra,Crime Against Women,Dowry Deaths,Female,31-45,3958,187,3771,2571,1387
2007,Urban,Goa,Property Crime,Arson,Female,31-45,4372,3218,1154,4333,39
2009,Rural,Madhya Pradesh,Property Crime,Burglary,Female,18-30,1067,491,576,768,299
2009,Urban,Delhi,Other Crimes,Fraud,Female,0-12,5812,708,5104,4755,1057
2004,Urban,Maharashtra,Other Crimes,Corruption,Male,18-30,6227,4230,1997,5187,1040
2008,Rural,Assam,Crime Against Women,Molestation,Male,31-45,4639,3642,997,3720,919
2002,Rural,Telangana,Other Crimes,Fraud,Female,0-12,6530,2664,3866,4140,2390
2003,Rural,Rajasthan,Property Crime,Arson,Male,0-12,6593,4352,2241,6262,331
2002,Urban,West Bengal,Other Crimes,Fraud,Female,46-60,9747,3127,6620,5482,4265
2001,Rural,Assam,Crime Against Women,Molestation,Male,18-30,1798,1337,461,1637,161
2004,Urban,Andhra Pradesh,Property Crime,Burglary,Female,31-45,9707,7455,2252,7840,1867
2007,Urban,Chhattisgarh,Crime Against Men,Murder,Female,18-30,7267,2015,5252,4649,2618
2003,Urban,Nagaland,Crime Against Children,Child Abuse,Male,31-45,7576,1719,5857,2789,4787
2009,Urban,Rajasthan,Crime Against Children,Kidnapping,Male,31-45,6115,4812,1303,5258,857
2005,Rural,Gujarat,Crime Against Men,Extortion,Female,31-45,5306,1786,3520,2799,2507
2004,Rural,Rajasthan,Crime Against Women,Dowry Deaths,Male,31-45,5618,2679,2939,4687,931
2004,Urban,Karnataka,Crime Against Men,Robbery,Female,31-45,254,249,5,251,3
2005,Rural,Punjab,Crime Against Women,Domestic Violence,Male,0-12,9393,6713,2680,8546,847
2004,Urban,Nagaland,Property Crime,Vandalism,Male,0-12,1389,1194,195,1218,171
2009,Rural,Mizoram,Other Crimes,Corruption,Male,46-60,9503,4149,5354,4514,4989
2007,Rural,Meghalaya,Crime Against Children,Kidnapping,Male,18-30,1764,218,1546,1732,32
2002,Rural,Arunachal Pradesh,Property Crime,Arson,Female,46-60,8992,8583,409,8958,34
2006,Urban,Tamil Nadu,Crime Against Men,Assault,Female,13-17,119,99,20,103,16
2005,Rural,Nagaland,Crime Against Children,Child Labor,Female,13-17,9033,8975,58,8987,46
2010,Rural,Jammu & Kashmir,Crime Against Women,Dowry Deaths,Female,13-17,4053,1772,2281,1990,2063
2002,Urban,Andhra Pradesh,Crime Against Women,Dowry Deaths,Male,31-45,4694,538,4156,784,3910
2010,Rural,Mizoram,Crime Against Men,Robbery,Male,31-45,481,264,217,391,90
2004,Urban,Arunachal Pradesh,Property Crime,Arson,Female,31-45,4394,321,4073,1686,2708
2010,Urban,Uttarakhand,Other Crimes,Corruption,Male,60+,1698,132,1566,1247,451
2007,Urban,Karnataka,Crime Against Children,Trafficking,Male,46-60,4508,3107,1401,3672,836
2003,Rural,Andhra Pradesh,Crime Against Women,Molestation,Female,46-60,4561,4170,391,4385,176
2003,Rural,Uttar Pradesh,Crime Against Children,Child Abuse,Male,0-12,4184,3761,423,3838,346
2002,Rural,Madhya Pradesh,Crime Against Women,Domestic Violence,Female,60+,4108,1946,2162,2135,1973
2009,Rural,Punjab,Crime Against Children,Child Labor,Female,0-12,5959,4644,1315,5714,245
2010,Rural,Mizoram,Crime Against Children,Trafficking,Female,0-12,4651,1556,3095,2790,1861
2007,Rural,Nagaland,Property Crime,Burglary,Female,60+,5454,1342,4112,1353,4101
2009,Rural,Bihar,Other Crimes,Cyber Crime,Female,0-12,594,571,23,572,22
2005,Rural,Telangana,Other Crimes,Cyber Crime,Male,18-30,9745,413,9332,1300,8445
2002,Rural,Jammu & Kashmir,Property Crime,Burglary,Male,13-17,4731,3972,759,3991,740
2005,Urban,Madhya Pradesh,Other Crimes,Cyber Crime,Female,46-60,271,73,198,76,195
2006,Urban,Goa,Property Crime,Theft,Female,0-12,3131,1720,1411,2218,913
2007,Urban,Rajasthan,Property Crime,Arson,Male,60+,1947,1747,200,1927,20
2002,Rural,Madhya Pradesh,Crime Against Women,Domestic Violence,Male,18-30,9569,1677,7892,6783,2786
2005,Urban,Chhattisgarh,Crime Against Women,Rape,Female,46-60,719,337,382,699,20
2005,Rural,Delhi,Property Crime,Vandalism,Male,13-17,5840,1301,4539,2911,2929
2001,Urban,Assam,Crime Against Children,Trafficking,Female,13-17,5346,3436,1910,4599,747
2002,Rural,Goa,Crime Against Men,Assault,Male,31-45,6560,3862,2698,4745,1815
2006,Urban,Nagaland,Crime Against Children,Trafficking,Female,0-12,7859,1196,6663,7521,338
2004,Urban,Andhra Pradesh,Property Crime,Theft,Male,60+,3043,1761,1282,3003,40
2008,Urban,Manipur,Crime Against Women,Molestation,Male,18-30,3724,187,3537,1650,2074
2002,Rural,Jharkhand,Other Crimes,Corruption,Male,31-45,3983,2415,1568,3606,377
2005,Rural,Madhya Pradesh,Crime Against Children,Child Abuse,Male,0-12,4955,4895,60,4944,11
2009,Urban,Chhattisgarh,Crime Against Men,Robbery,Male,31-45,6256,4985,1271,5861,395
2007,Urban,Manipur,Crime Against Men,Extortion,Female,0-12,8450,4782,3668,6310,2140
2005,Urban,West Bengal,Other Crimes,Fraud,Male,0-12,3148,3019,129,3089,59
2002,Rural,Manipur,Crime Against Children,Child Abuse,Female,31-45,6938,518,6420,3813,3125
2010,Urban,Chhattisgarh,Other Crimes,Corruption,Male,60+,5890,2238,3652,4794,1096
2002,Urban,Manipur,Other Crimes,Cyber Crime,Male,31-45,988,22,966,778,210
2006,Urban,Gujarat,Crime Against Men,Extortion,Male,31-45,9891,7682,2209,7976,1915
2005,Urban,Bihar,Crime Against Women,Domestic Violence,Male,0-12,3901,2675,1226,3179,722
2007,Rural,Himachal Pradesh,Crime Against Men,Murder,Male,13-17,6191,1174,5017,5873,318
2004,Urban,Arunachal Pradesh,Crime Against Women,Dowry Deaths,Male,46-60,1683,580,1103,988,695
2002,Rural,Tripura,Crime Against Children,Trafficking,Male,31-45,3904,2825,1079,3005,899
2010,Rural,Bihar,Crime Against Children,Kidnapping,Male,13-17,5833,1347,4486,1548,4285
2010,Urban,Andhra Pradesh,Crime Against Children,Child Labor,Male,18-30,7497,4505,2992,6246,1251
2005,Rural,Manipur,Crime Against Women,Domestic Violence,Female,18-30,4174,137,4037,3390,784
2005,Urban,Kerala,Crime Against Children,Trafficking,Female,13-17,4109,3775,334,4049,60
2009,Urban,Himachal Pradesh,Crime Against Women,Rape,Female,60+,1848,81,1767,989,859
2004,Urban,Mizoram,Crime Against Women,Dowry Deaths,Female,31-45,3632,241,3391,2545,1087
2009,Urban,Punjab,Crime Against Women,Dowry Deaths,Male,60+,9485,8724,761,9422,63
2007,Rural,Himachal Pradesh,Crime Against Men,Murder,Female,46-60,6822,3210,3612,6443,379
2009,Rural,Arunachal Pradesh,Property Crime,Vandalism,Male,13-17,8567,7030,1537,8007,560
2004,Urban,Odisha,Crime Against Men,Extortion,Female,46-60,8499,4363,4136,8131,368
2002,Rural,Chhattisgarh,Crime Against Men,Extortion,Male,46-60,2641,28,2613,2131,510
2005,Rural,Tripura,Crime Against Women,Domestic Violence,Male,46-60,4005,669,3336,3643,362
2002,Urban,Goa,Crime Against Men,Extortion,Female,46-60,5871,695,5176,3858,2013
2010,Urban,Himachal Pradesh,Property Crime,Vandalism,Female,31-45,885,250,635,471,414
2008,Urban,Uttarakhand,Crime Against Women,Dowry Deaths,Male,18-30,1748,408,1340,1517,231
2005,Urban,Andhra Pradesh,Crime Against Men,Robbery,Female,18-30,5086,4993,93,5027,59
2006,Rural,Himachal Pradesh,Other Crimes,Corruption,Male,18-30,6400,5731,669,6013,387
2008,Rural,Delhi,Crime Against Men,Robbery,Male,13-17,9837,3598,6239,9763,74
2001,Rural,Kerala,Property Crime,Theft,Male,46-60,8151,2359,5792,6604,1547
2005,Urban,Maharashtra,Crime Against Women,Rape,Male,60+,2793,766,2027,2392,401
2002,Rural,Mizoram,Other Crimes,Corruption,Female,31-45,5088,3935,1153,3961,1127
2005,Urban,Nagaland,Property Crime,Theft,Female,46-60,7365,1273,6092,3925,3440
2006,Rural,Rajasthan,Crime Against Children,Trafficking,Male,18-30,9623,4011,5612,7123,2500
2006,Rural,Odisha,Property Crime,Burglary,Female,18-30,2687,314,2373,1974,713
2010,Rural,Goa,Crime Against Women,Dowry Deaths,Male,60+,974,502,472,595,379
2007,Rural,Madhya Pradesh,Crime Against Men,Robbery,Male,60+,680,390,290,662,18
2003,Rural,Goa,Other Crimes,Cyber Crime,Female,46-60,5467,2884,2583,3071,2396
2003,Urban,Madhya Pradesh,Other Crimes,Fraud,Female,60+,6058,5759,299,5921,137
2007,Rural,Andhra Pradesh,Crime Against Children,Child Labor,Female,18-30,336,301,35,308,28
2003,Rural,Karnataka,Crime Against Children,Kidnapping,Female,60+,6616,1499,5117,2105,4511
2002,Urban,Uttar Pradesh,Crime Against Men,Murder,Male,18-30,5180,103,5077,4055,1125
2001,Urban,Odisha,Crime Against Women,Molestation,Female,0-12,6218,3964,2254,6162,56
2007,Urban,West Bengal,Crime Against Men,Murder,Male,18-30,4619,4428,191,4494,125
2005,Urban,Madhya Pradesh,Other Crimes,Fraud,Female,46-60,3915,815,3100,3599,316
2002,Urban,Delhi,Crime Against Men,Robbery,Male,0-12,2585,2307,278,2496,89
2008,Urban,Bihar,Property Crime,Arson,Female,13-17,140,40,100,103,37
2004,Urban,Jammu & Kashmir,Property Crime,Theft,Male,18-30,8537,7757,780,7921,616
2003,Urban,Kerala,Crime Against Women,Rape,Female,18-30,2689,1263,1426,1325,1364
2004,Rural,Tamil Nadu,Crime Against Children,Kidnapping,Male,46-60,4816,2508,2308,2928,1888
2005,Rural,Kerala,Crime Against Women,Domestic Violence,Female,18-30,274,22,252,106,168
2008,Rural,Meghalaya,Property Crime,Burglary,Male,0-12,6847,4141,2706,4239,2608
2004,Rural,Odisha,Property Crime,Theft,Female,13-17,4611,2461,2150,3238,1373
2006,Rural,Meghalaya,Crime Against Women,Dowry Deaths,Female,60+,8574,2929,5645,5048,3526
2006,Urban,Uttarakhand,Crime Against Children,Trafficking,Male,60+,7460,2704,4756,3817,3643
2005,Rural,Punjab,Other Crimes,Cyber Crime,Female,13-17,8189,7072,1117,7519,670
2003,Rural,Andhra Pradesh,Crime Against Children,Child Abuse,Male,60+,2687,1447,1240,2118,569
2009,Rural,Mizoram,Crime Against Men,Murder,Male,13-17,1972,311,1661,718,1254
2007,Rural,Jammu & Kashmir,Property Crime,Theft,Female,0-12,2724,1928,796,2494,230
2001,Rural,Sikkim,Property Crime,Burglary,Female,60+,8820,424,8396,7192,1628
2008,Urban,Mizoram,Crime Against Men,Murder,Female,18-30,1418,1202,216,1330,88
2008,Urban,Bihar,Crime Against Women,Rape,Male,46-60,6307,2983,3324,4674,1633
2001,Rural,Andhra Pradesh,Other Crimes,Cyber Crime,Male,18-30,4826,2574,2252,4763,63
2008,Rural,Telangana,Crime Against Children,Child Labor,Male,18-30,1354,596,758,1218,136
2009,Urban,Mizoram,Property Crime,Arson,Male,0-12,547,216,331,252,295
2007,Urban,Sikkim,Crime Against Men,Assault,Female,13-17,2739,250,2489,1046,1693
2007,Urban,Uttar Pradesh,Other Crimes,Corruption,Female,60+,8034,1660,6374,6943,1091
2001,Urban,Jharkhand,Property Crime,Vandalism,Male,31-45,9954,4174,5780,9315,639
2009,Urban,Gujarat,Property Crime,Vandalism,Male,18-30,8641,2972,5669,4682,3959
2008,Urban,Sikkim,Property Crime,Burglary,Male,18-30,2985,2434,551,2865,120
2005,Urban,West Bengal,Crime Against Women,Molestation,Female,13-17,1811,1422,389,1643,168
2006,Urban,Uttarakhand,Other Crimes,Corruption,Male,46-60,1874,338,1536,1059,815
2006,Rural,Arunachal Pradesh,Crime Against Men,Extortion,Female,60+,8354,4065,4289,7702,652
2004,Urban,Odisha,Crime Against Women,Rape,Male,18-30,3203,678,2525,1382,1821
2001,Urban,Meghalaya,Property Crime,Theft,Male,31-45,4154,1737,2417,4092,62
2002,Rural,Sikkim,Crime Against Children,Kidnapping,Male,0-12,1813,178,1635,1418,395
2006,Rural,Maharashtra,Crime Against Children,Child Labor,Male,46-60,8382,4695,3687,6645,1737
2004,Rural,Rajasthan,Crime Against Children,Trafficking,Male,0-12,3688,2920,768,3157,531
2004,Urban,Mizoram,Other Crimes,Corruption,Female,0-12,9295,7324,1971,9107,188
2007,Urban,Uttarakhand,Crime Against Children,Child Abuse,Female,46-60,3020,790,2230,2165,855
2010,Rural,Jharkhand,Other Crimes,Corruption,Male,60+,8870,4742,4128,8536,334
2009,Urban,Rajasthan,Crime Against Women,Domestic Violence,Female,0-12,7936,4738,3198,5097,2839
2006,Rural,Telangana,Crime Against Children,Trafficking,Female,60+,1769,1243,526,1701,68
2001,Urban,Assam,Crime Against Men,Murder,Female,46-60,8877,6785,2092,8214,663
2002,Urban,Maharashtra,Crime Against Children,Trafficking,Male,18-30,4524,2700,1824,3852,672
2003,Rural,Gujarat,Crime Against Children,Kidnapping,Male,13-17,6963,2649,4314,6907,56
2009,Rural,Karnataka,Crime Against Men,Extortion,Female,0-12,3133,516,2617,2894,239
2004,Urban,Nagaland,Crime Against Men,Robbery,Female,18-30,8306,346,7960,2252,6054
2006,Urban,Gujarat,Crime Against Men,Assault,Male,31-45,6892,4378,2514,6178,714
2005,Urban,Kerala,Crime Against Men,Robbery,Male,13-17,9739,5098,4641,5654,4085
2002,Urban,Mizoram,Crime Against Children,Child Abuse,Female,31-45,5987,1966,4021,5246,741
2005,Rural,Mizoram,Crime Against Women,Dowry Deaths,Male,13-17,2385,1793,592,2104,281
2002,Rural,Punjab,Crime Against Men,Assault,Female,31-45,1450,1161,289,1203,247
2008,Rural,Chhattisgarh,Property Crime,Burglary,Male,60+,7577,4743,2834,6310,1267
2005,Rural,Punjab,Crime Against Men,Assault,Male,60+,5317,388,4929,2827,2490
2007,Urban,Gujarat,Crime Against Children,Trafficking,Female,60+,1171,824,347,1064,107
2009,Rural,Haryana,Crime Against Men,Assault,Male,18-30,9269,1733,7536,2010,7259
2006,Rural,Telangana,Property Crime,Arson,Female,13-17,8060,6893,1167,7395,665
2006,Urban,Jharkhand,Crime Against Men,Extortion,Female,18-30,9451,9370,81,9445,6
2004,Rural,Arunachal Pradesh,Other Crimes,Cyber Crime,Male,0-12,1787,774,1013,1583,204
2004,Urban,Uttarakhand,Property Crime,Burglary,Male,13-17,6688,1009,5679,2779,3909
2010,Urban,Sikkim,Other Crimes,Fraud,Female,60+,7166,1441,5725,5725,1441
2010,Rural,Goa,Crime Against Women,Domestic Violence,Male,18-30,7568,2223,5345,2890,4678
2005,Urban,Goa,Crime Against Women,Molestation,Female,13-17,9607,7252,2355,8147,1460
2002,Urban,Chhattisgarh,Other Crimes,Drug Offense,Female,46-60,946,641,305,850,96
2008,Urban,Himachal Pradesh,Crime Against Men,Robbery,Male,46-60,3285,372,2913,2129,1156
2007,Urban,Uttar Pradesh,Property Crime,Theft,Male,31-45,3033,27,3006,1537,1496
2010,Rural,Delhi,Crime Against Men,Murder,Male,0-12,8374,1788,6586,3520,4854
2001,Urban,Rajasthan,Property Crime,Theft,Male,31-45,5024,165,4859,2899,2125
2008,Rural,Haryana,Other Crimes,Corruption,Male,31-45,4965,4001,964,4072,893
2006,Rural,Assam,Property Crime,Burglary,Female,13-17,3542,671,2871,2400,1142
2003,Rural,Nagaland,Crime Against Men,Robbery,Female,60+,9527,1404,8123,5181,4346
2007,Urban,Mizoram,Crime Against Men,Robbery,Female,0-12,1621,1143,478,1444,177
2002,Rural,Uttar Pradesh,Crime Against Children,Child Labor,Female,0-12,7662,5486,2176,6701,961
2002,Rural,Jammu & Kashmir,Crime Against Children,Trafficking,Male,13-17,9770,3849,5921,4372,5398
2006,Rural,Sikkim,Crime Against Men,Extortion,Female,13-17,6924,4524,2400,5945,979
2007,Urban,Gujarat,Crime Against Women,Rape,Male,46-60,132,84,48,132,0
2003,Urban,West Bengal,Crime Against Women,Molestation,Female,60+,5392,4212,1180,4633,759
2001,Rural,Uttarakhand,Crime Against Women,Domestic Violence,Female,31-45,643,111,532,535,108
2001,Urban,Andhra Pradesh,Crime Against Women,Domestic Violence,Female,46-60,5208,2331,2877,4332,876
2001,Urban,Himachal Pradesh,Property Crime,Arson,Male,46-60,3097,2533,564,2900,197
2002,Urban,Punjab,Crime Against Men,Murder,Female,60+,6046,5297,749,5582,464
2003,Rural,Chhattisgarh,Crime Against Men,Robbery,Male,0-12,8788,6264,2524,8507,281
2002,Rural,Goa,Crime Against Women,Molestation,Male,46-60,1971,925,1046,1393,578
2006,Rural,Nagaland,Property Crime,Theft,Female,46-60,4070,755,3315,3092,978
2004,Rural,West Bengal,Crime Against Men,Assault,Male,18-30,455,119,336,442,13
2002,Rural,Mizoram,Crime Against Men,Robbery,Female,13-17,3460,1421,2039,1890,1570
2008,Rural,Bihar,Property Crime,Vandalism,Male,31-45,6273,3423,2850,3989,2284
2002,Rural,Karnataka,Crime Against Children,Child Abuse,Female,0-12,1978,1593,385,1803,175
2006,Rural,Odisha,Crime Against Men,Murder,Male,18-30,8027,3896,4131,7079,948
2010,Urban,Punjab,Crime Against Women,Molestation,Female,0-12,5727,4564,1163,5480,247
2003,Rural,Karnataka,Crime Against Women,Dowry Deaths,Male,46-60,1371,1236,135,1334,37
2002,Urban,Meghalaya,Crime Against Men,Extortion,Male,31-45,7245,680,6565,2544,4701
2004,Urban,Kerala,Crime Against Men,Murder,Male,13-17,5131,3854,1277,4873,258
2001,Rural,Punjab,Crime Against Children,Trafficking,Male,31-45,9234,8206,1028,9204,30
2008,Urban,Jammu & Kashmir,Crime Against Men,Murder,Male,18-30,7068,1141,5927,2125,4943
2004,Rural,Odisha,Crime Against Men,Assault,Female,13-17,8783,5627,3156,7393,1390
2007,Rural,Telangana,Other Crimes,Drug Offense,Female,60+,3357,738,2619,1877,1480
2008,Rural,Maharashtra,Crime Against Children,Kidnapping,Male,13-17,261,227,34,235,26
2007,Urban,Andhra Pradesh,Property Crime,Burglary,Female,46-60,8351,3567,4784,4651,3700
2003,Rural,Bihar,Crime Against Women,Rape,Female,18-30,7606,7494,112,7600,6
2004,Rural,Jammu & Kashmir,Crime Against Men,Extortion,Female,46-60,4895,2733,2162,3871,1024
2004,Rural,Punjab,Crime Against Men,Assault,Female,0-12,4936,3825,1111,4775,161
2007,Urban,Himachal Pradesh,Property Crime,Theft,Female,18-30,5769,1711,4058,4142,1627
2005,Rural,Haryana,Crime Against Children,Trafficking,Female,60+,5215,2245,2970,2775,2440
2010,Rural,Haryana,Other Crimes,Drug Offense,Female,18-30,9839,6891,2948,8691,1148
2010,Rural,Bihar,Crime Against Men,Murder,Female,46-60,6843,4099,2744,5882,961
2003,Urban,Manipur,Crime Against Men,Robbery,Female,13-17,4355,2966,1389,3087,1268
2006,Urban,Gujarat,Other Crimes,Corruption,Female,46-60,632,304,328,311,321
2001,Urban,Chhattisgarh,Crime Against Children,Kidnapping,Male,46-60,3649,313,3336,1608,2041
2009,Urban,Arunachal Pradesh,Other Crimes,Drug Offense,Male,60+,6380,6047,333,6061,319
2007,Urban,Delhi,Other Crimes,Corruption,Female,60+,4821,2900,1921,3213,1608
2007,Rural,Nagaland,Property Crime,Arson,Female,13-17,4572,4544,28,4546,26
2004,Rural,Nagaland,Other Crimes,Corruption,Male,13-17,4024,1755,2269,2973,1051
2004,Urban,Gujarat,Property Crime,Burglary,Male,18-30,7470,4732,2738,5640,1830
2007,Urban,Nagaland,Crime Against Children,Child Labor,Male,46-60,6295,6021,274,6086,209
2004,Urban,Manipur,Crime Against Children,Trafficking,Male,0-12,276,239,37,274,2
2001,Rural,Haryana,Other Crimes,Fraud,Male,18-30,7591,3595,3996,6987,604
2008,Urban,Kerala,Other Crimes,Drug Offense,Male,0-12,676,403,273,448,228
2003,Rural,Uttarakhand,Other Crimes,Fraud,Female,60+,2155,1545,610,1974,181
2005,Urban,Haryana,Crime Against Women,Molestation,Female,18-30,8918,5259,3659,8600,318
2004,Rural,Mizoram,Crime Against Men,Murder,Female,0-12,5039,3931,1108,4919,120
2001,Urban,Maharashtra,Crime Against Women,Rape,Female,0-12,6105,4072,2033,4418,1687
2003,Urban,Arunachal Pradesh,Crime Against Women,Dowry Deaths,Male,0-12,9643,6905,2738,9474,169
2003,Rural,Mizoram,Other Crimes,Drug Offense,Female,18-30,3385,430,2955,2014,1371
2002,Urban,Meghalaya,Crime Against Children,Child Labor,Female,13-17,2982,840,2142,2004,978
2008,Urban,Arunachal Pradesh,Crime Against Children,Trafficking,Female,0-12,9373,3580,5793,6939,2434
2002,Rural,Delhi,Crime Against Women,Domestic Violence,Female,31-45,1381,1264,117,1338,43
2010,Rural,Maharashtra,Crime Against Women,Molestation,Male,31-45,766,401,365,668,98
2007,Rural,Punjab,Crime Against Children,Child Abuse,Female,46-60,8038,6534,1504,6866,1172
2008,Urban,Rajasthan,Crime Against Women,Rape,Female,60+,2737,2103,634,2658,79
2002,Rural,Assam,Other Crimes,Drug Offense,Male,60+,1195,521,674,1137,58
2008,Rural,Gujarat,Crime Against Women,Domestic Violence,Female,18-30,3175,1472,1703,2669,506
2002,Urban,Himachal Pradesh,Crime Against Women,Rape,Male,46-60,2656,490,2166,2554,102
2005,Rural,Rajasthan,Crime Against Men,Extortion,Female,0-12,5101,1113,3988,4664,437
2007,Urban,Assam,Crime Against Children,Trafficking,Male,13-17,8607,4780,3827,6374,2233
2005,Urban,Delhi,Property Crime,Arson,Female,31-45,300,103,197,256,44
2004,Rural,Nagaland,Crime Against Men,Assault,Male,31-45,224,78,146,223,1
2001,Rural,Maharashtra,Crime Against Women,Molestation,Female,60+,6411,1353,5058,4046,2365
2005,Rural,Himachal Pradesh,Property Crime,Burglary,Female,18-30,6328,2969,3359,3452,2876
2010,Rural,Odisha,Crime Against Children,Child Abuse,Male,31-45,4861,3145,1716,4045,816
2009,Urban,Manipur,Property Crime,Arson,Male,0-12,8611,7392,1219,8261,350
2009,Rural,Gujarat,Property Crime,Burglary,Male,0-12,489,105,384,310,179
2001,Rural,Goa,Crime Against Women,Dowry Deaths,Female,46-60,1182,471,711,963,219
2002,Urban,Jammu & Kashmir,Crime Against Men,Extortion,Male,31-45,520,456,64,479,41
2001,Urban,Tamil Nadu,Property Crime,Theft,Female,46-60,1733,1697,36,1714,19
2005,Rural,Assam,Other Crimes,Cyber Crime,Female,13-17,1114,150,964,183,931
2009,Rural,Telangana,Crime Against Children,Trafficking,Male,60+,4509,4312,197,4320,189
2004,Rural,Jammu & Kashmir,Crime Against Men,Assault,Female,18-30,9786,8352,1434,9015,771
2008,Urban,Assam,Crime Against Women,Molestation,Male,46-60,3781,2947,834,3481,300
2005,Rural,Tripura,Other Crimes,Corruption,Male,31-45,3047,1104,1943,1859,1188
2008,Urban,Goa,Other Crimes,Drug Offense,Female,46-60,761,306,455,358,403
2001,Rural,Assam,Crime Against Men,Assault,Male,46-60,2631,1715,916,2224,407
2001,Rural,Odisha,Crime Against Men,Robbery,Male,60+,6824,2003,4821,4556,2268
2007,Rural,Jharkhand,Crime Against Women,Rape,Male,0-12,9447,7342,2105,8039,1408
2005,Rural,Meghalaya,Crime Against Children,Trafficking,Male,31-45,7547,1891,5656,2242,5305
2009,Urban,West Bengal,Crime Against Men,Extortion,Female,46-60,2466,1648,818,2162,304
2003,Rural,Karnataka,Property Crime,Arson,Male,46-60,6098,4494,1604,4937,1161
2010,Urban,Delhi,Crime Against Women,Molestation,Female,13-17,3594,2339,1255,3491,103
2003,Rural,Bihar,Property Crime,Theft,Female,31-45,5780,636,5144,4250,1530
2002,Urban,Manipur,Crime Against Women,Molestation,Male,13-17,5111,2251,2860,4833,278
2007,Urban,Himachal Pradesh,Other Crimes,Drug Offense,Male,46-60,8905,6860,2045,7384,1521
2001,Urban,Odisha,Crime Against Children,Kidnapping,Female,46-60,945,594,351,935,10
2003,Urban,Odisha,Property Crime,Vandalism,Male,60+,6686,78,6608,6231,455
2002,Urban,Himachal Pradesh,Other Crimes,Cyber Crime,Male,60+,1732,1552,180,1660,72
2006,Urban,Goa,Crime Against Women,Dowry Deaths,Male,60+,7216,3004,4212,3638,3578
2009,Urban,Himachal Pradesh,Crime Against Men,Robbery,Female,60+,99,2,97,96,3
2008,Rural,Maharashtra,Crime Against Children,Trafficking,Female,13-17,7732,3407,4325,4771,2961
2006,Rural,Tamil Nadu,Crime Against Women,Domestic Violence,Male,0-12,2872,131,2741,2479,393
2010,Urban,Uttar Pradesh,Crime Against Women,Rape,Female,0-12,3293,2947,346,3121,172
2009,Rural,Karnataka,Crime Against Women,Molestation,Male,0-12,742,476,266,691,51
2009,Rural,Maharashtra,Crime Against Children,Kidnapping,Male,18-30,7128,5523,1605,6481,647
2010,Rural,Maharashtra,Property Crime,Vandalism,Male,60+,9771,999,8772,8600,1171
2001,Rural,Uttarakhand,Crime Against Women,Rape,Male,0-12,2045,674,1371,1472,573
2007,Rural,Uttarakhand,Other Crimes,Drug Offense,Female,0-12,5416,2156,3260,4230,1186
2001,Urban,Sikkim,Other Crimes,Fraud,Male,46-60,4323,130,4193,4313,10
2003,Urban,Jharkhand,Property Crime,Burglary,Male,46-60,7161,3328,3833,6241,920
2001,Rural,Madhya Pradesh,Property Crime,Arson,Male,13-17,5199,4068,1131,5051,148
2001,Urban,West Bengal,Other Crimes,Cyber Crime,Male,46-60,6323,4739,1584,5680,643
2008,Rural,Delhi,Crime Against Children,Child Abuse,Female,18-30,400,350,50,371,29
2005,Urban,Maharashtra,Other Crimes,Fraud,Female,0-12,1965,770,1195,812,1153
2004,Rural,West Bengal,Crime Against Children,Kidnapping,Male,46-60,6657,2734,3923,3832,2825
2001,Urban,Gujarat,Other Crimes,Drug Offense,Female,13-17,4833,1905,2928,2176,2657
2001,Urban,Bihar,Crime Against Men,Robbery,Female,18-30,6300,87,6213,2436,3864
2002,Urban,Gujarat,Crime Against Women,Rape,Female,60+,5324,1408,3916,2534,2790
2001,Rural,Uttar Pradesh,Property Crime,Theft,Female,18-30,4389,36,4353,2854,1535
2008,Rural,Uttar Pradesh,Crime Against Women,Dowry Deaths,Female,46-60,1774,482,1292,1006,768
2007,Rural,Haryana,Crime Against Women,Molestation,Female,0-12,7119,5543,1576,5981,1138
2008,Rural,Telangana,Crime Against Men,Murder,Female,31-45,8096,474,7622,8087,9
2004,Rural,Karnataka,Crime Against Children,Child Abuse,Female,13-17,4729,4460,269,4466,263
2010,Urban,Himachal Pradesh,Crime Against Women,Domestic Violence,Female,0-12,4226,651,3575,2890,1336
2010,Urban,Tamil Nadu,Crime Against Women,Rape,Female,18-30,7530,658,6872,2660,4870
2005,Rural,Chhattisgarh,Property Crime,Burglary,Male,0-12,8345,3431,4914,4605,3740
2006,Rural,Madhya Pradesh,Crime Against Men,Assault,Female,31-45,3338,2715,623,2995,343
2007,Urban,Assam,Crime Against Men,Assault,Male,18-30,7595,6070,1525,6134,1461
2008,Rural,Sikkim,Property Crime,Vandalism,Male,60+,1648,1239,409,1463,185
2007,Urban,Tamil Nadu,Property Crime,Theft,Female,18-30,7609,3666,3943,4617,2992
2002,Rural,Uttar Pradesh,Other Crimes,Corruption,Male,18-30,9267,1692,7575,8173,1094
2006,Rural,Karnataka,Property Crime,Vandalism,Female,60+,3518,2871,647,2877,641
2010,Urban,Assam,Crime Against Men,Extortion,Female,0-12,3618,1231,2387,2597,1021
2008,Rural,Andhra Pradesh,Other Crimes,Corruption,Female,60+,5488,3241,2247,4439,1049
2001,Rural,Chhattisgarh,Crime Against Women,Molestation,Female,18-30,6054,2988,3066,4373,1681
2001,Rural,Uttar Pradesh,Crime Against Women,Domestic Violence,Female,0-12,7403,1197,6206,5302,2101
2005,Rural,Assam,Other Crimes,Corruption,Female,13-17,4234,3406,828,3886,348
2002,Urban,Rajasthan,Property Crime,Arson,Male,46-60,2810,1769,1041,2651,159
2006,Urban,Karnataka,Property Crime,Vandalism,Male,18-30,2943,2306,637,2678,265
2002,Rural,Andhra Pradesh,Crime Against Men,Robbery,Male,0-12,7774,2095,5679,4167,3607
2002,Rural,Kerala,Property Crime,Theft,Female,13-17,5153,4207,946,4647,506
2001,Urban,Telangana,Crime Against Men,Assault,Male,60+,7523,2775,4748,6844,679
2007,Urban,Arunachal Pradesh,Crime Against Men,Murder,Female,60+,1668,866,802,1376,292
2010,Urban,Manipur,Crime Against Women,Molestation,Male,31-45,248,187,61,227,21
2006,Rural,Odisha,Crime Against Men,Assault,Male,46-60,9260,5762,3498,7546,1714
2006,Urban,Rajasthan,Other Crimes,Fraud,Female,31-45,1008,386,622,721,287
2005,Rural,Gujarat,Other Crimes,Drug Offense,Male,31-45,4231,597,3634,2935,1296
2002,Rural,Mizoram,Property Crime,Vandalism,Male,13-17,4380,512,3868,2997,1383
2005,Rural,Sikkim,Other Crimes,Corruption,Male,46-60,8676,3205,5471,4699,3977
2002,Rural,Kerala,Crime Against Men,Murder,Male,18-30,4142,2572,1570,3667,475
2003,Rural,Tripura,Property Crime,Vandalism,Male,46-60,7392,2866,4526,5648,1744
2009,Rural,Gujarat,Property Crime,Arson,Male,46-60,3805,1332,2473,1840,1965
2010,Urban,Goa,Crime Against Children,Child Labor,Female,0-12,8868,8741,127,8815,53
2009,Rural,Nagaland,Crime Against Children,Child Labor,Male,60+,2770,2473,297,2507,263
2007,Rural,Telangana,Crime Against Women,Dowry Deaths,Male,0-12,9381,7769,1612,8486,895
2010,Rural,Sikkim,Crime Against Men,Assault,Male,46-60,6373,2447,3926,5501,872
2009,Rural,Delhi,Crime Against Children,Kidnapping,Female,0-12,2295,2072,223,2217,78
2001,Urban,Delhi,Crime Against Women,Domestic Violence,Female,0-12,3378,115,3263,3140,238
2008,Rural,Uttar Pradesh,Other Crimes,Fraud,Female,31-45,5681,1683,3998,2886,2795
2001,Urban,Andhra Pradesh,Property Crime,Burglary,Female,46-60,7063,4077,2986,5188,1875
2009,Rural,Tripura,Crime Against Men,Robbery,Female,13-17,606,270,336,495,111
2003,Urban,Haryana,Other Crimes,Corruption,Male,13-17,5397,1581,3816,3354,2043
2004,Urban,Nagaland,Property Crime,Burglary,Female,18-30,8441,7668,773,7877,564
2001,Rural,Haryana,Crime Against Children,Child Labor,Female,0-12,1626,240,1386,1262,364
2009,Urban,Assam,Property Crime,Arson,Male,60+,1168,1085,83,1156,12
2006,Rural,Andhra Pradesh,Crime Against Children,Kidnapping,Female,31-45,1292,51,1241,153,1139
2006,Rural,Tripura,Crime Against Children,Trafficking,Female,18-30,8255,5587,2668,8131,124
2006,Rural,Bihar,Property Crime,Vandalism,Male,60+,6201,1216,4985,5367,834
2001,Urban,Jammu & Kashmir,Crime Against Children,Child Abuse,Female,46-60,2145,835,1310,2098,47
2002,Rural,Rajasthan,Crime Against Women,Dowry Deaths,Male,31-45,5403,497,4906,2307,3096
2004,Urban,Gujarat,Crime Against Women,Rape,Male,46-60,8822,6946,1876,7841,981
2004,Urban,Tamil Nadu,Other Crimes,Cyber Crime,Male,60+,5467,875,4592,1057,4410
2003,Rural,Haryana,Crime Against Women,Rape,Male,13-17,5350,3938,1412,4118,1232
2008,Urban,Himachal Pradesh,Crime Against Children,Trafficking,Male,18-30,3407,62,3345,1422,1985
2001,Urban,Uttar Pradesh,Crime Against Women,Domestic Violence,Female,0-12,4287,1832,2455,2655,1632
2007,Urban,Arunachal Pradesh,Other Crimes,Fraud,Male,46-60,463,391,72,427,36
2006,Rural,Tamil Nadu,Other Crimes,Corruption,Male,46-60,8093,232,7861,3075,5018
2007,Rural,Mizoram,Crime Against Children,Child Abuse,Female,18-30,490,395,95,480,10
2009,Urban,Uttar Pradesh,Crime Against Children,Child Abuse,Male,46-60,7561,365,7196,1059,6502
2004,Rural,Goa,Crime Against Children,Child Abuse,Female,60+,4032,1461,2571,2584,1448
2010,Rural,Assam,Other Crimes,Fraud,Female,18-30,1094,306,788,848,246
2001,Rural,Kerala,Crime Against Men,Robbery,Male,0-12,1378,1166,212,1192,186
2010,Rural,Haryana,Other Crimes,Cyber Crime,Male,18-30,3644,2720,924,3267,377
2008,Rural,Bihar,Crime Against Children,Child Abuse,Female,0-12,3598,3543,55,3561,37
2010,Rural,Bihar,Other Crimes,Drug Offense,Female,31-45,2948,394,2554,2129,819
2003,Rural,Chhattisgarh,Crime Against Men,Extortion,Male,0-12,4407,1711,2696,3995,412
2004,Urban,Jammu & Kashmir,Other Crimes,Fraud,Female,46-60,3290,431,2859,2521,769
2009,Rural,Assam,Property Crime,Theft,Female,46-60,2699,1539,1160,2181,518
2003,Urban,Goa,Other Crimes,Corruption,Male,60+,5867,777,5090,1511,4356
2007,Rural,Arunachal Pradesh,Crime Against Children,Trafficking,Male,60+,7832,1987,5845,2252,5580
2007,Rural,Karnataka,Crime Against Men,Robbery,Female,13-17,9319,4709,4610,6003,3316
2010,Rural,Haryana,Property Crime,Arson,Female,13-17,8005,573,7432,2075,5930
2008,Urban,Rajasthan,Other Crimes,Fraud,Male,46-60,2222,2016,206,2108,114
2010,Urban,West Bengal,Other Crimes,Drug Offense,Male,0-12,7633,712,6921,1822,5811
2003,Rural,Tamil Nadu,Property Crime,Theft,Male,46-60,2701,2002,699,2680,21
2009,Urban,Assam,Crime Against Men,Assault,Male,46-60,685,559,126,596,89
2009,Rural,Nagaland,Crime Against Women,Domestic Violence,Female,18-30,3984,2337,1647,3188,796
2002,Urban,Bihar,Crime Against Women,Dowry Deaths,Male,0-12,393,383,10,392,1
2007,Urban,Kerala,Crime Against Children,Trafficking,Male,13-17,4931,4254,677,4469,462
2010,Urban,Goa,Crime Against Men,Murder,Male,0-12,8253,7860,393,8004,249
2005,Urban,Arunachal Pradesh,Other Crimes,Cyber Crime,Female,18-30,6058,270,5788,3620,2438
2009,Rural,Kerala,Crime Against Children,Trafficking,Female,46-60,1230,466,764,688,542
2007,Urban,Uttarakhand,Property Crime,Burglary,Male,60+,5390,825,4565,2384,3006
2010,Urban,Punjab,Crime Against Men,Murder,Male,46-60,5789,5039,750,5170,619
2004,Urban,Bihar,Property Crime,Arson,Male,31-45,7440,5663,1777,6058,1382
2001,Rural,Assam,Crime Against Men,Assault,Female,13-17,3332,1346,1986,2286,1046
2008,Rural,Bihar,Crime Against Men,Murder,Male,31-45,4086,1392,2694,2935,1151
2010,Rural,Bihar,Crime Against Men,Murder,Female,0-12,8032,3233,4799,3323,4709
2010,Rural,Tamil Nadu,Crime Against Children,Child Labor,Female,0-12,2495,1147,1348,1858,637
2003,Urban,Rajasthan,Crime Against Women,Molestation,Female,13-17,1410,66,1344,991,419
2001,Urban,Punjab,Property Crime,Arson,Male,0-12,965,318,647,757,208
2003,Rural,Uttar Pradesh,Property Crime,Theft,Male,18-30,1922,1897,25,1903,19
2008,Rural,Tripura,Crime Against Women,Rape,Male,13-17,5957,1963,3994,2637,3320
2006,Urban,Goa,Property Crime,Arson,Male,0-12,1845,805,1040,1658,187
2004,Urban,Telangana,Other Crimes,Corruption,Male,31-45,2677,392,2285,1318,1359
2010,Urban,Karnataka,Crime Against Children,Child Abuse,Female,60+,2063,1264,799,1988,75
2003,Urban,Kerala,Other Crimes,Corruption,Male,13-17,7256,1123,6133,2558,4698
2007,Rural,Telangana,Other Crimes,Corruption,Male,13-17,3479,3000,479,3081,398
2008,Rural,Chhattisgarh,Other Crimes,Corruption,Female,13-17,2652,1220,1432,1391,1261
2004,Urban,Jammu & Kashmir,Crime Against Men,Robbery,Male,60+,9231,7266,1965,7786,1445
2004,Urban,Punjab,Crime Against Women,Dowry Deaths,Male,31-45,4549,4023,526,4122,427
2006,Rural,Manipur,Other Crimes,Fraud,Female,0-12,8565,8548,17,8559,6
2005,Urban,Chhattisgarh,Crime Against Men,Extortion,Male,13-17,2877,1801,1076,1808,1069
2002,Rural,Rajasthan,Crime Against Women,Dowry Deaths,Female,18-30,6480,1904,4576,5322,1158
2007,Rural,Jammu & Kashmir,Other Crimes,Drug Offense,Male,60+,783,268,515,692,91
2002,Urban,Sikkim,Other Crimes,Corruption,Male,0-12,4324,1357,2967,3311,1013
2010,Rural,Odisha,Crime Against Women,Molestation,Male,31-45,3849,2404,1445,2949,900
2010,Rural,Delhi,Property Crime,Theft,Male,13-17,3784,3582,202,3749,35
2007,Rural,Haryana,Property Crime,Vandalism,Female,0-12,2471,553,1918,1270,1201
2005,Urban,Karnataka,Crime Against Children,Child Abuse,Male,31-45,9420,6813,2607,6862,2558
2009,Rural,Chhattisgarh,Crime Against Men,Assault,Female,13-17,3026,1389,1637,1463,1563
2002,Rural,Arunachal Pradesh,Property Crime,Theft,Male,0-12,8161,170,7991,2202,5959
2004,Urban,Uttar Pradesh,Crime Against Women,Rape,Male,18-30,3613,3153,460,3273,340
2001,Rural,Madhya Pradesh,Other Crimes,Drug Offense,Female,0-12,6043,5849,194,5900,143
2007,Rural,Chhattisgarh,Crime Against Women,Molestation,Female,31-45,4986,1399,3587,1867,3119
2001,Rural,Uttarakhand,Crime Against Children,Child Abuse,Female,60+,3735,2761,974,3569,166
2006,Urban,Madhya Pradesh,Crime Against Men,Murder,Male,13-17,6397,225,6172,5019,1378
2010,Urban,Sikkim,Other Crimes,Drug Offense,Female,46-60,2367,1906,461,1978,389
2009,Rural,Nagaland,Other Crimes,Fraud,Male,31-45,3957,2237,1720,3473,484
2001,Rural,Maharashtra,Crime Against Children,Trafficking,Female,0-12,7833,5406,2427,6142,1691
2009,Urban,Sikkim,Crime Against Men,Murder,Male,31-45,368,133,235,215,153
2005,Urban,Uttarakhand,Crime Against Children,Child Labor,Female,13-17,7990,1629,6361,6699,1291
2001,Rural,Madhya Pradesh,Crime Against Women,Dowry Deaths,Female,60+,1941,183,1758,1415,526
2002,Rural,Andhra Pradesh,Other Crimes,Corruption,Female,13-17,1182,675,507,687,495
2006,Urban,Madhya Pradesh,Other Crimes,Drug Offense,Female,18-30,179,145,34,149,30
2006,Rural,Rajasthan,Crime Against Women,Domestic Violence,Female,13-17,5758,4845,913,4952,806
2006,Rural,Goa,Crime Against Men,Murder,Female,18-30,2013,1048,965,1286,727
2002,Urban,West Bengal,Property Crime,Theft,Male,13-17,1994,1896,98,1948,46
2009,Urban,Chhattisgarh,Property Crime,Burglary,Female,60+,1534,462,1072,688,846
2009,Urban,Jharkhand,Property Crime,Burglary,Male,46-60,1776,1480,296,1764,12
2003,Rural,Delhi,Other Crimes,Cyber Crime,Male,0-12,3988,3309,679,3750,238
2009,Rural,Gujarat,Crime Against Children,Child Labor,Female,46-60,5418,3840,1578,3950,1468
2006,Rural,Madhya Pradesh,Crime Against Men,Murder,Male,46-60,3534,3465,69,3474,60
2010,Rural,Delhi,Crime Against Women,Molestation,Female,13-17,3550,647,2903,3238,312
2002,Rural,Sikkim,Crime Against Men,Murder,Female,18-30,121,55,66,68,53
2006,Urban,Bihar,Other Crimes,Drug Offense,Female,18-30,2091,703,1388,727,1364
2006,Rural,Rajasthan,Crime Against Women,Molestation,Female,13-17,8652,3878,4774,6555,2097
2004,Urban,Nagaland,Crime Against Children,Trafficking,Male,46-60,1012,466,546,808,204
2005,Urban,Assam,Crime Against Men,Murder,Male,0-12,8409,7217,1192,7674,735
2008,Rural,Sikkim,Crime Against Children,Trafficking,Male,31-45,3027,2369,658,2728,299
2002,Urban,Mizoram,Other Crimes,Fraud,Male,0-12,1853,680,1173,927,926
2002,Urban,Assam,Crime Against Women,Molestation,Female,60+,6321,5326,995,5460,861
2008,Rural,Arunachal Pradesh,Other Crimes,Cyber Crime,Female,46-60,7342,4816,2526,5364,1978
2003,Urban,Assam,Crime Against Children,Trafficking,Female,18-30,518,123,395,410,108
2001,Urban,Jammu & Kashmir,Crime Against Women,Domestic Violence,Female,18-30,8660,1011,7649,5212,3448
2009,Rural,Haryana,Other Crimes,Corruption,Female,60+,8737,6632,2105,7729,1008
2010,Urban,Jammu & Kashmir,Crime Against Children,Kidnapping,Male,0-12,2548,2200,348,2539,9
2007,Rural,Maharashtra,Crime Against Men,Robbery,Female,0-12,7782,3392,4390,4545,3237
2009,Rural,Punjab,Crime Against Women,Dowry Deaths,Male,13-17,8326,6894,1432,6983,1343
2006,Urban,Kerala,Property Crime,Burglary,Male,46-60,4004,2613,1391,2982,1022
2005,Rural,Nagaland,Crime Against Women,Rape,Male,46-60,106,15,91,81,25
2006,Urban,Andhra Pradesh,Property Crime,Burglary,Female,46-60,6721,4503,2218,4652,2069
2001,Rural,Nagaland,Crime Against Children,Trafficking,Male,60+,6653,4894,1759,4982,1671
2010,Urban,Arunachal Pradesh,Other Crimes,Fraud,Female,46-60,523,307,216,328,195
2010,Urban,Madhya Pradesh,Crime Against Men,Extortion,Female,31-45,2790,1415,1375,2621,169
2003,Urban,Delhi,Crime Against Men,Murder,Male,18-30,7704,3968,3736,4234,3470
2004,Rural,Punjab,Crime Against Men,Assault,Male,31-45,6764,1838,4926,3983,2781
2010,Urban,Uttar Pradesh,Crime Against Women,Domestic Violence,Male,0-12,2919,2193,726,2836,83
2003,Rural,Karnataka,Property Crime,Theft,Female,13-17,4952,426,4526,2477,2475
2010,Rural,Assam,Other Crimes,Fraud,Female,46-60,8196,5530,2666,6865,1331
2005,Rural,Assam,Property Crime,Theft,Male,60+,1056,792,264,1015,41
2008,Rural,Nagaland,Property Crime,Vandalism,Male,13-17,6140,374,5766,1473,4667
2008,Rural,Sikkim,Property Crime,Burglary,Female,13-17,4437,4338,99,4380,57
2005,Urban,Jharkhand,Other Crimes,Corruption,Male,31-45,6638,1471,5167,4595,2043
2001,Urban,Rajasthan,Property Crime,Theft,Male,18-30,5152,4268,884,4345,807
2001,Rural,Jharkhand,Crime Against Women,Domestic Violence,Male,13-17,3629,3617,12,3629,0
2002,Rural,Kerala,Property Crime,Vandalism,Male,13-17,8250,7259,991,7643,607
2004,Urban,Kerala,Property Crime,Burglary,Male,18-30,4498,278,4220,2146,2352
2007,Urban,Sikkim,Property Crime,Vandalism,Female,46-60,5952,464,5488,3334,2618
2003,Rural,Rajasthan,Crime Against Children,Child Abuse,Male,31-45,4948,3731,1217,4535,413
2003,Rural,Sikkim,Other Crimes,Drug Offense,Female,0-12,9922,5110,4812,5493,4429
2001,Urban,Uttar Pradesh,Crime Against Children,Trafficking,Male,0-12,6858,2724,4134,3203,3655
2009,Urban,Bihar,Crime Against Children,Kidnapping,Male,31-45,3648,2623,1025,2826,822
2006,Urban,Mizoram,Crime Against Men,Assault,Male,60+,1470,38,1432,1264,206
2007,Urban,Assam,Other Crimes,Drug Offense,Female,18-30,4829,2443,2386,4156,673
2002,Rural,Chhattisgarh,Property Crime,Vandalism,Male,0-12,9815,5615,4200,5632,4183
2010,Rural,Karnataka,Crime Against Women,Rape,Male,31-45,1684,1618,66,1664,20
2010,Urban,Haryana,Crime Against Men,Assault,Male,13-17,1842,138,1704,1816,26
2009,Urban,Chhattisgarh,Crime Against Men,Murder,Female,31-45,7622,6816,806,7604,18
2009,Urban,Goa,Other Crimes,Corruption,Female,13-17,9560,469,9091,3760,5800
2002,Urban,Karnataka,Other Crimes,Cyber Crime,Female,60+,2357,241,2116,253,2104
2003,Rural,Uttar Pradesh,Crime Against Children,Trafficking,Male,0-12,7337,4850,2487,6480,857
2003,Urban,Karnataka,Crime Against Children,Trafficking,Male,46-60,52,48,4,49,3
2001,Urban,Madhya Pradesh,Crime Against Children,Kidnapping,Female,46-60,2126,1223,903,1732,394
2002,Urban,Jharkhand,Crime Against Women,Molestation,Female,18-30,8946,6290,2656,6655,2291
2001,Rural,Goa,Crime Against Children,Kidnapping,Male,46-60,3883,2190,1693,2854,1029
2002,Urban,Rajasthan,Crime Against Men,Extortion,Female,31-45,775,21,754,623,152
2004,Rural,Himachal Pradesh,Other Crimes,Cyber Crime,Female,46-60,5633,1505,4128,1882,3751
2007,Rural,Bihar,Crime Against Children,Child Abuse,Female,46-60,815,170,645,762,53
2001,Rural,Sikkim,Crime Against Children,Child Labor,Female,46-60,71,43,28,65,6
2001,Urban,Jammu & Kashmir,Crime Against Women,Dowry Deaths,Female,0-12,4131,835,3296,3064,1067
2010,Rural,Gujarat,Crime Against Children,Trafficking,Female,13-17,6122,6033,89,6054,68
2008,Urban,Madhya Pradesh,Property Crime,Theft,Male,60+,6396,6357,39,6360,36
2004,Rural,Haryana,Property Crime,Arson,Female,13-17,8907,7685,1222,8787,120
2010,Rural,Himachal Pradesh,Crime Against Men,Robbery,Male,13-17,9947,757,9190,2679,7268
2008,Rural,Maharashtra,Other Crimes,Drug Offense,Female,13-17,1575,1087,488,1148,427
2005,Urban,Mizoram,Other Crimes,Fraud,Female,0-12,3978,3927,51,3937,41
2010,Urban,Chhattisgarh,Property Crime,Arson,Male,13-17,9016,3822,5194,7562,1454
2002,Rural,Assam,Crime Against Children,Trafficking,Female,31-45,292,98,194,184,108
2003,Rural,Chhattisgarh,Other Crimes,Cyber Crime,Male,18-30,1810,1597,213,1802,8
2001,Urban,Telangana,Crime Against Children,Kidnapping,Male,0-12,1327,533,794,1041,286
2005,Rural,Chhattisgarh,Crime Against Children,Kidnapping,Male,31-45,6292,393,5899,434,5858
2006,Urban,Chhattisgarh,Crime Against Men,Assault,Male,31-45,2141,553,1588,2058,83
2003,Urban,Andhra Pradesh,Property Crime,Arson,Male,13-17,2455,2341,114,2363,92
2004,Urban,Goa,Crime Against Women,Rape,Male,13-17,5799,497,5302,3015,2784
2004,Urban,Jammu & Kashmir,Crime Against Women,Rape,Male,31-45,3079,2897,182,3061,18
2007,Urban,Andhra Pradesh,Other Crimes,Drug Offense,Male,13-17,8069,3406,4663,4027,4042
2010,Urban,West Bengal,Property Crime,Vandalism,Female,13-17,4079,9,4070,3105,974
2003,Urban,Mizoram,Property Crime,Vandalism,Male,46-60,218,22,196,47,171
2004,Urban,Manipur,Crime Against Men,Assault,Female,60+,4488,1465,3023,2119,2369
2004,Rural,West Bengal,Crime Against Children,Child Labor,Female,60+,5485,4054,1431,4894,591
2007,Urban,West Bengal,Property Crime,Vandalism,Female,18-30,3441,1310,2131,1817,1624
2009,Rural,Kerala,Crime Against Men,Assault,Male,0-12,1152,751,401,1063,89
2009,Rural,Arunachal Pradesh,Crime Against Men,Robbery,Female,0-12,8323,4792,3531,5141,3182
2007,Urban,Tamil Nadu,Crime Against Children,Trafficking,Male,60+,9869,8069,1800,8251,1618
2008,Urban,Maharashtra,Crime Against Children,Child Labor,Male,31-45,1722,1121,601,1654,68
2009,Rural,Arunachal Pradesh,Crime Against Women,Dowry Deaths,Female,13-17,8988,6208,2780,7866,1122
2003,Urban,Chhattisgarh,Crime Against Children,Trafficking,Male,60+,3523,1567,1956,2046,1477
2005,Rural,Jharkhand,Crime Against Women,Rape,Male,46-60,673,325,348,628,45
2005,Rural,Telangana,Crime Against Men,Extortion,Female,13-17,589,231,358,570,19
2003,Urban,West Bengal,Other Crimes,Drug Offense,Male,60+,1752,171,1581,1447,305
2007,Rural,Jammu & Kashmir,Crime Against Children,Child Labor,Male,60+,6877,2325,4552,3900,2977
2009,Rural,Arunachal Pradesh,Other Crimes,Corruption,Female,46-60,2903,2838,65,2880,23
2009,Rural,Andhra Pradesh,Other Crimes,Corruption,Female,13-17,8840,6207,2633,8819,21
2001,Urban,Gujarat,Crime Against Women,Domestic Violence,Male,13-17,6079,226,5853,2199,3880
2010,Urban,Nagaland,Other Crimes,Fraud,Female,13-17,7157,2397,4760,2846,4311
2004,Urban,Haryana,Crime Against Women,Molestation,Female,13-17,8498,359,8139,375,8123
2001,Urban,Goa,Other Crimes,Cyber Crime,Male,13-17,4182,1781,2401,2527,1655
2008,Rural,Andhra Pradesh,Crime Against Men,Extortion,Female,46-60,4443,3379,1064,3869,574
2006,Urban,Meghalaya,Property Crime,Arson,Female,18-30,7959,6849,1110,7414,545
2004,Rural,Bihar,Property Crime,Theft,Male,18-30,4439,1279,3160,3672,767
2003,Rural,Karnataka,Crime Against Men,Robbery,Female,0-12,5340,4184,1156,4295,1045
2007,Urban,Odisha,Property Crime,Arson,Female,60+,7617,2458,5159,2522,5095
2004,Urban,Himachal Pradesh,Other Crimes,Corruption,Male,31-45,9228,4502,4726,6811,2417
2008,Urban,Haryana,Property Crime,Arson,Male,0-12,1880,285,1595,1248,632
2008,Urban,Telangana,Crime Against Men,Extortion,Female,31-45,8654,4360,4294,8176,478
2002,Urban,Jammu & Kashmir,Other Crimes,Fraud,Male,0-12,9233,6781,2452,8154,1079
2007,Rural,Nagaland,Crime Against Children,Trafficking,Male,0-12,9399,8317,1082,9355,44
2002,Urban,Meghalaya,Crime Against Women,Molestation,Male,60+,7813,7391,422,7701,112
2003,Rural,Punjab,Crime Against Men,Murder,Female,0-12,6114,559,5555,5758,356
2004,Urban,Goa,Other Crimes,Drug Offense,Male,18-30,3207,2360,847,2895,312
2007,Urban,Sikkim,Crime Against Men,Murder,Male,0-12,5424,1089,4335,3359,2065
2004,Urban,Himachal Pradesh,Crime Against Men,Assault,Female,60+,8536,4683,3853,6921,1615
2004,Urban,Odisha,Crime Against Women,Domestic Violence,Female,18-30,2420,1069,1351,1779,641
2007,Rural,Telangana,Crime Against Women,Molestation,Female,31-45,130,42,88,69,61
2005,Urban,Tripura,Crime Against Women,Molestation,Female,31-45,2999,2794,205,2994,5
2005,Urban,Meghalaya,Other Crimes,Corruption,Male,18-30,8828,6643,2185,7424,1404
2005,Urban,Karnataka,Crime Against Women,Domestic Violence,Female,60+,6789,3426,3363,5913,876
2003,Urban,Bihar,Property Crime,Vandalism,Female,18-30,1644,1025,619,1152,492
2005,Rural,Jharkhand,Other Crimes,Drug Offense,Male,0-12,3229,2525,704,3089,140
2008,Urban,Punjab,Crime Against Men,Robbery,Female,46-60,9613,4410,5203,5130,4483
2004,Urban,Kerala,Crime Against Children,Trafficking,Male,0-12,4244,3730,514,3759,485
2005,Urban,Assam,Crime Against Men,Assault,Male,13-17,150,14,136,29,121
2005,Rural,Chhattisgarh,Crime Against Children,Child Labor,Female,13-17,7401,534,6867,7327,74
2001,Rural,Uttarakhand,Crime Against Women,Dowry Deaths,Female,31-45,4771,707,4064,2495,2276
2010,Rural,Telangana,Property Crime,Arson,Female,60+,7352,6325,1027,6703,649
2002,Rural,Maharashtra,Other Crimes,Cyber Crime,Male,18-30,7297,1297,6000,1902,5395
2009,Urban,Sikkim,Other Crimes,Fraud,Male,0-12,6330,4575,1755,5914,416
2010,Urban,Rajasthan,Crime Against Men,Robbery,Female,46-60,1987,1782,205,1979,8
2008,Urban,Gujarat,Other Crimes,Fraud,Male,13-17,3090,613,2477,1240,1850
2005,Rural,Arunachal Pradesh,Other Crimes,Fraud,Male,46-60,5317,168,5149,1377,3940
2010,Urban,Goa,Crime Against Women,Molestation,Male,18-30,3962,1165,2797,1529,2433
2002,Rural,Telangana,Property Crime,Vandalism,Male,46-60,7607,2457,5150,5366,2241
2008,Rural,West Bengal,Crime Against Men,Robbery,Female,31-45,349,294,55,336,13
2002,Rural,Odisha,Crime Against Men,Murder,Male,46-60,7626,7463,163,7562,64
2001,Urban,Telangana,Other Crimes,Fraud,Male,0-12,3733,55,3678,3305,428
2005,Urban,Goa,Other Crimes,Fraud,Male,60+,6646,5480,1166,6206,440
2010,Urban,Tamil Nadu,Property Crime,Vandalism,Female,18-30,4768,3054,1714,4174,594
2009,Urban,Sikkim,Crime Against Children,Trafficking,Male,31-45,4925,2027,2898,2513,2412
2001,Urban,Kerala,Other Crimes,Fraud,Female,46-60,6329,4385,1944,5627,702
2006,Urban,Tripura,Property Crime,Theft,Female,46-60,8906,78,8828,2576,6330
2007,Rural,Maharashtra,Other Crimes,Corruption,Male,18-30,5078,1641,3437,2466,2612
2004,Rural,Telangana,Crime Against Children,Child Labor,Female,46-60,8111,749,7362,4967,3144
2007,Urban,Odisha,Property Crime,Vandalism,Female,0-12,5439,3060,2379,4862,577
2002,Rural,Mizoram,Crime Against Men,Extortion,Male,60+,6810,1408,5402,5029,1781
2004,Rural,Madhya Pradesh,Crime Against Women,Dowry Deaths,Male,13-17,9762,3801,5961,4328,5434
2007,Rural,Chhattisgarh,Crime Against Men,Murder,Male,31-45,7471,3921,3550,4900,2571
2007,Urban,Madhya Pradesh,Other Crimes,Drug Offense,Male,31-45,6030,1292,4738,2366,3664
2009,Urban,Uttarakhand,Crime Against Men,Assault,Female,31-45,9535,1218,8317,9188,347
2002,Urban,Karnataka,Other Crimes,Cyber Crime,Female,46-60,602,483,119,515,87
2009,Urban,Jammu & Kashmir,Crime Against Children,Child Labor,Male,31-45,7593,110,7483,5132,2461
2008,Urban,Goa,Crime Against Children,Trafficking,Male,31-45,1984,653,1331,1552,432
2002,Rural,Nagaland,Crime Against Men,Robbery,Female,31-45,9562,7639,1923,7871,1691
2010,Rural,Sikkim,Property Crime,Burglary,Female,46-60,2330,1942,388,2000,330
2005,Rural,Maharashtra,Crime Against Women,Domestic Violence,Male,13-17,6223,1926,4297,5333,890
2003,Rural,Arunachal Pradesh,Crime Against Children,Kidnapping,Male,60+,5810,3375,2435,5781,29
2002,Urban,Himachal Pradesh,Other Crimes,Drug Offense,Female,46-60,9245,5845,3400,7991,1254
2007,Urban,Madhya Pradesh,Crime Against Women,Dowry Deaths,Female,46-60,5130,370,4760,3616,1514
2005,Rural,Kerala,Crime Against Women,Dowry Deaths,Male,31-45,2321,2190,131,2231,90
2010,Urban,Goa,Property Crime,Theft,Female,31-45,1486,218,1268,1318,168
2010,Rural,Nagaland,Crime Against Children,Trafficking,Female,46-60,8493,533,7960,5733,2760
2005,Rural,Uttar Pradesh,Property Crime,Theft,Male,46-60,606,79,527,284,322
2001,Urban,Tripura,Other Crimes,Corruption,Female,0-12,9339,4190,5149,8130,1209
2010,Urban,Arunachal Pradesh,Crime Against Women,Rape,Female,18-30,7878,7507,371,7684,194
2009,Rural,Gujarat,Crime Against Children,Child Abuse,Female,60+,7174,2737,4437,5868,1306
2001,Rural,Jharkhand,Crime Against Women,Molestation,Male,13-17,7163,5283,1880,6842,321
2003,Urban,Chhattisgarh,Other Crimes,Drug Offense,Female,13-17,1022,998,24,1009,13
2007,Rural,Arunachal Pradesh,Property Crime,Theft,Male,31-45,4414,2321,2093,4286,128
2006,Urban,Delhi,Crime Against Women,Molestation,Male,13-17,1671,291,1380,531,1140
2006,Urban,Gujarat,Other Crimes,Drug Offense,Male,46-60,426,71,355,336,90
2010,Rural,Delhi,Other Crimes,Cyber Crime,Female,46-60,7371,1256,6115,1679,5692
2004,Rural,Assam,Crime Against Children,Child Labor,Male,46-60,8529,2671,5858,7740,789
2001,Urban,Himachal Pradesh,Crime Against Children,Kidnapping,Female,18-30,3718,59,3659,1843,1875
2005,Rural,West Bengal,Property Crime,Arson,Male,60+,1812,83,1729,1003,809
2008,Urban,Arunachal Pradesh,Crime Against Women,Molestation,Male,46-60,5353,2955,2398,3437,1916
2004,Urban,Rajasthan,Crime Against Women,Molestation,Female,0-12,7848,1086,6762,4385,3463
2007,Urban,Bihar,Crime Against Children,Child Abuse,Female,46-60,7430,359,7071,4606,2824
2008,Rural,Sikkim,Crime Against Children,Child Labor,Female,18-30,4560,4220,340,4291,269
2009,Urban,Sikkim,Property Crime,Vandalism,Male,18-30,1222,794,428,959,263
2003,Rural,Punjab,Crime Against Children,Child Abuse,Male,0-12,3304,3095,209,3236,68
2007,Rural,Mizoram,Crime Against Women,Dowry Deaths,Female,18-30,3184,450,2734,2778,406
2007,Rural,Goa,Crime Against Children,Trafficking,Female,13-17,4100,3333,767,3785,315
2003,Rural,Odisha,Crime Against Children,Trafficking,Male,18-30,4955,2954,2001,4135,820
2001,Rural,Mizoram,Other Crimes,Drug Offense,Male,18-30,7441,549,6892,4140,3301
2004,Urban,Bihar,Property Crime,Theft,Male,18-30,9032,2239,6793,8400,632
2004,Urban,Arunachal Pradesh,Crime Against Men,Robbery,Female,0-12,5422,1880,3542,3939,1483
2002,Urban,Goa,Crime Against Women,Molestation,Female,18-30,4308,911,3397,3946,362
2009,Rural,Rajasthan,Crime Against Men,Assault,Male,0-12,4237,683,3554,3403,834
2003,Urban,Uttar Pradesh,Other Crimes,Drug Offense,Female,13-17,7678,1792,5886,5115,2563
2007,Rural,West Bengal,Crime Against Women,Molestation,Male,18-30,694,448,246,694,0
2003,Urban,Punjab,Property Crime,Burglary,Female,60+,875,42,833,358,517
2002,Rural,Himachal Pradesh,Other Crimes,Corruption,Male,0-12,4803,2331,2472,4687,116
2010,Urban,Tamil Nadu,Crime Against Children,Child Abuse,Female,18-30,1330,279,1051,1071,259
2005,Urban,Tripura,Crime Against Men,Extortion,Female,46-60,6569,5870,699,6268,301
2008,Rural,Delhi,Crime Against Children,Trafficking,Female,18-30,9836,1665,8171,7829,2007
2002,Urban,Telangana,Property Crime,Vandalism,Male,31-45,1768,388,1380,1250,518
2005,Rural,Tamil Nadu,Crime Against Women,Dowry Deaths,Female,13-17,922,412,510,695,227
2006,Urban,Punjab,Other Crimes,Corruption,Male,0-12,7306,59,7247,1803,5503
2001,Rural,Madhya Pradesh,Property Crime,Arson,Female,18-30,2256,658,1598,960,1296
2002,Urban,Himachal Pradesh,Crime Against Men,Extortion,Female,31-45,7953,5273,2680,7946,7
2009,Rural,Arunachal Pradesh,Other Crimes,Fraud,Male,13-17,3463,1008,2455,1706,1757
2001,Urban,Delhi,Crime Against Children,Child Abuse,Male,0-12,5164,2954,2210,4099,1065
2005,Urban,Punjab,Property Crime,Theft,Male,18-30,9342,3044,6298,3331,6011
2003,Rural,Himachal Pradesh,Crime Against Women,Dowry Deaths,Male,18-30,3761,1281,2480,2147,1614
2009,Rural,Arunachal Pradesh,Crime Against Women,Domestic Violence,Female,13-17,3714,946,2768,3533,181
2009,Rural,Odisha,Crime Against Children,Child Labor,Male,18-30,5264,696,4568,2547,2717
2003,Rural,Meghalaya,Crime Against Men,Extortion,Male,13-17,7076,6122,954,6284,792
2001,Rural,Nagaland,Property Crime,Burglary,Male,60+,2142,1076,1066,2008,134
2005,Rural,Karnataka,Crime Against Children,Child Abuse,Male,60+,4207,764,3443,2361,1846
2010,Rural,Meghalaya,Property Crime,Arson,Male,60+,4990,4432,558,4454,536
2005,Rural,Uttar Pradesh,Crime Against Children,Kidnapping,Male,13-17,5229,1563,3666,3540,1689
2010,Rural,Nagaland,Other Crimes,Corruption,Female,46-60,8283,2974,5309,4450,3833
2002,Urban,Tamil Nadu,Crime Against Women,Molestation,Male,31-45,2931,1250,1681,1428,1503
2007,Urban,Jammu & Kashmir,Other Crimes,Fraud,Female,18-30,6286,5117,1169,6159,127
2002,Urban,Karnataka,Other Crimes,Fraud,Male,46-60,6009,5594,415,5870,139
2007,Urban,Odisha,Crime Against Women,Rape,Male,13-17,7686,740,6946,3946,3740
2010,Urban,Bihar,Crime Against Children,Child Abuse,Female,18-30,568,525,43,551,17
2002,Rural,Madhya Pradesh,Crime Against Men,Assault,Female,13-17,7242,4518,2724,5783,1459
2004,Rural,Uttarakhand,Crime Against Men,Extortion,Female,60+,6329,5103,1226,5606,723
2008,Urban,Meghalaya,Crime Against Men,Robbery,Male,46-60,2100,1646,454,1969,131
2004,Rural,Jharkhand,Other Crimes,Cyber Crime,Male,31-45,7305,3897,3408,5179,2126
2010,Rural,Haryana,Crime Against Women,Molestation,Male,31-45,3491,3302,189,3477,14
2002,Rural,Haryana,Crime Against Children,Child Abuse,Female,31-45,4710,3250,1460,3998,712
2010,Urban,Sikkim,Property Crime,Vandalism,Male,13-17,1029,883,146,1004,25
2005,Rural,Karnataka,Other Crimes,Corruption,Male,60+,2569,2346,223,2359,210
2006,Urban,Maharashtra,Crime Against Men,Extortion,Female,0-12,1600,1184,416,1579,21
2006,Urban,Nagaland,Crime Against Women,Rape,Male,0-12,4903,1870,3033,3119,1784
2006,Rural,Uttar Pradesh,Crime Against Children,Kidnapping,Male,31-45,715,206,509,454,261
2003,Rural,Kerala,Crime Against Children,Kidnapping,Male,13-17,7916,3587,4329,5694,2222
2002,Rural,Manipur,Crime Against Children,Trafficking,Male,60+,7808,2394,5414,5824,1984
2006,Rural,Mizoram,Crime Against Men,Murder,Female,0-12,6418,1644,4774,4878,1540
2006,Rural,Mizoram,Property Crime,Theft,Female,31-45,6691,808,5883,1315,5376
2009,Rural,Tamil Nadu,Crime Against Children,Trafficking,Male,18-30,8998,3463,5535,7356,1642
2002,Rural,Assam,Property Crime,Arson,Female,13-17,3673,1598,2075,1685,1988
2005,Rural,Tamil Nadu,Crime Against Children,Child Abuse,Male,31-45,6225,514,5711,1355,4870
2007,Urban,Meghalaya,Other Crimes,Drug Offense,Male,0-12,9880,2801,7079,8139,1741
2004,Rural,Punjab,Crime Against Men,Extortion,Male,13-17,5432,2976,2456,4378,1054
2005,Urban,Jharkhand,Other Crimes,Drug Offense,Female,46-60,5968,2599,3369,5934,34
2003,Rural,Punjab,Crime Against Children,Child Labor,Female,13-17,758,405,353,434,324
2006,Rural,Chhattisgarh,Crime Against Men,Assault,Female,31-45,9866,2695,7171,6001,3865
2002,Rural,Delhi,Crime Against Women,Rape,Female,46-60,3796,1903,1893,3616,180
2005,Urban,Madhya Pradesh,Other Crimes,Fraud,Male,0-12,5915,1158,4757,5387,528
2008,Urban,Meghalaya,Crime Against Women,Domestic Violence,Female,31-45,6564,5525,1039,6359,205
2008,Rural,Goa,Crime Against Women,Domestic Violence,Female,0-12,9847,8562,1285,8648,1199
2005,Urban,West Bengal,Crime Against Children,Trafficking,Male,18-30,1079,485,594,825,254
2008,Rural,Maharashtra,Crime Against Men,Assault,Female,0-12,7788,5531,2257,7443,345
2007,Rural,Mizoram,Crime Against Women,Molestation,Female,0-12,7516,419,7097,2122,5394
2002,Urban,Delhi,Other Crimes,Drug Offense,Female,13-17,7787,2522,5265,3813,3974
2005,Urban,Jammu & Kashmir,Crime Against Children,Kidnapping,Male,46-60,3728,2376,1352,2930,798
2005,Urban,Jharkhand,Crime Against Men,Robbery,Male,0-12,8650,1814,6836,7105,1545
2003,Urban,Maharashtra,Crime Against Children,Child Abuse,Male,0-12,5735,4136,1599,4590,1145
2008,Rural,Meghalaya,Crime Against Men,Assault,Male,46-60,6720,16,6704,412,6308
2001,Rural,Himachal Pradesh,Property Crime,Theft,Female,60+,2578,167,2411,635,1943
2002,Urban,Kerala,Crime Against Children,Child Labor,Female,46-60,9803,3015,6788,3401,6402
2002,Rural,Haryana,Crime Against Children,Child Abuse,Female,18-30,3970,1366,2604,2663,1307
2003,Urban,Manipur,Crime Against Children,Child Abuse,Female,46-60,5050,2777,2273,3156,1894
2001,Urban,Sikkim,Property Crime,Arson,Female,13-17,3290,685,2605,2108,1182
2003,Rural,Nagaland,Property Crime,Vandalism,Female,31-45,151,74,77,83,68
2002,Urban,Mizoram,Crime Against Women,Dowry Deaths,Male,13-17,3082,1390,1692,2605,477
2001,Rural,Bihar,Crime Against Women,Molestation,Male,60+,3095,2691,404,2939,156
2006,Urban,West Bengal,Crime Against Children,Kidnapping,Male,0-12,244,38,206,152,92
2004,Urban,Chhattisgarh,Crime Against Men,Extortion,Male,46-60,970,748,222,877,93
2009,Rural,Uttarakhand,Crime Against Children,Trafficking,Male,0-12,402,73,329,325,77
2002,Urban,Haryana,Other Crimes,Corruption,Male,46-60,7032,2457,4575,2731,4301
2004,Rural,Telangana,Crime Against Children,Kidnapping,Male,46-60,1630,1542,88,1542,88
2004,Rural,Uttarakhand,Other Crimes,Drug Offense,Male,60+,2411,1756,655,2006,405
2003,Urban,Uttarakhand,Other Crimes,Fraud,Male,46-60,2829,2280,549,2313,516
2005,Rural,Madhya Pradesh,Crime Against Children,Trafficking,Male,18-30,5856,5833,23,5841,15
2006,Rural,Jharkhand,Crime Against Men,Extortion,Female,18-30,944,206,738,582,362
2002,Rural,Telangana,Crime Against Men,Extortion,Male,46-60,7506,5739,1767,6595,911
2007,Rural,Jharkhand,Other Crimes,Cyber Crime,Male,31-45,2976,1621,1355,1855,1121
2008,Urban,Tripura,Crime Against Children,Kidnapping,Male,13-17,1502,1352,150,1417,85
2001,Rural,Assam,Property Crime,Arson,Male,13-17,5414,399,5015,2010,3404
2008,Rural,Meghalaya,Other Crimes,Drug Offense,Male,31-45,2800,1731,1069,2208,592
2009,Rural,Himachal Pradesh,Crime Against Men,Murder,Female,60+,9182,7527,1655,8532,650
2002,Urban,West Bengal,Property Crime,Theft,Male,0-12,9652,4160,5492,8742,910
2005,Urban,Tamil Nadu,Crime Against Men,Assault,Female,31-45,4123,1817,2306,3957,166
2005,Rural,Maharashtra,Property Crime,Vandalism,Male,31-45,2654,2401,253,2647,7
2008,Urban,Karnataka,Crime Against Women,Dowry Deaths,Male,60+,7277,926,6351,1777,5500
2007,Urban,Sikkim,Crime Against Children,Child Abuse,Female,60+,4278,2807,1471,3253,1025
2001,Urban,Gujarat,Property Crime,Arson,Female,0-12,504,59,445,387,117
2004,Rural,Himachal Pradesh,Crime Against Men,Murder,Female,13-17,3457,2746,711,2800,657
2003,Rural,Rajasthan,Crime Against Men,Robbery,Male,60+,84,79,5,79,5
2004,Urban,Madhya Pradesh,Other Crimes,Drug Offense,Female,60+,8655,1548,7107,7201,1454
2010,Urban,Sikkim,Other Crimes,Fraud,Male,46-60,5767,4215,1552,4934,833
2002,Urban,Jammu & Kashmir,Property Crime,Burglary,Female,13-17,2009,167,1842,398,1611
2008,Urban,Maharashtra,Crime Against Women,Dowry Deaths,Male,31-45,2121,1295,826,1560,561
2004,Urban,Punjab,Crime Against Children,Child Labor,Male,13-17,7741,2456,5285,7704,37
2004,Rural,Maharashtra,Crime Against Women,Dowry Deaths,Male,46-60,9299,272,9027,2864,6435
2006,Urban,Madhya Pradesh,Crime Against Men,Extortion,Male,0-12,9744,2684,7060,9138,606
2010,Urban,Arunachal Pradesh,Other Crimes,Fraud,Male,18-30,7088,2638,4450,5754,1334
2006,Urban,Telangana,Crime Against Children,Trafficking,Male,46-60,195,160,35,186,9
2010,Rural,Delhi,Other Crimes,Drug Offense,Female,18-30,7160,5969,1191,6983,177
2007,Urban,Jharkhand,Crime Against Men,Robbery,Male,18-30,9747,8674,1073,9476,271
2001,Urban,Rajasthan,Crime Against Women,Dowry Deaths,Male,60+,4433,2485,1948,3511,922
2001,Urban,Meghalaya,Crime Against Men,Robbery,Male,31-45,2757,1329,1428,2331,426
2010,Rural,Nagaland,Property Crime,Vandalism,Female,13-17,8549,6776,1773,7036,1513
2006,Urban,Punjab,Property Crime,Arson,Male,31-45,5524,5108,416,5449,75
2002,Rural,Maharashtra,Crime Against Men,Assault,Female,18-30,7896,6090,1806,7561,335
2007,Rural,Odisha,Crime Against Men,Robbery,Male,13-17,9847,9055,792,9074,773
2001,Urban,Kerala,Other Crimes,Drug Offense,Male,18-30,6893,2112,4781,3938,2955
2008,Rural,Sikkim,Crime Against Women,Rape,Female,0-12,348,170,178,212,136
2002,Urban,Punjab,Crime Against Women,Rape,Male,13-17,3403,2470,933,3273,130
2006,Rural,Nagaland,Crime Against Men,Robbery,Female,31-45,8596,7494,1102,7742,854
2001,Urban,Himachal Pradesh,Property Crime,Arson,Male,60+,4459,628,3831,1528,2931
2003,Urban,Haryana,Crime Against Men,Murder,Male,31-45,7244,5553,1691,6539,705
2010,Rural,Bihar,Property Crime,Vandalism,Male,46-60,8963,3552,5411,5600,3363
2006,Urban,Rajasthan,Crime Against Children,Trafficking,Male,18-30,3553,3515,38,3551,2
2004,Urban,Sikkim,Other Crimes,Drug Offense,Female,13-17,8271,2339,5932,7583,688
2006,Urban,Uttarakhand,Crime Against Men,Assault,Male,18-30,4863,2389,2474,2485,2378
2008,Rural,Uttar Pradesh,Crime Against Women,Dowry Deaths,Female,18-30,8516,4053,4463,4712,3804
2001,Urban,Jammu & Kashmir,Other Crimes,Corruption,Female,13-17,3349,1357,1992,1994,1355
2004,Urban,West Bengal,Crime Against Children,Child Abuse,Female,46-60,8405,5289,3116,8138,267
2010,Urban,Jammu & Kashmir,Crime Against Men,Murder,Female,46-60,7065,6954,111,6974,91
2005,Rural,Goa,Property Crime,Theft,Male,13-17,5120,4964,156,4989,131
2006,Urban,Sikkim,Crime Against Children,Child Abuse,Female,18-30,8260,1201,7059,3295,4965
2003,Rural,Assam,Property Crime,Theft,Female,13-17,6771,5788,983,6053,718
2008,Urban,Rajasthan,Crime Against Children,Kidnapping,Female,60+,1579,1259,320,1452,127
2005,Urban,Arunachal Pradesh,Other Crimes,Cyber Crime,Female,60+,6993,1028,5965,5233,1760
2001,Urban,Chhattisgarh,Crime Against Children,Child Abuse,Female,46-60,2321,1257,1064,2115,206
2006,Urban,Gujarat,Other Crimes,Cyber Crime,Male,46-60,216,175,41,191,25
2010,Rural,Arunachal Pradesh,Crime Against Women,Domestic Violence,Male,0-12,8844,7460,1384,8131,713
2003,Urban,Kerala,Crime Against Men,Assault,Female,13-17,8869,6215,2654,7532,1337
2006,Rural,Sikkim,Crime Against Children,Child Labor,Female,31-45,3281,1173,2108,1826,1455
2010,Rural,Maharashtra,Crime Against Children,Kidnapping,Male,31-45,5950,5939,11,5946,4
2002,Urban,Chhattisgarh,Other Crimes,Corruption,Male,60+,1196,1029,167,1057,139
2004,Urban,Goa,Crime Against Children,Child Abuse,Female,60+,2433,535,1898,1385,1048
2010,Rural,Sikkim,Property Crime,Theft,Female,0-12,1619,1450,169,1487,132
2004,Rural,Uttar Pradesh,Crime Against Children,Child Abuse,Male,18-30,6679,929,5750,5208,1471
2004,Rural,Jharkhand,Crime Against Men,Extortion,Male,0-12,3310,576,2734,2560,750
2009,Rural,Telangana,Other Crimes,Corruption,Female,13-17,6205,5830,375,5985,220
2002,Rural,Madhya Pradesh,Crime Against Children,Child Abuse,Female,31-45,8415,192,8223,6402,2013
2009,Urban,Goa,Other Crimes,Fraud,Female,18-30,9841,9538,303,9796,45
2005,Urban,Chhattisgarh,Crime Against Men,Assault,Female,13-17,3240,2304,936,2540,700
2007,Rural,Assam,Crime Against Women,Dowry Deaths,Male,60+,3727,3344,383,3724,3
2002,Urban,Meghalaya,Crime Against Women,Molestation,Female,18-30,3548,555,2993,2840,708
2008,Urban,Uttar Pradesh,Property Crime,Burglary,Male,18-30,8118,7382,736,7695,423
2003,Urban,Tamil Nadu,Crime Against Men,Robbery,Female,46-60,645,471,174,555,90
2008,Rural,Nagaland,Crime Against Women,Molestation,Male,18-30,9815,1854,7961,7820,1995
2005,Urban,Punjab,Crime Against Children,Kidnapping,Male,0-12,9474,79,9395,8039,1435
2006,Rural,Maharashtra,Crime Against Children,Child Labor,Male,18-30,2555,267,2288,1356,1199
2010,Urban,Assam,Crime Against Men,Murder,Female,13-17,7546,6024,1522,7324,222
2005,Rural,Madhya Pradesh,Crime Against Women,Domestic Violence,Female,0-12,3681,3160,521,3633,48
2005,Rural,Manipur,Crime Against Women,Rape,Male,31-45,1494,266,1228,1237,257
2004,Urban,Telangana,Crime Against Men,Robbery,Male,18-30,9515,4108,5407,9324,191
2009,Urban,Uttarakhand,Crime Against Men,Extortion,Female,31-45,4646,3790,856,4632,14
2009,Rural,Manipur,Crime Against Children,Trafficking,Female,0-12,7648,6843,805,7101,547
2009,Urban,Nagaland,Crime Against Women,Rape,Male,13-17,5962,1706,4256,1758,4204
2001,Urban,Jammu & Kashmir,Property Crime,Vandalism,Male,13-17,4574,1250,3324,1390,3184
2006,Urban,Goa,Crime Against Men,Assault,Male,13-17,6229,4206,2023,5542,687
2005,Urban,Punjab,Crime Against Children,Child Abuse,Male,60+,7124,5602,1522,6839,285
2004,Urban,Haryana,Crime Against Men,Assault,Male,46-60,6374,5500,874,6185,189
2006,Urban,Telangana,Crime Against Women,Molestation,Male,0-12,5067,1067,4000,4338,729
2010,Rural,Telangana,Property Crime,Arson,Female,60+,2970,1217,1753,2235,735
2006,Urban,Nagaland,Crime Against Children,Trafficking,Female,31-45,2748,496,2252,2573,175
2003,Rural,Meghalaya,Crime Against Children,Trafficking,Female,18-30,6443,1861,4582,4968,1475
2002,Urban,Uttarakhand,Other Crimes,Fraud,Male,31-45,2943,135,2808,914,2029
2007,Rural,Madhya Pradesh,Crime Against Children,Child Labor,Male,60+,8773,7212,1561,8543,230
2004,Rural,Andhra Pradesh,Crime Against Women,Domestic Violence,Male,46-60,4346,2677,1669,4326,20
2007,Urban,Kerala,Crime Against Men,Assault,Male,46-60,1999,1361,638,1564,435
2006,Rural,Himachal Pradesh,Crime Against Children,Trafficking,Female,60+,9541,2790,6751,7041,2500
2006,Urban,West Bengal,Crime Against Men,Assault,Female,0-12,6635,4144,2491,4221,2414
2003,Urban,Tamil Nadu,Property Crime,Burglary,Male,18-30,2359,1501,858,1577,782
2002,Rural,Himachal Pradesh,Crime Against Men,Assault,Female,46-60,6622,5766,856,5924,698
2003,Urban,Sikkim,Crime Against Children,Kidnapping,Female,31-45,609,218,391,394,215
2008,Urban,Mizoram,Other Crimes,Fraud,Female,46-60,2928,1440,1488,1924,1004
2007,Rural,Himachal Pradesh,Other Crimes,Fraud,Female,13-17,9425,7689,1736,9212,213
2006,Urban,Haryana,Property Crime,Burglary,Female,60+,606,427,179,451,155
2004,Rural,Telangana,Property Crime,Vandalism,Female,18-30,7830,3074,4756,3305,4525
2008,Urban,Karnataka,Other Crimes,Cyber Crime,Male,0-12,436,274,162,360,76
2007,Rural,Nagaland,Other Crimes,Fraud,Female,60+,8195,4564,3631,7827,368
2004,Urban,Bihar,Crime Against Women,Domestic Violence,Male,31-45,5042,171,4871,1845,3197
2003,Urban,Manipur,Crime Against Men,Assault,Female,18-30,1937,537,1400,1099,838
2008,Urban,Maharashtra,Crime Against Men,Extortion,Male,13-17,858,397,461,488,370
2010,Urban,Nagaland,Property Crime,Arson,Female,60+,3751,1579,2172,2346,1405
2004,Urban,Meghalaya,Property Crime,Arson,Female,18-30,1212,352,860,482,730
2009,Rural,Punjab,Crime Against Children,Kidnapping,Male,60+,4795,2241,2554,3333,1462
2004,Urban,Nagaland,Crime Against Children,Kidnapping,Female,60+,5864,5369,495,5781,83
2010,Rural,Andhra Pradesh,Property Crime,Burglary,Female,13-17,1381,825,556,1020,361
2003,Rural,Odisha,Crime Against Children,Child Abuse,Male,18-30,6434,117,6317,3578,2856
2003,Rural,Arunachal Pradesh,Other Crimes,Corruption,Male,46-60,3536,4,3532,388,3148
2004,Rural,Maharashtra,Crime Against Children,Kidnapping,Male,13-17,4591,3318,1273,4059,532
2008,Rural,Bihar,Crime Against Children,Child Abuse,Male,31-45,4215,1990,2225,4045,170
2004,Urban,Telangana,Crime Against Men,Murder,Female,60+,6117,76,6041,4049,2068
2006,Urban,Bihar,Crime Against Children,Trafficking,Male,60+,9112,3563,5549,4808,4304
2003,Urban,Mizoram,Crime Against Men,Extortion,Male,60+,7735,6084,1651,7225,510
2002,Urban,Chhattisgarh,Crime Against Children,Trafficking,Male,31-45,9998,7672,2326,9639,359
2001,Rural,Tripura,Crime Against Men,Assault,Male,46-60,4482,3224,1258,4412,70
2002,Urban,Gujarat,Crime Against Children,Kidnapping,Male,46-60,6226,847,5379,1338,4888
2001,Rural,Kerala,Crime Against Children,Child Labor,Male,13-17,3749,2357,1392,2890,859
2008,Rural,Telangana,Other Crimes,Fraud,Male,46-60,9135,3079,6056,6047,3088
2008,Rural,Uttar Pradesh,Property Crime,Theft,Female,31-45,7815,6942,873,7149,666
2001,Urban,Meghalaya,Crime Against Children,Child Labor,Female,18-30,5201,4840,361,4897,304
2009,Urban,Kerala,Crime Against Children,Child Abuse,Male,0-12,4373,4162,211,4298,75
2002,Urban,Assam,Property Crime,Burglary,Female,60+,2589,1339,1250,2270,319
2005,Rural,Punjab,Property Crime,Vandalism,Male,46-60,5152,3165,1987,3850,1302
2003,Rural,Arunachal Pradesh,Other Crimes,Cyber Crime,Male,46-60,5297,3002,2295,3411,1886
2002,Rural,Himachal Pradesh,Crime Against Men,Assault,Female,0-12,481,176,305,391,90
2002,Rural,Goa,Crime Against Women,Rape,Female,31-45,3493,2978,515,3181,312
2002,Urban,Manipur,Crime Against Women,Molestation,Female,60+,4117,973,3144,1293,2824
2009,Rural,Odisha,Crime Against Men,Murder,Female,46-60,2446,991,1455,1274,1172
2006,Urban,Goa,Crime Against Children,Child Abuse,Female,31-45,2962,2845,117,2955,7
2010,Urban,Meghalaya,Crime Against Women,Domestic Violence,Male,46-60,7383,5047,2336,6040,1343
2005,Urban,Arunachal Pradesh,Crime Against Women,Molestation,Female,60+,578,108,470,319,259
2009,Urban,Bihar,Property Crime,Arson,Male,60+,6854,6300,554,6746,108
2005,Urban,Manipur,Crime Against Men,Extortion,Male,46-60,3308,1667,1641,3227,81
2007,Urban,Delhi,Property Crime,Theft,Male,46-60,7834,6567,1267,7203,631
2007,Rural,Telangana,Crime Against Men,Robbery,Male,46-60,2619,6,2613,2425,194
2003,Urban,Bihar,Crime Against Men,Robbery,Female,18-30,860,505,355,850,10
2010,Rural,Uttarakhand,Crime Against Children,Child Abuse,Male,31-45,6933,5076,1857,6007,926
2006,Urban,Manipur,Crime Against Men,Extortion,Male,31-45,4510,3973,537,4365,145
2010,Urban,Telangana,Crime Against Men,Extortion,Female,46-60,5683,4767,916,5389,294
2010,Rural,Meghalaya,Crime Against Women,Rape,Male,0-12,5846,5556,290,5694,152
2002,Rural,Madhya Pradesh,Crime Against Children,Trafficking,Female,13-17,5512,4842,670,5506,6
2008,Rural,Arunachal Pradesh,Property Crime,Burglary,Female,18-30,1497,644,853,1207,290
2009,Rural,Mizoram,Property Crime,Vandalism,Male,13-17,5036,379,4657,1130,3906
2007,Urban,Karnataka,Other Crimes,Fraud,Female,60+,9489,8127,1362,8944,545
2002,Urban,Assam,Other Crimes,Fraud,Male,13-17,8130,2671,5459,3313,4817
2005,Urban,Haryana,Crime Against Women,Dowry Deaths,Female,13-17,9881,8896,985,8975,906
2005,Rural,Sikkim,Crime Against Men,Extortion,Female,60+,3910,1983,1927,3111,799
2002,Rural,Tamil Nadu,Crime Against Women,Domestic Violence,Male,60+,7881,5110,2771,6739,1142
2003,Urban,Assam,Property Crime,Burglary,Male,31-45,7633,1601,6032,5845,1788
2010,Rural,Karnataka,Crime Against Children,Child Labor,Male,60+,1565,1185,380,1185,380
2005,Rural,Tripura,Property Crime,Theft,Female,31-45,7962,7324,638,7326,636
2004,Rural,Jammu & Kashmir,Other Crimes,Fraud,Female,31-45,5324,512,4812,5175,149
2007,Urban,Delhi,Crime Against Women,Dowry Deaths,Female,18-30,6359,3801,2558,3993,2366
2004,Urban,Odisha,Crime Against Men,Murder,Male,31-45,3846,2883,963,3506,340
2005,Urban,Manipur,Other Crimes,Corruption,Female,18-30,7525,796,6729,6278,1247
2005,Urban,Uttarakhand,Other Crimes,Fraud,Female,0-12,4125,1828,2297,2342,1783
2009,Rural,Delhi,Crime Against Men,Murder,Male,46-60,6147,3717,2430,5839,308
2008,Rural,Punjab,Crime Against Men,Robbery,Male,0-12,4032,2063,1969,2110,1922
2004,Urban,Tamil Nadu,Crime Against Men,Assault,Male,13-17,6174,4917,1257,5086,1088
2001,Rural,Delhi,Other Crimes,Cyber Crime,Male,46-60,7894,1317,6577,3552,4342
2002,Urban,Rajasthan,Crime Against Men,Murder,Female,18-30,3783,1330,2453,3414,369
2004,Rural,Madhya Pradesh,Crime Against Women,Dowry Deaths,Male,13-17,7946,1809,6137,4501,3445
2001,Rural,Assam,Other Crimes,Fraud,Male,31-45,9013,5370,3643,7585,1428
2006,Rural,Andhra Pradesh,Property Crime,Vandalism,Male,60+,7267,3383,3884,6565,702
2009,Urban,Rajasthan,Property Crime,Burglary,Female,46-60,3100,1447,1653,2733,367
2001,Rural,Karnataka,Other Crimes,Cyber Crime,Male,31-45,250,53,197,193,57
2008,Urban,Haryana,Property Crime,Vandalism,Male,18-30,6758,4274,2484,6276,482
2007,Urban,Delhi,Other Crimes,Cyber Crime,Female,18-30,3582,2934,648,3387,195
2005,Rural,Maharashtra,Crime Against Men,Assault,Male,18-30,1387,64,1323,609,778
2008,Urban,Kerala,Crime Against Women,Molestation,Female,13-17,1112,889,223,979,133
2008,Urban,Odisha,Other Crimes,Fraud,Male,46-60,9047,3383,5664,4048,4999
2006,Urban,Telangana,Crime Against Women,Dowry Deaths,Female,46-60,9011,745,8266,5940,3071
2006,Rural,Haryana,Other Crimes,Corruption,Female,46-60,1619,646,973,1614,5
2007,Rural,Manipur,Crime Against Women,Molestation,Male,46-60,5037,4208,829,4744,293
2007,Urban,Jharkhand,Crime Against Children,Trafficking,Male,31-45,2820,410,2410,2553,267
2009,Urban,Tripura,Property Crime,Burglary,Male,60+,3931,266,3665,292,3639
2003,Urban,Odisha,Property Crime,Theft,Male,18-30,816,232,584,242,574
2005,Rural,Maharashtra,Property Crime,Arson,Male,0-12,8190,160,8030,6979,1211
2006,Urban,Nagaland,Other Crimes,Cyber Crime,Female,18-30,3716,2509,1207,3611,105
2008,Urban,Maharashtra,Other Crimes,Fraud,Female,31-45,6251,1789,4462,5984,267
2001,Rural,Maharashtra,Other Crimes,Fraud,Male,18-30,1769,1490,279,1613,156
2009,Rural,Bihar,Property Crime,Vandalism,Male,31-45,7958,1911,6047,1942,6016
2010,Rural,Gujarat,Crime Against Children,Trafficking,Female,0-12,1648,478,1170,1627,21
2001,Urban,Assam,Property Crime,Vandalism,Male,13-17,2380,1722,658,2107,273
2001,Urban,Rajasthan,Other Crimes,Fraud,Female,60+,7985,4046,3939,4783,3202
2005,Rural,Sikkim,Crime Against Women,Molestation,Female,0-12,2381,741,1640,1139,1242
2006,Urban,Maharashtra,Crime Against Children,Child Abuse,Female,31-45,6469,3511,2958,4802,1667
2007,Rural,Meghalaya,Crime Against Men,Assault,Female,13-17,8158,3310,4848,5132,3026
2007,Rural,Uttar Pradesh,Property Crime,Theft,Female,0-12,1295,1014,281,1212,83
2006,Rural,Rajasthan,Crime Against Women,Dowry Deaths,Female,60+,9436,3649,5787,6436,3000
2001,Urban,Meghalaya,Crime Against Men,Robbery,Female,31-45,2707,548,2159,2562,145
2008,Urban,Delhi,Crime Against Children,Child Labor,Male,31-45,1482,1086,396,1266,216
2002,Rural,Assam,Property Crime,Burglary,Male,46-60,3453,2666,787,2697,756
2009,Rural,Chhattisgarh,Crime Against Women,Dowry Deaths,Female,60+,8476,7217,1259,7623,853
2007,Rural,Meghalaya,Property Crime,Theft,Male,46-60,3076,2879,197,2974,102
2009,Urban,Sikkim,Crime Against Women,Domestic Violence,Female,0-12,9288,2392,6896,8810,478
2003,Urban,Telangana,Property Crime,Burglary,Female,0-12,9075,3509,5566,5756,3319
2006,Rural,Karnataka,Crime Against Men,Assault,Male,0-12,5499,4339,1160,5273,226
2002,Rural,Sikkim,Crime Against Children,Trafficking,Female,13-17,6622,5366,1256,5377,1245
2006,Urban,Sikkim,Other Crimes,Corruption,Female,60+,3671,1733,1938,2794,877
2010,Urban,Karnataka,Crime Against Women,Rape,Female,18-30,6090,1177,4913,5967,123
2007,Rural,Gujarat,Crime Against Children,Child Labor,Male,31-45,7293,1233,6060,3308,3985
2010,Rural,Andhra Pradesh,Crime Against Men,Extortion,Female,46-60,755,668,87,738,17
2007,Urban,Himachal Pradesh,Other Crimes,Corruption,Male,60+,5535,295,5240,5472,63
2002,Rural,Himachal Pradesh,Crime Against Children,Trafficking,Male,0-12,8103,5083,3020,5530,2573
2006,Urban,Telangana,Crime Against Men,Murder,Male,46-60,470,187,283,454,16
2003,Rural,Rajasthan,Crime Against Women,Molestation,Male,46-60,2100,1832,268,1900,200
2004,Urban,Delhi,Crime Against Children,Child Abuse,Female,46-60,4604,4028,576,4415,189
2002,Rural,Karnataka,Crime Against Children,Trafficking,Female,60+,480,335,145,459,21
2009,Rural,Tripura,Property Crime,Vandalism,Female,46-60,6051,4790,1261,4986,1065
2007,Urban,Punjab,Other Crimes,Drug Offense,Male,60+,5981,3925,2056,5085,896
2008,Urban,Meghalaya,Property Crime,Burglary,Female,18-30,3253,233,3020,1683,1570
2001,Urban,Odisha,Crime Against Women,Molestation,Female,31-45,792,361,431,539,253
2005,Urban,Delhi,Property Crime,Vandalism,Male,18-30,5185,2060,3125,2651,2534
2003,Rural,Uttarakhand,Crime Against Men,Extortion,Female,18-30,8140,1004,7136,6680,1460
2001,Urban,Uttar Pradesh,Crime Against Women,Molestation,Male,0-12,6617,409,6208,3483,3134
2004,Urban,Mizoram,Crime Against Women,Rape,Male,31-45,533,424,109,462,71
2008,Rural,Karnataka,Other Crimes,Corruption,Female,18-30,4101,3704,397,3981,120
2001,Rural,Jharkhand,Property Crime,Burglary,Female,31-45,2314,182,2132,936,1378
2006,Urban,Meghalaya,Property Crime,Vandalism,Male,31-45,2667,1913,754,2224,443
2003,Rural,Rajasthan,Crime Against Women,Domestic Violence,Female,13-17,7872,140,7732,4973,2899
2003,Urban,Chhattisgarh,Crime Against Children,Trafficking,Male,13-17,9379,6965,2414,8727,652
2003,Urban,Assam,Crime Against Children,Child Abuse,Male,13-17,8745,8137,608,8711,34
2008,Rural,Delhi,Crime Against Men,Extortion,Male,60+,3653,1932,1721,1981,1672
2006,Urban,Nagaland,Other Crimes,Fraud,Female,60+,9284,1093,8191,9086,198
2007,Urban,Meghalaya,Property Crime,Burglary,Male,13-17,3241,653,2588,855,2386
2010,Urban,Mizoram,Other Crimes,Fraud,Male,18-30,4811,1685,3126,2502,2309
2007,Urban,Arunachal Pradesh,Other Crimes,Cyber Crime,Male,46-60,2659,304,2355,582,2077
2004,Rural,Uttar Pradesh,Crime Against Women,Rape,Female,31-45,7439,5770,1669,6078,1361
2008,Urban,Haryana,Crime Against Men,Extortion,Male,31-45,911,484,427,695,216
2008,Urban,Gujarat,Other Crimes,Corruption,Male,18-30,3330,3115,215,3166,164
2001,Urban,Nagaland,Crime Against Women,Domestic Violence,Male,60+,8115,5211,2904,8098,17
2006,Urban,Assam,Other Crimes,Drug Offense,Male,31-45,1217,55,1162,298,919
2007,Urban,Goa,Other Crimes,Corruption,Female,18-30,7090,6939,151,7088,2
2004,Rural,Himachal Pradesh,Crime Against Women,Rape,Female,46-60,3781,1251,2530,3583,198
2009,Rural,Chhattisgarh,Crime Against Women,Rape,Male,13-17,7130,598,6532,6420,710
2010,Urban,Haryana,Other Crimes,Fraud,Male,60+,1812,1806,6,1810,2
2005,Rural,Mizoram,Other Crimes,Cyber Crime,Male,60+,2315,11,2304,674,1641
2002,Urban,Karnataka,Crime Against Women,Molestation,Female,0-12,2782,298,2484,529,2253
2001,Rural,Meghalaya,Crime Against Children,Kidnapping,Male,31-45,1138,181,957,305,833
2008,Urban,Tripura,Property Crime,Arson,Female,46-60,9828,893,8935,7161,2667
2001,Urban,Himachal Pradesh,Crime Against Women,Rape,Female,0-12,1255,530,725,1105,150
2005,Urban,Karnataka,Crime Against Men,Extortion,Male,18-30,1401,219,1182,817,584
2006,Urban,Andhra Pradesh,Crime Against Men,Assault,Female,13-17,7471,4342,3129,4830,2641
2004,Rural,Sikkim,Crime Against Children,Child Abuse,Female,13-17,6111,2289,3822,3827,2284
2002,Rural,Delhi,Other Crimes,Drug Offense,Female,0-12,9096,813,8283,4108,4988
2003,Urban,Nagaland,Other Crimes,Cyber Crime,Male,18-30,2253,1773,480,2127,126
2006,Urban,Uttar Pradesh,Other Crimes,Fraud,Female,31-45,5359,327,5032,4025,1334
2002,Urban,Rajasthan,Crime Against Children,Trafficking,Female,13-17,8411,6494,1917,7249,1162
2005,Urban,Goa,Other Crimes,Cyber Crime,Male,18-30,3545,1321,2224,2050,1495
2001,Urban,Goa,Property Crime,Arson,Female,46-60,8913,5879,3034,8896,17
2002,Urban,Punjab,Crime Against Children,Trafficking,Female,46-60,9971,8009,1962,8080,1891
2010,Rural,West Bengal,Crime Against Men,Robbery,Male,46-60,3591,2250,1341,3212,379
2009,Urban,Mizoram,Other Crimes,Drug Offense,Female,13-17,2174,1957,217,2051,123
2001,Urban,Jharkhand,Property Crime,Burglary,Male,18-30,3241,2858,383,3227,14
2002,Urban,Mizoram,Crime Against Men,Murder,Female,13-17,7411,3235,4176,5931,1480
2002,Rural,Chhattisgarh,Other Crimes,Fraud,Female,13-17,5470,101,5369,1751,3719
2008,Rural,Bihar,Crime Against Children,Kidnapping,Male,0-12,8490,7996,494,8000,490
2007,Rural,Meghalaya,Crime Against Men,Robbery,Male,18-30,6359,299,6060,5254,1105
2002,Rural,Punjab,Crime Against Children,Child Labor,Male,46-60,4494,2855,1639,2885,1609
2004,Urban,Rajasthan,Crime Against Women,Molestation,Female,18-30,8467,3224,5243,6695,1772
2001,Urban,Mizoram,Property Crime,Burglary,Female,18-30,2152,1064,1088,1439,713
2001,Urban,Haryana,Property Crime,Theft,Male,13-17,7331,4722,2609,4815,2516
2001,Urban,Telangana,Crime Against Men,Assault,Female,13-17,8766,525,8241,1749,7017
2007,Rural,Sikkim,Crime Against Children,Child Abuse,Male,31-45,4248,2696,1552,4124,124
2001,Urban,Uttar Pradesh,Property Crime,Theft,Female,0-12,321,121,200,209,112
2009,Urban,Goa,Crime Against Children,Child Labor,Female,46-60,1870,1806,64,1814,56
2002,Rural,Himachal Pradesh,Crime Against Men,Extortion,Male,46-60,9126,6595,2531,9101,25
2001,Rural,Himachal Pradesh,Other Crimes,Fraud,Female,0-12,8119,3986,4133,4438,3681
2009,Rural,Sikkim,Crime Against Children,Kidnapping,Female,0-12,5844,2984,2860,5820,24
2003,Urban,Mizoram,Other Crimes,Cyber Crime,Male,18-30,6294,4868,1426,5510,784
2001,Urban,Delhi,Other Crimes,Drug Offense,Female,18-30,9569,97,9472,2807,6762
2004,Urban,Maharashtra,Crime Against Women,Molestation,Female,13-17,8458,7970,488,8348,110
2001,Rural,Sikkim,Crime Against Women,Domestic Violence,Male,0-12,3842,1876,1966,1894,1948
2003,Rural,Kerala,Crime Against Women,Molestation,Male,18-30,2540,2357,183,2398,142
2010,Rural,Madhya Pradesh,Crime Against Women,Rape,Female,0-12,5828,5116,712,5371,457
2010,Urban,Mizoram,Crime Against Men,Extortion,Female,18-30,8076,6817,1259,7963,113
2002,Urban,Uttar Pradesh,Crime Against Children,Child Labor,Female,31-45,1298,864,434,980,318
2008,Urban,Tamil Nadu,Crime Against Children,Kidnapping,Male,60+,6243,5772,471,6219,24
2009,Rural,Jharkhand,Crime Against Men,Assault,Male,13-17,3838,1424,2414,3295,543
2005,Urban,Maharashtra,Crime Against Children,Child Abuse,Female,0-12,3652,1897,1755,3472,180
2007,Rural,Maharashtra,Other Crimes,Drug Offense,Male,46-60,7810,1964,5846,7127,683
2009,Rural,Rajasthan,Property Crime,Arson,Male,18-30,4593,3908,685,4297,296
2008,Rural,Rajasthan,Other Crimes,Fraud,Female,46-60,866,116,750,776,90
2001,Urban,West Bengal,Crime Against Children,Kidnapping,Male,18-30,5982,5864,118,5910,72
2005,Rural,Bihar,Other Crimes,Corruption,Male,46-60,5835,2285,3550,3999,1836
2006,Urban,Goa,Property Crime,Burglary,Male,31-45,9224,198,9026,4730,4494
2005,Urban,Chhattisgarh,Crime Against Women,Rape,Female,18-30,3798,2977,821,3354,444
2003,Urban,Gujarat,Crime Against Women,Molestation,Female,13-17,4462,3258,1204,4429,33
2008,Urban,West Bengal,Crime Against Men,Murder,Female,18-30,9017,462,8555,4975,4042
2004,Rural,Uttar Pradesh,Other Crimes,Drug Offense,Female,46-60,2669,188,2481,1503,1166
2008,Rural,Assam,Crime Against Men,Extortion,Female,60+,2765,2717,48,2734,31
2008,Rural,Manipur,Crime Against Children,Kidnapping,Male,31-45,6126,951,5175,1002,5124
2009,Rural,Uttarakhand,Crime Against Children,Child Labor,Male,46-60,8705,3576,5129,6142,2563
2010,Rural,Delhi,Crime Against Men,Robbery,Female,31-45,5015,1357,3658,2198,2817
2003,Urban,Tripura,Crime Against Children,Child Abuse,Female,46-60,7263,5579,1684,5917,1346
2001,Urban,Gujarat,Other Crimes,Corruption,Male,46-60,3636,1668,1968,1759,1877
2001,Urban,Maharashtra,Property Crime,Arson,Male,46-60,5217,1735,3482,2925,2292
2003,Rural,Telangana,Other Crimes,Corruption,Female,31-45,481,283,198,342,139
2006,Urban,Rajasthan,Crime Against Women,Domestic Violence,Male,13-17,5168,2284,2884,4840,328
2007,Rural,Haryana,Other Crimes,Fraud,Male,46-60,9592,1838,7754,8858,734
2009,Rural,Sikkim,Crime Against Children,Trafficking,Female,31-45,2541,1060,1481,2421,120
2005,Rural,Telangana,Crime Against Men,Robbery,Male,0-12,7864,6512,1352,7294,570
2002,Rural,Assam,Crime Against Children,Child Abuse,Female,31-45,8414,4179,4235,6120,2294
2003,Rural,Tamil Nadu,Crime Against Children,Kidnapping,Female,46-60,6260,6221,39,6260,0
2010,Urban,Madhya Pradesh,Crime Against Women,Dowry Deaths,Female,60+,3921,2245,1676,3222,699
2001,Rural,Maharashtra,Crime Against Children,Child Labor,Male,31-45,4553,2447,2106,4104,449
2006,Urban,Tamil Nadu,Other Crimes,Drug Offense,Male,31-45,3932,303,3629,1037,2895
2007,Urban,Goa,Crime Against Men,Assault,Male,46-60,8849,8677,172,8730,119
2002,Rural,Haryana,Crime Against Women,Domestic Violence,Male,46-60,2460,283,2177,800,1660
2005,Urban,Maharashtra,Crime Against Children,Kidnapping,Male,0-12,830,206,624,241,589
2005,Rural,Chhattisgarh,Crime Against Women,Molestation,Male,0-12,8800,2701,6099,5183,3617
2003,Urban,Assam,Crime Against Women,Molestation,Male,31-45,7874,6070,1804,6780,1094
2010,Urban,Odisha,Crime Against Men,Extortion,Female,31-45,5414,3238,2176,3521,1893
2001,Rural,Jharkhand,Crime Against Women,Domestic Violence,Male,46-60,4991,4102,889,4445,546
2008,Urban,Telangana,Other Crimes,Corruption,Male,46-60,7853,7105,748,7309,544
2009,Urban,Meghalaya,Crime Against Men,Extortion,Male,0-12,9222,4806,4416,6199,3023
2010,Urban,Himachal Pradesh,Crime Against Women,Dowry Deaths,Male,60+,2454,1123,1331,1667,787
2007,Urban,Rajasthan,Crime Against Women,Dowry Deaths,Female,13-17,9798,6168,3630,9063,735
2009,Rural,Maharashtra,Property Crime,Arson,Female,13-17,1401,549,852,978,423
2001,Rural,Haryana,Other Crimes,Corruption,Male,46-60,6954,3516,3438,6720,234
2009,Urban,West Bengal,Crime Against Women,Molestation,Male,31-45,2274,2127,147,2185,89
2002,Urban,Jammu & Kashmir,Other Crimes,Corruption,Male,46-60,7846,1871,5975,4104,3742
2010,Urban,Assam,Property Crime,Vandalism,Male,18-30,6642,6552,90,6552,90
2002,Urban,Arunachal Pradesh,Crime Against Women,Dowry Deaths,Female,0-12,8048,2754,5294,4559,3489
2008,Rural,Maharashtra,Other Crimes,Corruption,Female,18-30,2522,1476,1046,1920,602
2004,Rural,Maharashtra,Crime Against Children,Trafficking,Male,13-17,9986,2923,7063,7756,2230
2005,Rural,Chhattisgarh,Property Crime,Vandalism,Male,60+,7244,5503,1741,5647,1597
2001,Urban,Chhattisgarh,Crime Against Men,Murder,Male,46-60,7429,3530,3899,3685,3744
2003,Rural,Assam,Crime Against Children,Trafficking,Male,46-60,1456,354,1102,975,481
2001,Urban,Haryana,Crime Against Women,Rape,Male,60+,4701,2597,2104,4069,632
2008,Urban,Andhra Pradesh,Crime Against Children,Trafficking,Male,13-17,230,81,149,159,71
2003,Rural,Arunachal Pradesh,Crime Against Women,Rape,Male,0-12,1817,1275,542,1757,60
2006,Rural,Jammu & Kashmir,Other Crimes,Corruption,Male,60+,917,312,605,906,11
2010,Urban,Punjab,Crime Against Men,Assault,Male,46-60,7802,3385,4417,7208,594
2002,Urban,Delhi,Property Crime,Vandalism,Male,0-12,6410,3594,2816,5045,1365
2001,Urban,Assam,Crime Against Women,Domestic Violence,Male,13-17,6793,4541,2252,4801,1992
2005,Rural,Rajasthan,Crime Against Children,Kidnapping,Male,0-12,1186,784,402,790,396
2004,Rural,Gujarat,Crime Against Men,Murder,Female,13-17,1745,705,1040,1042,703
2005,Rural,Sikkim,Property Crime,Theft,Female,60+,3143,2870,273,2879,264
2008,Urban,Kerala,Crime Against Women,Dowry Deaths,Male,31-45,2763,940,1823,1045,1718
2006,Rural,Telangana,Property Crime,Burglary,Female,0-12,3075,900,2175,977,2098
2001,Rural,Sikkim,Crime Against Men,Extortion,Female,46-60,4595,1856,2739,2104,2491
2007,Urban,Sikkim,Crime Against Men,Extortion,Female,60+,1270,135,1135,300,970
2010,Urban,Tripura,Crime Against Children,Child Abuse,Female,18-30,2536,191,2345,1637,899
2009,Rural,Himachal Pradesh,Crime Against Women,Molestation,Female,60+,2261,347,1914,471,1790
2004,Rural,Meghalaya,Property Crime,Theft,Male,13-17,9999,6541,3458,9971,28
2002,Rural,Arunachal Pradesh,Other Crimes,Fraud,Male,13-17,6059,1009,5050,5205,854
2009,Rural,Telangana,Property Crime,Theft,Female,60+,424,256,168,382,42
2003,Rural,Meghalaya,Crime Against Men,Extortion,Male,31-45,7694,3378,4316,6077,1617
2010,Rural,Kerala,Other Crimes,Corruption,Male,0-12,2784,2025,759,2142,642
2007,Urban,Arunachal Pradesh,Crime Against Children,Child Abuse,Female,31-45,7870,3453,4417,7432,438
2010,Urban,Tripura,Crime Against Women,Domestic Violence,Female,31-45,849,271,578,332,517
2006,Urban,Tripura,Property Crime,Arson,Male,0-12,1622,1406,216,1621,1
2003,Urban,Maharashtra,Property Crime,Vandalism,Male,18-30,709,557,152,563,146
2010,Rural,Sikkim,Property Crime,Vandalism,Male,13-17,8617,6246,2371,6937,1680
2005,Rural,Goa,Other Crimes,Drug Offense,Female,60+,2125,387,1738,412,1713
2006,Rural,Gujarat,Crime Against Women,Dowry Deaths,Female,18-30,2829,2180,649,2485,344
2008,Rural,Maharashtra,Property Crime,Theft,Male,31-45,2630,643,1987,1852,778
2008,Rural,Maharashtra,Crime Against Men,Robbery,Male,18-30,2460,1727,733,2139,321
2008,Urban,Goa,Other Crimes,Drug Offense,Female,31-45,8674,912,7762,5932,2742
2002,Rural,Andhra Pradesh,Crime Against Men,Murder,Male,18-30,8260,4226,4034,4618,3642
2010,Rural,Goa,Other Crimes,Drug Offense,Male,18-30,7727,3292,4435,7113,614
2005,Urban,Nagaland,Other Crimes,Fraud,Female,13-17,9140,4505,4635,6030,3110
2010,Urban,Andhra Pradesh,Crime Against Men,Robbery,Female,18-30,9340,2325,7015,4145,5195
2003,Rural,Telangana,Crime Against Children,Child Abuse,Female,13-17,2323,1314,1009,2188,135
2010,Rural,Uttarakhand,Crime Against Men,Robbery,Male,13-17,3416,2033,1383,3087,329
2010,Rural,Jammu & Kashmir,Property Crime,Burglary,Male,13-17,7778,6251,1527,7188,590
2005,Rural,Telangana,Crime Against Men,Murder,Male,31-45,8187,5059,3128,7198,989
2005,Urban,Punjab,Crime Against Women,Rape,Female,13-17,7247,2786,4461,3593,3654
2004,Rural,Assam,Property Crime,Burglary,Male,46-60,2471,1139,1332,1977,494
2008,Urban,Uttarakhand,Crime Against Children,Kidnapping,Male,31-45,4485,3902,583,4464,21
2008,Rural,Uttar Pradesh,Crime Against Women,Molestation,Female,0-12,6040,3029,3011,4732,1308
2008,Urban,Bihar,Crime Against Men,Murder,Male,18-30,401,119,282,159,242
2009,Rural,Jammu & Kashmir,Property Crime,Theft,Female,46-60,1083,486,597,533,550
2005,Rural,Mizoram,Other Crimes,Fraud,Male,31-45,2433,885,1548,1514,919
2005,Rural,Andhra Pradesh,Crime Against Children,Child Labor,Female,46-60,3738,1713,2025,3454,284
2010,Rural,Andhra Pradesh,Crime Against Men,Assault,Female,31-45,976,58,918,473,503
2002,Urban,Uttar Pradesh,Property Crime,Arson,Female,0-12,2669,958,1711,1336,1333
2010,Rural,Odisha,Crime Against Men,Murder,Female,60+,4241,2019,2222,3416,825
2004,Urban,Uttar Pradesh,Property Crime,Vandalism,Female,31-45,3639,1785,1854,2814,825
2010,Rural,Nagaland,Crime Against Women,Dowry Deaths,Male,60+,5043,1115,3928,4245,798
2010,Rural,Meghalaya,Crime Against Men,Assault,Female,60+,7140,1790,5350,5412,1728
2008,Urban,Uttarakhand,Property Crime,Vandalism,Male,46-60,4900,1223,3677,2689,2211
2004,Rural,Madhya Pradesh,Crime Against Children,Child Abuse,Male,18-30,3681,855,2826,1841,1840
2002,Rural,Jharkhand,Crime Against Women,Rape,Male,60+,6027,4782,1245,5510,517
2006,Urban,Bihar,Property Crime,Theft,Male,60+,9574,5114,4460,8639,935
2001,Urban,Telangana,Crime Against Men,Robbery,Male,0-12,3283,2075,1208,2833,450
2007,Rural,Jharkhand,Other Crimes,Fraud,Female,60+,2773,629,2144,1763,1010
2002,Rural,Nagaland,Crime Against Men,Assault,Male,60+,1927,1065,862,1138,789
2007,Rural,Assam,Crime Against Children,Child Abuse,Female,31-45,1256,872,384,988,268
2010,Urban,Goa,Crime Against Men,Assault,Female,31-45,259,204,55,256,3
2004,Urban,Andhra Pradesh,Property Crime,Vandalism,Male,60+,2927,1116,1811,1772,1155
2003,Urban,Maharashtra,Crime Against Men,Assault,Female,0-12,4888,3750,1138,4158,730
2008,Urban,Jammu & Kashmir,Crime Against Children,Child Abuse,Female,13-17,6477,4259,2218,4567,1910
2006,Urban,Haryana,Other Crimes,Drug Offense,Male,13-17,5382,4901,481,5333,49
2010,Urban,Bihar,Crime Against Men,Robbery,Male,60+,4275,2364,1911,3724,551
2008,Rural,Telangana,Crime Against Women,Molestation,Male,18-30,7153,5157,1996,5287,1866
2010,Rural,Manipur,Other Crimes,Corruption,Female,0-12,6331,3705,2626,5477,854
2002,Urban,Tripura,Property Crime,Burglary,Male,13-17,7220,6120,1100,7046,174
2004,Rural,Jharkhand,Crime Against Children,Child Abuse,Male,31-45,7644,982,6662,7351,293
2008,Urban,Mizoram,Crime Against Children,Trafficking,Female,0-12,1884,1864,20,1881,3
2002,Urban,Tripura,Crime Against Children,Trafficking,Male,31-45,9523,1767,7756,2180,7343
2010,Rural,Assam,Crime Against Men,Assault,Female,18-30,7667,3362,4305,7408,259
2001,Urban,Gujarat,Crime Against Men,Assault,Female,0-12,4252,3146,1106,3988,264
2010,Urban,Tamil Nadu,Other Crimes,Corruption,Male,13-17,6645,5716,929,6536,109
2009,Urban,Nagaland,Crime Against Women,Rape,Male,46-60,1512,1225,287,1298,214
2005,Urban,Rajasthan,Crime Against Women,Molestation,Male,46-60,7370,433,6937,998,6372
2007,Rural,Tripura,Crime Against Women,Rape,Female,60+,5072,1915,3157,4268,804
2008,Rural,Gujarat,Crime Against Children,Child Abuse,Male,0-12,7490,722,6768,1055,6435
2001,Rural,Delhi,Property Crime,Vandalism,Female,0-12,8353,6680,1673,7703,650
2009,Rural,Uttar Pradesh,Property Crime,Arson,Female,13-17,3387,1589,1798,3145,242
2008,Urban,Kerala,Other Crimes,Corruption,Female,46-60,9276,1620,7656,2980,6296
2010,Urban,Nagaland,Crime Against Men,Assault,Female,46-60,5939,831,5108,1377,4562
2002,Urban,Jharkhand,Other Crimes,Corruption,Male,46-60,6063,2989,3074,4669,1394
2001,Rural,Andhra Pradesh,Crime Against Men,Robbery,Male,60+,3640,2555,1085,2791,849
2009,Urban,Arunachal Pradesh,Crime Against Children,Trafficking,Female,46-60,4313,1273,3040,2465,1848
2010,Urban,Jharkhand,Crime Against Women,Dowry Deaths,Male,60+,501,221,280,389,112
2004,Urban,Jharkhand,Property Crime,Theft,Female,60+,4212,2011,2201,2570,1642
2010,Urban,West Bengal,Crime Against Men,Extortion,Female,13-17,644,100,544,580,64
2001,Urban,Mizoram,Crime Against Women,Rape,Female,46-60,5308,2705,2603,5213,95
2004,Rural,Rajasthan,Crime Against Children,Child Labor,Male,13-17,6822,1752,5070,5925,897
2001,Rural,Meghalaya,Property Crime,Burglary,Male,0-12,5898,2887,3011,5114,784
2008,Rural,Chhattisgarh,Crime Against Women,Domestic Violence,Female,13-17,9596,7651,1945,9368,228
2005,Rural,Mizoram,Other Crimes,Cyber Crime,Female,18-30,6456,1709,4747,5166,1290
2007,Urban,Kerala,Crime Against Men,Robbery,Female,31-45,3686,1384,2302,1450,2236
2009,Urban,Jammu & Kashmir,Property Crime,Vandalism,Male,0-12,7710,295,7415,4862,2848
2009,Rural,Himachal Pradesh,Other Crimes,Drug Offense,Male,31-45,2482,1451,1031,2378,104
2007,Urban,Punjab,Crime Against Men,Murder,Male,31-45,6582,1769,4813,5094,1488
2005,Rural,Andhra Pradesh,Crime Against Women,Rape,Female,60+,5526,5209,317,5262,264
2002,Rural,Karnataka,Other Crimes,Corruption,Female,18-30,522,161,361,171,351
2005,Rural,Sikkim,Crime Against Men,Assault,Male,13-17,2959,1350,1609,2870,89
2005,Urban,Andhra Pradesh,Crime Against Children,Kidnapping,Female,18-30,5019,4766,253,4967,52
2003,Rural,Haryana,Crime Against Children,Trafficking,Male,18-30,1820,561,1259,596,1224
2003,Rural,West Bengal,Crime Against Men,Murder,Female,60+,3613,963,2650,1195,2418
2004,Urban,Chhattisgarh,Crime Against Women,Dowry Deaths,Female,0-12,9701,1905,7796,2492,7209
2005,Urban,Uttarakhand,Crime Against Children,Trafficking,Male,60+,9001,3157,5844,6644,2357
2008,Urban,Maharashtra,Property Crime,Arson,Female,18-30,4208,757,3451,2139,2069
2007,Rural,Madhya Pradesh,Crime Against Women,Rape,Female,0-12,861,161,700,253,608
2003,Urban,Himachal Pradesh,Other Crimes,Corruption,Male,18-30,3654,2945,709,3588,66
2004,Urban,West Bengal,Property Crime,Theft,Male,31-45,2253,750,1503,872,1381
2006,Urban,Uttar Pradesh,Crime Against Women,Molestation,Male,0-12,3883,1805,2078,3173,710
2005,Urban,Punjab,Crime Against Children,Child Abuse,Female,13-17,5333,412,4921,5314,19
2009,Rural,Chhattisgarh,Crime Against Children,Kidnapping,Female,46-60,6811,4555,2256,4894,1917
2006,Urban,Tamil Nadu,Crime Against Children,Trafficking,Female,13-17,705,612,93,641,64
2002,Rural,Uttarakhand,Crime Against Women,Dowry Deaths,Male,18-30,3033,1726,1307,2323,710
2008,Rural,Arunachal Pradesh,Crime Against Men,Extortion,Male,13-17,5287,4622,665,5172,115
2010,Urban,Mizoram,Property Crime,Theft,Female,46-60,4022,627,3395,3594,428
2003,Rural,Bihar,Crime Against Children,Kidnapping,Female,18-30,2799,2045,754,2649,150
2009,Urban,Mizoram,Other Crimes,Fraud,Female,0-12,6007,145,5862,6003,4
2007,Urban,Delhi,Crime Against Men,Robbery,Female,31-45,4756,3942,814,4357,399
2007,Rural,Uttar Pradesh,Crime Against Children,Child Labor,Male,18-30,7252,6343,909,6604,648
2010,Urban,Assam,Crime Against Men,Robbery,Female,0-12,4558,3563,995,4210,348
2009,Urban,Uttarakhand,Crime Against Women,Domestic Violence,Male,31-45,8695,3085,5610,7806,889
2005,Rural,Manipur,Other Crimes,Cyber Crime,Male,46-60,7506,1661,5845,5081,2425
2004,Rural,Sikkim,Crime Against Men,Robbery,Female,13-17,6973,5442,1531,6435,538
2009,Rural,Arunachal Pradesh,Crime Against Children,Trafficking,Female,13-17,525,273,252,470,55
2003,Urban,Maharashtra,Crime Against Women,Dowry Deaths,Female,31-45,1606,1223,383,1338,268
2010,Urban,Kerala,Crime Against Men,Extortion,Male,18-30,51,22,29,41,10
2005,Urban,Madhya Pradesh,Other Crimes,Fraud,Male,46-60,2685,1419,1266,1540,1145
2005,Urban,Rajasthan,Other Crimes,Corruption,Male,46-60,8998,7398,1600,7507,1491
2003,Urban,Madhya Pradesh,Property Crime,Theft,Male,0-12,7393,5141,2252,6310,1083
2002,Rural,Kerala,Crime Against Children,Child Abuse,Male,60+,9260,8365,895,8780,480
2010,Urban,Uttar Pradesh,Crime Against Children,Trafficking,Male,18-30,707,667,40,701,6
2003,Urban,Madhya Pradesh,Crime Against Women,Rape,Male,60+,5470,4142,1328,5425,45
2003,Rural,Telangana,Other Crimes,Fraud,Female,13-17,1505,1386,119,1406,99
2006,Urban,Kerala,Crime Against Children,Child Abuse,Female,13-17,2057,513,1544,1613,444
2001,Rural,West Bengal,Crime Against Women,Domestic Violence,Female,31-45,5693,579,5114,704,4989
2002,Rural,Haryana,Property Crime,Burglary,Male,31-45,2681,143,2538,1226,1455
2006,Urban,Haryana,Property Crime,Burglary,Female,60+,9482,3954,5528,6677,2805
2002,Rural,Nagaland,Other Crimes,Fraud,Male,13-17,6988,3963,3025,6384,604
2010,Urban,Meghalaya,Crime Against Men,Assault,Male,46-60,210,168,42,187,23
2006,Urban,Jharkhand,Crime Against Children,Child Abuse,Female,60+,7039,2411,4628,4656,2383
2008,Rural,Punjab,Property Crime,Vandalism,Male,46-60,589,16,573,219,370
2002,Rural,Sikkim,Other Crimes,Cyber Crime,Male,31-45,436,368,68,430,6
2009,Urban,Odisha,Other Crimes,Drug Offense,Female,13-17,7308,364,6944,1193,6115
2004,Rural,Meghalaya,Other Crimes,Drug Offense,Male,31-45,3572,2944,628,3243,329
2007,Urban,Mizoram,Crime Against Men,Murder,Female,60+,925,517,408,542,383
2008,Rural,Punjab,Crime Against Children,Trafficking,Male,31-45,8848,2546,6302,5345,3503
2006,Rural,Punjab,Crime Against Women,Domestic Violence,Male,60+,4180,3341,839,3916,264
2008,Urban,Himachal Pradesh,Crime Against Children,Child Abuse,Female,46-60,89,40,49,66,23
2001,Urban,Tripura,Crime Against Women,Domestic Violence,Male,31-45,1523,411,1112,545,978
2002,Rural,Uttar Pradesh,Other Crimes,Fraud,Male,13-17,4311,3686,625,4051,260
2005,Urban,Uttar Pradesh,Crime Against Women,Molestation,Female,60+,6634,6433,201,6574,60
2006,Rural,Rajasthan,Other Crimes,Drug Offense,Male,13-17,8715,7961,754,8657,58
2007,Rural,Kerala,Property Crime,Burglary,Female,18-30,5209,2844,2365,3718,1491
2003,Rural,Tamil Nadu,Property Crime,Burglary,Female,31-45,3695,392,3303,1550,2145
2002,Rural,Karnataka,Crime Against Women,Molestation,Female,60+,9407,3532,5875,4341,5066
2001,Urban,Jammu & Kashmir,Other Crimes,Cyber Crime,Male,18-30,5867,765,5102,3283,2584
2006,Rural,Sikkim,Other Crimes,Cyber Crime,Male,0-12,3203,2282,921,2710,493
2008,Rural,Rajasthan,Property Crime,Burglary,Male,60+,1205,634,571,1065,140
2003,Rural,Tamil Nadu,Crime Against Men,Extortion,Male,46-60,6016,1771,4245,3057,2959
2007,Urban,Madhya Pradesh,Property Crime,Arson,Female,13-17,6724,2279,4445,4664,2060
2010,Urban,Meghalaya,Crime Against Women,Dowry Deaths,Female,60+,8667,7753,914,8211,456
2001,Urban,Meghalaya,Crime Against Women,Molestation,Female,60+,1592,438,1154,1109,483
2009,Urban,Telangana,Property Crime,Theft,Male,31-45,4016,1095,2921,2096,1920
2006,Urban,Delhi,Crime Against Children,Child Abuse,Male,0-12,9654,6523,3131,6579,3075
2003,Rural,Punjab,Crime Against Children,Child Labor,Male,46-60,5017,1537,3480,4490,527
2001,Urban,Assam,Crime Against Children,Kidnapping,Male,60+,8572,8512,60,8534,38
2004,Rural,Tripura,Property Crime,Vandalism,Male,46-60,6219,46,6173,3885,2334
2004,Rural,Nagaland,Crime Against Women,Domestic Violence,Female,60+,4158,2497,1661,2537,1621
2004,Rural,Uttarakhand,Other Crimes,Cyber Crime,Female,31-45,4350,456,3894,1821,2529
2006,Urban,Telangana,Property Crime,Arson,Male,46-60,8218,1144,7074,3193,5025
2001,Rural,West Bengal,Other Crimes,Cyber Crime,Male,18-30,3671,2560,1111,2864,807
2001,Urban,Rajasthan,Crime Against Children,Kidnapping,Female,0-12,3408,965,2443,3205,203
2009,Urban,Delhi,Crime Against Women,Dowry Deaths,Female,60+,9973,9092,881,9599,374
2009,Rural,Uttar Pradesh,Property Crime,Burglary,Male,46-60,8899,7924,975,8686,213
2001,Urban,Punjab,Other Crimes,Cyber Crime,Male,18-30,722,308,414,612,110
2008,Rural,Jharkhand,Other Crimes,Cyber Crime,Male,0-12,9857,696,9161,2347,7510
2008,Urban,Jharkhand,Crime Against Men,Robbery,Female,31-45,9955,235,9720,7825,2130
2010,Rural,West Bengal,Crime Against Children,Trafficking,Male,18-30,9062,3713,5349,5234,3828
2002,Urban,Goa,Crime Against Women,Domestic Violence,Male,31-45,8440,8282,158,8385,55
2007,Rural,Karnataka,Property Crime,Burglary,Male,31-45,4039,1388,2651,2823,1216
2007,Urban,Sikkim,Crime Against Men,Murder,Male,46-60,2004,1783,221,2004,0
2004,Rural,Tamil Nadu,Crime Against Men,Extortion,Male,0-12,1853,1184,669,1205,648
2006,Rural,Haryana,Property Crime,Arson,Male,31-45,6222,4570,1652,5255,967
2006,Rural,Assam,Property Crime,Vandalism,Female,0-12,3990,3721,269,3848,142
2009,Urban,Delhi,Property Crime,Burglary,Female,18-30,7016,1110,5906,5960,1056
2010,Urban,Maharashtra,Other Crimes,Drug Offense,Male,31-45,3607,727,2880,3593,14
2010,Urban,Tamil Nadu,Crime Against Men,Robbery,Male,0-12,5333,617,4716,2134,3199
2009,Urban,Delhi,Other Crimes,Drug Offense,Male,31-45,6596,5865,731,6284,312
2002,Urban,Andhra Pradesh,Other Crimes,Cyber Crime,Female,31-45,5613,4962,651,5349,264
2004,Rural,Assam,Crime Against Children,Trafficking,Male,60+,7425,6154,1271,7049,376
2008,Urban,Maharashtra,Crime Against Men,Robbery,Female,0-12,8393,6238,2155,7407,986
2003,Rural,Meghalaya,Other Crimes,Corruption,Male,13-17,6505,1689,4816,2518,3987
2003,Rural,Gujarat,Crime Against Children,Trafficking,Male,18-30,2721,30,2691,2359,362
2001,Rural,Nagaland,Crime Against Women,Rape,Male,46-60,1844,1443,401,1670,174
2004,Rural,West Bengal,Property Crime,Theft,Male,18-30,1848,70,1778,1844,4
2003,Rural,Odisha,Other Crimes,Fraud,Female,0-12,2453,1070,1383,1528,925
2010,Rural,Arunachal Pradesh,Crime Against Men,Robbery,Male,13-17,1644,1127,517,1607,37
2003,Rural,Haryana,Crime Against Men,Murder,Female,46-60,6960,6188,772,6236,724
2006,Rural,Chhattisgarh,Crime Against Women,Rape,Male,31-45,4383,3881,502,3959,424
2001,Rural,Meghalaya,Crime Against Women,Dowry Deaths,Female,13-17,9185,2246,6939,5739,3446
2006,Urban,Tamil Nadu,Crime Against Women,Molestation,Female,31-45,6667,3561,3106,5564,1103
2008,Rural,Odisha,Crime Against Children,Trafficking,Male,18-30,5614,5489,125,5585,29
2004,Rural,Gujarat,Crime Against Men,Extortion,Female,31-45,2748,1615,1133,1961,787
2001,Rural,Madhya Pradesh,Crime Against Women,Molestation,Male,31-45,8457,6166,2291,6522,1935
2008,Rural,Assam,Property Crime,Arson,Female,46-60,9915,1710,8205,5602,4313
2006,Rural,Nagaland,Other Crimes,Drug Offense,Female,13-17,7318,6924,394,6995,323
2006,Rural,Andhra Pradesh,Property Crime,Burglary,Male,60+,4926,2605,2321,3167,1759
2009,Urban,Gujarat,Crime Against Children,Trafficking,Male,0-12,4095,2998,1097,4027,68
2010,Rural,Jharkhand,Other Crimes,Drug Offense,Male,46-60,289,107,182,201,88
2006,Rural,Kerala,Crime Against Children,Kidnapping,Female,0-12,3049,2236,813,2976,73
2003,Urban,Himachal Pradesh,Crime Against Children,Trafficking,Female,13-17,2360,2291,69,2297,63
2003,Urban,Telangana,Other Crimes,Cyber Crime,Female,60+,6814,6124,690,6291,523
2010,Rural,Delhi,Other Crimes,Fraud,Female,46-60,9273,1066,8207,8089,1184
2001,Urban,Andhra Pradesh,Crime Against Children,Child Abuse,Male,31-45,2303,1668,635,1863,440
2003,Urban,Delhi,Crime Against Children,Child Abuse,Female,0-12,7635,1142,6493,3159,4476
2007,Rural,Odisha,Crime Against Women,Domestic Violence,Male,60+,3857,1173,2684,1629,2228
2001,Rural,Arunachal Pradesh,Property Crime,Theft,Male,18-30,215,149,66,207,8
2010,Urban,Uttar Pradesh,Crime Against Men,Extortion,Male,13-17,1460,204,1256,475,985
2004,Rural,Karnataka,Property Crime,Vandalism,Female,46-60,9132,6447,2685,6557,2575
2006,Urban,Arunachal Pradesh,Other Crimes,Fraud,Female,60+,5458,205,5253,4720,738
2001,Rural,Mizoram,Property Crime,Arson,Male,18-30,6698,6034,664,6198,500
2008,Rural,Arunachal Pradesh,Property Crime,Burglary,Male,46-60,4146,2398,1748,3811,335
2006,Urban,Mizoram,Crime Against Men,Murder,Male,0-12,1952,915,1037,1087,865
2003,Rural,Kerala,Crime Against Children,Child Abuse,Male,0-12,9026,6649,2377,7252,1774
2003,Rural,Uttarakhand,Crime Against Women,Dowry Deaths,Male,13-17,4883,1628,3255,3983,900
2009,Rural,Assam,Property Crime,Vandalism,Male,31-45,280,185,95,234,46
2003,Rural,Nagaland,Crime Against Men,Robbery,Female,0-12,3323,769,2554,1836,1487
2002,Urban,Meghalaya,Other Crimes,Drug Offense,Female,13-17,9650,4375,5275,6293,3357
2003,Urban,Delhi,Other Crimes,Corruption,Male,13-17,8985,6515,2470,6793,2192
2009,Urban,Jharkhand,Crime Against Men,Robbery,Male,31-45,757,252,505,306,451
2005,Urban,Odisha,Other Crimes,Corruption,Male,60+,9555,4513,5042,8079,1476
2007,Urban,Arunachal Pradesh,Property Crime,Vandalism,Female,31-45,3706,3338,368,3540,166
2005,Rural,West Bengal,Crime Against Men,Assault,Female,31-45,1816,125,1691,516,1300
2002,Urban,Arunachal Pradesh,Property Crime,Theft,Male,60+,5473,2790,2683,5182,291
2004,Rural,Uttarakhand,Other Crimes,Corruption,Female,0-12,3868,1994,1874,3309,559
2008,Rural,West Bengal,Crime Against Children,Kidnapping,Male,31-45,4250,2139,2111,2499,1751
2009,Rural,Kerala,Crime Against Children,Trafficking,Male,46-60,9183,2100,7083,2203,6980
2006,Urban,Haryana,Crime Against Men,Assault,Male,0-12,4732,467,4265,1169,3563
2009,Rural,Goa,Other Crimes,Fraud,Female,46-60,3504,35,3469,1182,2322
2009,Urban,Uttar Pradesh,Property Crime,Vandalism,Male,0-12,6017,2036,3981,3591,2426
2007,Rural,Sikkim,Property Crime,Burglary,Male,31-45,348,205,143,271,77
2006,Rural,Delhi,Other Crimes,Drug Offense,Male,0-12,1476,600,876,750,726
2005,Rural,Haryana,Crime Against Women,Dowry Deaths,Male,46-60,3375,1476,1899,3001,374
2006,Urban,Arunachal Pradesh,Crime Against Men,Extortion,Male,60+,8708,6877,1831,8340,368
2004,Rural,Manipur,Crime Against Men,Robbery,Male,18-30,2802,2625,177,2693,109
2010,Urban,Sikkim,Other Crimes,Corruption,Female,13-17,5417,4542,875,4763,654
2010,Rural,Haryana,Other Crimes,Cyber Crime,Male,31-45,8233,4310,3923,4848,3385
2002,Rural,Arunachal Pradesh,Crime Against Men,Murder,Male,60+,4152,649,3503,771,3381
2005,Rural,Haryana,Crime Against Men,Extortion,Female,0-12,9582,2242,7340,4326,5256
2002,Urban,Karnataka,Crime Against Men,Murder,Male,60+,9260,5240,4020,6295,2965
2004,Urban,Himachal Pradesh,Crime Against Men,Robbery,Female,18-30,1378,776,602,1174,204
2004,Rural,Odisha,Crime Against Children,Kidnapping,Female,60+,9692,6294,3398,8051,1641
2004,Urban,Tripura,Property Crime,Vandalism,Female,60+,2475,480,1995,569,1906
2005,Urban,Manipur,Property Crime,Burglary,Male,18-30,2873,105,2768,1339,1534
2008,Urban,Meghalaya,Crime Against Men,Murder,Male,13-17,2181,522,1659,1257,924
2002,Rural,Jammu & Kashmir,Crime Against Men,Murder,Male,46-60,7535,3637,3898,5203,2332
2003,Rural,Himachal Pradesh,Crime Against Children,Child Labor,Female,0-12,1517,191,1326,1020,497
2010,Urban,Chhattisgarh,Crime Against Women,Rape,Male,0-12,9617,1348,8269,7043,2574
2005,Rural,Jammu & Kashmir,Crime Against Men,Assault,Male,60+,8889,3935,4954,8520,369
2001,Rural,Tamil Nadu,Crime Against Women,Rape,Female,31-45,413,303,110,393,20
2009,Urban,Karnataka,Crime Against Women,Domestic Violence,Male,0-12,8074,2906,5168,6466,1608
2002,Urban,Gujarat,Crime Against Women,Domestic Violence,Male,31-45,9612,9549,63,9583,29
2004,Urban,Gujarat,Property Crime,Arson,Female,31-45,8772,2209,6563,6515,2257
2010,Rural,Karnataka,Property Crime,Arson,Female,46-60,1339,80,1259,705,634
2001,Urban,Mizoram,Crime Against Men,Extortion,Female,0-12,1900,1135,765,1634,266
2002,Rural,Manipur,Property Crime,Burglary,Female,18-30,7774,6085,1689,6785,989
2010,Rural,Maharashtra,Crime Against Men,Assault,Male,31-45,8768,8093,675,8726,42
2010,Urban,Mizoram,Property Crime,Theft,Male,31-45,3077,2821,256,3022,55
2005,Rural,Meghalaya,Crime Against Children,Kidnapping,Female,60+,8735,425,8310,7940,795
2009,Rural,Madhya Pradesh,Other Crimes,Drug Offense,Female,46-60,7897,2163,5734,6722,1175
2005,Rural,Sikkim,Other Crimes,Fraud,Female,13-17,7420,5420,2000,7120,300
2009,Urban,Kerala,Crime Against Men,Murder,Female,0-12,7206,4693,2513,5219,1987
2006,Urban,Uttar Pradesh,Crime Against Women,Molestation,Female,46-60,3710,1667,2043,3135,575
2008,Rural,Meghalaya,Crime Against Women,Rape,Male,60+,5560,771,4789,1006,4554
2008,Urban,Karnataka,Crime Against Men,Robbery,Female,31-45,9476,8535,941,8774,702
2008,Rural,West Bengal,Crime Against Children,Child Abuse,Female,13-17,5652,901,4751,3229,2423
2004,Urban,Uttarakhand,Crime Against Women,Rape,Male,31-45,5425,864,4561,1474,3951
2008,Urban,Nagaland,Crime Against Women,Domestic Violence,Female,0-12,3212,413,2799,3048,164
2007,Rural,Punjab,Crime Against Men,Robbery,Male,13-17,4354,467,3887,2955,1399
2003,Urban,Uttar Pradesh,Crime Against Men,Robbery,Female,0-12,4537,3342,1195,4436,101
2001,Urban,Sikkim,Crime Against Children,Child Abuse,Male,0-12,2520,724,1796,2466,54
2004,Rural,Meghalaya,Crime Against Women,Rape,Male,13-17,5623,647,4976,1372,4251
2007,Urban,Manipur,Crime Against Men,Assault,Female,13-17,8289,8287,2,8287,2
2006,Urban,Andhra Pradesh,Crime Against Children,Trafficking,Male,13-17,6697,4300,2397,5181,1516
2001,Rural,Assam,Other Crimes,Drug Offense,Male,31-45,4422,590,3832,2181,2241
2004,Rural,Odisha,Property Crime,Vandalism,Male,60+,3502,26,3476,1695,1807
2006,Rural,Tamil Nadu,Crime Against Children,Trafficking,Male,60+,762,499,263,680,82
2004,Urban,Assam,Crime Against Men,Murder,Female,31-45,1375,981,394,1163,212
2002,Urban,Uttarakhand,Crime Against Women,Dowry Deaths,Male,60+,8727,3366,5361,4480,4247
2001,Urban,Chhattisgarh,Other Crimes,Fraud,Female,18-30,9103,1471,7632,3251,5852
2009,Rural,Haryana,Crime Against Children,Child Abuse,Female,0-12,9317,3426,5891,6155,3162
2008,Urban,Maharashtra,Crime Against Children,Child Abuse,Male,31-45,3896,1573,2323,3574,322
2006,Urban,Kerala,Property Crime,Arson,Male,18-30,6881,2756,4125,4595,2286
2009,Rural,Goa,Crime Against Women,Molestation,Male,60+,4463,3675,788,4205,258
2008,Rural,Haryana,Other Crimes,Cyber Crime,Male,0-12,4963,3811,1152,4839,124
2008,Rural,Sikkim,Other Crimes,Drug Offense,Female,46-60,8586,7385,1201,7764,822
2003,Urban,Maharashtra,Crime Against Children,Kidnapping,Male,31-45,5573,4441,1132,5101,472
2002,Rural,Delhi,Other Crimes,Corruption,Male,60+,5718,4280,1438,4689,1029
2005,Urban,Punjab,Crime Against Men,Assault,Female,13-17,6715,4077,2638,5364,1351
2003,Urban,Andhra Pradesh,Property Crime,Arson,Male,13-17,2670,1209,1461,1923,747
2008,Urban,Odisha,Other Crimes,Fraud,Female,0-12,6880,1769,5111,6369,511
2004,Rural,Kerala,Property Crime,Arson,Female,18-30,6008,1247,4761,5683,325
2001,Urban,Himachal Pradesh,Crime Against Men,Extortion,Male,31-45,8828,650,8178,2142,6686
2006,Rural,Kerala,Crime Against Men,Assault,Male,13-17,7349,1887,5462,6332,1017
2004,Urban,Bihar,Crime Against Children,Trafficking,Male,13-17,2686,2503,183,2600,86
2001,Rural,Nagaland,Crime Against Children,Child Labor,Male,60+,5630,1012,4618,1062,4568
2007,Urban,Assam,Crime Against Children,Kidnapping,Female,13-17,7924,2538,5386,3314,4610
2006,Rural,Manipur,Other Crimes,Cyber Crime,Male,0-12,6372,2709,3663,3793,2579
2004,Urban,Haryana,Other Crimes,Fraud,Female,13-17,6779,6708,71,6717,62
2004,Rural,Nagaland,Crime Against Women,Molestation,Female,18-30,7232,2158,5074,3123,4109
2009,Rural,Goa,Property Crime,Burglary,Male,46-60,8743,6936,1807,8741,2
2005,Rural,Himachal Pradesh,Crime Against Children,Trafficking,Female,31-45,6558,5935,623,6050,508
2008,Urban,West Bengal,Property Crime,Vandalism,Male,13-17,3844,466,3378,2156,1688
2001,Rural,Maharashtra,Other Crimes,Corruption,Female,13-17,6359,515,5844,1936,4423
2004,Rural,Manipur,Crime Against Children,Trafficking,Female,0-12,7535,937,6598,1397,6138
2005,Rural,Jammu & Kashmir,Crime Against Women,Rape,Female,0-12,9229,5493,3736,7024,2205
2005,Rural,Jammu & Kashmir,Crime Against Children,Kidnapping,Female,0-12,1956,1748,208,1762,194
2008,Rural,Jharkhand,Crime Against Women,Dowry Deaths,Male,0-12,2998,1754,1244,2260,738
2009,Rural,Uttarakhand,Property Crime,Theft,Male,13-17,3772,559,3213,1461,2311
2002,Rural,Odisha,Property Crime,Vandalism,Female,18-30,4358,2879,1479,3011,1347
2006,Urban,Uttar Pradesh,Crime Against Men,Robbery,Male,31-45,1060,737,323,739,321
2009,Urban,Bihar,Property Crime,Arson,Female,0-12,9534,5031,4503,5296,4238
2001,Rural,Jammu & Kashmir,Other Crimes,Corruption,Female,31-45,1533,54,1479,257,1276
2007,Urban,Jharkhand,Property Crime,Burglary,Female,0-12,4237,3306,931,4227,10
2004,Rural,Sikkim,Crime Against Women,Domestic Violence,Female,0-12,212,11,201,29,183
2006,Urban,Himachal Pradesh,Other Crimes,Drug Offense,Male,60+,7200,4639,2561,5010,2190
2001,Urban,Chhattisgarh,Crime Against Children,Child Abuse,Female,0-12,8799,8276,523,8739,60
2008,Urban,Goa,Crime Against Women,Domestic Violence,Male,46-60,5278,2510,2768,4349,929
2008,Urban,Uttar Pradesh,Crime Against Women,Molestation,Female,18-30,2733,1037,1696,1846,887
2007,Rural,Manipur,Property Crime,Arson,Male,0-12,2349,771,1578,2113,236
2002,Urban,West Bengal,Other Crimes,Cyber Crime,Male,46-60,1531,1068,463,1476,55
2009,Urban,Andhra Pradesh,Property Crime,Arson,Female,60+,6348,3189,3159,4236,2112
2003,Rural,Goa,Other Crimes,Drug Offense,Male,31-45,2872,831,2041,931,1941
2004,Urban,Manipur,Property Crime,Arson,Female,0-12,6999,2776,4223,4376,2623
2009,Rural,Sikkim,Other Crimes,Cyber Crime,Male,46-60,2998,1092,1906,1736,1262
2005,Rural,Andhra Pradesh,Property Crime,Vandalism,Male,18-30,4546,4328,218,4404,142
2007,Urban,Telangana,Crime Against Women,Domestic Violence,Female,31-45,8450,2363,6087,5128,3322
2008,Rural,Jharkhand,Other Crimes,Fraud,Male,31-45,6309,2805,3504,3912,2397
2008,Urban,Assam,Crime Against Women,Dowry Deaths,Female,46-60,6788,2352,4436,6480,308
2010,Urban,Maharashtra,Crime Against Women,Rape,Female,46-60,9759,3380,6379,4414,5345
2010,Urban,Bihar,Crime Against Children,Trafficking,Female,0-12,9669,7908,1761,8993,676
2004,Rural,Karnataka,Crime Against Women,Domestic Violence,Female,18-30,1355,1190,165,1322,33
2009,Rural,Maharashtra,Crime Against Children,Child Labor,Male,31-45,691,85,606,399,292
2003,Urban,Assam,Property Crime,Burglary,Female,31-45,5624,1828,3796,4232,1392
2004,Rural,Nagaland,Property Crime,Theft,Male,31-45,3290,2411,879,3190,100
2008,Rural,Uttarakhand,Crime Against Women,Dowry Deaths,Female,13-17,4227,3212,1015,3702,525
2010,Rural,Telangana,Property Crime,Vandalism,Male,18-30,8472,4075,4397,7213,1259
2003,Rural,Tamil Nadu,Property Crime,Vandalism,Female,31-45,5517,1820,3697,3403,2114
2003,Rural,Rajasthan,Other Crimes,Corruption,Female,18-30,3318,752,2566,933,2385
2004,Rural,Sikkim,Crime Against Men,Robbery,Female,18-30,5229,882,4347,2555,2674
2009,Urban,Telangana,Property Crime,Theft,Female,18-30,9022,1231,7791,5960,3062
2003,Urban,Uttar Pradesh,Property Crime,Burglary,Female,0-12,2272,19,2253,625,1647
2002,Urban,Uttarakhand,Crime Against Children,Child Abuse,Female,31-45,6751,3660,3091,5819,932
2009,Urban,Uttarakhand,Crime Against Men,Robbery,Female,60+,3414,2621,793,2646,768
2008,Urban,Haryana,Other Crimes,Corruption,Male,13-17,5574,3100,2474,4898,676
2002,Rural,Bihar,Property Crime,Burglary,Female,46-60,8486,7719,767,7760,726
2005,Rural,Andhra Pradesh,Crime Against Women,Rape,Female,13-17,1823,97,1726,494,1329
2001,Urban,West Bengal,Crime Against Men,Murder,Male,18-30,7966,2898,5068,5558,2408
2007,Rural,Punjab,Other Crimes,Corruption,Male,13-17,5040,2360,2680,4335,705
2009,Urban,Meghalaya,Other Crimes,Cyber Crime,Male,0-12,2212,1882,330,2149,63
2006,Urban,Nagaland,Property Crime,Theft,Female,18-30,5060,3963,1097,3996,1064
2004,Urban,Mizoram,Crime Against Men,Murder,Male,31-45,5217,2803,2414,3446,1771
2004,Rural,Himachal Pradesh,Crime Against Men,Extortion,Female,0-12,3996,270,3726,1087,2909
2004,Urban,Delhi,Crime Against Men,Robbery,Female,0-12,7382,240,7142,4143,3239
2001,Rural,Delhi,Other Crimes,Corruption,Female,18-30,7602,4862,2740,5521,2081
2008,Urban,Arunachal Pradesh,Crime Against Men,Robbery,Female,0-12,6578,6500,78,6510,68
2008,Rural,Manipur,Other Crimes,Corruption,Female,46-60,9921,9791,130,9829,92
2004,Urban,Uttar Pradesh,Crime Against Children,Child Labor,Male,18-30,8234,435,7799,819,7415
2010,Urban,Telangana,Crime Against Women,Rape,Female,31-45,7938,5415,2523,5762,2176
2004,Urban,Manipur,Crime Against Children,Child Labor,Female,60+,4513,272,4241,1428,3085
2006,Urban,Arunachal Pradesh,Crime Against Men,Murder,Male,13-17,3637,533,3104,1970,1667
2006,Rural,Andhra Pradesh,Crime Against Women,Domestic Violence,Female,0-12,7072,2632,4440,5197,1875
2003,Rural,Haryana,Other Crimes,Corruption,Male,18-30,2590,1543,1047,2344,246
2001,Rural,Haryana,Crime Against Children,Trafficking,Male,18-30,5029,4697,332,4883,146
2004,Rural,Kerala,Crime Against Women,Domestic Violence,Female,31-45,8108,8082,26,8089,19
2007,Urban,Maharashtra,Other Crimes,Corruption,Male,0-12,3731,1626,2105,2950,781
2005,Rural,Tamil Nadu,Property Crime,Arson,Male,13-17,1493,734,759,971,522
2007,Urban,Punjab,Other Crimes,Corruption,Female,0-12,2133,732,1401,1938,195
2001,Rural,Himachal Pradesh,Crime Against Children,Child Labor,Male,13-17,4043,2421,1622,3149,894
2005,Urban,Mizoram,Crime Against Men,Robbery,Male,0-12,5334,294,5040,4235,1099
2005,Rural,Odisha,Crime Against Women,Molestation,Female,60+,6552,275,6277,5129,1423
2005,Rural,Madhya Pradesh,Crime Against Men,Extortion,Male,13-17,8387,8302,85,8377,10
2002,Urban,Tamil Nadu,Crime Against Women,Dowry Deaths,Male,46-60,4259,1706,2553,3942,317
2004,Urban,Nagaland,Other Crimes,Fraud,Female,0-12,2063,784,1279,2012,51
2007,Rural,Meghalaya,Other Crimes,Fraud,Female,0-12,5928,5577,351,5630,298
2002,Urban,Telangana,Crime Against Men,Robbery,Female,13-17,456,12,444,377,79
2004,Rural,Mizoram,Crime Against Women,Dowry Deaths,Female,13-17,3097,1936,1161,2022,1075
2005,Urban,West Bengal,Crime Against Men,Extortion,Female,31-45,5395,1947,3448,2952,2443
2010,Urban,Uttar Pradesh,Crime Against Men,Robbery,Female,18-30,632,237,395,486,146
2010,Rural,Meghalaya,Crime Against Women,Dowry Deaths,Female,0-12,9794,8078,1716,8121,1673
2005,Urban,Punjab,Other Crimes,Fraud,Male,18-30,4944,3687,1257,4694,250
2005,Urban,Madhya Pradesh,Property Crime,Arson,Female,0-12,9801,7074,2727,9744,57
2009,Rural,West Bengal,Property Crime,Burglary,Female,0-12,8103,1305,6798,1633,6470
2001,Urban,Gujarat,Property Crime,Vandalism,Female,0-12,5129,2165,2964,3927,1202
2004,Urban,Sikkim,Other Crimes,Drug Offense,Male,13-17,7726,7500,226,7543,183
2005,Urban,Arunachal Pradesh,Crime Against Women,Molestation,Female,18-30,8194,1641,6553,1974,6220
2009,Rural,Maharashtra,Crime Against Children,Child Abuse,Female,60+,730,140,590,499,231
2008,Urban,Assam,Crime Against Men,Extortion,Female,13-17,5149,270,4879,1799,3350
2009,Urban,Gujarat,Crime Against Women,Molestation,Male,60+,207,123,84,205,2
2006,Rural,Kerala,Property Crime,Theft,Male,31-45,7292,2224,5068,4427,2865
2003,Rural,Tamil Nadu,Other Crimes,Cyber Crime,Female,46-60,4511,2849,1662,4235,276
2001,Urban,Bihar,Crime Against Children,Trafficking,Male,60+,3825,433,3392,2001,1824
2006,Urban,Odisha,Crime Against Men,Assault,Female,13-17,6688,4958,1730,6405,283
2007,Urban,West Bengal,Property Crime,Burglary,Female,60+,8564,7758,806,8053,511
2005,Urban,Meghalaya,Crime Against Men,Extortion,Female,0-12,3167,1320,1847,2919,248
2010,Rural,Rajasthan,Property Crime,Arson,Female,13-17,7043,3918,3125,5314,1729
2008,Urban,Meghalaya,Other Crimes,Fraud,Male,18-30,2670,1843,827,2401,269
2006,Rural,Nagaland,Property Crime,Vandalism,Female,0-12,5011,651,4360,2174,2837
2004,Rural,Karnataka,Crime Against Men,Robbery,Female,13-17,3147,1078,2069,2234,913
2007,Urban,Uttarakhand,Crime Against Children,Kidnapping,Male,0-12,225,18,207,125,100
2010,Urban,Goa,Property Crime,Vandalism,Male,18-30,2453,1050,1403,1974,479
2005,Rural,Andhra Pradesh,Crime Against Children,Trafficking,Male,18-30,4387,2474,1913,3372,1015
2005,Rural,Delhi,Crime Against Children,Trafficking,Female,0-12,5599,2458,3141,5018,581
2008,Urban,Andhra Pradesh,Crime Against Women,Rape,Female,46-60,3402,2463,939,3032,370
2009,Urban,Karnataka,Crime Against Children,Child Labor,Female,60+,9822,4823,4999,8480,1342
2008,Rural,Goa,Other Crimes,Cyber Crime,Female,0-12,6202,24,6178,4888,1314
2007,Rural,Tamil Nadu,Crime Against Men,Murder,Female,46-60,681,614,67,661,20
2006,Urban,Telangana,Crime Against Women,Rape,Male,13-17,9349,8963,386,9325,24
2001,Rural,Maharashtra,Crime Against Men,Murder,Female,31-45,304,246,58,298,6
2004,Urban,Assam,Crime Against Men,Extortion,Male,31-45,9355,190,9165,1701,7654
2001,Rural,Goa,Other Crimes,Fraud,Male,46-60,3542,814,2728,2989,553
2002,Rural,Telangana,Other Crimes,Fraud,Female,0-12,7581,7244,337,7523,58
2009,Rural,Jammu & Kashmir,Other Crimes,Corruption,Male,60+,3315,2953,362,3027,288
2005,Rural,Mizoram,Crime Against Men,Extortion,Female,18-30,3883,3379,504,3520,363
2007,Urban,Meghalaya,Other Crimes,Corruption,Male,31-45,7309,4521,2788,6567,742
2009,Rural,Assam,Other Crimes,Fraud,Female,0-12,2986,1015,1971,2953,33
2001,Rural,Delhi,Property Crime,Arson,Male,31-45,7011,514,6497,1846,5165
2002,Urban,Madhya Pradesh,Property Crime,Vandalism,Male,46-60,7706,2964,4742,4276,3430
2003,Rural,Tripura,Other Crimes,Drug Offense,Female,0-12,5029,1397,3632,4246,783
2005,Rural,Madhya Pradesh,Crime Against Men,Assault,Male,18-30,9948,927,9021,4920,5028
2009,Rural,Tripura,Crime Against Women,Rape,Female,0-12,205,17,188,121,84
2003,Urban,Delhi,Property Crime,Burglary,Male,0-12,3019,2234,785,2709,310
2007,Rural,Manipur,Crime Against Men,Assault,Female,31-45,4007,3495,512,3921,86
2001,Urban,Arunachal Pradesh,Crime Against Men,Murder,Male,18-30,8272,7191,1081,7783,489
2007,Rural,Uttarakhand,Crime Against Men,Assault,Female,13-17,8442,8233,209,8396,46
2005,Rural,Goa,Crime Against Men,Murder,Female,46-60,8499,1667,6832,5789,2710
2004,Rural,Manipur,Crime Against Men,Assault,Male,60+,4157,284,3873,2288,1869
2005,Rural,Nagaland,Property Crime,Vandalism,Female,18-30,3558,3044,514,3239,319
2004,Urban,Tamil Nadu,Crime Against Women,Dowry Deaths,Female,18-30,7531,2482,5049,6722,809
2010,Rural,Kerala,Property Crime,Burglary,Female,46-60,1854,667,1187,1204,650
2002,Rural,Gujarat,Crime Against Men,Assault,Female,31-45,2590,1002,1588,1676,914
2004,Urban,Mizoram,Property Crime,Theft,Male,13-17,1005,537,468,654,351
2004,Rural,Meghalaya,Crime Against Children,Kidnapping,Female,60+,4460,2168,2292,3842,618
2007,Urban,Manipur,Property Crime,Vandalism,Female,31-45,7140,6729,411,6978,162
2003,Rural,Maharashtra,Property Crime,Arson,Male,46-60,2065,633,1432,1110,955
2010,Urban,Uttar Pradesh,Other Crimes,Corruption,Female,46-60,2547,1136,1411,1866,681
2001,Rural,Delhi,Other Crimes,Fraud,Male,18-30,7178,2244,4934,4500,2678
2009,Urban,Bihar,Crime Against Men,Extortion,Male,13-17,7079,2929,4150,6177,902
2003,Rural,Haryana,Property Crime,Theft,Female,0-12,225,138,87,211,14
2003,Urban,Meghalaya,Property Crime,Vandalism,Male,0-12,2452,2097,355,2197,255
2010,Urban,Mizoram,Crime Against Children,Child Labor,Female,18-30,6728,3797,2931,3902,2826
2009,Rural,Maharashtra,Crime Against Women,Dowry Deaths,Female,13-17,3866,3577,289,3632,234
2006,Urban,West Bengal,Crime Against Women,Domestic Violence,Female,13-17,9508,8674,834,9066,442
2005,Rural,Meghalaya,Other Crimes,Corruption,Male,31-45,3365,552,2813,2920,445
2009,Rural,Arunachal Pradesh,Crime Against Men,Assault,Male,46-60,7272,4810,2462,4867,2405
2008,Urban,Uttarakhand,Crime Against Women,Domestic Violence,Female,18-30,5047,4774,273,4942,105
2009,Rural,Manipur,Crime Against Women,Rape,Female,60+,2971,1144,1827,1422,1549
2004,Urban,Gujarat,Crime Against Children,Trafficking,Female,18-30,3314,809,2505,859,2455
2003,Rural,Delhi,Crime Against Children,Kidnapping,Female,60+,604,542,62,587,17
2006,Urban,Delhi,Crime Against Men,Murder,Female,46-60,8235,4495,3740,6364,1871
2005,Rural,Gujarat,Crime Against Men,Assault,Male,46-60,2218,1995,223,2076,142
2005,Urban,West Bengal,Crime Against Children,Trafficking,Male,18-30,4664,4587,77,4643,21
2005,Rural,Gujarat,Other Crimes,Drug Offense,Male,60+,6544,3892,2652,6006,538
2003,Urban,Tripura,Crime Against Children,Child Abuse,Male,31-45,4278,3975,303,4021,257
2005,Urban,Punjab,Crime Against Children,Child Abuse,Male,60+,3948,2914,1034,3332,616
2005,Urban,Haryana,Crime Against Women,Dowry Deaths,Female,0-12,561,391,170,398,163
2010,Rural,Assam,Crime Against Women,Rape,Male,31-45,6033,4889,1144,5435,598
2010,Rural,Meghalaya,Property Crime,Burglary,Female,31-45,7052,1451,5601,4784,2268
2006,Urban,Haryana,Property Crime,Vandalism,Female,60+,8737,2741,5996,6781,1956
2002,Urban,Jharkhand,Crime Against Men,Murder,Female,13-17,8361,3147,5214,5906,2455
2009,Rural,Delhi,Other Crimes,Fraud,Female,0-12,6429,192,6237,5612,817
2004,Urban,Maharashtra,Crime Against Children,Kidnapping,Male,46-60,1341,56,1285,503,838
2006,Rural,Jharkhand,Crime Against Children,Trafficking,Female,18-30,7518,3605,3913,4744,2774
2003,Urban,Manipur,Crime Against Children,Child Labor,Female,60+,9233,7635,1598,8376,857
2007,Urban,Chhattisgarh,Crime Against Children,Kidnapping,Male,18-30,3666,2816,850,3460,206
2004,Urban,Kerala,Crime Against Women,Rape,Male,60+,5611,1070,4541,4361,1250
2001,Rural,Delhi,Crime Against Men,Murder,Male,60+,6139,1829,4310,2546,3593
2007,Urban,Manipur,Crime Against Women,Rape,Male,46-60,8894,3334,5560,7163,1731
2002,Urban,Manipur,Crime Against Men,Extortion,Female,13-17,5595,938,4657,2979,2616
2009,Urban,Karnataka,Crime Against Women,Domestic Violence,Male,60+,3150,1176,1974,2689,461
2002,Urban,Kerala,Crime Against Children,Trafficking,Male,31-45,1276,505,771,981,295
2001,Urban,Himachal Pradesh,Other Crimes,Drug Offense,Female,60+,1348,470,878,946,402
2007,Urban,Bihar,Crime Against Men,Extortion,Male,60+,8099,232,7867,5739,2360
2010,Rural,Uttar Pradesh,Property Crime,Vandalism,Male,13-17,8268,3114,5154,7548,720
2008,Urban,Meghalaya,Property Crime,Burglary,Male,13-17,2175,536,1639,1118,1057
2008,Urban,Odisha,Other Crimes,Corruption,Female,0-12,3839,2620,1219,3228,611
2010,Rural,Gujarat,Crime Against Women,Domestic Violence,Female,0-12,7101,612,6489,1755,5346
2004,Rural,Manipur,Property Crime,Theft,Female,13-17,510,146,364,230,280
2002,Urban,Sikkim,Other Crimes,Fraud,Female,46-60,2094,298,1796,1686,408
2007,Rural,Meghalaya,Crime Against Children,Child Labor,Female,0-12,8530,7629,901,8305,225
2002,Urban,Tripura,Crime Against Men,Extortion,Female,18-30,9212,5314,3898,7691,1521
2002,Urban,Tamil Nadu,Crime Against Women,Domestic Violence,Male,60+,50,7,43,18,32
2007,Urban,Andhra Pradesh,Crime Against Men,Robbery,Male,31-45,6458,4840,1618,5757,701
2005,Rural,Punjab,Crime Against Children,Child Abuse,Female,13-17,7166,824,6342,5224,1942
2010,Urban,Manipur,Crime Against Women,Domestic Violence,Female,13-17,2036,622,1414,1379,657
2010,Rural,Jharkhand,Crime Against Children,Child Labor,Male,0-12,5586,2071,3515,2467,3119
2004,Urban,Tripura,Crime Against Children,Trafficking,Female,46-60,1789,1217,572,1647,142
2003,Rural,Jharkhand,Other Crimes,Cyber Crime,Male,31-45,4834,2651,2183,3377,1457
2005,Urban,Gujarat,Property Crime,Theft,Male,60+,8001,1388,6613,5253,2748
2008,Urban,Assam,Crime Against Children,Trafficking,Female,18-30,497,159,338,492,5
2007,Rural,Bihar,Crime Against Men,Assault,Male,13-17,1475,1189,286,1253,222
2006,Urban,Chhattisgarh,Crime Against Children,Child Labor,Male,13-17,4153,886,3267,1195,2958
2001,Rural,Madhya Pradesh,Crime Against Women,Domestic Violence,Male,46-60,7366,4955,2411,6936,430
2002,Rural,Uttar Pradesh,Property Crime,Arson,Male,46-60,1871,946,925,1684,187
2006,Rural,Karnataka,Crime Against Men,Murder,Male,18-30,780,389,391,658,122
2001,Rural,Uttar Pradesh,Property Crime,Arson,Female,18-30,173,49,124,140,33
2005,Rural,Haryana,Crime Against Children,Kidnapping,Male,18-30,2877,647,2230,730,2147
2003,Rural,Uttar Pradesh,Crime Against Children,Child Labor,Female,60+,3712,815,2897,3207,505
2010,Rural,Nagaland,Crime Against Women,Rape,Female,0-12,1193,515,678,887,306
2005,Rural,Assam,Crime Against Men,Extortion,Male,13-17,8613,1844,6769,6931,1682
2004,Urban,Manipur,Crime Against Men,Murder,Male,31-45,4190,860,3330,3284,906
2007,Rural,Gujarat,Other Crimes,Cyber Crime,Male,0-12,8300,1932,6368,5670,2630
2009,Rural,Mizoram,Crime Against Women,Molestation,Female,46-60,5520,1071,4449,4428,1092
2001,Rural,Bihar,Crime Against Women,Dowry Deaths,Male,0-12,3082,626,2456,2272,810
2003,Rural,West Bengal,Crime Against Women,Rape,Male,60+,1439,728,711,917,522
2005,Urban,Uttarakhand,Crime Against Children,Child Abuse,Female,13-17,5854,2008,3846,5216,638
2008,Rural,Kerala,Property Crime,Vandalism,Male,0-12,4439,3728,711,4188,251
2002,Urban,Goa,Other Crimes,Drug Offense,Female,0-12,6453,1407,5046,2023,4430
2007,Urban,Uttar Pradesh,Property Crime,Vandalism,Female,46-60,7674,1792,5882,7086,588
2010,Rural,Jharkhand,Property Crime,Vandalism,Male,60+,5923,5660,263,5763,160
2010,Urban,Karnataka,Crime Against Women,Rape,Male,46-60,2390,2162,228,2335,55
2010,Urban,Meghalaya,Crime Against Women,Rape,Female,0-12,248,205,43,211,37
2004,Rural,Kerala,Other Crimes,Cyber Crime,Male,18-30,5664,5207,457,5454,210
2008,Urban,Uttarakhand,Crime Against Women,Molestation,Female,46-60,3262,289,2973,542,2720
2001,Rural,Uttar Pradesh,Other Crimes,Cyber Crime,Female,18-30,2715,542,2173,2532,183
2008,Urban,Madhya Pradesh,Crime Against Men,Murder,Male,0-12,6790,2102,4688,3845,2945
2005,Urban,Jharkhand,Crime Against Women,Molestation,Female,46-60,8342,2728,5614,8246,96
2006,Urban,Bihar,Crime Against Men,Murder,Female,18-30,3638,3579,59,3588,50
2003,Urban,Himachal Pradesh,Crime Against Women,Molestation,Female,0-12,2554,1910,644,2439,115
2003,Urban,Goa,Other Crimes,Cyber Crime,Male,13-17,609,609,0,609,0
2001,Urban,Madhya Pradesh,Property Crime,Burglary,Female,60+,6869,4038,2831,5555,1314
2001,Rural,Jharkhand,Crime Against Children,Kidnapping,Female,31-45,7674,1009,6665,5237,2437
2010,Rural,Meghalaya,Crime Against Children,Trafficking,Female,18-30,1307,223,1084,422,885
2001,Rural,Assam,Other Crimes,Corruption,Female,46-60,5031,4542,489,4702,329
2002,Rural,Bihar,Crime Against Men,Assault,Female,13-17,4086,2512,1574,3245,841
2005,Urban,Odisha,Crime Against Women,Dowry Deaths,Female,31-45,9776,6709,3067,9601,175
2002,Urban,Mizoram,Crime Against Children,Kidnapping,Male,13-17,8439,6485,1954,6710,1729
2010,Urban,West Bengal,Property Crime,Arson,Male,13-17,7083,3308,3775,6584,499
2003,Rural,Gujarat,Crime Against Women,Dowry Deaths,Male,13-17,5221,4383,838,4532,689
2003,Urban,Arunachal Pradesh,Property Crime,Theft,Female,31-45,7694,1152,6542,6325,1369
2005,Rural,Bihar,Crime Against Children,Trafficking,Male,0-12,5718,3007,2711,3851,1867
2001,Urban,Karnataka,Other Crimes,Corruption,Female,13-17,6688,5051,1637,5468,1220
2007,Rural,Jharkhand,Crime Against Men,Robbery,Male,46-60,4490,772,3718,3219,1271
2005,Urban,Himachal Pradesh,Crime Against Women,Molestation,Female,46-60,3848,108,3740,681,3167
2008,Rural,Mizoram,Property Crime,Arson,Female,60+,1449,1327,122,1434,15
2008,Rural,Tamil Nadu,Other Crimes,Corruption,Female,13-17,5391,4135,1256,4391,1000
2004,Urban,Madhya Pradesh,Property Crime,Arson,Male,31-45,4195,3027,1168,3417,778
2005,Urban,Kerala,Crime Against Children,Child Abuse,Female,31-45,8717,7311,1406,8280,437
2007,Urban,Chhattisgarh,Property Crime,Burglary,Male,46-60,4085,3275,810,3961,124
2005,Rural,Jharkhand,Crime Against Children,Trafficking,Female,13-17,455,422,33,442,13
2004,Rural,Punjab,Other Crimes,Corruption,Female,31-45,8893,2629,6264,8079,814
2009,Rural,Gujarat,Crime Against Children,Child Abuse,Female,31-45,1288,661,627,918,370
2006,Urban,Jammu & Kashmir,Crime Against Men,Assault,Male,46-60,7276,1962,5314,3465,3811
2006,Rural,Chhattisgarh,Crime Against Children,Child Labor,Male,31-45,4902,3209,1693,3879,1023
2010,Urban,Andhra Pradesh,Crime Against Children,Child Abuse,Female,0-12,2876,453,2423,1718,1158
2004,Rural,Odisha,Crime Against Men,Robbery,Female,31-45,6728,5578,1150,6657,71
2001,Rural,Kerala,Crime Against Men,Robbery,Female,0-12,2321,1496,825,2215,106
2008,Rural,Delhi,Other Crimes,Drug Offense,Male,60+,4103,2643,1460,3106,997
2010,Rural,Arunachal Pradesh,Other Crimes,Fraud,Male,46-60,6048,244,5804,1880,4168
2010,Rural,Tamil Nadu,Other Crimes,Cyber Crime,Male,0-12,5145,782,4363,1696,3449
2004,Urban,Nagaland,Crime Against Men,Assault,Female,31-45,2991,680,2311,1876,1115
2009,Rural,Goa,Other Crimes,Cyber Crime,Female,60+,1957,90,1867,606,1351
2005,Urban,Maharashtra,Crime Against Children,Child Labor,Female,60+,4265,1730,2535,2890,1375
2010,Rural,Kerala,Crime Against Children,Child Labor,Male,31-45,4379,2122,2257,2405,1974
2008,Urban,Assam,Other Crimes,Cyber Crime,Male,13-17,9543,3694,5849,8929,614
2002,Urban,Sikkim,Other Crimes,Drug Offense,Female,0-12,3220,51,3169,236,2984
2007,Urban,Andhra Pradesh,Property Crime,Arson,Female,46-60,9137,2578,6559,7722,1415
2002,Rural,Kerala,Crime Against Men,Robbery,Male,46-60,532,265,267,322,210
2002,Urban,Karnataka,Crime Against Women,Molestation,Male,60+,8937,7541,1396,8287,650
2004,Rural,Chhattisgarh,Other Crimes,Fraud,Male,46-60,7965,7387,578,7413,552
2005,Urban,Mizoram,Crime Against Women,Domestic Violence,Female,0-12,2769,648,2121,768,2001
2010,Urban,Assam,Property Crime,Vandalism,Female,0-12,5654,2218,3436,2551,3103
2009,Rural,Haryana,Crime Against Children,Trafficking,Male,18-30,6469,1508,4961,5569,900
2008,Rural,Mizoram,Other Crimes,Drug Offense,Male,60+,6214,4950,1264,5428,786
2002,Urban,Rajasthan,Property Crime,Vandalism,Male,13-17,9684,733,8951,5941,3743
2004,Urban,Haryana,Crime Against Children,Child Abuse,Female,46-60,9859,1005,8854,5422,4437
2001,Urban,Mizoram,Crime Against Men,Extortion,Female,13-17,2761,2411,350,2712,49
2010,Rural,Tamil Nadu,Property Crime,Burglary,Female,18-30,1541,1132,409,1467,74
2003,Rural,Assam,Other Crimes,Corruption,Male,18-30,9150,1601,7549,6535,2615
2003,Urban,Madhya Pradesh,Crime Against Women,Rape,Male,18-30,2016,1138,878,1818,198
2006,Urban,Punjab,Other Crimes,Cyber Crime,Female,46-60,831,730,101,791,40
2010,Rural,Assam,Crime Against Men,Extortion,Male,31-45,545,296,249,321,224
2005,Rural,Himachal Pradesh,Property Crime,Burglary,Male,13-17,7975,2311,5664,4662,3313
2001,Urban,Goa,Crime Against Women,Molestation,Male,18-30,5193,2423,2770,3088,2105
2003,Urban,Meghalaya,Other Crimes,Cyber Crime,Male,46-60,8806,5108,3698,7596,1210
2003,Urban,Meghalaya,Crime Against Children,Child Abuse,Female,60+,9309,6278,3031,8153,1156
2008,Rural,Goa,Property Crime,Theft,Female,31-45,1042,600,442,645,397
2009,Urban,Punjab,Crime Against Men,Assault,Female,46-60,1584,47,1537,454,1130
2008,Rural,Assam,Property Crime,Vandalism,Female,13-17,8261,2633,5628,6254,2007
2004,Rural,West Bengal,Property Crime,Theft,Male,60+,4310,3826,484,4209,101
2007,Urban,Assam,Crime Against Children,Kidnapping,Male,0-12,4854,4113,741,4732,122
2004,Rural,Rajasthan,Crime Against Women,Dowry Deaths,Male,60+,3068,2592,476,2901,167
2005,Rural,Himachal Pradesh,Crime Against Men,Assault,Female,46-60,108,103,5,107,1
2010,Urban,Mizoram,Property Crime,Burglary,Female,46-60,7200,1916,5284,3433,3767
2009,Rural,Telangana,Crime Against Men,Assault,Female,13-17,5037,4374,663,4779,258
2001,Urban,Chhattisgarh,Crime Against Women,Rape,Male,18-30,5655,49,5606,2610,3045
2002,Urban,Chhattisgarh,Crime Against Women,Domestic Violence,Male,13-17,7206,1516,5690,1800,5406
2006,Urban,Delhi,Other Crimes,Corruption,Female,13-17,1384,802,582,1224,160
2009,Urban,Chhattisgarh,Crime Against Women,Molestation,Female,60+,6483,5681,802,5926,557
2010,Rural,Kerala,Crime Against Children,Child Labor,Female,13-17,2238,2115,123,2221,17
2001,Urban,Uttar Pradesh,Crime Against Children,Child Labor,Female,0-12,2212,1671,541,1942,270
2004,Urban,Madhya Pradesh,Other Crimes,Fraud,Male,18-30,2798,1517,1281,2725,73
2008,Urban,Maharashtra,Crime Against Children,Child Abuse,Male,18-30,5492,2118,3374,3855,1637
2004,Urban,Assam,Crime Against Women,Molestation,Male,31-45,4068,3578,490,3893,175
2001,Rural,Assam,Crime Against Women,Dowry Deaths,Female,60+,5360,2139,3221,4971,389
2004,Rural,Telangana,Crime Against Children,Child Labor,Male,13-17,191,14,177,160,31
2007,Rural,West Bengal,Other Crimes,Fraud,Male,18-30,9306,3274,6032,7555,1751
2004,Urban,Kerala,Other Crimes,Corruption,Male,46-60,4711,1241,3470,2071,2640
2009,Rural,Jammu & Kashmir,Crime Against Children,Trafficking,Female,46-60,1213,1013,200,1171,42
2010,Urban,Haryana,Other Crimes,Corruption,Male,31-45,745,348,397,596,149
2001,Rural,Manipur,Crime Against Men,Robbery,Female,18-30,7523,3574,3949,5320,2203
2008,Urban,Uttarakhand,Crime Against Children,Kidnapping,Female,31-45,1102,632,470,997,105
2002,Rural,Manipur,Crime Against Children,Child Abuse,Female,31-45,8933,76,8857,3456,5477
2007,Urban,West Bengal,Crime Against Women,Domestic Violence,Female,46-60,7389,2187,5202,5377,2012
2010,Urban,Tamil Nadu,Crime Against Men,Robbery,Male,31-45,4553,1178,3375,1558,2995
2002,Urban,Telangana,Property Crime,Burglary,Male,46-60,7178,4234,2944,6259,919
2009,Urban,Delhi,Crime Against Men,Murder,Male,46-60,7788,4092,3696,7481,307
2001,Rural,Nagaland,Crime Against Women,Domestic Violence,Male,31-45,5286,97,5189,3509,1777
2003,Urban,Nagaland,Crime Against Men,Assault,Male,13-17,1325,731,594,1252,73
2008,Rural,Madhya Pradesh,Crime Against Men,Robbery,Female,31-45,1788,1549,239,1554,234
2003,Urban,Uttarakhand,Property Crime,Theft,Female,13-17,7691,11,7680,530,7161
2003,Rural,Haryana,Property Crime,Vandalism,Male,13-17,3361,405,2956,3065,296
2004,Urban,Delhi,Crime Against Women,Rape,Female,18-30,9402,5751,3651,7058,2344
2002,Urban,Madhya Pradesh,Crime Against Women,Dowry Deaths,Female,31-45,8537,3485,5052,3782,4755
2001,Rural,Delhi,Property Crime,Burglary,Female,31-45,2116,1050,1066,1421,695
2005,Urban,Tripura,Other Crimes,Cyber Crime,Male,46-60,7533,5497,2036,5575,1958
2006,Rural,Goa,Crime Against Men,Murder,Male,13-17,3119,3055,64,3083,36
2008,Urban,Telangana,Crime Against Women,Domestic Violence,Male,13-17,3625,804,2821,1059,2566
2003,Urban,Bihar,Crime Against Women,Molestation,Male,0-12,591,274,317,321,270
2004,Urban,Sikkim,Crime Against Men,Murder,Female,18-30,54,8,46,27,27
2006,Urban,Gujarat,Crime Against Children,Child Abuse,Male,0-12,2225,791,1434,1125,1100
2006,Urban,Maharashtra,Crime Against Women,Molestation,Male,13-17,129,104,25,115,14
2005,Urban,Tripura,Other Crimes,Corruption,Male,46-60,9362,9140,222,9308,54
2006,Urban,Assam,Property Crime,Vandalism,Female,0-12,5051,4386,665,4904,147
2007,Rural,Chhattisgarh,Property Crime,Theft,Male,13-17,7075,5913,1162,6617,458
2008,Rural,Sikkim,Crime Against Children,Child Abuse,Male,46-60,5843,2183,3660,2900,2943
2004,Urban,Haryana,Property Crime,Vandalism,Male,31-45,753,528,225,718,35
2005,Rural,Uttar Pradesh,Crime Against Women,Dowry Deaths,Female,31-45,9359,1501,7858,4253,5106
2005,Urban,Madhya Pradesh,Other Crimes,Corruption,Female,31-45,6892,400,6492,3084,3808
2005,Urban,Jharkhand,Crime Against Women,Rape,Female,31-45,542,251,291,273,269
2009,Urban,Uttarakhand,Property Crime,Theft,Female,0-12,347,327,20,339,8
2001,Urban,Odisha,Crime Against Women,Dowry Deaths,Male,18-30,6017,1256,4761,3584,2433
2004,Rural,Chhattisgarh,Property Crime,Vandalism,Male,0-12,9184,1902,7282,6735,2449
2002,Rural,Uttarakhand,Crime Against Men,Assault,Female,13-17,1175,852,323,938,237
2007,Urban,Jammu & Kashmir,Crime Against Women,Domestic Violence,Male,31-45,3582,3430,152,3576,6
2009,Urban,Delhi,Other Crimes,Cyber Crime,Male,0-12,5641,3528,2113,4261,1380
2007,Rural,Himachal Pradesh,Crime Against Women,Rape,Female,18-30,6410,1258,5152,3913,2497
2005,Rural,Goa,Other Crimes,Corruption,Male,0-12,4513,1363,3150,4289,224
2006,Rural,Kerala,Property Crime,Vandalism,Male,60+,670,424,246,515,155
2003,Rural,Uttarakhand,Property Crime,Arson,Female,31-45,6543,356,6187,2297,4246
2009,Urban,Jharkhand,Crime Against Men,Extortion,Female,31-45,2723,1431,1292,2331,392
2009,Urban,Punjab,Crime Against Women,Domestic Violence,Male,46-60,6649,520,6129,4440,2209
2008,Rural,Kerala,Crime Against Men,Robbery,Female,46-60,5678,3110,2568,4460,1218
2001,Urban,Karnataka,Crime Against Women,Rape,Female,60+,6273,193,6080,6074,199
2007,Urban,Punjab,Crime Against Women,Molestation,Female,46-60,7004,5033,1971,6130,874
2006,Urban,Kerala,Property Crime,Theft,Female,46-60,9988,4546,5442,5169,4819
2003,Rural,Kerala,Property Crime,Vandalism,Female,31-45,2675,2042,633,2418,257
2002,Urban,Andhra Pradesh,Property Crime,Vandalism,Female,46-60,9989,1840,8149,2259,7730
2009,Urban,Manipur,Crime Against Men,Assault,Female,18-30,3916,391,3525,2184,1732
2008,Rural,Chhattisgarh,Crime Against Men,Extortion,Male,13-17,3088,2888,200,3064,24
2009,Rural,Nagaland,Crime Against Children,Child Labor,Male,31-45,3200,1016,2184,2370,830
2001,Rural,Telangana,Crime Against Women,Rape,Male,60+,5546,33,5513,1103,4443
2009,Urban,Telangana,Property Crime,Burglary,Female,46-60,8017,1060,6957,6971,1046
2002,Urban,Mizoram,Other Crimes,Fraud,Male,31-45,2410,2367,43,2381,29
2008,Rural,Madhya Pradesh,Other Crimes,Drug Offense,Male,13-17,5420,198,5222,3322,2098
2002,Rural,Rajasthan,Property Crime,Arson,Female,0-12,3145,2399,746,2479,666
2009,Urban,Sikkim,Crime Against Men,Extortion,Male,46-60,4951,4581,370,4889,62
2007,Urban,West Bengal,Crime Against Children,Child Labor,Female,31-45,5482,3786,1696,5202,280
2006,Rural,Karnataka,Crime Against Men,Murder,Female,13-17,7280,2171,5109,4586,2694
2006,Urban,Kerala,Property Crime,Arson,Female,60+,1623,1480,143,1567,56
2001,Urban,Chhattisgarh,Other Crimes,Corruption,Male,18-30,3727,2367,1360,3381,346
2008,Urban,Haryana,Crime Against Men,Assault,Male,18-30,6965,149,6816,5352,1613
2010,Rural,Goa,Crime Against Children,Trafficking,Male,60+,322,35,287,250,72
2009,Rural,Telangana,Crime Against Children,Child Abuse,Female,31-45,6892,4207,2685,4528,2364
2010,Urban,Jammu & Kashmir,Crime Against Men,Robbery,Male,46-60,6514,5734,780,6014,500
2001,Rural,Bihar,Other Crimes,Drug Offense,Male,0-12,4739,3170,1569,3748,991
2010,Urban,Arunachal Pradesh,Property Crime,Arson,Female,13-17,2574,2332,242,2465,109
2004,Urban,Delhi,Other Crimes,Cyber Crime,Female,60+,5680,4774,906,5003,677
2001,Rural,Kerala,Crime Against Women,Rape,Female,31-45,4153,2242,1911,3474,679
2008,Rural,West Bengal,Crime Against Men,Robbery,Female,46-60,8538,3509,5029,8416,122
2003,Rural,Telangana,Property Crime,Theft,Male,46-60,7695,2975,4720,4718,2977
2002,Rural,Uttar Pradesh,Other Crimes,Cyber Crime,Female,31-45,7907,5967,1940,7778,129
2008,Rural,Himachal Pradesh,Crime Against Women,Domestic Violence,Female,31-45,2294,1142,1152,2026,268
2009,Rural,Jharkhand,Crime Against Women,Rape,Female,0-12,3457,3297,160,3431,26
2006,Rural,Madhya Pradesh,Crime Against Women,Molestation,Female,60+,1615,201,1414,1503,112
2001,Rural,Tripura,Crime Against Women,Rape,Male,18-30,1530,1075,455,1274,256
2005,Urban,Jharkhand,Crime Against Women,Molestation,Female,31-45,3290,807,2483,3034,256
2002,Urban,Nagaland,Crime Against Men,Assault,Male,0-12,3184,502,2682,582,2602
2008,Urban,Kerala,Crime Against Men,Murder,Male,0-12,4804,3622,1182,4529,275
2009,Rural,Mizoram,Property Crime,Vandalism,Female,46-60,4684,2070,2614,4273,411
2002,Rural,Telangana,Other Crimes,Drug Offense,Male,18-30,3924,3485,439,3778,146
2008,Urban,Odisha,Crime Against Women,Rape,Female,60+,8624,7777,847,8183,441
2005,Rural,Tripura,Property Crime,Vandalism,Female,13-17,8439,3706,4733,8361,78
2007,Urban,Rajasthan,Crime Against Children,Child Labor,Male,0-12,2810,1042,1768,1994,816
2006,Rural,Rajasthan,Property Crime,Theft,Male,18-30,9700,9316,384,9481,219
2009,Rural,Uttarakhand,Crime Against Children,Child Abuse,Male,13-17,8165,1479,6686,3636,4529
2009,Rural,Jammu & Kashmir,Crime Against Women,Molestation,Male,46-60,7136,3561,3575,5837,1299
2001,Rural,Andhra Pradesh,Property Crime,Arson,Female,13-17,8402,628,7774,3534,4868
2007,Urban,Karnataka,Crime Against Women,Domestic Violence,Male,0-12,839,469,370,678,161
2007,Rural,Rajasthan,Crime Against Men,Assault,Female,0-12,9775,9628,147,9763,12
2009,Rural,Odisha,Property Crime,Burglary,Female,31-45,7070,5761,1309,6081,989
2002,Urban,Chhattisgarh,Crime Against Children,Child Labor,Male,31-45,649,147,502,406,243
2006,Urban,Goa,Crime Against Women,Rape,Female,13-17,7456,4522,2934,7339,117
2009,Rural,Kerala,Property Crime,Burglary,Male,31-45,8373,686,7687,824,7549
2002,Rural,Kerala,Property Crime,Theft,Male,18-30,5942,4761,1181,5596,346
2010,Urban,Tamil Nadu,Property Crime,Vandalism,Female,46-60,878,260,618,595,283
2004,Rural,Chhattisgarh,Crime Against Women,Domestic Violence,Male,46-60,4889,1003,3886,2186,2703
2006,Urban,Goa,Crime Against Children,Trafficking,Female,31-45,5905,4197,1708,4371,1534
2007,Urban,Meghalaya,Crime Against Children,Trafficking,Male,31-45,8276,5214,3062,6355,1921
2009,Rural,Punjab,Crime Against Men,Extortion,Female,60+,911,26,885,657,254
2001,Urban,Uttarakhand,Other Crimes,Cyber Crime,Female,31-45,745,738,7,738,7
2003,Urban,Karnataka,Crime Against Men,Murder,Male,31-45,5534,3668,1866,5340,194
2009,Urban,Odisha,Crime Against Women,Dowry Deaths,Female,31-45,4073,3896,177,3978,95
2010,Urban,Uttarakhand,Crime Against Men,Murder,Male,0-12,3140,807,2333,2930,210
2004,Urban,Uttarakhand,Crime Against Women,Dowry Deaths,Female,46-60,1811,784,1027,931,880
2001,Urban,Rajasthan,Crime Against Children,Kidnapping,Male,13-17,7019,576,6443,6243,776
2001,Rural,Manipur,Crime Against Men,Assault,Male,0-12,1354,756,598,1006,348
2007,Urban,Telangana,Property Crime,Burglary,Female,31-45,7482,1791,5691,4984,2498
2003,Rural,Mizoram,Crime Against Women,Rape,Male,46-60,7146,2014,5132,4063,3083
2001,Urban,Jharkhand,Other Crimes,Cyber Crime,Female,31-45,3515,3160,355,3491,24
2007,Urban,Kerala,Other Crimes,Cyber Crime,Female,46-60,736,178,558,329,407
2010,Rural,Telangana,Crime Against Women,Rape,Male,18-30,2981,1351,1630,1686,1295
2007,Rural,Arunachal Pradesh,Crime Against Children,Child Abuse,Female,46-60,2865,291,2574,341,2524
2005,Urban,Uttar Pradesh,Crime Against Women,Domestic Violence,Male,60+,8550,2607,5943,5596,2954
2004,Rural,Madhya Pradesh,Crime Against Men,Assault,Female,31-45,9848,2525,7323,9041,807
2006,Urban,Uttarakhand,Property Crime,Vandalism,Male,0-12,7333,3936,3397,5483,1850
2009,Rural,Jharkhand,Crime Against Women,Domestic Violence,Male,0-12,1945,94,1851,1635,310
2006,Rural,Andhra Pradesh,Crime Against Men,Robbery,Male,46-60,3501,363,3138,1583,1918
2006,Urban,Uttar Pradesh,Crime Against Women,Molestation,Female,13-17,4170,175,3995,2031,2139
2008,Rural,Gujarat,Property Crime,Theft,Male,18-30,4284,2393,1891,3382,902
2008,Rural,Chhattisgarh,Crime Against Women,Molestation,Female,18-30,1691,482,1209,1471,220
2007,Rural,Jammu & Kashmir,Property Crime,Burglary,Female,13-17,1627,484,1143,619,1008
2002,Urban,West Bengal,Crime Against Men,Extortion,Female,60+,1405,165,1240,742,663
2009,Rural,Jharkhand,Crime Against Women,Dowry Deaths,Male,18-30,2833,2664,169,2712,121
2002,Urban,Uttar Pradesh,Other Crimes,Corruption,Female,46-60,5429,2621,2808,4128,1301
2008,Urban,West Bengal,Property Crime,Vandalism,Male,60+,6160,4114,2046,5610,550
2004,Rural,Odisha,Other Crimes,Fraud,Female,13-17,3308,3254,54,3301,7
2009,Urban,Andhra Pradesh,Crime Against Children,Child Labor,Male,0-12,5964,4625,1339,4710,1254
2009,Urban,Arunachal Pradesh,Crime Against Children,Child Labor,Female,13-17,844,500,344,502,342
2010,Rural,Goa,Other Crimes,Corruption,Female,60+,723,560,163,609,114
2002,Rural,Andhra Pradesh,Crime Against Men,Extortion,Female,18-30,347,296,51,311,36
2005,Rural,Mizoram,Crime Against Children,Child Abuse,Male,0-12,5600,4619,981,5144,456
2006,Rural,Himachal Pradesh,Crime Against Children,Trafficking,Male,0-12,4515,672,3843,3120,1395
2001,Urban,Uttarakhand,Property Crime,Vandalism,Male,0-12,7290,5398,1892,5841,1449
2008,Rural,Uttar Pradesh,Crime Against Children,Trafficking,Female,18-30,4725,3545,1180,3805,920
2004,Urban,Meghalaya,Other Crimes,Cyber Crime,Male,31-45,3742,3339,403,3461,281
2002,Rural,Kerala,Property Crime,Arson,Female,0-12,9306,6848,2458,8234,1072
2005,Urban,Tripura,Crime Against Men,Assault,Female,60+,4761,3606,1155,4639,122
2008,Rural,Uttar Pradesh,Property Crime,Vandalism,Female,0-12,1760,721,1039,817,943
2007,Rural,Maharashtra,Crime Against Children,Child Abuse,Female,0-12,4697,1878,2819,3136,1561
2002,Rural,Mizoram,Property Crime,Arson,Male,13-17,3124,1247,1877,2728,396
2002,Rural,Maharashtra,Crime Against Children,Child Abuse,Male,60+,3695,848,2847,1155,2540
2005,Urban,Goa,Crime Against Children,Child Labor,Male,31-45,5023,2,5021,4706,317
2003,Rural,Himachal Pradesh,Property Crime,Vandalism,Male,18-30,9891,2836,7055,7558,2333
2007,Rural,Maharashtra,Crime Against Women,Dowry Deaths,Male,31-45,2386,597,1789,975,1411
2010,Rural,Uttarakhand,Crime Against Children,Child Labor,Female,46-60,825,175,650,257,568
2003,Rural,Haryana,Crime Against Children,Child Abuse,Male,13-17,7088,160,6928,4632,2456
2003,Rural,Bihar,Crime Against Women,Dowry Deaths,Female,60+,9663,8532,1131,9203,460
2010,Rural,Haryana,Other Crimes,Fraud,Male,60+,9097,4293,4804,8369,728
2002,Urban,Manipur,Property Crime,Theft,Male,31-45,1315,939,376,1179,136
2009,Rural,Odisha,Property Crime,Vandalism,Female,46-60,76,29,47,34,42
2005,Rural,Tripura,Crime Against Men,Robbery,Male,31-45,6291,3660,2631,4569,1722
2002,Rural,Jammu & Kashmir,Crime Against Men,Extortion,Male,0-12,160,44,116,67,93
2003,Rural,Karnataka,Crime Against Men,Robbery,Male,13-17,8055,3907,4148,5247,2808
2004,Rural,Chhattisgarh,Property Crime,Vandalism,Female,0-12,393,334,59,359,34
2001,Urban,Delhi,Property Crime,Vandalism,Female,31-45,5714,3811,1903,4560,1154
2005,Rural,Chhattisgarh,Property Crime,Vandalism,Female,31-45,3726,1908,1818,3393,333
2006,Urban,Uttarakhand,Crime Against Men,Robbery,Female,13-17,8482,2738,5744,4060,4422
2003,Rural,Punjab,Crime Against Women,Rape,Female,18-30,9167,7492,1675,8056,1111
2002,Rural,Uttarakhand,Crime Against Women,Molestation,Male,13-17,4161,1487,2674,3296,865
2007,Urban,Arunachal Pradesh,Crime Against Men,Assault,Female,13-17,448,185,263,193,255
2003,Rural,Goa,Crime Against Men,Robbery,Male,46-60,9843,8727,1116,9603,240
2010,Rural,Mizoram,Other Crimes,Drug Offense,Male,13-17,7762,1258,6504,6749,1013
2001,Urban,Meghalaya,Crime Against Men,Assault,Female,60+,4735,2616,2119,3552,1183
2004,Rural,Nagaland,Property Crime,Arson,Female,0-12,7879,5603,2276,7154,725
2006,Rural,Haryana,Other Crimes,Drug Offense,Female,13-17,6801,4116,2685,5000,1801
2009,Urban,Assam,Other Crimes,Fraud,Male,46-60,5617,4323,1294,5433,184
2010,Rural,Punjab,Crime Against Women,Domestic Violence,Female,46-60,1409,1306,103,1309,100
2002,Rural,Haryana,Crime Against Women,Domestic Violence,Female,31-45,5689,3919,1770,4385,1304
2008,Rural,Manipur,Crime Against Children,Child Abuse,Male,60+,3672,412,3260,2783,889
2008,Rural,Uttar Pradesh,Crime Against Children,Child Labor,Female,60+,4835,3186,1649,4769,66
2005,Urban,Jammu & Kashmir,Crime Against Children,Child Abuse,Male,60+,3929,1087,2842,1441,2488
2008,Urban,Goa,Crime Against Women,Molestation,Female,46-60,2450,461,1989,2057,393
2001,Urban,Tamil Nadu,Crime Against Women,Domestic Violence,Male,0-12,1935,1463,472,1501,434
2005,Urban,Meghalaya,Property Crime,Vandalism,Male,18-30,5804,3946,1858,5416,388
2007,Urban,Andhra Pradesh,Crime Against Women,Rape,Female,46-60,3693,1434,2259,3471,222
2010,Urban,Punjab,Crime Against Children,Kidnapping,Female,31-45,262,18,244,91,171
2005,Urban,Delhi,Other Crimes,Cyber Crime,Male,13-17,8868,6595,2273,6643,2225
2007,Rural,Madhya Pradesh,Crime Against Men,Murder,Female,18-30,7937,2753,5184,7758,179
2007,Urban,Karnataka,Other Crimes,Drug Offense,Female,31-45,2034,196,1838,1839,195
2002,Urban,Uttar Pradesh,Property Crime,Vandalism,Female,0-12,4565,982,3583,4556,9
2009,Rural,Karnataka,Crime Against Children,Kidnapping,Male,31-45,8159,471,7688,6136,2023
2005,Urban,Andhra Pradesh,Property Crime,Burglary,Female,46-60,632,23,609,398,234
2001,Urban,Gujarat,Crime Against Children,Kidnapping,Female,13-17,2700,806,1894,2306,394
2009,Urban,Goa,Crime Against Women,Domestic Violence,Male,13-17,8185,6375,1810,7115,1070
2005,Rural,Meghalaya,Crime Against Women,Molestation,Female,60+,5755,1668,4087,2557,3198
2001,Rural,Andhra Pradesh,Crime Against Women,Rape,Male,31-45,4187,2216,1971,3270,917
2005,Rural,Uttar Pradesh,Crime Against Men,Robbery,Female,46-60,8221,5612,2609,6342,1879
2002,Urban,Jharkhand,Crime Against Women,Dowry Deaths,Female,46-60,1743,357,1386,1023,720
2002,Urban,Tamil Nadu,Property Crime,Arson,Male,46-60,140,68,72,105,35
2005,Rural,Haryana,Crime Against Children,Child Abuse,Male,18-30,2384,92,2292,2098,286
2009,Rural,Kerala,Crime Against Children,Child Labor,Female,31-45,6662,2587,4075,3066,3596
2001,Urban,Nagaland,Crime Against Men,Extortion,Male,31-45,2985,1480,1505,1906,1079
2003,Urban,Madhya Pradesh,Crime Against Men,Assault,Male,46-60,3084,1688,1396,1928,1156
2002,Rural,Himachal Pradesh,Property Crime,Burglary,Female,46-60,2922,2127,795,2761,161
2002,Rural,Gujarat,Crime Against Women,Domestic Violence,Female,60+,8848,2588,6260,3036,5812
2009,Urban,Bihar,Other Crimes,Fraud,Male,13-17,4240,3976,264,4200,40
2003,Rural,Uttar Pradesh,Crime Against Women,Rape,Female,18-30,3234,2788,446,2970,264
2007,Urban,Jharkhand,Property Crime,Theft,Female,13-17,9490,2274,7216,4491,4999
2008,Urban,Chhattisgarh,Other Crimes,Drug Offense,Male,0-12,683,168,515,609,74
2004,Urban,Karnataka,Other Crimes,Corruption,Male,0-12,8341,1582,6759,4029,4312
2004,Rural,Odisha,Crime Against Women,Domestic Violence,Female,18-30,9923,9386,537,9749,174
2009,Urban,Manipur,Property Crime,Arson,Female,46-60,7423,6788,635,7057,366
2007,Rural,Rajasthan,Crime Against Women,Molestation,Female,0-12,7698,3571,4127,3612,4086
2002,Urban,Delhi,Crime Against Children,Child Labor,Female,0-12,3619,939,2680,3206,413
2001,Urban,Bihar,Property Crime,Vandalism,Male,13-17,1206,745,461,1078,128
2007,Urban,Punjab,Crime Against Children,Trafficking,Male,0-12,8632,5434,3198,6917,1715
2010,Rural,Rajasthan,Crime Against Men,Robbery,Male,13-17,6185,1092,5093,4234,1951
2010,Urban,Jammu & Kashmir,Property Crime,Theft,Male,60+,4107,3273,834,3307,800
2010,Rural,Nagaland,Other Crimes,Cyber Crime,Female,13-17,1332,907,425,1310,22
2004,Rural,Karnataka,Other Crimes,Cyber Crime,Female,60+,835,290,545,375,460
2005,Rural,Uttar Pradesh,Crime Against Women,Domestic Violence,Female,46-60,3996,1410,2586,1692,2304
2003,Urban,Punjab,Crime Against Women,Rape,Female,46-60,7576,173,7403,5466,2110
2002,Rural,Odisha,Crime Against Children,Child Labor,Female,46-60,7067,2565,4502,6727,340
2003,Rural,Sikkim,Other Crimes,Cyber Crime,Female,0-12,6057,2639,3418,2778,3279
2004,Urban,West Bengal,Property Crime,Theft,Male,0-12,6952,5885,1067,6389,563
2003,Urban,Telangana,Property Crime,Vandalism,Male,13-17,8891,637,8254,5648,3243
2005,Rural,Bihar,Crime Against Men,Murder,Female,46-60,1302,1236,66,1273,29
2004,Urban,Delhi,Property Crime,Burglary,Male,13-17,6878,6397,481,6429,449
2001,Rural,Maharashtra,Property Crime,Arson,Female,13-17,6004,1676,4328,5725,279
2009,Rural,Uttar Pradesh,Property Crime,Vandalism,Male,13-17,1960,1681,279,1747,213
2006,Rural,Gujarat,Crime Against Women,Rape,Male,13-17,8594,2221,6373,8555,39
2008,Urban,Himachal Pradesh,Crime Against Children,Trafficking,Male,46-60,6439,5751,688,6395,44
2009,Urban,Tamil Nadu,Crime Against Women,Rape,Male,31-45,1974,1155,819,1413,561
2007,Urban,Tripura,Property Crime,Theft,Female,31-45,9683,3424,6259,4333,5350
2005,Rural,Madhya Pradesh,Crime Against Women,Domestic Violence,Male,0-12,1547,1203,344,1432,115
2002,Rural,Chhattisgarh,Property Crime,Vandalism,Female,18-30,6916,6244,672,6709,207
2006,Rural,Jammu & Kashmir,Crime Against Men,Robbery,Female,46-60,2798,384,2414,865,1933
2004,Urban,Telangana,Property Crime,Arson,Male,0-12,50,3,47,19,31
2003,Urban,Manipur,Property Crime,Burglary,Male,18-30,3688,1455,2233,2740,948
2006,Urban,Rajasthan,Crime Against Children,Child Labor,Female,31-45,6987,3516,3471,5239,1748
2004,Urban,Uttarakhand,Crime Against Men,Extortion,Female,60+,3472,1938,1534,3410,62
2004,Rural,Mizoram,Property Crime,Arson,Female,31-45,4955,12,4943,3507,1448
2006,Rural,Karnataka,Crime Against Women,Molestation,Male,46-60,5530,2645,2885,3694,1836
2010,Urban,Manipur,Crime Against Children,Child Labor,Female,60+,915,416,499,671,244
2008,Urban,Jharkhand,Property Crime,Theft,Male,31-45,7976,6902,1074,7650,326
2007,Rural,West Bengal,Crime Against Children,Trafficking,Male,60+,6665,4481,2184,4603,2062
2002,Urban,Uttar Pradesh,Crime Against Children,Child Abuse,Female,46-60,7462,554,6908,6307,1155
2003,Rural,Haryana,Crime Against Women,Domestic Violence,Male,31-45,3583,1816,1767,3461,122
2003,Urban,Punjab,Crime Against Men,Extortion,Female,31-45,7368,320,7048,5476,1892
2010,Urban,Manipur,Crime Against Men,Robbery,Female,31-45,4929,2281,2648,4637,292
2002,Urban,West Bengal,Crime Against Children,Child Labor,Male,31-45,1361,437,924,1029,332
2002,Rural,Madhya Pradesh,Crime Against Children,Kidnapping,Male,60+,2411,724,1687,1286,1125
2004,Rural,Goa,Crime Against Children,Child Abuse,Female,31-45,3096,2740,356,3046,50
2007,Urban,Rajasthan,Other Crimes,Cyber Crime,Female,0-12,1804,456,1348,542,1262
2008,Urban,Tripura,Other Crimes,Drug Offense,Female,31-45,3229,2637,592,2929,300
2007,Urban,Chhattisgarh,Property Crime,Arson,Male,0-12,2612,838,1774,2275,337
2008,Rural,Jammu & Kashmir,Property Crime,Burglary,Female,13-17,4909,3906,1003,4681,228
2009,Rural,Goa,Crime Against Women,Rape,Female,0-12,9132,4063,5069,4763,4369
2004,Rural,Jharkhand,Crime Against Men,Assault,Female,31-45,4111,3330,781,3971,140
2004,Urban,Madhya Pradesh,Crime Against Men,Robbery,Male,46-60,4872,2650,2222,3359,1513
2008,Rural,Gujarat,Property Crime,Theft,Female,13-17,2042,4,2038,1832,210
2007,Rural,West Bengal,Crime Against Children,Trafficking,Female,46-60,3845,3453,392,3694,151
2004,Rural,Rajasthan,Crime Against Men,Extortion,Male,31-45,9911,4239,5672,7334,2577
2003,Rural,Sikkim,Property Crime,Theft,Female,18-30,3094,1537,1557,2082,1012
2003,Rural,Chhattisgarh,Property Crime,Vandalism,Male,31-45,8915,4329,4586,5718,3197
2001,Rural,Mizoram,Other Crimes,Corruption,Male,46-60,6910,2741,4169,5077,1833
2002,Rural,Uttarakhand,Other Crimes,Drug Offense,Female,0-12,145,131,14,139,6
2009,Urban,Assam,Property Crime,Vandalism,Male,46-60,2837,2377,460,2429,408
2002,Urban,Madhya Pradesh,Crime Against Men,Murder,Female,46-60,6042,3977,2065,5478,564
2002,Urban,Meghalaya,Crime Against Women,Dowry Deaths,Female,46-60,2834,866,1968,916,1918
2006,Rural,Delhi,Crime Against Children,Kidnapping,Female,13-17,6776,4512,2264,4837,1939
2009,Rural,Meghalaya,Property Crime,Theft,Female,18-30,2040,1041,999,1955,85
2004,Urban,Odisha,Crime Against Women,Domestic Violence,Female,60+,5240,225,5015,4147,1093
2005,Urban,Gujarat,Crime Against Men,Assault,Female,0-12,2363,2320,43,2354,9
2004,Urban,Haryana,Other Crimes,Corruption,Male,13-17,2875,1559,1316,1784,1091
2003,Rural,Manipur,Property Crime,Vandalism,Male,60+,8973,7264,1709,8757,216
2008,Urban,Bihar,Other Crimes,Cyber Crime,Female,46-60,3715,2505,1210,2605,1110
2001,Urban,Himachal Pradesh,Crime Against Women,Domestic Violence,Male,0-12,5552,2150,3402,4954,598
2004,Rural,Telangana,Other Crimes,Cyber Crime,Female,18-30,8426,5292,3134,7536,890
2003,Rural,Karnataka,Crime Against Children,Trafficking,Male,31-45,6805,1627,5178,1873,4932
2006,Urban,Haryana,Crime Against Men,Assault,Male,46-60,364,315,49,334,30
2001,Urban,Andhra Pradesh,Crime Against Men,Murder,Male,60+,1918,1172,746,1396,522
2010,Urban,Tripura,Crime Against Children,Kidnapping,Female,0-12,4213,2402,1811,2974,1239
2007,Rural,Rajasthan,Crime Against Women,Molestation,Male,18-30,8515,503,8012,5570,2945
2002,Urban,Assam,Crime Against Children,Child Abuse,Female,46-60,8995,7459,1536,8150,845
2005,Urban,Arunachal Pradesh,Crime Against Women,Domestic Violence,Female,0-12,6642,3218,3424,3948,2694
2006,Rural,Telangana,Property Crime,Burglary,Male,18-30,2541,1757,784,2158,383
2003,Urban,Uttar Pradesh,Property Crime,Arson,Female,31-45,1976,159,1817,526,1450
2010,Urban,Meghalaya,Other Crimes,Corruption,Female,13-17,2209,543,1666,1534,675
2008,Urban,Bihar,Crime Against Men,Extortion,Female,18-30,1953,1249,704,1318,635
2006,Urban,Telangana,Crime Against Women,Molestation,Female,13-17,705,462,243,671,34
2002,Rural,Punjab,Property Crime,Burglary,Male,0-12,8756,200,8556,5202,3554
2009,Urban,Odisha,Other Crimes,Drug Offense,Female,0-12,9163,5032,4131,8146,1017
2005,Urban,Jammu & Kashmir,Crime Against Women,Rape,Female,0-12,9208,1725,7483,6187,3021
2002,Rural,Maharashtra,Crime Against Children,Child Labor,Male,60+,3276,1519,1757,1535,1741
2008,Rural,Haryana,Crime Against Women,Rape,Female,13-17,1029,206,823,662,367
2004,Urban,Sikkim,Crime Against Men,Robbery,Female,13-17,666,429,237,627,39
2003,Rural,Gujarat,Property Crime,Arson,Female,60+,9582,6685,2897,8211,1371
2007,Rural,Andhra Pradesh,Crime Against Children,Child Labor,Male,31-45,8669,8419,250,8553,116
2002,Rural,Bihar,Crime Against Women,Molestation,Male,46-60,7034,6644,390,6760,274
2007,Urban,Tripura,Crime Against Women,Dowry Deaths,Male,0-12,5096,5014,82,5082,14
2005,Rural,Rajasthan,Crime Against Women,Rape,Male,0-12,4957,341,4616,3252,1705
2010,Rural,Gujarat,Other Crimes,Cyber Crime,Female,0-12,2719,2308,411,2553,166
2004,Rural,Chhattisgarh,Crime Against Women,Domestic Violence,Female,0-12,8007,7651,356,7770,237
2007,Urban,Tripura,Crime Against Women,Domestic Violence,Female,46-60,3583,232,3351,1936,1647
2001,Rural,Jharkhand,Crime Against Children,Kidnapping,Female,46-60,3349,2803,546,2981,368
2001,Urban,West Bengal,Crime Against Children,Trafficking,Female,13-17,7139,2360,4779,5245,1894
2006,Urban,Bihar,Property Crime,Theft,Male,13-17,6900,4482,2418,6879,21
2006,Urban,Haryana,Crime Against Children,Child Labor,Male,13-17,4489,1291,3198,4271,218
2004,Rural,Telangana,Crime Against Men,Assault,Male,0-12,7733,6741,992,6789,944
2005,Urban,Andhra Pradesh,Crime Against Children,Trafficking,Female,0-12,3913,718,3195,1779,2134
2009,Urban,Manipur,Crime Against Men,Robbery,Male,13-17,3823,2102,1721,2420,1403
2005,Rural,Arunachal Pradesh,Property Crime,Theft,Female,18-30,2467,2425,42,2433,34
2004,Rural,Madhya Pradesh,Crime Against Men,Murder,Female,31-45,9694,8627,1067,8630,1064
2004,Urban,Madhya Pradesh,Crime Against Men,Extortion,Female,60+,6990,3887,3103,5666,1324
2005,Urban,Uttar Pradesh,Other Crimes,Fraud,Male,13-17,5295,876,4419,2342,2953
2009,Rural,Delhi,Crime Against Women,Rape,Male,18-30,9744,6984,2760,7332,2412
2006,Rural,Bihar,Crime Against Men,Extortion,Female,13-17,5626,3209,2417,4986,640
2006,Urban,Jammu & Kashmir,Crime Against Women,Dowry Deaths,Female,46-60,8325,7598,727,7633,692
2001,Urban,Himachal Pradesh,Crime Against Men,Assault,Male,46-60,2628,1706,922,2179,449
2003,Rural,Jammu & Kashmir,Crime Against Men,Murder,Male,46-60,8738,3151,5587,6436,2302
2009,Rural,Kerala,Crime Against Women,Molestation,Female,60+,2366,1107,1259,2163,203
2002,Urban,Goa,Property Crime,Arson,Female,18-30,1893,1124,769,1810,83
2008,Urban,Gujarat,Crime Against Children,Child Labor,Female,60+,4141,796,3345,2182,1959
2003,Urban,Manipur,Crime Against Children,Child Labor,Male,13-17,8381,1199,7182,6708,1673
2001,Rural,Mizoram,Other Crimes,Corruption,Female,0-12,1174,14,1160,601,573
2010,Urban,Madhya Pradesh,Other Crimes,Fraud,Female,46-60,3505,1101,2404,2969,536
2010,Rural,Nagaland,Crime Against Men,Robbery,Male,31-45,4987,3262,1725,4600,387
2004,Urban,Uttar Pradesh,Other Crimes,Corruption,Male,18-30,7007,636,6371,2870,4137
2001,Urban,Telangana,Crime Against Women,Dowry Deaths,Male,18-30,5096,896,4200,1715,3381
2004,Urban,Maharashtra,Property Crime,Arson,Female,46-60,1799,1405,394,1644,155
2005,Rural,Arunachal Pradesh,Property Crime,Burglary,Female,31-45,3907,1070,2837,1706,2201
2002,Urban,Himachal Pradesh,Crime Against Men,Assault,Male,31-45,4801,2329,2472,2366,2435
2002,Urban,Tamil Nadu,Other Crimes,Fraud,Female,0-12,1757,216,1541,348,1409
2010,Rural,Jammu & Kashmir,Crime Against Women,Molestation,Male,0-12,3048,2929,119,2964,84
2007,Rural,Karnataka,Crime Against Children,Child Abuse,Male,13-17,7537,3357,4180,3681,3856
2004,Rural,Himachal Pradesh,Property Crime,Burglary,Female,0-12,3226,679,2547,1251,1975
2004,Rural,Odisha,Property Crime,Arson,Female,0-12,8570,1215,7355,4262,4308
2001,Urban,Karnataka,Crime Against Men,Assault,Male,60+,4771,1479,3292,4049,722
2008,Urban,Telangana,Crime Against Children,Child Labor,Male,18-30,159,39,120,40,119
2001,Rural,Madhya Pradesh,Other Crimes,Fraud,Male,13-17,965,244,721,670,295
2010,Rural,Punjab,Crime Against Children,Child Abuse,Male,31-45,3539,1636,1903,3082,457
2007,Rural,Nagaland,Crime Against Men,Robbery,Male,13-17,9975,593,9382,2273,7702
2008,Rural,Bihar,Crime Against Children,Child Abuse,Male,31-45,4332,2172,2160,2541,1791
2005,Urban,Nagaland,Crime Against Women,Molestation,Male,18-30,8887,2752,6135,6579,2308
2008,Urban,Kerala,Other Crimes,Cyber Crime,Female,0-12,5667,5522,145,5594,73
2007,Rural,Jharkhand,Crime Against Children,Child Abuse,Female,18-30,3071,1910,1161,2188,883
2004,Urban,Rajasthan,Crime Against Women,Rape,Male,46-60,6971,6251,720,6605,366
2007,Rural,Sikkim,Crime Against Women,Dowry Deaths,Female,31-45,2070,1985,85,2053,17
2008,Urban,Kerala,Other Crimes,Cyber Crime,Female,0-12,2377,1946,431,2187,190
2008,Rural,Delhi,Crime Against Men,Assault,Male,31-45,8753,1221,7532,1689,7064
2001,Rural,Kerala,Other Crimes,Cyber Crime,Male,0-12,9047,7173,1874,8546,501
2005,Rural,Telangana,Property Crime,Burglary,Female,31-45,9591,6573,3018,8852,739
2001,Rural,Karnataka,Other Crimes,Drug Offense,Male,31-45,2898,2508,390,2672,226
2009,Rural,Rajasthan,Other Crimes,Fraud,Male,31-45,3974,2807,1167,3641,333
2004,Rural,Jharkhand,Property Crime,Vandalism,Male,18-30,7954,5651,2303,5818,2136
2008,Rural,Karnataka,Other Crimes,Corruption,Female,31-45,7859,3694,4165,4302,3557
2009,Rural,West Bengal,Crime Against Children,Trafficking,Female,13-17,5874,5584,290,5746,128
2004,Rural,Kerala,Crime Against Men,Assault,Female,0-12,3753,3607,146,3616,137
2003,Rural,West Bengal,Crime Against Children,Child Abuse,Male,18-30,3541,1483,2058,2929,612
2004,Rural,Maharashtra,Other Crimes,Corruption,Female,0-12,2390,486,1904,2070,320
2002,Rural,Maharashtra,Property Crime,Arson,Male,18-30,4554,2149,2405,4251,303
2009,Rural,Tamil Nadu,Crime Against Men,Robbery,Female,60+,1436,1189,247,1279,157
2005,Rural,Arunachal Pradesh,Crime Against Children,Kidnapping,Male,46-60,9741,4840,4901,6265,3476
2001,Rural,Kerala,Crime Against Women,Domestic Violence,Female,18-30,4611,1286,3325,2522,2089
2001,Rural,Rajasthan,Property Crime,Arson,Female,46-60,922,120,802,241,681
2008,Urban,Uttarakhand,Other Crimes,Corruption,Male,13-17,4076,3278,798,3996,80
2010,Urban,Jammu & Kashmir,Crime Against Men,Assault,Male,18-30,3958,432,3526,437,3521
2001,Urban,Goa,Other Crimes,Fraud,Male,60+,7019,3368,3651,6959,60
2006,Urban,Mizoram,Property Crime,Vandalism,Female,0-12,771,374,397,702,69
2006,Urban,Rajasthan,Other Crimes,Drug Offense,Female,31-45,2780,2283,497,2432,348
2009,Rural,Chhattisgarh,Crime Against Women,Dowry Deaths,Female,46-60,6764,2150,4614,2216,4548
2002,Rural,Andhra Pradesh,Property Crime,Arson,Female,0-12,2754,348,2406,2664,90
2010,Rural,Punjab,Other Crimes,Fraud,Male,46-60,8097,3046,5051,7323,774
2009,Rural,Meghalaya,Other Crimes,Cyber Crime,Male,13-17,5963,5782,181,5891,72
2007,Rural,Assam,Crime Against Men,Extortion,Male,18-30,1288,217,1071,1264,24
2005,Rural,Meghalaya,Crime Against Children,Trafficking,Female,0-12,2926,1319,1607,1466,1460
2005,Urban,Uttarakhand,Other Crimes,Drug Offense,Male,0-12,1461,807,654,1207,254
2006,Urban,Meghalaya,Other Crimes,Drug Offense,Female,18-30,7692,6393,1299,6908,784
2001,Urban,Andhra Pradesh,Crime Against Children,Trafficking,Female,46-60,3802,3615,187,3681,121
2007,Rural,Manipur,Other Crimes,Corruption,Female,46-60,3741,3663,78,3705,36
2008,Rural,Himachal Pradesh,Crime Against Women,Rape,Female,46-60,7016,6690,326,6974,42
2001,Rural,Meghalaya,Other Crimes,Corruption,Male,0-12,768,539,229,714,54
2002,Urban,Himachal Pradesh,Other Crimes,Corruption,Female,0-12,5144,161,4983,2722,2422
2007,Rural,Telangana,Crime Against Children,Kidnapping,Female,13-17,355,133,222,302,53
2009,Rural,Chhattisgarh,Other Crimes,Drug Offense,Male,13-17,2037,852,1185,1438,599
2010,Urban,Karnataka,Crime Against Women,Domestic Violence,Male,0-12,1685,1521,164,1652,33
2001,Rural,Goa,Other Crimes,Cyber Crime,Male,18-30,7228,511,6717,6685,543
2005,Urban,Gujarat,Crime Against Women,Dowry Deaths,Female,0-12,5403,250,5153,2165,3238
2001,Rural,Bihar,Other Crimes,Cyber Crime,Female,18-30,7194,1714,5480,4219,2975
2007,Urban,West Bengal,Property Crime,Theft,Male,31-45,4951,1683,3268,1864,3087
2010,Rural,Gujarat,Property Crime,Theft,Male,13-17,8289,1571,6718,4719,3570
2001,Urban,Punjab,Property Crime,Vandalism,Male,60+,412,127,285,286,126
2001,Rural,Kerala,Crime Against Women,Dowry Deaths,Female,13-17,5983,3772,2211,3817,2166
2007,Urban,Uttar Pradesh,Crime Against Women,Molestation,Male,18-30,325,65,260,177,148
2007,Rural,Tripura,Other Crimes,Fraud,Male,31-45,4171,901,3270,3414,757
2006,Urban,Bihar,Crime Against Children,Trafficking,Female,13-17,8060,5671,2389,7089,971
2007,Rural,Gujarat,Property Crime,Theft,Male,60+,8940,1528,7412,5079,3861
2001,Urban,Uttar Pradesh,Crime Against Women,Rape,Male,13-17,4400,1986,2414,3722,678
2003,Urban,Uttar Pradesh,Crime Against Men,Extortion,Male,46-60,4630,4252,378,4387,243
2004,Rural,Karnataka,Property Crime,Vandalism,Male,60+,384,283,101,330,54
2010,Urban,West Bengal,Crime Against Men,Robbery,Female,0-12,9737,4939,4798,5720,4017
2006,Urban,Haryana,Crime Against Children,Kidnapping,Male,31-45,3585,3435,150,3455,130
2004,Urban,West Bengal,Crime Against Men,Murder,Female,0-12,7444,5452,1992,7444,0
2007,Urban,Bihar,Crime Against Children,Child Abuse,Male,0-12,8231,1534,6697,2411,5820
2002,Urban,Telangana,Property Crime,Vandalism,Male,31-45,2259,2000,259,2010,249
2005,Rural,Sikkim,Crime Against Men,Robbery,Male,31-45,267,229,38,259,8
2006,Rural,Madhya Pradesh,Crime Against Men,Robbery,Female,46-60,5955,5572,383,5589,366
2006,Rural,Manipur,Crime Against Women,Dowry Deaths,Male,31-45,873,311,562,578,295
2008,Rural,Uttarakhand,Property Crime,Arson,Male,60+,3416,1680,1736,2608,808
2002,Urban,Tripura,Property Crime,Theft,Male,60+,6518,4708,1810,6137,381
2009,Urban,Rajasthan,Crime Against Women,Domestic Violence,Female,18-30,2657,97,2560,370,2287
2001,Urban,Jharkhand,Other Crimes,Fraud,Male,13-17,3055,2058,997,2888,167
2010,Urban,Andhra Pradesh,Crime Against Children,Kidnapping,Male,18-30,2698,1756,942,2495,203
2007,Rural,Bihar,Crime Against Women,Molestation,Male,0-12,7981,3330,4651,6539,1442
2003,Rural,Maharashtra,Other Crimes,Corruption,Male,18-30,7714,354,7360,6387,1327
2003,Rural,West Bengal,Other Crimes,Fraud,Male,46-60,7814,727,7087,1857,5957
2007,Rural,Telangana,Crime Against Children,Trafficking,Female,31-45,7459,6675,784,7031,428
2002,Urban,Bihar,Crime Against Children,Kidnapping,Male,60+,996,440,556,556,440
2001,Urban,Meghalaya,Crime Against Children,Trafficking,Female,0-12,6930,6085,845,6130,800
2002,Rural,Madhya Pradesh,Crime Against Men,Robbery,Male,18-30,2389,2074,315,2236,153
2006,Rural,Goa,Crime Against Children,Kidnapping,Male,60+,4234,1732,2502,3122,1112
2001,Urban,Himachal Pradesh,Property Crime,Arson,Female,13-17,9408,7552,1856,9109,299
2009,Rural,Karnataka,Crime Against Women,Rape,Male,46-60,8547,1583,6964,4516,4031
2002,Urban,Maharashtra,Other Crimes,Cyber Crime,Male,46-60,2595,1217,1378,1910,685
2005,Urban,Haryana,Property Crime,Burglary,Male,18-30,1631,1409,222,1564,67
2002,Rural,Telangana,Property Crime,Arson,Female,46-60,4676,3870,806,4597,79
2004,Rural,Madhya Pradesh,Other Crimes,Fraud,Female,46-60,9410,3586,5824,5995,3415
2001,Rural,Andhra Pradesh,Other Crimes,Cyber Crime,Female,31-45,6724,5522,1202,6657,67
2009,Urban,Uttarakhand,Other Crimes,Corruption,Female,18-30,7257,2189,5068,6028,1229
2003,Urban,Uttar Pradesh,Property Crime,Burglary,Male,60+,8517,7526,991,8135,382
2006,Urban,Karnataka,Crime Against Men,Assault,Female,0-12,6743,4185,2558,5391,1352
2010,Rural,Haryana,Property Crime,Arson,Female,0-12,5923,3813,2110,4390,1533
2006,Urban,Maharashtra,Crime Against Women,Molestation,Female,0-12,7579,668,6911,2835,4744
2002,Rural,Bihar,Crime Against Women,Rape,Female,60+,5178,4475,703,5015,163
2006,Urban,Rajasthan,Property Crime,Burglary,Male,0-12,966,421,545,511,455
2005,Rural,Uttar Pradesh,Crime Against Men,Extortion,Male,46-60,2431,1152,1279,2171,260
2010,Rural,Uttarakhand,Crime Against Women,Rape,Female,31-45,6304,5945,359,6248,56
2007,Rural,Uttarakhand,Other Crimes,Drug Offense,Male,18-30,9406,5334,4072,9120,286
2002,Urban,Madhya Pradesh,Crime Against Men,Assault,Female,46-60,6304,2389,3915,5810,494
2004,Urban,Bihar,Other Crimes,Fraud,Female,31-45,4259,3254,1005,3773,486
2007,Urban,Telangana,Crime Against Children,Child Labor,Male,60+,7758,2171,5587,5946,1812
2010,Urban,Gujarat,Crime Against Women,Domestic Violence,Male,46-60,4110,3164,946,3658,452
2005,Rural,Mizoram,Crime Against Women,Domestic Violence,Male,13-17,6292,1513,4779,2900,3392
2008,Urban,Andhra Pradesh,Crime Against Men,Extortion,Male,31-45,7511,2791,4720,3668,3843
2003,Rural,Tripura,Crime Against Men,Assault,Female,31-45,5131,2121,3010,4595,536
2002,Rural,Tamil Nadu,Crime Against Children,Trafficking,Female,60+,9502,5677,3825,7166,2336
2005,Urban,West Bengal,Crime Against Men,Assault,Male,31-45,6023,1492,4531,5937,86
2003,Rural,Kerala,Property Crime,Burglary,Male,18-30,1162,340,822,648,514
2007,Urban,Arunachal Pradesh,Property Crime,Burglary,Female,31-45,6955,535,6420,965,5990
2003,Rural,Goa,Other Crimes,Cyber Crime,Male,31-45,1757,1341,416,1521,236
2004,Urban,Tamil Nadu,Crime Against Children,Kidnapping,Female,60+,9184,5469,3715,6535,2649
2003,Urban,Arunachal Pradesh,Crime Against Children,Trafficking,Male,31-45,9022,4229,4793,6147,2875
2001,Urban,Odisha,Crime Against Children,Trafficking,Male,18-30,7318,4775,2543,5078,2240
2003,Rural,Karnataka,Crime Against Women,Dowry Deaths,Female,13-17,7143,6895,248,6997,146
2002,Urban,Jharkhand,Property Crime,Theft,Female,46-60,6115,4041,2074,5312,803
2003,Rural,Manipur,Crime Against Children,Child Labor,Female,18-30,9109,2816,6293,7943,1166
2003,Urban,Jammu & Kashmir,Property Crime,Theft,Female,31-45,9781,5160,4621,6481,3300
2006,Rural,Maharashtra,Other Crimes,Corruption,Male,18-30,2496,139,2357,1760,736
2010,Rural,Tamil Nadu,Crime Against Women,Dowry Deaths,Male,13-17,2465,745,1720,1235,1230
2005,Urban,Odisha,Other Crimes,Fraud,Male,46-60,7228,4898,2330,5433,1795
2008,Urban,Madhya Pradesh,Crime Against Women,Domestic Violence,Male,60+,9288,4038,5250,6427,2861
2001,Urban,Mizoram,Crime Against Children,Trafficking,Male,13-17,7213,6774,439,7119,94
2007,Urban,Manipur,Crime Against Women,Domestic Violence,Male,18-30,5738,438,5300,2343,3395
2008,Rural,Meghalaya,Property Crime,Vandalism,Male,31-45,6602,691,5911,3719,2883
2003,Rural,Uttar Pradesh,Property Crime,Vandalism,Female,46-60,3444,1833,1611,3398,46
2002,Rural,Rajasthan,Crime Against Children,Child Labor,Male,0-12,2097,1817,280,1829,268
2005,Urban,Himachal Pradesh,Property Crime,Burglary,Female,13-17,7793,2380,5413,2471,5322
2008,Urban,Gujarat,Crime Against Children,Kidnapping,Female,18-30,9284,7719,1565,8009,1275
2002,Urban,Arunachal Pradesh,Crime Against Children,Child Labor,Male,13-17,1235,447,788,1020,215
2001,Rural,Sikkim,Other Crimes,Fraud,Male,31-45,5466,1883,3583,3394,2072
2001,Rural,West Bengal,Property Crime,Burglary,Female,46-60,8479,1849,6630,6254,2225
2008,Rural,Arunachal Pradesh,Crime Against Children,Child Labor,Male,18-30,4126,265,3861,727,3399
2005,Rural,Rajasthan,Crime Against Women,Dowry Deaths,Male,46-60,1988,446,1542,1496,492
2007,Urban,Haryana,Crime Against Women,Molestation,Male,46-60,2462,1717,745,1761,701
2006,Rural,Tamil Nadu,Crime Against Children,Child Abuse,Female,46-60,8124,3270,4854,7128,996
2004,Urban,Assam,Property Crime,Theft,Female,60+,9456,2121,7335,3815,5641
2008,Urban,Rajasthan,Crime Against Women,Dowry Deaths,Female,60+,185,82,103,172,13
2005,Rural,Sikkim,Crime Against Children,Kidnapping,Female,60+,4873,3689,1184,4822,51
2001,Urban,Delhi,Crime Against Women,Rape,Male,31-45,3354,2688,666,3088,266
2007,Rural,West Bengal,Crime Against Women,Molestation,Male,0-12,6266,4796,1470,6032,234
2003,Rural,Jharkhand,Crime Against Men,Assault,Male,46-60,3159,374,2785,1465,1694
2007,Urban,Assam,Crime Against Men,Assault,Female,31-45,896,251,645,465,431
2004,Rural,Haryana,Crime Against Men,Murder,Male,18-30,9961,1883,8078,9377,584
2007,Rural,Uttarakhand,Crime Against Children,Child Labor,Male,13-17,8442,3444,4998,6580,1862
2005,Rural,Himachal Pradesh,Crime Against Men,Murder,Female,31-45,9472,1167,8305,6745,2727
2007,Rural,Kerala,Crime Against Children,Kidnapping,Female,31-45,7641,2171,5470,7419,222
2005,Rural,Manipur,Crime Against Children,Kidnapping,Female,13-17,6529,6110,419,6447,82
2006,Rural,Uttar Pradesh,Crime Against Men,Robbery,Female,13-17,4646,458,4188,4366,280
2007,Urban,Uttar Pradesh,Crime Against Children,Kidnapping,Male,46-60,599,111,488,418,181
2005,Urban,Karnataka,Crime Against Children,Child Abuse,Male,18-30,8490,3204,5286,5145,3345
2006,Urban,Tripura,Other Crimes,Fraud,Female,13-17,5673,1447,4226,4134,1539
2006,Rural,Goa,Property Crime,Vandalism,Female,46-60,4854,4035,819,4352,502
2002,Urban,Karnataka,Crime Against Men,Assault,Female,0-12,7348,5154,2194,5301,2047
2001,Rural,Jammu & Kashmir,Crime Against Men,Robbery,Female,0-12,4690,231,4459,908,3782
2008,Urban,Odisha,Crime Against Women,Molestation,Female,31-45,6803,4114,2689,4467,2336
2007,Urban,Telangana,Crime Against Men,Murder,Male,31-45,9014,7304,1710,7672,1342
2003,Urban,Himachal Pradesh,Other Crimes,Cyber Crime,Female,0-12,3213,975,2238,2613,600
2009,Urban,Kerala,Other Crimes,Corruption,Female,60+,4749,525,4224,2672,2077
2004,Rural,Arunachal Pradesh,Crime Against Women,Domestic Violence,Male,13-17,2412,2406,6,2411,1
2007,Urban,Sikkim,Crime Against Men,Extortion,Male,13-17,956,428,528,884,72
2007,Urban,Goa,Crime Against Children,Child Labor,Female,46-60,5908,2396,3512,5648,260
2005,Rural,Meghalaya,Crime Against Men,Murder,Male,31-45,423,289,134,419,4
2003,Rural,Tripura,Crime Against Women,Rape,Male,31-45,5035,449,4586,676,4359
2007,Urban,Assam,Crime Against Men,Assault,Male,60+,9874,2974,6900,3908,5966
2002,Rural,Rajasthan,Crime Against Children,Trafficking,Male,18-30,2490,298,2192,1359,1131
2002,Rural,Haryana,Property Crime,Theft,Male,18-30,7672,6589,1083,7136,536
2005,Urban,Delhi,Crime Against Children,Trafficking,Female,46-60,1026,885,141,975,51
2001,Rural,Sikkim,Crime Against Women,Domestic Violence,Female,46-60,6277,3167,3110,3544,2733
2007,Rural,Tripura,Crime Against Men,Assault,Female,18-30,3494,3228,266,3411,83
2006,Rural,Arunachal Pradesh,Crime Against Women,Molestation,Female,46-60,6052,5125,927,5637,415
2002,Urban,Arunachal Pradesh,Property Crime,Arson,Male,60+,1577,462,1115,680,897
2010,Urban,Rajasthan,Other Crimes,Cyber Crime,Female,31-45,4932,1752,3180,1931,3001
2002,Rural,Karnataka,Crime Against Children,Child Abuse,Male,0-12,2179,1338,841,1487,692
2005,Rural,Punjab,Crime Against Children,Trafficking,Female,46-60,1207,1000,207,1058,149
2009,Rural,Mizoram,Crime Against Men,Assault,Female,0-12,209,180,29,189,20
2002,Urban,Haryana,Property Crime,Burglary,Female,0-12,8026,905,7121,6244,1782
2002,Urban,Nagaland,Crime Against Women,Molestation,Male,46-60,423,343,80,389,34
2004,Urban,Madhya Pradesh,Crime Against Children,Kidnapping,Male,13-17,5522,716,4806,2329,3193
2003,Rural,Meghalaya,Crime Against Men,Assault,Female,18-30,4094,3074,1020,3558,536
2007,Rural,Karnataka,Property Crime,Burglary,Male,46-60,9815,3028,6787,6627,3188
2005,Rural,Himachal Pradesh,Crime Against Children,Trafficking,Female,18-30,3557,2311,1246,2966,591
2006,Urban,Gujarat,Other Crimes,Fraud,Female,18-30,6418,4988,1430,5802,616
2010,Rural,Jammu & Kashmir,Crime Against Men,Murder,Male,0-12,7663,1149,6514,1795,5868
2007,Urban,Maharashtra,Crime Against Children,Child Abuse,Male,0-12,3126,1191,1935,2683,443
2001,Rural,Tripura,Crime Against Women,Domestic Violence,Male,60+,7742,5607,2135,6398,1344
2001,Urban,West Bengal,Other Crimes,Fraud,Female,60+,6662,27,6635,4934,1728
2002,Urban,Gujarat,Crime Against Children,Trafficking,Male,13-17,1122,575,547,591,531
2003,Urban,Kerala,Crime Against Children,Child Labor,Male,18-30,2029,454,1575,1737,292
2003,Rural,Uttarakhand,Crime Against Children,Trafficking,Female,31-45,3586,2871,715,3343,243
2007,Rural,Mizoram,Crime Against Children,Trafficking,Female,13-17,4656,510,4146,757,3899
2003,Urban,Uttar Pradesh,Crime Against Women,Molestation,Male,18-30,1910,691,1219,1450,460
2003,Urban,Kerala,Crime Against Women,Domestic Violence,Female,18-30,254,59,195,209,45
2008,Urban,Manipur,Crime Against Women,Dowry Deaths,Female,46-60,9307,6966,2341,7473,1834
2009,Urban,Assam,Crime Against Women,Molestation,Female,18-30,6533,5215,1318,6168,365
2005,Rural,Bihar,Property Crime,Vandalism,Male,46-60,9384,3141,6243,5559,3825
2003,Rural,Mizoram,Property Crime,Vandalism,Male,0-12,8287,4482,3805,4732,3555
2002,Urban,Meghalaya,Crime Against Children,Child Abuse,Male,0-12,4925,2926,1999,4194,731
2006,Urban,Odisha,Crime Against Men,Assault,Male,13-17,4637,2209,2428,4325,312
2007,Urban,Manipur,Crime Against Men,Extortion,Male,46-60,7499,6207,1292,7481,18
2007,Rural,Tripura,Crime Against Women,Rape,Male,31-45,6364,1778,4586,6127,237
2007,Rural,Goa,Crime Against Children,Child Abuse,Male,18-30,2230,1996,234,2042,188
2009,Urban,Punjab,Crime Against Children,Kidnapping,Male,31-45,4125,2258,1867,2962,1163
2004,Urban,Punjab,Crime Against Women,Domestic Violence,Female,0-12,9628,794,8834,1823,7805
2003,Rural,Gujarat,Crime Against Men,Extortion,Female,46-60,2843,1060,1783,1676,1167
2003,Urban,Manipur,Property Crime,Vandalism,Female,60+,4551,1269,3282,1842,2709
2004,Urban,West Bengal,Property Crime,Arson,Male,18-30,6687,147,6540,4141,2546
2005,Urban,Gujarat,Property Crime,Vandalism,Female,60+,2989,776,2213,1560,1429
2005,Urban,Uttar Pradesh,Crime Against Men,Extortion,Female,46-60,4925,299,4626,4604,321
2006,Rural,Uttarakhand,Crime Against Children,Child Labor,Female,0-12,4740,3490,1250,4013,727
2005,Urban,Mizoram,Other Crimes,Corruption,Male,0-12,6357,3585,2772,6091,266
2010,Urban,Karnataka,Property Crime,Vandalism,Female,31-45,9601,5803,3798,6616,2985
2003,Urban,Uttarakhand,Crime Against Children,Trafficking,Female,60+,4557,3444,1113,3631,926
2005,Urban,Kerala,Crime Against Men,Extortion,Male,31-45,1014,908,106,908,106
2002,Urban,Maharashtra,Other Crimes,Drug Offense,Female,60+,6872,6510,362,6595,277
2004,Urban,Tamil Nadu,Crime Against Children,Trafficking,Female,60+,747,654,93,728,19
2004,Rural,Maharashtra,Crime Against Children,Kidnapping,Female,46-60,6625,888,5737,4151,2474
2010,Urban,Manipur,Property Crime,Burglary,Male,0-12,7400,6417,983,6565,835
2001,Urban,Odisha,Crime Against Men,Assault,Male,60+,1982,314,1668,1425,557
2006,Rural,Mizoram,Crime Against Children,Child Labor,Male,13-17,3513,1642,1871,3343,170
2003,Urban,Kerala,Crime Against Women,Domestic Violence,Female,31-45,430,252,178,328,102
2004,Urban,Delhi,Crime Against Children,Trafficking,Male,13-17,7756,5889,1867,7748,8
2006,Rural,Rajasthan,Crime Against Children,Child Abuse,Male,13-17,4176,3452,724,3725,451
2001,Rural,Punjab,Crime Against Women,Rape,Male,18-30,2216,1618,598,1891,325
2007,Rural,Gujarat,Other Crimes,Corruption,Female,46-60,3757,3136,621,3380,377
2003,Rural,Karnataka,Property Crime,Theft,Female,46-60,5069,2031,3038,2558,2511
2001,Rural,Jharkhand,Crime Against Women,Molestation,Female,60+,2373,1611,762,1870,503
2003,Rural,Uttar Pradesh,Crime Against Women,Domestic Violence,Male,46-60,945,574,371,594,351
2010,Rural,Uttarakhand,Crime Against Children,Child Labor,Male,0-12,3069,1698,1371,2205,864
2010,Rural,Goa,Crime Against Children,Kidnapping,Female,46-60,1803,1254,549,1261,542
2010,Rural,Odisha,Crime Against Children,Child Labor,Male,60+,504,487,17,503,1
2008,Urban,Meghalaya,Crime Against Men,Robbery,Male,60+,8456,1769,6687,6524,1932
2005,Rural,Telangana,Property Crime,Theft,Female,13-17,1434,12,1422,544,890
2010,Rural,Kerala,Crime Against Women,Molestation,Male,18-30,8168,2260,5908,6340,1828
2004,Urban,Karnataka,Crime Against Women,Dowry Deaths,Female,18-30,5386,2183,3203,2617,2769
2004,Urban,Tamil Nadu,Crime Against Men,Extortion,Female,18-30,6111,2960,3151,5107,1004
2009,Urban,Tamil Nadu,Crime Against Women,Dowry Deaths,Male,13-17,9405,4093,5312,8013,1392
2005,Urban,Jammu & Kashmir,Crime Against Men,Assault,Male,31-45,8201,1074,7127,4623,3578
2009,Urban,Uttar Pradesh,Crime Against Children,Child Abuse,Female,13-17,5742,5298,444,5532,210
2009,Rural,Jharkhand,Crime Against Children,Child Labor,Male,18-30,4562,4118,444,4537,25
2005,Rural,Uttar Pradesh,Crime Against Children,Child Labor,Female,18-30,5384,3054,2330,3903,1481
2002,Rural,Meghalaya,Crime Against Men,Robbery,Female,18-30,9787,958,8829,5571,4216
2004,Rural,Bihar,Property Crime,Arson,Female,0-12,2190,1001,1189,1089,1101
2002,Rural,Uttar Pradesh,Other Crimes,Cyber Crime,Female,18-30,8872,5836,3036,6511,2361
2002,Rural,Assam,Crime Against Children,Trafficking,Male,13-17,3135,187,2948,1644,1491
2003,Urban,Goa,Other Crimes,Cyber Crime,Female,0-12,3218,89,3129,2372,846
2008,Rural,Telangana,Crime Against Women,Molestation,Female,46-60,9819,9171,648,9414,405
2003,Rural,Odisha,Crime Against Women,Molestation,Female,31-45,7532,3793,3739,4774,2758
2001,Rural,Himachal Pradesh,Crime Against Women,Rape,Female,18-30,2845,2333,512,2674,171
2005,Rural,Tripura,Property Crime,Vandalism,Female,18-30,4555,3894,661,4094,461
2002,Urban,Jammu & Kashmir,Crime Against Children,Child Abuse,Male,46-60,9725,2034,7691,4178,5547
2004,Rural,Himachal Pradesh,Property Crime,Arson,Female,18-30,3872,546,3326,2704,1168
2009,Urban,Uttar Pradesh,Property Crime,Vandalism,Female,18-30,2733,214,2519,2391,342
2003,Rural,West Bengal,Crime Against Children,Child Labor,Female,0-12,7340,2011,5329,4977,2363
2005,Urban,Maharashtra,Property Crime,Burglary,Male,0-12,1128,894,234,965,163
2010,Urban,Delhi,Property Crime,Burglary,Female,13-17,2653,1090,1563,1611,1042
2005,Urban,Goa,Property Crime,Vandalism,Male,0-12,7219,4726,2493,4980,2239
2008,Urban,Sikkim,Crime Against Women,Rape,Female,0-12,6146,2361,3785,2370,3776
2006,Urban,Tamil Nadu,Crime Against Men,Murder,Female,0-12,1326,986,340,1230,96
2004,Rural,Sikkim,Crime Against Men,Extortion,Female,60+,6767,2266,4501,5332,1435
2002,Urban,Nagaland,Other Crimes,Fraud,Female,13-17,2515,1977,538,2113,402
2009,Urban,Gujarat,Other Crimes,Corruption,Male,46-60,8173,4229,3944,5852,2321
2004,Rural,Karnataka,Crime Against Men,Robbery,Male,31-45,85,55,30,62,23
2007,Urban,West Bengal,Crime Against Men,Extortion,Male,0-12,6039,2059,3980,3854,2185
2006,Urban,Nagaland,Property Crime,Burglary,Female,31-45,4205,801,3404,2431,1774
2002,Urban,Sikkim,Property Crime,Arson,Female,0-12,5606,990,4616,5437,169
2005,Rural,Goa,Other Crimes,Fraud,Female,31-45,9502,4319,5183,9319,183
2009,Urban,Odisha,Property Crime,Vandalism,Female,0-12,4151,3844,307,3921,230
2003,Rural,Nagaland,Crime Against Men,Murder,Male,13-17,5938,1043,4895,3333,2605
2004,Rural,Maharashtra,Property Crime,Theft,Male,31-45,1818,407,1411,732,1086
2001,Urban,Tamil Nadu,Crime Against Men,Murder,Male,60+,2632,1912,720,2246,386
2001,Urban,Uttar Pradesh,Property Crime,Burglary,Male,31-45,9977,7996,1981,9574,403
2003,Rural,Meghalaya,Other Crimes,Fraud,Male,0-12,5058,2777,2281,3593,1465
2006,Urban,Assam,Other Crimes,Fraud,Female,18-30,1264,599,665,641,623
2007,Urban,Andhra Pradesh,Other Crimes,Cyber Crime,Male,0-12,4358,3386,972,3418,940
2004,Rural,Jammu & Kashmir,Crime Against Women,Domestic Violence,Female,31-45,5157,2137,3020,2165,2992
2006,Urban,Assam,Crime Against Children,Child Labor,Male,31-45,774,471,303,513,261
2007,Urban,Kerala,Crime Against Children,Kidnapping,Male,60+,6882,1757,5125,5651,1231
2003,Urban,Uttarakhand,Property Crime,Arson,Female,46-60,6453,5608,845,5630,823
2009,Urban,Jharkhand,Crime Against Men,Murder,Female,46-60,5700,450,5250,2551,3149
2007,Rural,Madhya Pradesh,Crime Against Women,Rape,Female,46-60,5334,2652,2682,3745,1589
2008,Urban,West Bengal,Crime Against Children,Child Abuse,Male,31-45,7459,1166,6293,1429,6030
2003,Rural,Arunachal Pradesh,Crime Against Men,Assault,Male,0-12,5584,2857,2727,4145,1439
2009,Rural,Kerala,Crime Against Children,Child Labor,Male,0-12,6159,4640,1519,5132,1027
2001,Urban,Maharashtra,Property Crime,Burglary,Female,31-45,8512,711,7801,3532,4980
2001,Rural,Haryana,Other Crimes,Corruption,Female,46-60,3428,2185,1243,3319,109
2010,Urban,Jammu & Kashmir,Other Crimes,Fraud,Male,31-45,1967,1319,648,1432,535
2008,Rural,Tripura,Property Crime,Arson,Female,60+,1865,174,1691,1118,747
2004,Urban,Himachal Pradesh,Crime Against Men,Murder,Male,60+,557,425,132,442,115
2003,Urban,Karnataka,Crime Against Men,Extortion,Female,46-60,6608,5607,1001,6556,52
2006,Rural,Arunachal Pradesh,Crime Against Men,Robbery,Female,46-60,2376,2126,250,2255,121
2003,Urban,Kerala,Other Crimes,Drug Offense,Male,0-12,3028,887,2141,1625,1403
2008,Urban,Himachal Pradesh,Crime Against Children,Child Labor,Female,0-12,9482,8053,1429,8117,1365
2003,Rural,Himachal Pradesh,Crime Against Children,Child Abuse,Female,13-17,481,150,331,179,302
2001,Urban,Bihar,Property Crime,Vandalism,Male,18-30,5123,109,5014,198,4925
2007,Rural,Kerala,Property Crime,Theft,Female,13-17,9312,479,8833,5229,4083
2010,Urban,Punjab,Crime Against Men,Robbery,Male,31-45,7219,1687,5532,2645,4574
2008,Urban,Nagaland,Crime Against Women,Domestic Violence,Male,13-17,1780,1056,724,1184,596
2001,Urban,Manipur,Crime Against Men,Extortion,Male,31-45,2040,664,1376,710,1330
2005,Rural,Karnataka,Other Crimes,Cyber Crime,Female,60+,7471,1823,5648,4907,2564
2007,Urban,Chhattisgarh,Crime Against Men,Murder,Female,18-30,6160,546,5614,6098,62
2004,Rural,Chhattisgarh,Crime Against Men,Assault,Female,60+,5943,5480,463,5622,321
2001,Rural,Arunachal Pradesh,Property Crime,Burglary,Male,18-30,7491,5975,1516,6829,662
2004,Urban,Sikkim,Other Crimes,Drug Offense,Female,31-45,7585,6062,1523,6749,836
2002,Rural,Gujarat,Crime Against Children,Child Labor,Female,46-60,1088,893,195,994,94
2007,Urban,Chhattisgarh,Crime Against Women,Dowry Deaths,Female,0-12,2942,1380,1562,1613,1329
2006,Urban,Assam,Crime Against Children,Kidnapping,Male,60+,2605,933,1672,2213,392
2009,Rural,Odisha,Other Crimes,Corruption,Female,31-45,5865,2025,3840,4290,1575
2004,Rural,Maharashtra,Property Crime,Burglary,Female,31-45,410,326,84,343,67
2005,Rural,Bihar,Property Crime,Burglary,Male,60+,4179,554,3625,3821,358
2001,Rural,Maharashtra,Crime Against Children,Kidnapping,Female,31-45,7966,224,7742,1733,6233
2007,Rural,Odisha,Crime Against Men,Assault,Female,31-45,9889,1832,8057,2200,7689
2010,Rural,Jammu & Kashmir,Crime Against Men,Murder,Female,18-30,2421,602,1819,1309,1112
2008,Urban,West Bengal,Property Crime,Theft,Female,46-60,1801,1670,131,1794,7
2002,Rural,Jammu & Kashmir,Crime Against Men,Robbery,Male,0-12,9353,4959,4394,7297,2056
2009,Rural,Goa,Crime Against Women,Domestic Violence,Male,13-17,779,221,558,250,529
2006,Urban,Haryana,Crime Against Men,Assault,Male,60+,5892,40,5852,2215,3677
2005,Urban,Jammu & Kashmir,Other Crimes,Cyber Crime,Female,60+,5569,4352,1217,4782,787
2002,Rural,Jammu & Kashmir,Other Crimes,Fraud,Male,0-12,5553,2664,2889,4813,740
2009,Rural,Jammu & Kashmir,Crime Against Men,Extortion,Female,31-45,2157,1314,843,2019,138
2001,Urban,Rajasthan,Property Crime,Arson,Female,60+,7507,214,7293,4970,2537
2002,Urban,Goa,Property Crime,Theft,Female,46-60,8175,7937,238,8069,106
2004,Rural,Sikkim,Crime Against Men,Murder,Male,60+,6633,2999,3634,5313,1320
2009,Rural,Gujarat,Crime Against Men,Robbery,Female,18-30,116,2,114,51,65
2003,Rural,Uttar Pradesh,Other Crimes,Corruption,Male,46-60,2047,513,1534,531,1516
2010,Urban,Manipur,Crime Against Women,Domestic Violence,Female,18-30,4350,3526,824,3808,542
2001,Rural,Telangana,Crime Against Children,Kidnapping,Female,18-30,9608,374,9234,8151,1457
2001,Urban,Punjab,Property Crime,Arson,Male,31-45,4174,990,3184,3052,1122
2006,Rural,Uttarakhand,Crime Against Women,Domestic Violence,Male,0-12,4918,4823,95,4856,62
2009,Urban,Haryana,Crime Against Women,Molestation,Male,60+,8624,3268,5356,5380,3244
2007,Rural,Madhya Pradesh,Property Crime,Burglary,Male,18-30,9571,1968,7603,4158,5413
2005,Rural,Telangana,Property Crime,Burglary,Female,13-17,5023,136,4887,816,4207
2007,Rural,Kerala,Crime Against Men,Extortion,Male,60+,6130,4096,2034,4331,1799
2005,Urban,Nagaland,Other Crimes,Drug Offense,Female,13-17,8064,6549,1515,7249,815
2001,Urban,Kerala,Property Crime,Arson,Female,60+,2367,2099,268,2218,149
2005,Urban,Delhi,Crime Against Women,Dowry Deaths,Male,0-12,5330,2340,2990,4020,1310
2003,Urban,Tamil Nadu,Crime Against Women,Dowry Deaths,Female,0-12,3404,1184,2220,1832,1572
2003,Rural,Andhra Pradesh,Crime Against Women,Rape,Female,46-60,795,709,86,729,66
2009,Rural,Uttar Pradesh,Crime Against Women,Rape,Male,60+,2754,50,2704,2285,469
2009,Urban,Andhra Pradesh,Other Crimes,Drug Offense,Female,18-30,6521,4347,2174,6317,204
2006,Rural,Punjab,Other Crimes,Drug Offense,Female,13-17,2065,850,1215,850,1215
2006,Rural,Meghalaya,Crime Against Children,Kidnapping,Male,18-30,5112,3109,2003,3662,1450
2007,Rural,Arunachal Pradesh,Crime Against Children,Child Abuse,Male,31-45,6415,1486,4929,5001,1414
2003,Rural,Telangana,Crime Against Women,Molestation,Male,13-17,3995,3466,529,3764,231
2010,Urban,West Bengal,Other Crimes,Drug Offense,Female,0-12,5392,3159,2233,4238,1154
2004,Urban,Goa,Property Crime,Arson,Female,13-17,737,638,99,676,61
2002,Urban,Goa,Crime Against Women,Domestic Violence,Female,60+,8151,1807,6344,6973,1178
2005,Urban,Bihar,Crime Against Women,Rape,Male,18-30,7314,6057,1257,6625,689
2003,Rural,Telangana,Crime Against Women,Rape,Female,46-60,5625,684,4941,2941,2684
2005,Urban,Manipur,Crime Against Women,Rape,Female,13-17,3137,1894,1243,1975,1162
2008,Urban,Manipur,Crime Against Children,Child Labor,Female,60+,4569,3668,901,4145,424
2001,Rural,Meghalaya,Crime Against Children,Child Abuse,Male,46-60,7380,6078,1302,7200,180
2002,Urban,West Bengal,Property Crime,Vandalism,Female,13-17,1497,1237,260,1276,221
2010,Rural,Meghalaya,Crime Against Men,Robbery,Female,60+,4390,81,4309,3998,392
2009,Rural,Nagaland,Property Crime,Vandalism,Male,60+,6285,429,5856,2006,4279
2009,Rural,West Bengal,Crime Against Children,Child Abuse,Female,46-60,943,634,309,894,49
2005,Rural,Maharashtra,Crime Against Children,Child Labor,Female,60+,1425,704,721,987,438
2002,Urban,Assam,Crime Against Women,Molestation,Female,0-12,943,475,468,708,235
2003,Rural,Arunachal Pradesh,Crime Against Men,Extortion,Male,46-60,1328,1182,146,1304,24
2008,Rural,Jharkhand,Crime Against Men,Murder,Female,13-17,6870,5435,1435,5627,1243
2002,Urban,Bihar,Crime Against Children,Trafficking,Male,60+,6870,4041,2829,4782,2088
2008,Rural,Karnataka,Other Crimes,Drug Offense,Female,0-12,517,343,174,369,148
2001,Rural,Telangana,Other Crimes,Corruption,Female,46-60,8376,5200,3176,5588,2788
2004,Urban,Gujarat,Crime Against Women,Domestic Violence,Male,60+,3942,1033,2909,3283,659
2009,Urban,Assam,Crime Against Men,Murder,Female,46-60,9626,9137,489,9380,246
2005,Urban,Nagaland,Crime Against Children,Child Abuse,Male,13-17,726,613,113,701,25
2004,Rural,Himachal Pradesh,Other Crimes,Cyber Crime,Female,18-30,3453,3203,250,3402,51
2001,Urban,Rajasthan,Crime Against Men,Assault,Female,13-17,3081,2135,946,2345,736
2005,Rural,Uttar Pradesh,Crime Against Children,Kidnapping,Female,60+,6001,2309,3692,2498,3503
2001,Urban,Tripura,Property Crime,Theft,Female,18-30,2178,1697,481,1874,304
2003,Rural,Andhra Pradesh,Crime Against Children,Child Abuse,Female,60+,981,864,117,905,76
2001,Urban,Punjab,Other Crimes,Fraud,Female,0-12,9911,7414,2497,8439,1472
2002,Rural,Himachal Pradesh,Crime Against Women,Domestic Violence,Male,0-12,4350,1678,2672,2818,1532
2004,Rural,Bihar,Other Crimes,Corruption,Female,0-12,1355,1181,174,1214,141
2007,Rural,Kerala,Crime Against Men,Robbery,Female,0-12,4075,1080,2995,3705,370
2006,Rural,Chhattisgarh,Crime Against Children,Trafficking,Male,31-45,6034,2820,3214,5820,214
2009,Rural,Nagaland,Crime Against Children,Trafficking,Female,46-60,8285,2710,5575,3715,4570
2009,Rural,West Bengal,Other Crimes,Fraud,Female,13-17,5698,2110,3588,4261,1437
2006,Urban,Andhra Pradesh,Property Crime,Theft,Female,0-12,4312,866,3446,1700,2612
2007,Urban,Odisha,Property Crime,Arson,Male,0-12,5459,1807,3652,2327,3132
2007,Rural,Uttar Pradesh,Crime Against Men,Assault,Male,18-30,5539,1733,3806,4167,1372
2006,Rural,Manipur,Crime Against Women,Molestation,Male,31-45,7144,1576,5568,4503,2641
2004,Urban,Uttarakhand,Other Crimes,Corruption,Male,0-12,1130,369,761,590,540
2002,Urban,Karnataka,Crime Against Children,Trafficking,Female,31-45,8066,3441,4625,6437,1629
2009,Urban,Tamil Nadu,Other Crimes,Fraud,Female,13-17,4679,506,4173,4384,295
2010,Urban,Bihar,Crime Against Women,Rape,Female,60+,9760,6498,3262,9176,584
2006,Rural,Karnataka,Crime Against Men,Extortion,Female,60+,6698,6006,692,6564,134
2001,Urban,Punjab,Crime Against Women,Dowry Deaths,Female,60+,3224,3069,155,3124,100
2008,Urban,Goa,Other Crimes,Drug Offense,Male,46-60,6896,2930,3966,3881,3015
2004,Rural,Himachal Pradesh,Crime Against Children,Trafficking,Male,60+,6085,5950,135,5971,114
2010,Urban,Rajasthan,Property Crime,Vandalism,Female,60+,9390,6417,2973,7775,1615
2003,Urban,Uttarakhand,Other Crimes,Corruption,Male,60+,5844,5156,688,5613,231
2002,Rural,Manipur,Crime Against Men,Murder,Female,18-30,878,428,450,634,244
2004,Urban,Uttarakhand,Crime Against Children,Child Labor,Female,0-12,1064,175,889,772,292
2008,Rural,Bihar,Other Crimes,Cyber Crime,Male,60+,215,96,119,190,25
2006,Rural,Odisha,Crime Against Women,Domestic Violence,Male,60+,289,276,13,276,13
2007,Urban,Punjab,Property Crime,Vandalism,Male,0-12,7594,259,7335,1165,6429
2010,Urban,Arunachal Pradesh,Property Crime,Arson,Female,46-60,7875,1135,6740,3482,4393
2001,Urban,Himachal Pradesh,Property Crime,Arson,Female,31-45,1642,1570,72,1627,15
2002,Rural,Assam,Crime Against Children,Child Abuse,Female,0-12,7778,598,7180,2733,5045
2008,Urban,Jharkhand,Crime Against Women,Molestation,Male,13-17,724,155,569,322,402
2007,Urban,Nagaland,Crime Against Children,Kidnapping,Male,18-30,6882,6690,192,6793,89
2009,Rural,Tamil Nadu,Crime Against Children,Kidnapping,Female,31-45,8434,5077,3357,5184,3250
2003,Urban,Goa,Other Crimes,Corruption,Male,0-12,3387,2354,1033,2680,707
2007,Rural,Gujarat,Property Crime,Burglary,Male,0-12,8394,6932,1462,7293,1101
2004,Urban,Meghalaya,Crime Against Men,Assault,Male,0-12,2763,728,2035,1918,845
2002,Rural,Tripura,Crime Against Women,Rape,Female,60+,687,556,131,613,74
2010,Urban,Andhra Pradesh,Crime Against Men,Robbery,Male,46-60,3904,1730,2174,2076,1828
2006,Urban,Telangana,Crime Against Men,Assault,Male,60+,5252,557,4695,3863,1389
2008,Rural,Jharkhand,Property Crime,Theft,Female,60+,2106,64,2042,409,1697
2004,Rural,Manipur,Crime Against Men,Extortion,Male,13-17,2286,72,2214,1838,448
2002,Rural,Haryana,Other Crimes,Drug Offense,Male,46-60,1763,536,1227,848,915
2001,Rural,Chhattisgarh,Crime Against Children,Kidnapping,Male,13-17,698,110,588,523,175
2005,Urban,Assam,Other Crimes,Corruption,Male,13-17,8429,6068,2361,7836,593
2006,Rural,Jammu & Kashmir,Crime Against Children,Kidnapping,Male,46-60,6928,3926,3002,5002,1926
2002,Rural,Maharashtra,Crime Against Women,Domestic Violence,Male,13-17,7879,3560,4319,7403,476
2009,Urban,Uttar Pradesh,Crime Against Men,Assault,Male,18-30,3694,995,2699,2497,1197
2009,Rural,Assam,Property Crime,Arson,Male,60+,753,693,60,719,34
2006,Rural,Haryana,Crime Against Men,Murder,Female,0-12,465,322,143,394,71
2004,Urban,Telangana,Crime Against Men,Assault,Male,0-12,8242,6998,1244,7114,1128
2007,Urban,Kerala,Crime Against Women,Dowry Deaths,Female,18-30,1892,875,1017,888,1004
2009,Urban,Maharashtra,Property Crime,Burglary,Male,18-30,2707,910,1797,2208,499
2005,Rural,Punjab,Crime Against Women,Molestation,Male,18-30,4697,3584,1113,3794,903
2008,Rural,Delhi,Property Crime,Vandalism,Male,31-45,1174,1133,41,1134,40
2006,Rural,Bihar,Crime Against Women,Molestation,Female,13-17,1456,628,828,677,779
2008,Rural,Manipur,Property Crime,Arson,Male,46-60,7120,60,7060,5551,1569
2002,Urban,Odisha,Property Crime,Theft,Male,0-12,2240,160,2080,478,1762
2006,Rural,Chhattisgarh,Other Crimes,Fraud,Male,13-17,3498,151,3347,1491,2007
2007,Urban,Uttar Pradesh,Crime Against Children,Kidnapping,Female,31-45,3387,1701,1686,2912,475
2007,Rural,Assam,Crime Against Women,Rape,Male,0-12,8434,1266,7168,5705,2729
2006,Urban,Nagaland,Crime Against Women,Domestic Violence,Male,18-30,6215,565,5650,5089,1126
2010,Urban,Sikkim,Crime Against Women,Dowry Deaths,Male,13-17,809,644,165,655,154
2002,Urban,Bihar,Crime Against Women,Rape,Male,31-45,4958,4555,403,4788,170
2008,Urban,Mizoram,Crime Against Men,Robbery,Female,60+,4636,4153,483,4436,200
2001,Urban,Telangana,Crime Against Men,Murder,Male,0-12,4098,1368,2730,2338,1760
2002,Urban,Karnataka,Crime Against Women,Molestation,Male,13-17,6976,2635,4341,6428,548
2005,Rural,Rajasthan,Other Crimes,Fraud,Male,0-12,7320,6300,1020,6645,675
2003,Urban,Nagaland,Crime Against Men,Robbery,Male,31-45,3723,2221,1502,2297,1426
2008,Urban,Haryana,Crime Against Women,Domestic Violence,Female,13-17,9765,2171,7594,2762,7003
2010,Urban,Jharkhand,Property Crime,Burglary,Female,13-17,3553,3172,381,3221,332
2009,Rural,Meghalaya,Property Crime,Arson,Female,0-12,7796,1170,6626,2159,5637
2006,Urban,Uttar Pradesh,Crime Against Women,Molestation,Female,13-17,2502,153,2349,367,2135
2008,Urban,Himachal Pradesh,Property Crime,Burglary,Female,31-45,9793,106,9687,9773,20
2009,Urban,Himachal Pradesh,Other Crimes,Cyber Crime,Female,60+,4717,2251,2466,3817,900
2009,Urban,Rajasthan,Other Crimes,Corruption,Male,13-17,9007,8324,683,8519,488
2010,Rural,Manipur,Crime Against Women,Domestic Violence,Male,13-17,6681,4649,2032,5771,910
2002,Rural,Madhya Pradesh,Crime Against Men,Assault,Female,46-60,3677,35,3642,1567,2110
2004,Rural,Uttarakhand,Crime Against Women,Rape,Female,46-60,7707,6156,1551,7272,435
2004,Urban,Manipur,Crime Against Men,Robbery,Male,31-45,8098,5324,2774,7133,965
2008,Urban,Sikkim,Crime Against Women,Domestic Violence,Male,18-30,972,874,98,899,73
2007,Urban,Bihar,Other Crimes,Drug Offense,Female,60+,3161,3153,8,3154,7
2009,Urban,Kerala,Crime Against Children,Child Abuse,Male,31-45,1087,18,1069,687,400
2002,Urban,Jammu & Kashmir,Crime Against Women,Rape,Male,13-17,481,76,405,128,353
2003,Urban,Telangana,Property Crime,Vandalism,Male,13-17,98,29,69,62,36
2002,Urban,Meghalaya,Crime Against Women,Domestic Violence,Male,46-60,1397,768,629,1280,117
2008,Rural,Meghalaya,Crime Against Children,Child Labor,Male,60+,3554,1652,1902,2604,950
2008,Rural,Andhra Pradesh,Crime Against Children,Trafficking,Female,18-30,2694,871,1823,1758,936
2008,Urban,Jammu & Kashmir,Other Crimes,Drug Offense,Female,60+,7521,6835,686,7062,459
2009,Rural,Telangana,Crime Against Women,Domestic Violence,Female,31-45,250,22,228,125,125
2001,Urban,Karnataka,Property Crime,Vandalism,Female,0-12,6534,2,6532,5894,640
2001,Rural,Kerala,Crime Against Women,Domestic Violence,Female,18-30,5808,3472,2336,5492,316
2003,Rural,West Bengal,Crime Against Men,Robbery,Female,0-12,7260,6649,611,6663,597
2008,Rural,Bihar,Crime Against Women,Domestic Violence,Male,60+,1868,223,1645,1153,715
2003,Rural,Jharkhand,Property Crime,Theft,Male,46-60,4165,2946,1219,3635,530
2010,Rural,Haryana,Crime Against Men,Robbery,Female,60+,383,230,153,378,5
2007,Rural,Manipur,Other Crimes,Corruption,Male,0-12,3265,1412,1853,2493,772
2003,Rural,Sikkim,Property Crime,Arson,Male,13-17,8494,6793,1701,7712,782
2010,Rural,Kerala,Property Crime,Burglary,Female,18-30,2841,705,2136,1155,1686
2010,Urban,Arunachal Pradesh,Crime Against Men,Assault,Female,60+,1647,299,1348,1020,627
2008,Rural,Delhi,Other Crimes,Drug Offense,Female,46-60,3557,1690,1867,3391,166
2007,Rural,Tripura,Crime Against Men,Assault,Male,60+,1576,385,1191,610,966
2003,Rural,Manipur,Property Crime,Burglary,Male,46-60,5197,3386,1811,4821,376
2007,Rural,Madhya Pradesh,Crime Against Women,Molestation,Male,0-12,6181,3682,2499,4577,1604
2002,Rural,Arunachal Pradesh,Other Crimes,Fraud,Female,0-12,5138,1270,3868,2397,2741
2004,Urban,West Bengal,Crime Against Men,Robbery,Female,0-12,9853,144,9709,2417,7436
2009,Rural,Himachal Pradesh,Crime Against Women,Molestation,Female,0-12,3125,2403,722,2827,298
2006,Rural,Jammu & Kashmir,Other Crimes,Fraud,Male,31-45,1250,1114,136,1197,53
2004,Rural,Jammu & Kashmir,Crime Against Men,Murder,Female,18-30,7118,3637,3481,4483,2635
2002,Rural,Kerala,Property Crime,Arson,Female,31-45,6980,2175,4805,2417,4563
2002,Rural,Arunachal Pradesh,Property Crime,Burglary,Female,0-12,1752,1285,467,1667,85
2001,Rural,Goa,Crime Against Children,Kidnapping,Female,60+,5634,1448,4186,2199,3435
2001,Rural,Himachal Pradesh,Crime Against Men,Extortion,Male,13-17,2331,1801,530,2173,158
2008,Rural,Meghalaya,Crime Against Women,Domestic Violence,Male,60+,4659,4136,523,4459,200
2010,Urban,Sikkim,Crime Against Men,Robbery,Male,13-17,7819,1100,6719,5654,2165
2010,Urban,Mizoram,Crime Against Men,Murder,Male,46-60,7706,1859,5847,4954,2752
2002,Urban,Odisha,Crime Against Women,Rape,Male,0-12,1921,252,1669,1554,367
2002,Rural,Sikkim,Crime Against Women,Rape,Male,18-30,3022,2727,295,2741,281
2008,Rural,Uttar Pradesh,Crime Against Women,Molestation,Female,18-30,7486,843,6643,3740,3746
2004,Urban,Himachal Pradesh,Crime Against Men,Assault,Female,46-60,8400,3292,5108,7484,916
2008,Rural,Haryana,Crime Against Children,Child Abuse,Male,13-17,1110,778,332,833,277
2002,Rural,Manipur,Crime Against Women,Domestic Violence,Female,46-60,9391,8895,496,9021,370
2006,Rural,Haryana,Crime Against Women,Domestic Violence,Female,60+,71,43,28,67,4
2004,Urban,Jammu & Kashmir,Property Crime,Theft,Female,60+,9410,4201,5209,5911,3499
2006,Rural,Madhya Pradesh,Other Crimes,Fraud,Female,18-30,8961,6360,2601,7084,1877
2008,Urban,Telangana,Crime Against Men,Robbery,Male,60+,6163,4869,1294,5110,1053
2004,Rural,Manipur,Crime Against Women,Domestic Violence,Female,46-60,3043,1113,1930,2980,63
2003,Rural,Assam,Crime Against Children,Child Labor,Female,46-60,2248,1430,818,1459,789
2004,Rural,Maharashtra,Crime Against Men,Robbery,Female,60+,3003,1748,1255,2489,514
2005,Rural,Meghalaya,Other Crimes,Fraud,Male,60+,8703,7819,884,8313,390
2006,Rural,Haryana,Other Crimes,Drug Offense,Female,18-30,4434,294,4140,4032,402
2002,Urban,Haryana,Crime Against Children,Trafficking,Male,60+,1443,975,468,1105,338
2002,Rural,Himachal Pradesh,Other Crimes,Drug Offense,Male,18-30,5546,977,4569,2966,2580
2007,Urban,Tamil Nadu,Property Crime,Arson,Female,0-12,5504,2506,2998,4130,1374
2010,Urban,Kerala,Crime Against Women,Domestic Violence,Male,31-45,6457,4751,1706,6437,20
2001,Rural,Tripura,Crime Against Women,Domestic Violence,Male,46-60,7289,1275,6014,2100,5189
2005,Rural,Gujarat,Crime Against Children,Trafficking,Male,31-45,6229,3772,2457,4734,1495
2007,Rural,Goa,Crime Against Women,Dowry Deaths,Female,46-60,6385,679,5706,3062,3323
2001,Urban,Mizoram,Crime Against Men,Extortion,Male,0-12,5345,1096,4249,1678,3667
2004,Rural,Haryana,Crime Against Men,Extortion,Female,31-45,8486,6569,1917,7345,1141
2008,Urban,Telangana,Other Crimes,Corruption,Female,0-12,4617,1921,2696,4533,84
2009,Urban,Rajasthan,Crime Against Women,Molestation,Male,46-60,8683,8573,110,8577,106
2005,Rural,Bihar,Crime Against Men,Murder,Male,18-30,1859,250,1609,1218,641
2007,Rural,Jammu & Kashmir,Crime Against Children,Trafficking,Male,18-30,8346,1,8345,8034,312
2002,Urban,Chhattisgarh,Other Crimes,Corruption,Female,0-12,8540,4400,4140,4730,3810
2004,Rural,Arunachal Pradesh,Crime Against Children,Child Labor,Female,18-30,6250,3949,2301,5645,605
2006,Rural,Uttarakhand,Other Crimes,Drug Offense,Female,60+,739,434,305,611,128
2004,Urban,Odisha,Crime Against Men,Assault,Male,0-12,8249,2465,5784,5002,3247
2009,Rural,Tripura,Crime Against Children,Child Labor,Female,13-17,7506,2290,5216,4349,3157
2002,Urban,Gujarat,Property Crime,Burglary,Male,60+,5885,869,5016,5024,861
2005,Rural,Jammu & Kashmir,Crime Against Men,Extortion,Female,60+,6105,1354,4751,5099,1006
2006,Urban,Kerala,Property Crime,Vandalism,Female,60+,1200,826,374,965,235
2001,Urban,Punjab,Crime Against Men,Assault,Male,13-17,5205,4227,978,4363,842
2010,Urban,Arunachal Pradesh,Crime Against Women,Dowry Deaths,Male,46-60,9327,5465,3862,5998,3329
2004,Urban,Punjab,Other Crimes,Corruption,Male,46-60,8069,7556,513,7646,423
2003,Urban,Maharashtra,Crime Against Women,Domestic Violence,Male,31-45,5025,1449,3576,4058,967
2003,Urban,Uttarakhand,Other Crimes,Cyber Crime,Female,0-12,1167,524,643,1151,16
2009,Rural,Goa,Crime Against Children,Child Abuse,Female,0-12,5267,941,4326,3841,1426
2010,Urban,Telangana,Crime Against Children,Child Labor,Female,18-30,8022,523,7499,5318,2704
2004,Rural,Punjab,Property Crime,Burglary,Male,0-12,4572,128,4444,3421,1151
2003,Urban,West Bengal,Property Crime,Burglary,Female,18-30,6701,4072,2629,6234,467
2007,Urban,Rajasthan,Crime Against Men,Murder,Male,46-60,8087,6286,1801,7454,633
2007,Rural,Uttar Pradesh,Property Crime,Vandalism,Female,46-60,3446,413,3033,2850,596
2005,Urban,Tamil Nadu,Other Crimes,Fraud,Male,31-45,7780,3973,3807,5442,2338
2004,Urban,Gujarat,Crime Against Men,Extortion,Female,60+,1905,806,1099,1483,422
2001,Urban,Nagaland,Property Crime,Burglary,Male,18-30,7083,3549,3534,6082,1001
2005,Rural,Jharkhand,Crime Against Children,Child Labor,Female,0-12,604,50,554,567,37
2003,Urban,Bihar,Other Crimes,Cyber Crime,Male,0-12,3117,2975,142,3083,34
2002,Rural,Andhra Pradesh,Crime Against Men,Assault,Female,18-30,4718,4506,212,4515,203
2004,Rural,Jharkhand,Crime Against Children,Kidnapping,Male,60+,2334,1294,1040,1728,606
2007,Rural,Chhattisgarh,Other Crimes,Cyber Crime,Male,60+,988,714,274,790,198
2004,Rural,West Bengal,Crime Against Women,Molestation,Male,18-30,732,27,705,262,470
2005,Urban,Assam,Property Crime,Theft,Male,31-45,8618,2831,5787,4491,4127
2008,Rural,Tripura,Crime Against Children,Kidnapping,Male,60+,1860,535,1325,1188,672
2009,Urban,Jammu & Kashmir,Crime Against Women,Domestic Violence,Male,18-30,1172,493,679,1046,126
2006,Rural,Rajasthan,Crime Against Men,Robbery,Male,60+,4697,3441,1256,3987,710
2001,Rural,Goa,Crime Against Children,Child Labor,Male,31-45,677,255,422,575,102
2001,Rural,Madhya Pradesh,Crime Against Children,Trafficking,Male,60+,2525,1168,1357,1430,1095
2008,Urban,Sikkim,Crime Against Women,Rape,Female,13-17,4029,62,3967,3895,134
2007,Urban,Tripura,Property Crime,Theft,Female,31-45,3368,2329,1039,3222,146
2010,Rural,Jammu & Kashmir,Other Crimes,Fraud,Female,18-30,6187,2533,3654,4661,1526
2004,Rural,Arunachal Pradesh,Property Crime,Theft,Female,60+,5364,4990,374,5129,235
2008,Rural,Jharkhand,Crime Against Men,Assault,Male,18-30,8416,2902,5514,5019,3397
2001,Rural,Meghalaya,Crime Against Children,Child Abuse,Male,18-30,9304,6698,2606,9176,128
2008,Rural,Nagaland,Property Crime,Theft,Male,60+,2129,257,1872,1293,836
2002,Urban,Assam,Crime Against Children,Child Abuse,Female,60+,5095,1131,3964,1851,3244
2004,Urban,Madhya Pradesh,Crime Against Children,Child Labor,Female,60+,6486,2182,4304,4370,2116
2001,Urban,Jammu & Kashmir,Crime Against Men,Extortion,Female,60+,7835,3076,4759,6291,1544
2009,Urban,Bihar,Crime Against Men,Murder,Female,13-17,4223,1524,2699,4096,127
2006,Rural,Maharashtra,Crime Against Men,Extortion,Female,31-45,2155,2105,50,2108,47
2003,Urban,Nagaland,Crime Against Children,Kidnapping,Female,46-60,604,61,543,588,16
2002,Rural,Delhi,Crime Against Men,Murder,Male,0-12,3125,2552,573,2927,198
2008,Urban,Delhi,Crime Against Women,Domestic Violence,Male,31-45,8512,1559,6953,3005,5507
2007,Urban,Uttarakhand,Crime Against Men,Assault,Female,46-60,7445,6037,1408,6546,899
2005,Urban,Sikkim,Crime Against Children,Child Labor,Female,46-60,9864,2153,7711,4625,5239
2004,Urban,Himachal Pradesh,Crime Against Women,Dowry Deaths,Male,46-60,6103,4393,1710,5498,605
2006,Urban,Madhya Pradesh,Property Crime,Burglary,Female,13-17,9632,2162,7470,7606,2026
2008,Rural,Arunachal Pradesh,Crime Against Children,Child Abuse,Male,0-12,3862,2477,1385,3117,745
2004,Rural,Mizoram,Crime Against Men,Murder,Female,13-17,2485,2002,483,2031,454
2001,Urban,Jharkhand,Other Crimes,Cyber Crime,Male,0-12,6036,2905,3131,5003,1033
2005,Rural,Uttar Pradesh,Crime Against Women,Rape,Male,13-17,1189,1038,151,1039,150
2002,Urban,Telangana,Property Crime,Theft,Female,13-17,166,47,119,80,86
2003,Rural,Chhattisgarh,Property Crime,Theft,Female,0-12,1298,840,458,957,341
2008,Urban,Mizoram,Crime Against Men,Assault,Male,13-17,6371,6030,341,6327,44
2008,Urban,Goa,Crime Against Women,Dowry Deaths,Male,18-30,6674,1658,5016,4391,2283
2004,Urban,Tripura,Other Crimes,Cyber Crime,Male,13-17,8566,2930,5636,8023,543
2006,Urban,Tripura,Crime Against Men,Assault,Male,13-17,9010,3688,5322,6576,2434
2008,Rural,Assam,Crime Against Women,Molestation,Female,46-60,6913,6855,58,6908,5
2002,Urban,Madhya Pradesh,Crime Against Children,Kidnapping,Female,60+,3312,1180,2132,1644,1668
2002,Urban,Arunachal Pradesh,Crime Against Men,Murder,Male,60+,8836,7654,1182,8269,567
2007,Rural,Jharkhand,Other Crimes,Fraud,Female,0-12,722,423,299,701,21
2010,Urban,Bihar,Property Crime,Vandalism,Male,31-45,136,70,66,110,26
2010,Urban,Jammu & Kashmir,Crime Against Women,Domestic Violence,Female,46-60,8510,5104,3406,6613,1897
2007,Urban,Nagaland,Crime Against Men,Murder,Female,18-30,3207,527,2680,799,2408
2004,Rural,Karnataka,Crime Against Women,Rape,Female,0-12,257,22,235,120,137
2003,Rural,Gujarat,Other Crimes,Cyber Crime,Male,46-60,2135,1518,617,1808,327
2001,Rural,Odisha,Crime Against Women,Domestic Violence,Female,60+,9108,6482,2626,7483,1625
2003,Urban,Rajasthan,Crime Against Women,Rape,Female,0-12,1365,582,783,1168,197
2006,Rural,Uttarakhand,Crime Against Women,Molestation,Female,0-12,2545,146,2399,1710,835
2004,Urban,Jammu & Kashmir,Property Crime,Theft,Male,13-17,7787,26,7761,2522,5265
2008,Rural,Andhra Pradesh,Property Crime,Burglary,Female,60+,7615,7019,596,7044,571
2007,Rural,Himachal Pradesh,Crime Against Women,Molestation,Male,60+,7163,1520,5643,6372,791
2007,Rural,Jharkhand,Crime Against Men,Extortion,Male,0-12,1468,1082,386,1123,345
2005,Urban,Gujarat,Other Crimes,Corruption,Female,60+,9790,9245,545,9782,8
2001,Rural,Sikkim,Crime Against Men,Robbery,Male,0-12,9637,3128,6509,8535,1102
2005,Rural,Delhi,Property Crime,Theft,Female,60+,8690,425,8265,5933,2757
2004,Rural,West Bengal,Crime Against Men,Extortion,Male,0-12,4206,3852,354,4094,112
2008,Rural,Maharashtra,Crime Against Children,Kidnapping,Male,60+,4401,1021,3380,3433,968
2005,Rural,Delhi,Crime Against Women,Rape,Female,18-30,8432,7594,838,7747,685
2007,Urban,Odisha,Property Crime,Arson,Female,31-45,5192,2785,2407,2821,2371
2003,Rural,Maharashtra,Crime Against Children,Child Labor,Female,0-12,3258,2089,1169,2515,743
2008,Rural,Madhya Pradesh,Crime Against Children,Kidnapping,Male,13-17,8258,7117,1141,7612,646
2005,Urban,Madhya Pradesh,Crime Against Men,Robbery,Female,60+,1168,653,515,901,267
2003,Rural,Kerala,Crime Against Men,Extortion,Female,18-30,3872,114,3758,3436,436
2002,Rural,Delhi,Crime Against Men,Murder,Female,31-45,6788,1809,4979,6214,574
2007,Rural,Nagaland,Crime Against Women,Molestation,Male,60+,1746,1403,343,1710,36
2007,Rural,Jammu & Kashmir,Other Crimes,Corruption,Male,31-45,3729,2976,753,3600,129
2003,Rural,Goa,Property Crime,Burglary,Male,31-45,6771,1550,5221,2483,4288
2003,Rural,Sikkim,Crime Against Children,Child Abuse,Male,31-45,6706,940,5766,1330,5376
2009,Urban,Meghalaya,Other Crimes,Fraud,Female,0-12,324,241,83,265,59
2010,Urban,Arunachal Pradesh,Property Crime,Burglary,Female,46-60,3296,142,3154,2439,857
2002,Rural,Arunachal Pradesh,Crime Against Men,Extortion,Female,46-60,4223,1995,2228,3415,808
2010,Rural,Assam,Crime Against Women,Molestation,Female,60+,2594,1273,1321,2395,199
2004,Rural,Rajasthan,Property Crime,Theft,Female,18-30,3805,132,3673,266,3539
2008,Rural,Telangana,Other Crimes,Cyber Crime,Male,46-60,4280,3641,639,3878,402
2008,Urban,Rajasthan,Property Crime,Arson,Female,0-12,8677,1865,6812,2634,6043
2007,Rural,Goa,Property Crime,Vandalism,Female,60+,2311,435,1876,1985,326
2006,Rural,Tripura,Crime Against Children,Kidnapping,Male,60+,6122,330,5792,3831,2291
2003,Rural,West Bengal,Other Crimes,Cyber Crime,Female,18-30,1596,298,1298,1573,23
2010,Rural,Bihar,Crime Against Men,Robbery,Male,60+,9157,7637,1520,8402,755
2005,Urban,Delhi,Crime Against Children,Child Labor,Male,18-30,8908,735,8173,3721,5187
2006,Rural,Himachal Pradesh,Other Crimes,Fraud,Female,60+,7939,6555,1384,7064,875
2008,Urban,West Bengal,Crime Against Children,Trafficking,Female,31-45,3679,907,2772,2569,1110
2009,Urban,Manipur,Crime Against Women,Molestation,Male,0-12,4680,768,3912,2586,2094
2003,Urban,Meghalaya,Crime Against Men,Robbery,Female,46-60,1141,494,647,842,299
2008,Urban,Madhya Pradesh,Crime Against Women,Rape,Female,18-30,6429,4238,2191,5105,1324
2007,Rural,Punjab,Crime Against Children,Kidnapping,Male,31-45,2919,2116,803,2483,436
2006,Rural,Manipur,Property Crime,Arson,Male,0-12,4870,1509,3361,2572,2298
2007,Urban,Uttar Pradesh,Crime Against Women,Dowry Deaths,Female,13-17,6596,4282,2314,6062,534
2009,Urban,Goa,Crime Against Children,Kidnapping,Female,46-60,7367,4866,2501,5578,1789
2006,Rural,Manipur,Crime Against Women,Molestation,Male,31-45,7932,7566,366,7775,157
2006,Rural,Jammu & Kashmir,Crime Against Children,Child Abuse,Female,0-12,187,138,49,174,13
2002,Urban,Odisha,Crime Against Children,Kidnapping,Male,0-12,8982,4648,4334,7904,1078
2005,Urban,Himachal Pradesh,Other Crimes,Corruption,Male,18-30,2451,618,1833,1287,1164
2006,Rural,Sikkim,Crime Against Women,Rape,Female,46-60,3016,2276,740,2488,528
2002,Urban,Goa,Other Crimes,Fraud,Male,0-12,172,147,25,157,15
2005,Urban,Telangana,Property Crime,Vandalism,Male,0-12,2780,990,1790,1783,997
2003,Urban,Nagaland,Other Crimes,Cyber Crime,Female,0-12,2386,1420,966,1708,678
2004,Urban,Sikkim,Property Crime,Vandalism,Male,18-30,748,560,188,586,162
2006,Rural,Jharkhand,Crime Against Women,Molestation,Male,13-17,3841,3005,836,3606,235
2001,Rural,Rajasthan,Crime Against Women,Rape,Male,0-12,5962,3499,2463,5221,741
2004,Rural,Bihar,Crime Against Children,Child Abuse,Male,18-30,1820,114,1706,840,980
2004,Rural,Bihar,Other Crimes,Fraud,Male,60+,2668,911,1757,1138,1530
2010,Urban,Kerala,Crime Against Children,Child Labor,Female,31-45,2074,1446,628,1645,429
2010,Urban,Tamil Nadu,Property Crime,Burglary,Male,13-17,2891,893,1998,2828,63
2007,Urban,Arunachal Pradesh,Other Crimes,Cyber Crime,Male,46-60,4540,2054,2486,4017,523
2004,Urban,Karnataka,Crime Against Women,Rape,Male,13-17,6237,5316,921,5629,608
2008,Rural,Odisha,Crime Against Women,Rape,Male,0-12,9899,2198,7701,9167,732
2007,Urban,Himachal Pradesh,Other Crimes,Cyber Crime,Male,31-45,9883,4585,5298,5819,4064
2008,Rural,Tamil Nadu,Crime Against Children,Child Abuse,Male,46-60,5862,2968,2894,3381,2481
2001,Rural,Karnataka,Crime Against Women,Molestation,Female,13-17,5057,234,4823,1414,3643
2003,Urban,Chhattisgarh,Crime Against Women,Rape,Male,31-45,9307,3121,6186,3588,5719
2010,Urban,Uttarakhand,Property Crime,Theft,Female,18-30,5978,1028,4950,4117,1861
2003,Rural,Bihar,Property Crime,Burglary,Female,18-30,1508,1182,326,1507,1
2008,Urban,Jharkhand,Other Crimes,Fraud,Female,18-30,9911,5057,4854,9783,128
2006,Urban,Goa,Property Crime,Vandalism,Male,46-60,8153,7618,535,8040,113
2003,Urban,Haryana,Crime Against Women,Rape,Male,60+,1853,390,1463,1660,193
2009,Urban,Chhattisgarh,Crime Against Women,Rape,Male,31-45,54,40,14,48,6
2007,Rural,Rajasthan,Crime Against Children,Kidnapping,Male,31-45,6719,1723,4996,2092,4627
2005,Rural,Himachal Pradesh,Crime Against Women,Rape,Male,13-17,4215,3314,901,4162,53
2006,Rural,Assam,Other Crimes,Fraud,Female,18-30,4082,4003,79,4058,24
2006,Urban,Uttarakhand,Other Crimes,Cyber Crime,Female,18-30,5275,3207,2068,3523,1752
2009,Urban,Jammu & Kashmir,Other Crimes,Cyber Crime,Female,60+,8578,3894,4684,7392,1186
2002,Urban,Uttar Pradesh,Crime Against Men,Extortion,Male,0-12,2764,1959,805,2677,87
2004,Urban,Sikkim,Property Crime,Burglary,Male,60+,7513,2403,5110,6010,1503
2004,Urban,Uttar Pradesh,Crime Against Children,Trafficking,Male,0-12,3549,54,3495,1589,1960
2004,Rural,Himachal Pradesh,Crime Against Children,Child Labor,Female,46-60,5399,1429,3970,5047,352
2004,Rural,Madhya Pradesh,Crime Against Women,Molestation,Female,13-17,7048,6516,532,6802,246
2005,Urban,Karnataka,Crime Against Children,Child Labor,Female,13-17,130,31,99,43,87
2008,Urban,Goa,Property Crime,Vandalism,Male,0-12,616,328,288,419,197
2003,Rural,Tripura,Crime Against Women,Dowry Deaths,Male,18-30,5964,4880,1084,5030,934
2001,Rural,Telangana,Property Crime,Theft,Male,13-17,3393,9,3384,2268,1125
2001,Rural,Arunachal Pradesh,Crime Against Women,Rape,Female,0-12,6739,5690,1049,6252,487
2001,Rural,Bihar,Crime Against Children,Trafficking,Male,0-12,3426,929,2497,1890,1536
2009,Rural,Nagaland,Other Crimes,Fraud,Male,46-60,103,2,101,24,79
2004,Rural,Jharkhand,Property Crime,Vandalism,Female,46-60,3883,885,2998,3076,807
2005,Rural,Goa,Other Crimes,Corruption,Female,0-12,9781,8903,878,9593,188
2010,Rural,Meghalaya,Other Crimes,Cyber Crime,Male,60+,4145,2155,1990,3496,649
2001,Urban,Jharkhand,Property Crime,Burglary,Female,60+,6210,1475,4735,2550,3660
2010,Urban,Chhattisgarh,Other Crimes,Fraud,Female,13-17,6269,6160,109,6212,57
2010,Urban,Tamil Nadu,Crime Against Women,Rape,Female,13-17,1631,365,1266,1280,351
2009,Rural,Punjab,Crime Against Women,Molestation,Male,18-30,2642,0,2642,2466,176
2002,Rural,Delhi,Other Crimes,Corruption,Female,31-45,2337,888,1449,1785,552
2002,Rural,Tamil Nadu,Crime Against Women,Molestation,Female,31-45,4312,2693,1619,4135,177
2003,Rural,Sikkim,Crime Against Men,Extortion,Female,60+,4707,2093,2614,3598,1109
2009,Urban,Punjab,Crime Against Women,Dowry Deaths,Male,46-60,8122,174,7948,7294,828
2005,Urban,Chhattisgarh,Crime Against Children,Child Abuse,Male,18-30,7144,5350,1794,6594,550
2009,Urban,West Bengal,Crime Against Children,Kidnapping,Female,46-60,4982,912,4070,2854,2128
2002,Rural,Sikkim,Property Crime,Vandalism,Male,13-17,9847,1985,7862,4357,5490
2003,Urban,Sikkim,Crime Against Men,Extortion,Male,18-30,5619,2034,3585,3792,1827
2007,Urban,Jammu & Kashmir,Property Crime,Vandalism,Male,18-30,9959,4950,5009,6045,3914
2008,Rural,Telangana,Crime Against Men,Robbery,Female,13-17,9394,3845,5549,4699,4695
2002,Rural,Uttar Pradesh,Crime Against Men,Assault,Male,60+,4745,824,3921,2036,2709
2002,Rural,Gujarat,Crime Against Children,Child Labor,Female,60+,9610,5715,3895,8840,770
2003,Urban,Chhattisgarh,Crime Against Men,Assault,Female,0-12,527,121,406,281,246
2001,Urban,Andhra Pradesh,Property Crime,Burglary,Female,60+,5832,4346,1486,5818,14
2008,Rural,Chhattisgarh,Crime Against Women,Molestation,Male,60+,3944,966,2978,3880,64
2004,Urban,Bihar,Crime Against Children,Child Labor,Male,18-30,7004,6869,135,6952,52
2001,Urban,Tamil Nadu,Other Crimes,Fraud,Female,31-45,2013,435,1578,1086,927
2010,Urban,West Bengal,Property Crime,Vandalism,Female,18-30,1616,1226,390,1471,145
2002,Rural,Himachal Pradesh,Crime Against Women,Domestic Violence,Male,0-12,2596,1803,793,2031,565
2006,Urban,Haryana,Crime Against Women,Dowry Deaths,Male,0-12,1867,679,1188,866,1001
2005,Urban,Gujarat,Property Crime,Arson,Female,60+,4749,2680,2069,3227,1522
2009,Rural,Chhattisgarh,Crime Against Children,Child Labor,Female,18-30,6279,6005,274,6031,248
2010,Urban,Himachal Pradesh,Crime Against Men,Assault,Male,13-17,8717,3486,5231,6863,1854
2001,Urban,Meghalaya,Crime Against Women,Molestation,Female,31-45,7787,280,7507,2193,5594
2004,Rural,Punjab,Other Crimes,Corruption,Female,13-17,1410,475,935,1208,202
2004,Rural,Uttar Pradesh,Crime Against Men,Murder,Female,18-30,6716,5879,837,6035,681
2004,Rural,Uttarakhand,Crime Against Men,Robbery,Female,0-12,9366,4733,4633,7824,1542
2009,Urban,Goa,Crime Against Women,Molestation,Female,0-12,1967,725,1242,971,996
2007,Rural,Tripura,Crime Against Men,Robbery,Male,18-30,4775,3574,1201,4568,207
2002,Urban,West Bengal,Property Crime,Arson,Female,18-30,1138,448,690,1059,79
2001,Urban,Nagaland,Other Crimes,Corruption,Female,13-17,6703,3530,3173,4724,1979
2004,Urban,Mizoram,Crime Against Children,Trafficking,Female,60+,3519,1594,1925,1622,1897
2001,Urban,Gujarat,Property Crime,Vandalism,Male,46-60,2310,1021,1289,1853,457
2010,Urban,Maharashtra,Crime Against Women,Rape,Male,60+,7089,3274,3815,4010,3079
2004,Rural,Tamil Nadu,Crime Against Women,Molestation,Male,31-45,9941,4758,5183,5954,3987
2010,Rural,Mizoram,Other Crimes,Corruption,Female,13-17,5070,4858,212,5048,22
2006,Urban,Uttarakhand,Property Crime,Arson,Female,46-60,4831,957,3874,4267,564
2005,Urban,Meghalaya,Other Crimes,Drug Offense,Male,31-45,8639,1314,7325,4392,4247
2010,Urban,Tamil Nadu,Property Crime,Burglary,Male,60+,9125,2815,6310,7435,1690
2009,Urban,Arunachal Pradesh,Crime Against Women,Dowry Deaths,Female,60+,8149,6984,1165,8121,28
2001,Rural,Maharashtra,Crime Against Men,Murder,Male,46-60,4173,1022,3151,4130,43
2002,Rural,Sikkim,Crime Against Children,Trafficking,Male,18-30,2003,433,1570,1490,513
2008,Rural,Tripura,Crime Against Women,Domestic Violence,Female,13-17,8236,6792,1444,7768,468
2004,Urban,Chhattisgarh,Other Crimes,Cyber Crime,Male,13-17,5507,907,4600,2596,2911
2004,Urban,Tripura,Crime Against Men,Robbery,Male,18-30,7976,7936,40,7960,16
2010,Urban,Uttarakhand,Crime Against Men,Extortion,Female,0-12,1910,1413,497,1709,201
2007,Rural,West Bengal,Property Crime,Burglary,Female,31-45,6133,3545,2588,5893,240
2005,Rural,Telangana,Crime Against Men,Extortion,Male,46-60,7790,2778,5012,3699,4091
2009,Urban,Goa,Crime Against Children,Trafficking,Male,31-45,2787,2611,176,2652,135
2007,Rural,Arunachal Pradesh,Crime Against Men,Murder,Female,13-17,7236,5854,1382,6095,1141
2003,Rural,Rajasthan,Crime Against Women,Molestation,Male,31-45,2543,2466,77,2494,49
2007,Rural,West Bengal,Crime Against Women,Domestic Violence,Male,46-60,1789,1023,766,1388,401
2006,Rural,Andhra Pradesh,Property Crime,Vandalism,Male,46-60,5043,3776,1267,4306,737
2008,Urban,Punjab,Crime Against Men,Robbery,Female,18-30,8063,2416,5647,7209,854
2003,Rural,Jammu & Kashmir,Property Crime,Burglary,Female,46-60,8362,6116,2246,8158,204
2004,Rural,Jharkhand,Crime Against Children,Trafficking,Female,31-45,607,264,343,335,272
2010,Rural,Tamil Nadu,Other Crimes,Fraud,Female,31-45,9765,1268,8497,7634,2131
2006,Urban,Rajasthan,Crime Against Women,Domestic Violence,Female,46-60,6121,3086,3035,5876,245
2005,Rural,Manipur,Crime Against Children,Child Labor,Female,13-17,3701,3091,610,3474,227
2003,Urban,Mizoram,Crime Against Women,Domestic Violence,Female,31-45,9946,9300,646,9667,279
2007,Urban,Delhi,Crime Against Women,Molestation,Male,18-30,3549,3157,392,3303,246
2007,Rural,Maharashtra,Other Crimes,Cyber Crime,Female,0-12,5445,4992,453,5264,181
2002,Urban,Kerala,Crime Against Children,Kidnapping,Female,60+,1395,1266,129,1326,69
2006,Urban,West Bengal,Crime Against Children,Kidnapping,Male,46-60,7472,2823,4649,3376,4096
2006,Urban,Assam,Crime Against Men,Robbery,Male,0-12,1588,906,682,911,677
2005,Rural,Bihar,Other Crimes,Cyber Crime,Male,18-30,6317,2070,4247,5588,729
2001,Urban,Bihar,Crime Against Women,Dowry Deaths,Male,31-45,2454,1328,1126,2202,252
2003,Urban,Punjab,Property Crime,Burglary,Female,46-60,1871,472,1399,1087,784
2002,Urban,Tamil Nadu,Crime Against Men,Assault,Female,31-45,5208,5166,42,5168,40
2005,Rural,Telangana,Property Crime,Vandalism,Female,13-17,2172,1588,584,1879,293
2002,Urban,Telangana,Crime Against Children,Child Abuse,Male,46-60,7618,3599,4019,4288,3330
2004,Urban,Uttar Pradesh,Crime Against Children,Kidnapping,Female,0-12,2817,1479,1338,1742,1075
2001,Urban,West Bengal,Crime Against Children,Child Abuse,Female,60+,1173,743,430,1031,142
2008,Rural,Kerala,Crime Against Men,Murder,Female,0-12,8998,1721,7277,2110,6888
2002,Urban,Uttar Pradesh,Crime Against Children,Trafficking,Male,60+,411,388,23,394,17
2007,Urban,Andhra Pradesh,Crime Against Children,Trafficking,Male,60+,6051,3563,2488,4242,1809
2001,Rural,Chhattisgarh,Crime Against Women,Rape,Female,13-17,6421,195,6226,5148,1273
2009,Rural,Punjab,Crime Against Men,Extortion,Male,60+,5778,779,4999,3357,2421
2009,Rural,Jharkhand,Property Crime,Burglary,Female,13-17,9235,3149,6086,6854,2381
2007,Rural,Jammu & Kashmir,Crime Against Children,Trafficking,Male,46-60,1935,801,1134,1207,728
2008,Rural,Uttar Pradesh,Crime Against Women,Domestic Violence,Male,13-17,3849,2022,1827,2667,1182
2003,Rural,Bihar,Crime Against Children,Child Labor,Female,0-12,6169,5164,1005,5846,323
2002,Rural,Uttar Pradesh,Property Crime,Theft,Male,18-30,4451,38,4413,2835,1616
2001,Urban,Jammu & Kashmir,Crime Against Men,Assault,Female,31-45,8822,7855,967,8271,551
2006,Rural,Jharkhand,Crime Against Women,Dowry Deaths,Male,18-30,1292,151,1141,825,467
2006,Urban,Delhi,Crime Against Women,Rape,Female,31-45,963,600,363,733,230
2005,Rural,Telangana,Property Crime,Theft,Male,31-45,3644,2003,1641,2552,1092
2007,Rural,Madhya Pradesh,Crime Against Men,Extortion,Male,18-30,2773,1133,1640,1790,983
2008,Rural,Andhra Pradesh,Property Crime,Burglary,Male,18-30,2122,1104,1018,1724,398
2006,Urban,Manipur,Property Crime,Arson,Male,18-30,8341,5918,2423,6893,1448
2001,Rural,Maharashtra,Crime Against Men,Assault,Female,60+,5570,1239,4331,2774,2796
2010,Rural,Himachal Pradesh,Crime Against Women,Domestic Violence,Male,13-17,5105,2197,2908,3074,2031
2003,Rural,Jammu & Kashmir,Other Crimes,Cyber Crime,Female,13-17,9038,5821,3217,7048,1990
2005,Urban,Bihar,Other Crimes,Drug Offense,Male,46-60,4920,1421,3499,4623,297
2003,Rural,Bihar,Crime Against Women,Dowry Deaths,Female,0-12,9063,483,8580,2851,6212
2010,Rural,Nagaland,Crime Against Women,Rape,Female,18-30,6635,5763,872,6122,513
2006,Rural,Meghalaya,Crime Against Men,Assault,Male,31-45,3976,349,3627,1466,2510
2002,Urban,Manipur,Crime Against Men,Robbery,Male,60+,4129,20,4109,1882,2247
2005,Urban,Chhattisgarh,Other Crimes,Fraud,Male,46-60,6829,505,6324,4015,2814
2003,Urban,Kerala,Crime Against Women,Molestation,Male,0-12,3975,1218,2757,2522,1453
2010,Urban,Maharashtra,Crime Against Children,Kidnapping,Female,46-60,6936,1265,5671,1582,5354
2003,Urban,Telangana,Crime Against Women,Molestation,Male,18-30,144,127,17,144,0
2006,Rural,Himachal Pradesh,Crime Against Children,Kidnapping,Male,0-12,334,214,120,228,106
2003,Urban,Jharkhand,Crime Against Men,Murder,Female,46-60,8014,4926,3088,6913,1101
2007,Urban,Goa,Crime Against Children,Trafficking,Female,31-45,9983,1479,8504,5429,4554
2010,Urban,Maharashtra,Crime Against Children,Kidnapping,Female,46-60,298,284,14,293,5
2007,Rural,Arunachal Pradesh,Crime Against Women,Molestation,Female,60+,309,158,151,245,64
2005,Urban,Himachal Pradesh,Crime Against Children,Child Labor,Male,60+,2760,462,2298,1483,1277
2002,Rural,Assam,Other Crimes,Cyber Crime,Female,0-12,4486,3013,1473,3865,621
2001,Rural,West Bengal,Other Crimes,Fraud,Female,46-60,2832,1092,1740,1836,996
2001,Rural,Tripura,Crime Against Children,Child Labor,Female,31-45,2235,273,1962,931,1304
2006,Urban,Bihar,Crime Against Children,Kidnapping,Male,13-17,8107,6717,1390,7980,127
2004,Rural,Jharkhand,Crime Against Men,Robbery,Female,0-12,2991,2561,430,2733,258
2006,Urban,Uttarakhand,Crime Against Children,Child Labor,Female,46-60,1504,532,972,1332,172
2003,Rural,Meghalaya,Crime Against Children,Trafficking,Female,31-45,622,310,312,547,75
2008,Rural,Arunachal Pradesh,Other Crimes,Fraud,Male,13-17,1569,1369,200,1493,76
2006,Urban,Sikkim,Property Crime,Arson,Female,46-60,563,410,153,479,84
2005,Urban,Madhya Pradesh,Crime Against Men,Robbery,Female,18-30,6856,4047,2809,4473,2383
2003,Rural,Chhattisgarh,Property Crime,Vandalism,Female,31-45,6719,4487,2232,5820,899
2001,Rural,Uttar Pradesh,Crime Against Children,Child Labor,Male,0-12,8776,7695,1081,8534,242
2006,Rural,Maharashtra,Other Crimes,Corruption,Female,60+,9561,762,8799,4929,4632
2001,Rural,Delhi,Property Crime,Arson,Female,46-60,2753,556,2197,1200,1553
2003,Urban,Andhra Pradesh,Crime Against Women,Rape,Female,31-45,9460,817,8643,7267,2193
2006,Rural,Kerala,Crime Against Women,Domestic Violence,Male,0-12,7736,1801,5935,4829,2907
2007,Rural,Punjab,Crime Against Men,Murder,Male,0-12,8632,508,8124,8620,12
2004,Rural,Delhi,Crime Against Children,Child Labor,Male,18-30,5723,409,5314,3859,1864
2010,Rural,Uttar Pradesh,Crime Against Women,Domestic Violence,Male,18-30,8622,6710,1912,8010,612
2001,Urban,Andhra Pradesh,Crime Against Men,Assault,Female,13-17,9575,5072,4503,7570,2005
2005,Rural,Goa,Property Crime,Arson,Female,18-30,788,512,276,659,129
2007,Rural,Manipur,Other Crimes,Drug Offense,Female,0-12,398,301,97,389,9
2005,Urban,Haryana,Other Crimes,Fraud,Female,31-45,6870,3845,3025,6401,469
2010,Rural,Madhya Pradesh,Property Crime,Arson,Male,31-45,5949,2288,3661,4409,1540
2006,Urban,Mizoram,Other Crimes,Drug Offense,Male,13-17,9560,3200,6360,9504,56
2006,Rural,Nagaland,Crime Against Women,Molestation,Male,0-12,9956,7183,2773,7563,2393
2009,Urban,Jammu & Kashmir,Crime Against Women,Rape,Female,31-45,1019,83,936,890,129
2001,Rural,Karnataka,Other Crimes,Fraud,Female,46-60,7123,5536,1587,6937,186
2009,Urban,Rajasthan,Crime Against Men,Extortion,Male,31-45,3022,575,2447,1185,1837
2008,Urban,Sikkim,Property Crime,Vandalism,Male,31-45,3242,1103,2139,1253,1989
2001,Urban,Mizoram,Other Crimes,Corruption,Male,60+,3408,64,3344,1274,2134
2003,Urban,Manipur,Property Crime,Vandalism,Male,13-17,3406,1598,1808,2851,555
2010,Urban,Jammu & Kashmir,Property Crime,Burglary,Female,31-45,3706,3117,589,3320,386
2002,Rural,Himachal Pradesh,Property Crime,Vandalism,Male,31-45,566,388,178,470,96
2003,Urban,Maharashtra,Other Crimes,Corruption,Female,13-17,8511,5220,3291,5412,3099
2006,Urban,Chhattisgarh,Crime Against Women,Domestic Violence,Male,13-17,1624,372,1252,404,1220
2007,Rural,Himachal Pradesh,Crime Against Children,Child Labor,Male,13-17,6350,2367,3983,4853,1497
2008,Rural,Uttarakhand,Property Crime,Vandalism,Male,60+,9252,5290,3962,6576,2676
2005,Urban,Sikkim,Crime Against Men,Robbery,Male,31-45,6736,3093,3643,3256,3480
2002,Urban,Madhya Pradesh,Other Crimes,Drug Offense,Female,0-12,2768,300,2468,1964,804
2002,Rural,Uttarakhand,Other Crimes,Fraud,Male,18-30,7552,6563,989,7322,230
2003,Urban,Madhya Pradesh,Crime Against Women,Domestic Violence,Male,0-12,2552,2112,440,2411,141
2010,Urban,Meghalaya,Crime Against Children,Child Labor,Male,0-12,9108,783,8325,8894,214
2007,Urban,Jammu & Kashmir,Crime Against Women,Molestation,Male,46-60,5651,2602,3049,3182,2469
2007,Rural,Chhattisgarh,Property Crime,Arson,Female,46-60,3346,246,3100,3173,173
2001,Rural,West Bengal,Crime Against Women,Molestation,Male,31-45,9276,4707,4569,8277,999
2009,Urban,Jammu & Kashmir,Crime Against Women,Dowry Deaths,Female,0-12,3908,3742,166,3869,39
2009,Rural,Jammu & Kashmir,Crime Against Men,Robbery,Female,13-17,2294,1262,1032,1455,839
2007,Rural,Uttarakhand,Other Crimes,Cyber Crime,Female,46-60,3834,3402,432,3674,160
2009,Urban,Assam,Other Crimes,Fraud,Male,46-60,6338,551,5787,2028,4310
2008,Urban,West Bengal,Property Crime,Burglary,Male,60+,671,95,576,155,516
2007,Rural,Madhya Pradesh,Crime Against Women,Rape,Female,60+,6536,6181,355,6343,193
2007,Rural,Tamil Nadu,Crime Against Children,Child Labor,Male,13-17,7198,6759,439,7155,43
2004,Rural,Maharashtra,Other Crimes,Cyber Crime,Female,0-12,2875,2170,705,2373,502
2010,Rural,Rajasthan,Crime Against Men,Extortion,Female,0-12,4726,1390,3336,1445,3281
2003,Rural,Kerala,Property Crime,Vandalism,Female,13-17,2304,1129,1175,1232,1072
2002,Urban,Odisha,Property Crime,Burglary,Female,60+,3770,2402,1368,2932,838
2006,Rural,Bihar,Crime Against Women,Rape,Male,0-12,255,232,23,254,1
2007,Urban,Himachal Pradesh,Property Crime,Burglary,Male,31-45,1515,1186,329,1446,69
2007,Urban,Kerala,Crime Against Women,Molestation,Female,13-17,1647,852,795,981,666
2004,Rural,Rajasthan,Crime Against Men,Assault,Male,18-30,4124,1390,2734,1394,2730
2006,Urban,Jammu & Kashmir,Other Crimes,Drug Offense,Female,46-60,5799,2815,2984,3550,2249
2009,Rural,Telangana,Crime Against Women,Dowry Deaths,Female,31-45,8831,358,8473,4195,4636
2010,Urban,Bihar,Crime Against Men,Robbery,Female,46-60,8602,563,8039,7735,867
2010,Urban,Manipur,Property Crime,Theft,Male,13-17,8254,3747,4507,5400,2854
2001,Urban,Jharkhand,Crime Against Women,Domestic Violence,Male,31-45,2227,973,1254,1239,988
2003,Rural,Karnataka,Property Crime,Burglary,Male,13-17,6509,966,5543,3608,2901
2003,Rural,Andhra Pradesh,Crime Against Women,Domestic Violence,Female,0-12,7934,5205,2729,7130,804
2003,Rural,Madhya Pradesh,Crime Against Children,Child Abuse,Male,31-45,3845,1266,2579,2223,1622
2009,Rural,Sikkim,Other Crimes,Corruption,Female,31-45,3186,1882,1304,2802,384
2004,Rural,Uttarakhand,Crime Against Women,Domestic Violence,Male,13-17,757,481,276,507,250
2008,Urban,Andhra Pradesh,Crime Against Women,Rape,Female,18-30,6075,894,5181,3406,2669
2005,Rural,Meghalaya,Crime Against Children,Child Labor,Male,60+,809,398,411,714,95
2010,Rural,Gujarat,Property Crime,Arson,Male,13-17,8058,6689,1369,6815,1243
2010,Urban,Mizoram,Crime Against Children,Child Abuse,Male,18-30,3841,3230,611,3280,561
2008,Urban,Punjab,Crime Against Men,Assault,Female,46-60,6637,4331,2306,5518,1119
2004,Rural,Chhattisgarh,Crime Against Men,Extortion,Female,13-17,6545,1097,5448,4696,1849
2010,Rural,Nagaland,Crime Against Men,Extortion,Female,46-60,6892,3238,3654,6082,810
2006,Rural,Uttar Pradesh,Crime Against Men,Murder,Male,18-30,1163,268,895,590,573
2004,Rural,Arunachal Pradesh,Property Crime,Theft,Female,31-45,2368,185,2183,2080,288
2004,Rural,Uttarakhand,Crime Against Men,Robbery,Female,60+,5226,2845,2381,4276,950
2002,Urban,Kerala,Crime Against Men,Murder,Male,0-12,1167,538,629,887,280
2002,Rural,Jammu & Kashmir,Crime Against Women,Domestic Violence,Male,13-17,3018,2426,592,2452,566
2004,Urban,Meghalaya,Crime Against Children,Child Labor,Male,46-60,1874,522,1352,1304,570
2009,Rural,Himachal Pradesh,Other Crimes,Fraud,Female,0-12,5294,1253,4041,1582,3712
2005,Rural,Haryana,Crime Against Women,Rape,Female,13-17,3425,1243,2182,1648,1777
2009,Rural,Gujarat,Crime Against Men,Robbery,Male,60+,5345,4609,736,5290,55
2003,Rural,Andhra Pradesh,Other Crimes,Corruption,Male,31-45,6756,5037,1719,6293,463
2010,Rural,Nagaland,Property Crime,Vandalism,Male,13-17,3990,3852,138,3959,31
2010,Urban,Arunachal Pradesh,Crime Against Men,Extortion,Male,0-12,5544,2353,3191,4045,1499
2002,Rural,Karnataka,Crime Against Men,Robbery,Female,0-12,988,30,958,234,754
2002,Rural,Tamil Nadu,Property Crime,Theft,Male,60+,6225,903,5322,3446,2779
2001,Rural,Goa,Property Crime,Arson,Male,13-17,7652,3922,3730,5001,2651
2005,Urban,Uttar Pradesh,Crime Against Women,Rape,Male,13-17,916,405,511,803,113
2005,Rural,Manipur,Other Crimes,Drug Offense,Male,46-60,5982,2467,3515,3174,2808
2002,Rural,Assam,Crime Against Women,Dowry Deaths,Female,31-45,4036,2676,1360,2812,1224
2001,Urban,Rajasthan,Crime Against Women,Dowry Deaths,Female,46-60,832,493,339,723,109
2006,Urban,Gujarat,Crime Against Men,Extortion,Female,31-45,8652,3395,5257,6310,2342
2001,Rural,Delhi,Property Crime,Vandalism,Female,31-45,3991,348,3643,1046,2945
2005,Rural,Uttarakhand,Property Crime,Vandalism,Female,18-30,5197,2989,2208,3237,1960
2006,Rural,Karnataka,Property Crime,Arson,Female,60+,4750,1686,3064,3208,1542
2004,Rural,Chhattisgarh,Property Crime,Arson,Male,46-60,8531,2515,6016,7317,1214
2009,Urban,Maharashtra,Crime Against Children,Trafficking,Male,13-17,4529,3142,1387,4094,435
2004,Rural,Madhya Pradesh,Crime Against Children,Child Abuse,Male,46-60,4741,1782,2959,2106,2635
2009,Rural,Telangana,Other Crimes,Cyber Crime,Male,18-30,4740,2230,2510,2742,1998
2002,Rural,Bihar,Crime Against Women,Domestic Violence,Female,0-12,5739,2650,3089,4957,782
2006,Rural,Himachal Pradesh,Other Crimes,Fraud,Male,46-60,2180,1389,791,2115,65
2003,Urban,Karnataka,Crime Against Children,Child Abuse,Male,31-45,9235,2570,6665,8643,592
2005,Urban,Nagaland,Crime Against Men,Extortion,Male,60+,7321,5875,1446,6663,658
2001,Rural,Chhattisgarh,Crime Against Women,Molestation,Female,46-60,8739,2830,5909,3956,4783
2005,Urban,Telangana,Crime Against Women,Rape,Male,18-30,8772,1739,7033,1920,6852
2004,Urban,Arunachal Pradesh,Property Crime,Vandalism,Male,46-60,5094,4619,475,4828,266
2002,Urban,Rajasthan,Property Crime,Arson,Female,31-45,7731,3296,4435,5719,2012
2009,Rural,Madhya Pradesh,Crime Against Women,Molestation,Female,0-12,6381,5561,820,5807,574
2010,Rural,Nagaland,Crime Against Men,Murder,Male,60+,7235,2743,4492,6894,341
2009,Urban,Delhi,Crime Against Children,Child Labor,Female,60+,1916,317,1599,1085,831
2006,Urban,Tamil Nadu,Property Crime,Burglary,Male,0-12,2927,1020,1907,2567,360
2004,Rural,Bihar,Crime Against Children,Trafficking,Female,46-60,9115,5204,3911,5510,3605
2004,Urban,Assam,Property Crime,Vandalism,Female,13-17,7530,4834,2696,6914,616
2008,Urban,Tripura,Property Crime,Vandalism,Male,46-60,269,226,43,268,1
2005,Rural,Rajasthan,Property Crime,Theft,Female,18-30,6990,4993,1997,5153,1837
2003,Rural,Jharkhand,Crime Against Women,Dowry Deaths,Female,18-30,5136,1996,3140,2529,2607
2004,Urban,Uttar Pradesh,Other Crimes,Cyber Crime,Female,46-60,9302,1358,7944,2875,6427
2005,Rural,Punjab,Property Crime,Vandalism,Male,31-45,5776,3925,1851,4021,1755
2009,Urban,Meghalaya,Other Crimes,Drug Offense,Male,18-30,8407,5960,2447,6055,2352
2009,Rural,Maharashtra,Crime Against Men,Robbery,Male,31-45,5167,3873,1294,4878,289
2002,Rural,Uttar Pradesh,Crime Against Children,Child Labor,Male,60+,1451,1261,190,1437,14
2001,Urban,Haryana,Other Crimes,Cyber Crime,Female,0-12,8901,1835,7066,2283,6618
2010,Rural,Delhi,Other Crimes,Drug Offense,Male,31-45,2444,2054,390,2174,270
2003,Urban,Chhattisgarh,Crime Against Women,Dowry Deaths,Female,0-12,2727,69,2658,2123,604
2006,Rural,Telangana,Crime Against Children,Trafficking,Female,13-17,5707,2430,3277,4096,1611
2007,Urban,West Bengal,Crime Against Men,Murder,Male,60+,5513,251,5262,5240,273
2009,Rural,Uttar Pradesh,Other Crimes,Corruption,Female,18-30,2073,1624,449,1673,400
2010,Rural,Jharkhand,Crime Against Children,Trafficking,Male,0-12,8034,1811,6223,6662,1372
2003,Urban,Himachal Pradesh,Property Crime,Arson,Female,31-45,1053,710,343,913,140
2010,Urban,Chhattisgarh,Other Crimes,Fraud,Male,60+,6094,2429,3665,4252,1842
2004,Urban,Goa,Other Crimes,Fraud,Male,0-12,3594,2690,904,2913,681
2005,Urban,Assam,Other Crimes,Cyber Crime,Male,13-17,2944,1004,1940,2549,395
2010,Rural,Maharashtra,Crime Against Women,Rape,Female,13-17,1089,52,1037,206,883
2004,Rural,Rajasthan,Crime Against Children,Child Labor,Female,13-17,6652,2036,4616,3244,3408
2002,Rural,Jharkhand,Crime Against Children,Child Abuse,Male,18-30,6985,5292,1693,5657,1328
2002,Rural,Tripura,Other Crimes,Cyber Crime,Male,31-45,8500,6350,2150,6869,1631
2007,Rural,Uttar Pradesh,Crime Against Women,Rape,Female,13-17,5736,4737,999,4858,878
2007,Urban,Delhi,Crime Against Men,Extortion,Male,31-45,9447,2495,6952,7389,2058
2009,Rural,Odisha,Property Crime,Burglary,Male,60+,2563,964,1599,2063,500
2007,Urban,Uttar Pradesh,Crime Against Women,Dowry Deaths,Male,60+,2055,1688,367,1720,335
2003,Rural,Kerala,Crime Against Women,Molestation,Male,31-45,4912,2893,2019,4852,60
2010,Urban,Nagaland,Property Crime,Burglary,Male,31-45,9177,5647,3530,8073,1104
2004,Rural,Odisha,Crime Against Men,Murder,Male,31-45,8373,8295,78,8325,48
2010,Urban,Manipur,Other Crimes,Corruption,Male,46-60,2895,840,2055,2403,492
2003,Urban,Meghalaya,Other Crimes,Cyber Crime,Female,31-45,1367,1137,230,1299,68
2005,Urban,Jharkhand,Other Crimes,Cyber Crime,Male,18-30,2481,1175,1306,1439,1042
2004,Rural,Andhra Pradesh,Crime Against Women,Rape,Male,46-60,2708,521,2187,975,1733
2009,Urban,Chhattisgarh,Property Crime,Arson,Female,46-60,6562,4742,1820,5956,606
2008,Rural,Haryana,Property Crime,Burglary,Female,0-12,5418,1444,3974,2259,3159
2010,Urban,Gujarat,Crime Against Men,Assault,Male,13-17,1510,553,957,1476,34
2004,Rural,Mizoram,Crime Against Children,Kidnapping,Male,0-12,3298,3047,251,3202,96
2007,Urban,Nagaland,Other Crimes,Fraud,Male,0-12,5050,1122,3928,4568,482
2005,Rural,Maharashtra,Property Crime,Theft,Female,60+,3033,541,2492,1215,1818
2001,Rural,Haryana,Other Crimes,Fraud,Male,13-17,667,0,667,264,403
2007,Rural,West Bengal,Crime Against Women,Dowry Deaths,Female,0-12,512,111,401,181,331
2002,Urban,Punjab,Crime Against Women,Molestation,Female,18-30,4369,4179,190,4296,73
2008,Urban,Madhya Pradesh,Other Crimes,Drug Offense,Male,46-60,2661,2568,93,2647,14
2002,Rural,Goa,Crime Against Men,Robbery,Male,0-12,288,240,48,286,2
2005,Urban,Kerala,Crime Against Women,Rape,Male,46-60,6694,6337,357,6517,177
2007,Urban,Punjab,Other Crimes,Fraud,Female,13-17,2645,992,1653,1463,1182
2010,Urban,Rajasthan,Property Crime,Theft,Female,31-45,4880,2170,2710,2565,2315
2002,Rural,Assam,Property Crime,Burglary,Male,31-45,1007,167,840,630,377
2001,Rural,Madhya Pradesh,Crime Against Women,Domestic Violence,Female,46-60,7406,1511,5895,2676,4730
2007,Rural,Meghalaya,Crime Against Women,Dowry Deaths,Male,46-60,7025,6035,990,6445,580
2009,Rural,Manipur,Other Crimes,Fraud,Male,60+,3380,3207,173,3301,79
2007,Rural,Jammu & Kashmir,Property Crime,Theft,Male,18-30,1897,595,1302,881,1016
2005,Urban,Madhya Pradesh,Property Crime,Theft,Male,13-17,6569,821,5748,4334,2235
2002,Rural,West Bengal,Crime Against Women,Rape,Male,13-17,4865,620,4245,4112,753
2007,Urban,Haryana,Crime Against Men,Assault,Male,18-30,6849,4786,2063,5648,1201
2004,Urban,Karnataka,Property Crime,Arson,Female,31-45,595,31,564,378,217
2010,Rural,Punjab,Other Crimes,Cyber Crime,Female,60+,5523,2712,2811,4179,1344
2003,Rural,Himachal Pradesh,Property Crime,Burglary,Male,0-12,6391,3980,2411,6066,325
2004,Rural,Rajasthan,Crime Against Women,Molestation,Male,31-45,6425,3389,3036,5528,897
2001,Urban,West Bengal,Property Crime,Arson,Female,31-45,7301,5302,1999,6729,572
2005,Rural,Manipur,Property Crime,Burglary,Male,31-45,6635,4795,1840,6460,175
2007,Rural,Haryana,Property Crime,Burglary,Male,0-12,6627,2504,4123,3411,3216
2003,Urban,Nagaland,Property Crime,Theft,Male,31-45,9174,6379,2795,6606,2568
2003,Rural,Jammu & Kashmir,Crime Against Women,Dowry Deaths,Male,31-45,7107,4894,2213,5902,1205
2009,Urban,Rajasthan,Crime Against Men,Robbery,Male,60+,8495,3955,4540,8085,410
2007,Urban,Gujarat,Crime Against Men,Robbery,Male,60+,2295,331,1964,646,1649
2002,Urban,Madhya Pradesh,Property Crime,Vandalism,Female,13-17,7349,6970,379,7276,73
2010,Rural,Assam,Crime Against Children,Child Labor,Male,46-60,644,566,78,621,23
2010,Rural,Karnataka,Crime Against Men,Murder,Female,13-17,8073,7899,174,8044,29
2007,Urban,Himachal Pradesh,Crime Against Men,Assault,Male,46-60,784,188,596,407,377
2009,Urban,Meghalaya,Crime Against Men,Assault,Male,46-60,6966,643,6323,3934,3032
2009,Rural,Uttarakhand,Crime Against Women,Domestic Violence,Female,18-30,7841,4807,3034,5988,1853
2007,Rural,Tripura,Other Crimes,Cyber Crime,Male,31-45,7663,3967,3696,4381,3282
2001,Urban,Himachal Pradesh,Crime Against Women,Rape,Male,18-30,9556,8078,1478,9373,183
2006,Urban,West Bengal,Other Crimes,Corruption,Female,13-17,369,241,128,281,88
2009,Urban,Uttarakhand,Property Crime,Theft,Female,31-45,5929,1208,4721,3595,2334
2010,Urban,Manipur,Crime Against Children,Trafficking,Male,60+,7651,395,7256,3050,4601
2003,Urban,Sikkim,Other Crimes,Corruption,Male,0-12,5789,2374,3415,5655,134
2001,Urban,Rajasthan,Crime Against Children,Child Labor,Female,46-60,3000,1793,1207,2523,477
2008,Rural,Arunachal Pradesh,Crime Against Men,Assault,Female,46-60,8719,4802,3917,4927,3792
2001,Rural,Punjab,Property Crime,Burglary,Female,46-60,9322,6520,2802,7411,1911
2001,Urban,Odisha,Property Crime,Arson,Male,46-60,3391,1507,1884,2569,822
2010,Urban,Assam,Other Crimes,Cyber Crime,Male,31-45,96,95,1,95,1
2009,Urban,Tamil Nadu,Crime Against Men,Extortion,Male,31-45,1297,872,425,1006,291
2010,Rural,Odisha,Crime Against Women,Rape,Female,0-12,6213,5761,452,5821,392
2008,Rural,Arunachal Pradesh,Other Crimes,Corruption,Female,60+,223,201,22,222,1
2009,Rural,Kerala,Crime Against Men,Robbery,Female,31-45,703,606,97,684,19
2009,Rural,Bihar,Crime Against Men,Murder,Male,46-60,633,534,99,550,83
2010,Urban,Maharashtra,Crime Against Men,Robbery,Female,13-17,1381,182,1199,280,1101
2006,Urban,Assam,Crime Against Men,Robbery,Female,60+,6250,1928,4322,3924,2326
2010,Urban,Punjab,Crime Against Children,Child Labor,Female,46-60,2716,506,2210,1571,1145
2006,Rural,Mizoram,Other Crimes,Fraud,Male,18-30,4164,411,3753,3717,447
2006,Urban,Jammu & Kashmir,Other Crimes,Drug Offense,Female,13-17,3890,720,3170,3876,14
2003,Rural,Gujarat,Other Crimes,Cyber Crime,Male,31-45,3802,1752,2050,3471,331
2005,Urban,Assam,Other Crimes,Corruption,Male,13-17,1052,357,695,660,392
2010,Rural,Madhya Pradesh,Crime Against Women,Molestation,Male,60+,8029,6005,2024,6633,1396
2006,Rural,Sikkim,Crime Against Children,Kidnapping,Male,46-60,7694,7544,150,7582,112
2004,Urban,Meghalaya,Crime Against Children,Child Labor,Male,18-30,1011,745,266,804,207
2001,Rural,Arunachal Pradesh,Other Crimes,Fraud,Female,31-45,3623,1568,2055,3164,459
2009,Rural,Madhya Pradesh,Crime Against Children,Kidnapping,Female,18-30,8533,3813,4720,5353,3180
2004,Urban,Odisha,Property Crime,Arson,Male,31-45,2486,1749,737,1825,661
2001,Rural,Haryana,Crime Against Children,Child Abuse,Female,60+,9268,336,8932,353,8915
2002,Urban,Uttarakhand,Crime Against Children,Kidnapping,Female,13-17,8698,1931,6767,6644,2054
2010,Urban,Mizoram,Other Crimes,Fraud,Female,31-45,8385,8064,321,8320,65
2006,Urban,Odisha,Property Crime,Vandalism,Male,31-45,3037,1921,1116,3003,34
2005,Urban,Jharkhand,Other Crimes,Fraud,Female,31-45,2449,2434,15,2448,1
2005,Urban,Tripura,Other Crimes,Fraud,Female,0-12,1357,410,947,1350,7
2008,Urban,Chhattisgarh,Crime Against Children,Child Labor,Male,31-45,693,437,256,505,188
2003,Rural,Chhattisgarh,Other Crimes,Corruption,Female,18-30,3644,3057,587,3252,392
2003,Rural,Manipur,Crime Against Women,Domestic Violence,Female,18-30,310,130,180,305,5
2002,Rural,Bihar,Crime Against Men,Murder,Male,13-17,9268,2405,6863,7146,2122
2004,Rural,Haryana,Crime Against Children,Trafficking,Male,31-45,5908,4093,1815,4632,1276
2002,Urban,Meghalaya,Crime Against Children,Trafficking,Female,31-45,920,371,549,814,106
2007,Rural,Uttar Pradesh,Crime Against Men,Murder,Male,60+,1580,901,679,1355,225
2009,Rural,Uttar Pradesh,Property Crime,Burglary,Female,60+,2300,297,2003,2095,205
2006,Rural,Mizoram,Other Crimes,Fraud,Male,13-17,7846,1166,6680,3734,4112
2001,Rural,Goa,Crime Against Men,Assault,Male,60+,6237,5260,977,5495,742
2002,Urban,Bihar,Other Crimes,Drug Offense,Male,46-60,6311,1737,4574,3665,2646
2010,Rural,Jharkhand,Other Crimes,Drug Offense,Female,18-30,6189,3487,2702,4887,1302
2005,Rural,Odisha,Crime Against Men,Murder,Female,31-45,2286,2160,126,2162,124
2008,Rural,Chhattisgarh,Property Crime,Burglary,Female,18-30,7541,3173,4368,5649,1892
2004,Urban,Haryana,Crime Against Men,Murder,Female,0-12,4429,2694,1735,2995,1434
2001,Rural,Karnataka,Crime Against Children,Child Labor,Male,0-12,9579,9557,22,9565,14
2003,Urban,Himachal Pradesh,Crime Against Children,Kidnapping,Female,13-17,5969,3366,2603,4004,1965
2006,Rural,Rajasthan,Crime Against Women,Rape,Male,0-12,688,40,648,91,597
2008,Urban,Punjab,Crime Against Men,Murder,Female,46-60,3483,1508,1975,1953,1530
2006,Urban,Manipur,Crime Against Men,Murder,Male,46-60,4538,3097,1441,3735,803
2006,Urban,Punjab,Crime Against Men,Extortion,Male,18-30,9186,496,8690,4287,4899
2004,Rural,Madhya Pradesh,Property Crime,Vandalism,Male,46-60,1284,1098,186,1231,53
2006,Urban,West Bengal,Crime Against Children,Child Labor,Female,0-12,9412,5970,3442,9029,383
2008,Rural,Himachal Pradesh,Other Crimes,Corruption,Female,13-17,488,188,300,333,155
2001,Rural,Madhya Pradesh,Crime Against Children,Trafficking,Male,18-30,9575,7229,2346,7842,1733
2006,Rural,Madhya Pradesh,Crime Against Men,Assault,Male,13-17,2875,1184,1691,2473,402
2010,Urban,Punjab,Property Crime,Burglary,Female,0-12,6509,750,5759,5213,1296
2010,Rural,Telangana,Other Crimes,Fraud,Female,13-17,7296,5766,1530,5860,1436
2003,Urban,Meghalaya,Crime Against Men,Assault,Male,46-60,3149,1766,1383,2755,394
2007,Urban,Uttarakhand,Crime Against Children,Child Labor,Female,13-17,6765,6063,702,6585,180
2009,Rural,Punjab,Property Crime,Theft,Female,60+,4670,1174,3496,3997,673
2006,Rural,Manipur,Crime Against Women,Dowry Deaths,Female,60+,2587,1075,1512,1535,1052
2005,Urban,Jammu & Kashmir,Other Crimes,Corruption,Male,18-30,5234,1471,3763,5074,160
2009,Rural,Chhattisgarh,Crime Against Women,Rape,Female,46-60,6494,179,6315,1549,4945
2004,Rural,Maharashtra,Property Crime,Arson,Male,31-45,4947,3582,1365,4226,721
2004,Urban,Assam,Crime Against Children,Kidnapping,Male,46-60,8286,290,7996,6557,1729
2009,Urban,Meghalaya,Crime Against Women,Dowry Deaths,Male,60+,2258,1620,638,1953,305
2006,Urban,Tamil Nadu,Crime Against Men,Extortion,Male,60+,6616,3652,2964,5388,1228
2010,Urban,Rajasthan,Crime Against Men,Murder,Male,60+,5855,4255,1600,5330,525
2005,Rural,Madhya Pradesh,Property Crime,Arson,Male,31-45,8180,7595,585,7858,322
2006,Rural,Madhya Pradesh,Crime Against Women,Domestic Violence,Female,13-17,6694,3281,3413,5779,915
2003,Urban,West Bengal,Crime Against Children,Child Abuse,Male,31-45,661,313,348,444,217
2010,Urban,Delhi,Property Crime,Burglary,Male,31-45,7381,5574,1807,6655,726
2002,Urban,Goa,Other Crimes,Fraud,Female,13-17,9388,5029,4359,7830,1558
2005,Rural,Assam,Crime Against Women,Domestic Violence,Male,60+,8607,3082,5525,8285,322
2009,Urban,Jharkhand,Crime Against Women,Domestic Violence,Female,60+,1300,897,403,1225,75
2010,Rural,Rajasthan,Crime Against Men,Extortion,Male,46-60,8609,6095,2514,7259,1350
2010,Urban,Chhattisgarh,Other Crimes,Corruption,Male,18-30,1826,1719,107,1777,49
2002,Urban,Punjab,Property Crime,Arson,Female,46-60,9887,7501,2386,7782,2105
2004,Urban,Telangana,Crime Against Children,Trafficking,Male,60+,5191,4661,530,4783,408
2009,Rural,Telangana,Crime Against Women,Molestation,Female,31-45,2562,2092,470,2216,346
2010,Rural,Bihar,Crime Against Women,Domestic Violence,Male,0-12,7306,182,7124,4666,2640
2009,Rural,Uttarakhand,Other Crimes,Cyber Crime,Female,0-12,808,693,115,797,11
2002,Urban,Mizoram,Other Crimes,Fraud,Female,13-17,9786,7597,2189,8574,1212
2002,Urban,Maharashtra,Crime Against Men,Murder,Female,18-30,5225,2084,3141,3352,1873
2001,Urban,Andhra Pradesh,Crime Against Children,Kidnapping,Female,46-60,200,12,188,158,42
2007,Rural,Assam,Crime Against Women,Dowry Deaths,Female,60+,4568,3265,1303,3873,695
2002,Urban,Gujarat,Crime Against Children,Child Labor,Male,0-12,7415,6726,689,6789,626
2004,Urban,Punjab,Other Crimes,Fraud,Female,18-30,8475,8465,10,8468,7
2006,Urban,Gujarat,Other Crimes,Fraud,Female,18-30,4968,3900,1068,4965,3
2003,Rural,Mizoram,Other Crimes,Drug Offense,Male,13-17,7985,4774,3211,6721,1264
2006,Urban,Uttarakhand,Property Crime,Burglary,Male,31-45,1821,1105,716,1411,410
2005,Urban,Telangana,Crime Against Men,Extortion,Female,46-60,5469,675,4794,4728,741
2010,Rural,Manipur,Crime Against Women,Rape,Male,13-17,6709,131,6578,3366,3343
2003,Rural,Kerala,Other Crimes,Cyber Crime,Female,18-30,6701,5820,881,6324,377
2004,Urban,Manipur,Property Crime,Burglary,Female,60+,6425,1967,4458,3875,2550
2007,Rural,Punjab,Other Crimes,Drug Offense,Female,31-45,4164,475,3689,671,3493
2005,Urban,Manipur,Property Crime,Burglary,Male,13-17,7161,4402,2759,5004,2157
2005,Rural,Punjab,Crime Against Children,Trafficking,Female,0-12,324,181,143,263,61
2009,Urban,Mizoram,Crime Against Men,Murder,Female,60+,9918,7024,2894,8789,1129
2006,Urban,Uttarakhand,Crime Against Men,Extortion,Male,46-60,3524,2851,673,2888,636
2010,Urban,Meghalaya,Property Crime,Burglary,Female,60+,8763,3998,4765,7548,1215
2009,Urban,Andhra Pradesh,Crime Against Women,Molestation,Female,31-45,1617,1239,378,1340,277
2008,Urban,Andhra Pradesh,Crime Against Men,Murder,Female,18-30,5908,969,4939,1976,3932
2007,Urban,Uttarakhand,Crime Against Children,Child Labor,Female,0-12,2816,2739,77,2755,61
2009,Urban,Karnataka,Property Crime,Vandalism,Male,18-30,3711,1141,2570,2264,1447
2004,Rural,Rajasthan,Other Crimes,Fraud,Female,31-45,1581,1112,469,1451,130
2009,Urban,Karnataka,Other Crimes,Fraud,Female,0-12,1258,874,384,905,353
2002,Rural,Sikkim,Crime Against Men,Extortion,Male,13-17,2683,1907,776,2188,495
2002,Urban,West Bengal,Crime Against Men,Robbery,Female,31-45,4064,1398,2666,2982,1082
2010,Rural,Tripura,Crime Against Children,Trafficking,Male,13-17,2692,521,2171,1713,979
2009,Rural,Bihar,Crime Against Men,Robbery,Male,18-30,7985,5297,2688,6109,1876
2001,Rural,Jammu & Kashmir,Property Crime,Burglary,Male,60+,3241,760,2481,1247,1994
2007,Rural,Nagaland,Property Crime,Theft,Female,60+,9170,5937,3233,7466,1704
2009,Rural,Jammu & Kashmir,Crime Against Men,Assault,Female,46-60,7228,4497,2731,7087,141
2001,Urban,Uttarakhand,Crime Against Men,Murder,Male,18-30,279,205,74,258,21
2002,Rural,Delhi,Property Crime,Burglary,Male,60+,5118,2866,2252,4479,639
2004,Urban,Gujarat,Crime Against Children,Kidnapping,Female,46-60,6138,119,6019,1198,4940
2006,Urban,Arunachal Pradesh,Property Crime,Vandalism,Male,13-17,6970,5483,1487,6511,459
2009,Urban,Goa,Crime Against Women,Molestation,Female,31-45,2146,1039,1107,1067,1079
2009,Urban,Kerala,Other Crimes,Drug Offense,Female,18-30,2964,1128,1836,2779,185
2005,Rural,Uttarakhand,Crime Against Men,Assault,Male,18-30,9617,2769,6848,9287,330
2007,Urban,Haryana,Crime Against Men,Assault,Male,0-12,6831,5884,947,6175,656
2009,Urban,Goa,Other Crimes,Fraud,Male,13-17,4044,2184,1860,2519,1525
2010,Rural,Karnataka,Other Crimes,Cyber Crime,Female,18-30,1198,1185,13,1192,6
2001,Urban,Chhattisgarh,Crime Against Women,Dowry Deaths,Female,31-45,3369,66,3303,1102,2267
2005,Rural,Uttarakhand,Property Crime,Arson,Male,13-17,5483,4295,1188,5337,146
2005,Rural,Rajasthan,Property Crime,Vandalism,Male,18-30,5459,1141,4318,1370,4089
2004,Urban,West Bengal,Property Crime,Vandalism,Male,13-17,1453,1057,396,1452,1
2009,Urban,Uttarakhand,Crime Against Women,Domestic Violence,Male,13-17,3836,3063,773,3411,425
2005,Rural,Tamil Nadu,Other Crimes,Corruption,Male,46-60,8630,5644,2986,7494,1136
2007,Urban,Uttar Pradesh,Property Crime,Burglary,Male,31-45,874,299,575,449,425
2005,Rural,Maharashtra,Crime Against Children,Child Abuse,Female,0-12,6968,1071,5897,4458,2510
2002,Urban,Haryana,Crime Against Women,Molestation,Female,31-45,9554,4514,5040,8877,677
2004,Rural,Bihar,Crime Against Children,Child Abuse,Male,31-45,7849,4985,2864,7637,212
2005,Urban,Karnataka,Crime Against Women,Dowry Deaths,Male,31-45,8635,1472,7163,2509,6126
2003,Rural,Arunachal Pradesh,Crime Against Women,Dowry Deaths,Female,18-30,9362,6715,2647,6799,2563
2003,Urban,Sikkim,Property Crime,Arson,Male,31-45,5673,837,4836,3138,2535
2006,Rural,Kerala,Crime Against Men,Extortion,Male,0-12,2956,41,2915,176,2780
2003,Rural,Uttar Pradesh,Other Crimes,Corruption,Male,13-17,8617,1093,7524,1634,6983
2001,Rural,Karnataka,Other Crimes,Cyber Crime,Female,60+,8352,6477,1875,7559,793
2004,Urban,Arunachal Pradesh,Other Crimes,Corruption,Female,60+,5574,3435,2139,5282,292
2005,Rural,Telangana,Property Crime,Burglary,Female,60+,6008,1259,4749,4450,1558
2004,Urban,Haryana,Crime Against Women,Dowry Deaths,Female,60+,7519,521,6998,2672,4847
2007,Urban,Bihar,Crime Against Women,Molestation,Female,18-30,6188,1471,4717,2501,3687
2001,Rural,Manipur,Crime Against Women,Molestation,Female,31-45,758,583,175,697,61
2002,Rural,Manipur,Crime Against Men,Assault,Female,46-60,1409,525,884,660,749
2009,Urban,Haryana,Crime Against Men,Assault,Female,18-30,8274,459,7815,5447,2827
2001,Urban,Goa,Crime Against Men,Extortion,Male,46-60,2146,267,1879,524,1622
2001,Urban,Andhra Pradesh,Crime Against Women,Molestation,Female,0-12,1214,351,863,361,853
2009,Rural,Tamil Nadu,Property Crime,Arson,Male,46-60,614,538,76,584,30
2005,Urban,Tripura,Crime Against Children,Child Labor,Female,13-17,5846,2020,3826,5207,639
2002,Rural,Uttar Pradesh,Other Crimes,Fraud,Male,46-60,2240,2176,64,2185,55
2008,Urban,Karnataka,Crime Against Women,Molestation,Male,13-17,5941,2079,3862,3801,2140
2008,Urban,Tripura,Crime Against Men,Extortion,Male,18-30,2772,2216,556,2239,533
2002,Rural,Bihar,Crime Against Men,Assault,Male,60+,5175,4536,639,4919,256
2009,Urban,Maharashtra,Crime Against Men,Extortion,Male,31-45,5591,2340,3251,2705,2886
2003,Rural,Karnataka,Crime Against Children,Kidnapping,Male,31-45,5950,2974,2976,3489,2461
2008,Rural,West Bengal,Crime Against Women,Molestation,Female,46-60,2067,1049,1018,1770,297
2009,Urban,Assam,Other Crimes,Drug Offense,Male,31-45,2156,446,1710,1567,589
2006,Rural,Telangana,Crime Against Women,Dowry Deaths,Female,60+,6740,4106,2634,4955,1785
2009,Rural,Jammu & Kashmir,Crime Against Men,Robbery,Male,0-12,8351,7581,770,7981,370
2009,Rural,Goa,Crime Against Women,Molestation,Female,60+,4969,4897,72,4901,68
2001,Rural,Chhattisgarh,Property Crime,Arson,Male,18-30,6350,2818,3532,6326,24
2003,Urban,Kerala,Crime Against Children,Kidnapping,Female,0-12,6452,5762,690,5848,604
2010,Urban,Sikkim,Other Crimes,Fraud,Male,60+,4207,1965,2242,3307,900
2010,Urban,Manipur,Crime Against Women,Dowry Deaths,Female,46-60,9352,5130,4222,5520,3832
2002,Rural,Jharkhand,Property Crime,Vandalism,Male,13-17,7298,1139,6159,6775,523
2008,Urban,Tripura,Property Crime,Arson,Male,46-60,7274,358,6916,2928,4346
2002,Rural,Telangana,Property Crime,Burglary,Female,18-30,250,27,223,214,36
2009,Rural,Delhi,Crime Against Men,Murder,Male,0-12,7893,2545,5348,2916,4977
2007,Urban,West Bengal,Property Crime,Arson,Male,0-12,343,265,78,329,14
2004,Rural,Tamil Nadu,Property Crime,Vandalism,Female,31-45,6160,3919,2241,5599,561
2006,Rural,Tamil Nadu,Crime Against Women,Rape,Female,31-45,6498,3523,2975,6069,429
2005,Urban,Sikkim,Other Crimes,Fraud,Female,0-12,6266,1899,4367,5925,341
2009,Rural,Gujarat,Crime Against Women,Molestation,Female,0-12,5337,4610,727,5200,137
2004,Rural,Rajasthan,Crime Against Children,Child Labor,Female,46-60,8333,2083,6250,5662,2671
2007,Rural,Nagaland,Crime Against Men,Murder,Male,46-60,4816,2072,2744,3098,1718
2010,Urban,Gujarat,Other Crimes,Corruption,Female,0-12,6424,2098,4326,4417,2007
2007,Rural,Jammu & Kashmir,Crime Against Children,Kidnapping,Male,18-30,3873,3335,538,3694,179
2002,Rural,Madhya Pradesh,Other Crimes,Corruption,Male,0-12,4875,3325,1550,3345,1530
2001,Urban,Bihar,Other Crimes,Drug Offense,Female,13-17,9023,2956,6067,3394,5629
2004,Urban,Uttar Pradesh,Property Crime,Theft,Female,31-45,9884,8613,1271,9656,228
2009,Urban,Chhattisgarh,Crime Against Children,Child Labor,Female,0-12,8383,223,8160,3557,4826
2001,Rural,Sikkim,Crime Against Men,Robbery,Female,46-60,8016,2522,5494,2977,5039
2010,Rural,Goa,Other Crimes,Drug Offense,Female,18-30,1754,1434,320,1690,64
2010,Urban,Uttar Pradesh,Property Crime,Vandalism,Male,0-12,9176,3321,5855,3688,5488
2004,Rural,Chhattisgarh,Crime Against Children,Trafficking,Male,0-12,8120,1324,6796,3441,4679
2006,Rural,Andhra Pradesh,Other Crimes,Cyber Crime,Female,13-17,8254,5716,2538,6350,1904
2002,Rural,Manipur,Other Crimes,Corruption,Female,0-12,8775,2271,6504,6992,1783
2009,Rural,Delhi,Crime Against Children,Trafficking,Female,46-60,5988,4806,1182,4882,1106
2005,Urban,Karnataka,Crime Against Men,Murder,Female,46-60,2321,1857,464,1955,366
2002,Rural,Bihar,Other Crimes,Drug Offense,Female,13-17,7950,4259,3691,7650,300
2010,Urban,Nagaland,Crime Against Children,Child Labor,Female,31-45,6585,390,6195,5627,958
2010,Urban,Sikkim,Crime Against Children,Trafficking,Male,18-30,1020,801,219,888,132
2001,Rural,Goa,Property Crime,Arson,Male,46-60,7306,6279,1027,6840,466
2005,Urban,Tripura,Crime Against Women,Domestic Violence,Male,0-12,6184,3893,2291,4078,2106
2002,Urban,Punjab,Crime Against Women,Domestic Violence,Male,18-30,6393,2314,4079,3514,2879
2009,Rural,Telangana,Crime Against Women,Domestic Violence,Male,46-60,873,522,351,530,343
2004,Rural,Madhya Pradesh,Property Crime,Arson,Female,0-12,1390,518,872,1039,351
2003,Rural,Uttar Pradesh,Crime Against Men,Extortion,Male,13-17,795,780,15,793,2
2006,Rural,Arunachal Pradesh,Crime Against Women,Dowry Deaths,Female,13-17,237,62,175,117,120
2003,Urban,Mizoram,Crime Against Men,Assault,Male,31-45,1131,950,181,992,139
2001,Rural,Kerala,Crime Against Men,Assault,Male,60+,8795,7706,1089,7900,895
2010,Urban,Madhya Pradesh,Crime Against Men,Murder,Male,13-17,6495,500,5995,4022,2473
2009,Rural,West Bengal,Property Crime,Burglary,Male,31-45,3554,134,3420,3376,178
2009,Urban,Mizoram,Crime Against Men,Assault,Female,31-45,5452,151,5301,4121,1331
2004,Urban,Gujarat,Property Crime,Vandalism,Male,60+,307,45,262,136,171
2008,Urban,Punjab,Crime Against Women,Dowry Deaths,Male,0-12,2197,1355,842,1855,342
2008,Rural,Gujarat,Other Crimes,Corruption,Female,0-12,9348,3855,5493,7492,1856
2002,Rural,Kerala,Crime Against Men,Extortion,Male,13-17,6635,73,6562,4335,2300
2007,Urban,Goa,Property Crime,Arson,Female,18-30,8719,2114,6605,5670,3049
2006,Urban,Telangana,Property Crime,Theft,Male,13-17,2896,944,1952,1743,1153
2003,Rural,Kerala,Other Crimes,Cyber Crime,Female,46-60,1525,1007,518,1111,414
2007,Urban,Andhra Pradesh,Crime Against Women,Dowry Deaths,Male,13-17,1101,356,745,751,350
2006,Urban,Karnataka,Crime Against Children,Child Abuse,Female,13-17,2682,1244,1438,2616,66
2002,Rural,Assam,Crime Against Children,Child Abuse,Female,18-30,2209,559,1650,2136,73
2007,Urban,Arunachal Pradesh,Other Crimes,Drug Offense,Female,60+,3136,2326,810,2812,324
2005,Rural,Tamil Nadu,Crime Against Women,Domestic Violence,Female,60+,80,42,38,69,11
2010,Urban,Madhya Pradesh,Property Crime,Vandalism,Male,18-30,7232,5711,1521,6811,421
2006,Rural,Sikkim,Property Crime,Vandalism,Female,31-45,5976,277,5699,1565,4411
2009,Urban,Delhi,Other Crimes,Fraud,Female,0-12,9118,7511,1607,7868,1250
2010,Rural,Rajasthan,Other Crimes,Drug Offense,Female,46-60,2679,63,2616,2393,286
2008,Rural,Bihar,Crime Against Children,Child Labor,Male,0-12,78,53,25,66,12
2008,Rural,Karnataka,Crime Against Women,Domestic Violence,Male,60+,1315,37,1278,682,633
2004,Urban,Mizoram,Other Crimes,Fraud,Female,0-12,8066,3769,4297,6896,1170
2005,Rural,Nagaland,Crime Against Women,Molestation,Male,60+,7930,4187,3743,5053,2877
2006,Urban,Telangana,Other Crimes,Fraud,Female,18-30,7038,2329,4709,5965,1073
2002,Urban,Himachal Pradesh,Property Crime,Arson,Male,13-17,432,84,348,171,261
2009,Urban,Maharashtra,Crime Against Women,Rape,Female,31-45,8607,6391,2216,7419,1188
2007,Urban,Bihar,Crime Against Children,Kidnapping,Female,31-45,1501,1033,468,1352,149
2004,Urban,Mizoram,Crime Against Men,Extortion,Male,13-17,5895,5035,860,5460,435
2005,Urban,West Bengal,Other Crimes,Fraud,Female,31-45,4903,226,4677,2417,2486
2003,Rural,West Bengal,Other Crimes,Corruption,Male,31-45,7067,5252,1815,6498,569
2009,Urban,Andhra Pradesh,Crime Against Men,Assault,Male,60+,4060,683,3377,1611,2449
2007,Rural,Punjab,Property Crime,Arson,Female,18-30,9160,3624,5536,5056,4104
2004,Urban,Himachal Pradesh,Crime Against Women,Domestic Violence,Female,60+,8990,6690,2300,7638,1352
2005,Urban,Manipur,Crime Against Children,Kidnapping,Male,31-45,6050,5981,69,6006,44
2001,Urban,Karnataka,Crime Against Men,Murder,Male,13-17,773,111,662,767,6
2004,Urban,Jammu & Kashmir,Other Crimes,Drug Offense,Male,18-30,4617,3543,1074,4129,488
2004,Rural,Odisha,Other Crimes,Cyber Crime,Female,46-60,6253,1134,5119,3812,2441
2003,Urban,Nagaland,Property Crime,Burglary,Male,60+,9408,4566,4842,9282,126
2010,Rural,Himachal Pradesh,Other Crimes,Corruption,Female,18-30,4035,2421,1614,3095,940
2004,Rural,Assam,Crime Against Women,Domestic Violence,Female,13-17,5394,5141,253,5277,117
2003,Rural,Madhya Pradesh,Crime Against Children,Child Abuse,Female,60+,2357,56,2301,701,1656
2007,Urban,Haryana,Other Crimes,Fraud,Male,31-45,6109,4345,1764,5243,866
2002,Rural,Arunachal Pradesh,Other Crimes,Cyber Crime,Male,60+,2940,2406,534,2910,30
2006,Rural,Jammu & Kashmir,Other Crimes,Cyber Crime,Male,0-12,7920,415,7505,3267,4653
2001,Rural,Karnataka,Property Crime,Burglary,Female,13-17,7797,7771,26,7783,14
2009,Rural,Mizoram,Other Crimes,Fraud,Female,0-12,3519,2400,1119,2405,1114
2010,Rural,Assam,Property Crime,Vandalism,Male,31-45,3380,2272,1108,3215,165
2002,Rural,Madhya Pradesh,Other Crimes,Drug Offense,Female,13-17,245,10,235,110,135
2005,Rural,Rajasthan,Other Crimes,Corruption,Female,46-60,9973,8409,1564,9697,276
2004,Urban,Haryana,Property Crime,Burglary,Male,18-30,1372,433,939,1095,277
2004,Rural,Uttar Pradesh,Crime Against Children,Child Abuse,Male,18-30,2489,1724,765,1751,738
2006,Urban,Manipur,Property Crime,Burglary,Male,60+,6476,5076,1400,5809,667
2006,Rural,Tamil Nadu,Property Crime,Arson,Male,0-12,9887,3496,6391,9859,28
2003,Urban,Manipur,Crime Against Children,Trafficking,Female,13-17,8991,5054,3937,6301,2690
2003,Rural,Mizoram,Property Crime,Arson,Male,13-17,9107,2753,6354,4967,4140
2008,Rural,Jammu & Kashmir,Property Crime,Arson,Male,60+,9141,3782,5359,4558,4583
2010,Rural,Madhya Pradesh,Crime Against Men,Murder,Male,18-30,868,39,829,543,325
2002,Urban,Arunachal Pradesh,Crime Against Women,Dowry Deaths,Male,0-12,6371,3398,2973,5170,1201
2004,Rural,Nagaland,Crime Against Children,Child Abuse,Male,46-60,9997,4298,5699,6005,3992
2006,Urban,Jammu & Kashmir,Crime Against Women,Domestic Violence,Male,31-45,3661,3236,425,3540,121
2008,Rural,Andhra Pradesh,Crime Against Women,Domestic Violence,Male,60+,8108,3561,4547,5217,2891
2001,Rural,Madhya Pradesh,Crime Against Children,Trafficking,Male,13-17,9269,9220,49,9226,43
2008,Urban,Odisha,Crime Against Women,Molestation,Female,0-12,3475,1906,1569,2529,946
2001,Urban,Sikkim,Crime Against Children,Trafficking,Male,31-45,2308,1421,887,1828,480
2009,Urban,West Bengal,Crime Against Men,Murder,Female,18-30,7616,7131,485,7366,250
2007,Rural,Uttarakhand,Other Crimes,Corruption,Female,60+,7064,4192,2872,6264,800
2005,Urban,Delhi,Crime Against Women,Rape,Male,60+,1343,833,510,1046,297
2006,Urban,Assam,Crime Against Children,Child Labor,Male,0-12,5929,3655,2274,5738,191
2006,Rural,Andhra Pradesh,Crime Against Children,Kidnapping,Female,31-45,9957,5355,4602,9078,879
2007,Rural,Himachal Pradesh,Crime Against Women,Dowry Deaths,Female,60+,1427,199,1228,714,713
2007,Rural,Tripura,Other Crimes,Corruption,Female,60+,1269,127,1142,683,586
2001,Urban,Gujarat,Property Crime,Arson,Female,13-17,3218,2342,876,2616,602
2002,Urban,Mizoram,Crime Against Women,Domestic Violence,Female,0-12,5111,4538,573,4554,557
2010,Urban,Himachal Pradesh,Crime Against Men,Robbery,Male,0-12,7445,6463,982,7256,189
2009,Urban,Telangana,Crime Against Men,Assault,Male,18-30,6675,4806,1869,5397,1278
2005,Rural,Andhra Pradesh,Other Crimes,Cyber Crime,Male,31-45,881,50,831,543,338
2010,Urban,Kerala,Crime Against Children,Child Labor,Female,18-30,6348,4948,1400,5488,860
2003,Urban,Kerala,Crime Against Women,Dowry Deaths,Female,31-45,2244,1654,590,1753,491
2003,Urban,Uttarakhand,Crime Against Women,Rape,Male,46-60,3286,1544,1742,1556,1730
2001,Rural,Karnataka,Other Crimes,Drug Offense,Female,0-12,5272,892,4380,2034,3238
2010,Rural,Punjab,Other Crimes,Corruption,Female,46-60,6935,1133,5802,5305,1630
2009,Urban,Tripura,Other Crimes,Drug Offense,Male,18-30,1741,1078,663,1577,164
2002,Rural,Mizoram,Property Crime,Arson,Male,0-12,6296,3908,2388,5101,1195
2005,Urban,Delhi,Crime Against Children,Trafficking,Male,0-12,5791,284,5507,2738,3053
2001,Urban,Uttar Pradesh,Crime Against Children,Kidnapping,Female,13-17,3520,3280,240,3300,220
2002,Urban,Tamil Nadu,Crime Against Children,Trafficking,Female,60+,167,56,111,121,46
2010,Urban,Haryana,Other Crimes,Cyber Crime,Male,13-17,6137,5373,764,5697,440
2002,Rural,Arunachal Pradesh,Other Crimes,Cyber Crime,Female,0-12,7877,5387,2490,6543,1334
2008,Rural,Himachal Pradesh,Crime Against Women,Dowry Deaths,Male,13-17,8216,8117,99,8201,15
2008,Rural,Mizoram,Crime Against Men,Robbery,Male,31-45,2141,761,1380,2082,59
2009,Urban,Gujarat,Crime Against Women,Dowry Deaths,Male,60+,4018,1445,2573,2889,1129
2003,Rural,Uttarakhand,Crime Against Women,Molestation,Male,18-30,1213,59,1154,315,898
2005,Urban,Odisha,Crime Against Women,Dowry Deaths,Male,60+,9648,2973,6675,3717,5931
2007,Rural,Mizoram,Property Crime,Burglary,Male,0-12,2514,1725,789,1946,568
2010,Rural,Bihar,Other Crimes,Fraud,Male,13-17,2735,2005,730,2287,448
2010,Rural,Jharkhand,Other Crimes,Fraud,Female,60+,1169,674,495,949,220
2004,Urban,Meghalaya,Other Crimes,Fraud,Female,46-60,5616,375,5241,587,5029
2008,Rural,Jammu & Kashmir,Crime Against Men,Robbery,Male,0-12,4777,2808,1969,2948,1829
2005,Rural,Bihar,Crime Against Children,Child Labor,Male,0-12,6778,4112,2666,4678,2100
2008,Rural,Jharkhand,Crime Against Women,Domestic Violence,Female,46-60,7665,6039,1626,6155,1510
2010,Rural,Meghalaya,Crime Against Women,Domestic Violence,Male,60+,7128,126,7002,4756,2372
2008,Urban,Tripura,Crime Against Women,Rape,Male,13-17,1982,1368,614,1611,371
2001,Urban,Goa,Crime Against Women,Rape,Male,60+,786,437,349,650,136
2010,Urban,Himachal Pradesh,Crime Against Women,Dowry Deaths,Male,13-17,1914,1848,66,1857,57
2006,Urban,Odisha,Crime Against Men,Murder,Male,0-12,2472,581,1891,1571,901
2002,Urban,Tripura,Crime Against Women,Domestic Violence,Male,0-12,8442,82,8360,7561,881
2001,Urban,Delhi,Crime Against Children,Child Labor,Female,0-12,8339,6527,1812,7150,1189
2007,Urban,Gujarat,Crime Against Women,Molestation,Female,31-45,9891,7577,2314,8031,1860
2001,Urban,Goa,Property Crime,Vandalism,Male,60+,7356,6043,1313,6462,894
2009,Urban,Uttar Pradesh,Crime Against Men,Robbery,Female,18-30,8838,1817,7021,2150,6688
2009,Urban,Rajasthan,Other Crimes,Cyber Crime,Female,46-60,297,192,105,242,55
2010,Rural,Mizoram,Property Crime,Burglary,Male,60+,8680,60,8620,285,8395
2002,Rural,Jammu & Kashmir,Other Crimes,Fraud,Female,31-45,7639,5398,2241,6145,1494
2008,Rural,Tripura,Other Crimes,Cyber Crime,Male,31-45,753,265,488,318,435
2005,Rural,Arunachal Pradesh,Crime Against Men,Assault,Male,18-30,3989,2606,1383,3657,332
2001,Urban,Gujarat,Crime Against Men,Murder,Male,46-60,3041,318,2723,1171,1870
2001,Urban,Karnataka,Crime Against Women,Domestic Violence,Female,0-12,5832,4108,1724,4143,1689
2007,Rural,Delhi,Other Crimes,Drug Offense,Male,60+,4738,3604,1134,4326,412
2002,Rural,Telangana,Crime Against Women,Rape,Female,60+,3293,2797,496,3262,31
2007,Urban,Manipur,Crime Against Men,Murder,Male,13-17,6376,1730,4646,1896,4480
2005,Rural,Maharashtra,Crime Against Men,Robbery,Female,18-30,3078,2620,458,2672,406
2002,Urban,Haryana,Crime Against Men,Robbery,Female,18-30,2064,2059,5,2063,1
2007,Rural,Goa,Crime Against Women,Rape,Male,31-45,3183,2131,1052,2920,263
2010,Urban,Rajasthan,Crime Against Children,Kidnapping,Female,31-45,8061,7947,114,7949,112
2004,Urban,Uttarakhand,Property Crime,Vandalism,Female,18-30,3174,342,2832,2040,1134
2010,Urban,Tamil Nadu,Crime Against Women,Domestic Violence,Female,0-12,8105,457,7648,3941,4164
2003,Rural,Nagaland,Crime Against Children,Child Abuse,Female,31-45,5757,5216,541,5395,362
2008,Urban,Himachal Pradesh,Crime Against Children,Trafficking,Male,31-45,4988,2548,2440,2623,2365
2006,Urban,Maharashtra,Property Crime,Burglary,Male,31-45,8489,2522,5967,2599,5890
2004,Rural,Meghalaya,Crime Against Children,Child Abuse,Female,13-17,1444,1434,10,1440,4
2010,Urban,Manipur,Crime Against Men,Extortion,Female,46-60,8101,6959,1142,7688,413
2003,Rural,Jharkhand,Other Crimes,Drug Offense,Female,60+,5468,4864,604,5038,430
2009,Rural,Sikkim,Other Crimes,Cyber Crime,Male,13-17,4291,3682,609,3745,546
2010,Urban,Haryana,Crime Against Men,Assault,Male,18-30,8317,615,7702,823,7494
2009,Urban,Delhi,Crime Against Men,Assault,Male,13-17,1443,549,894,1123,320
2006,Urban,Kerala,Property Crime,Burglary,Male,31-45,4733,2761,1972,3233,1500
2007,Urban,Karnataka,Crime Against Women,Domestic Violence,Male,0-12,6472,1885,4587,5558,914
2006,Rural,Odisha,Crime Against Men,Robbery,Male,13-17,4765,1587,3178,3924,841
2005,Rural,Odisha,Property Crime,Theft,Female,13-17,8128,3479,4649,5844,2284
2010,Urban,Bihar,Other Crimes,Fraud,Female,31-45,8305,4204,4101,7924,381
2007,Urban,Tripura,Other Crimes,Corruption,Male,60+,5873,5231,642,5362,511
2009,Urban,Rajasthan,Crime Against Women,Molestation,Male,31-45,5471,3372,2099,4983,488
2008,Rural,Odisha,Other Crimes,Drug Offense,Female,13-17,3962,3397,565,3853,109
2004,Urban,Karnataka,Crime Against Women,Domestic Violence,Female,60+,7187,3857,3330,3947,3240
2007,Urban,Uttarakhand,Property Crime,Burglary,Male,18-30,2280,2123,157,2124,156
2008,Rural,Assam,Property Crime,Arson,Female,60+,7232,6859,373,7076,156
2002,Urban,Assam,Other Crimes,Drug Offense,Female,13-17,9343,6469,2874,7775,1568
2004,Urban,Mizoram,Crime Against Men,Murder,Male,60+,9835,7825,2010,8204,1631
2010,Rural,Himachal Pradesh,Other Crimes,Drug Offense,Female,18-30,1595,425,1170,971,624
2004,Rural,Odisha,Crime Against Men,Robbery,Female,31-45,4772,171,4601,3872,900
2007,Rural,Kerala,Property Crime,Arson,Male,0-12,6581,3353,3228,3775,2806
2003,Rural,Andhra Pradesh,Crime Against Children,Trafficking,Male,46-60,5110,1527,3583,2705,2405
2009,Urban,Andhra Pradesh,Crime Against Women,Molestation,Female,31-45,4907,3334,1573,4189,718
2006,Urban,West Bengal,Crime Against Men,Murder,Female,31-45,229,134,95,209,20
2004,Rural,Himachal Pradesh,Property Crime,Theft,Male,60+,7140,186,6954,6104,1036
2005,Urban,Meghalaya,Crime Against Children,Child Abuse,Male,31-45,4884,4498,386,4597,287
2002,Rural,Tamil Nadu,Property Crime,Theft,Female,46-60,5816,2216,3600,2601,3215
2002,Urban,Tripura,Property Crime,Vandalism,Male,0-12,4238,4006,232,4097,141
2008,Urban,Kerala,Crime Against Men,Robbery,Female,46-60,5393,2615,2778,4703,690
2009,Rural,Odisha,Crime Against Children,Child Labor,Male,46-60,8737,181,8556,7523,1214
2006,Rural,Haryana,Crime Against Men,Assault,Female,13-17,1362,713,649,935,427
2002,Urban,Jharkhand,Crime Against Men,Extortion,Female,31-45,6841,1564,5277,2320,4521
2003,Rural,Tamil Nadu,Crime Against Men,Murder,Male,13-17,6785,3920,2865,4188,2597
2005,Urban,Kerala,Crime Against Men,Murder,Male,60+,5609,628,4981,2298,3311
2010,Rural,Bihar,Crime Against Men,Robbery,Male,46-60,940,37,903,750,190
2004,Rural,Assam,Crime Against Women,Molestation,Female,46-60,2583,1676,907,1911,672
2008,Urban,Tamil Nadu,Other Crimes,Corruption,Male,18-30,3841,1855,1986,2365,1476
2001,Urban,Nagaland,Crime Against Children,Child Abuse,Female,0-12,7037,11,7026,5942,1095
2006,Rural,Uttar Pradesh,Crime Against Men,Extortion,Female,13-17,1854,309,1545,1069,785
2001,Urban,Gujarat,Other Crimes,Cyber Crime,Male,46-60,798,573,225,761,37
2008,Rural,Goa,Property Crime,Burglary,Male,46-60,2640,2145,495,2413,227
2002,Rural,Gujarat,Crime Against Women,Rape,Female,31-45,8031,5405,2626,6935,1096
2001,Rural,Sikkim,Crime Against Children,Child Labor,Female,18-30,5512,4653,859,4664,848
2005,Urban,Odisha,Crime Against Women,Domestic Violence,Male,13-17,4730,1353,3377,2924,1806
2001,Rural,Arunachal Pradesh,Property Crime,Burglary,Female,0-12,319,243,76,263,56
2007,Urban,Jammu & Kashmir,Other Crimes,Corruption,Male,18-30,5945,1266,4679,3723,2222
2003,Rural,Haryana,Crime Against Women,Domestic Violence,Female,18-30,1041,460,581,712,329
2007,Rural,Jharkhand,Property Crime,Theft,Male,46-60,2205,546,1659,1335,870
2005,Rural,Maharashtra,Crime Against Men,Robbery,Female,0-12,3214,2301,913,2352,862
2004,Rural,Madhya Pradesh,Crime Against Children,Kidnapping,Female,31-45,5039,1309,3730,4593,446
2001,Urban,Rajasthan,Crime Against Men,Extortion,Male,13-17,2136,1726,410,1756,380
2007,Urban,Karnataka,Property Crime,Arson,Male,31-45,5940,37,5903,4442,1498
2009,Rural,Telangana,Other Crimes,Cyber Crime,Female,31-45,5421,4660,761,5286,135
2009,Urban,Mizoram,Crime Against Children,Trafficking,Female,46-60,4571,2642,1929,4336,235
2006,Rural,Telangana,Crime Against Men,Extortion,Female,31-45,375,283,92,334,41
2009,Rural,Himachal Pradesh,Property Crime,Burglary,Male,18-30,787,401,386,731,56
2007,Rural,Kerala,Property Crime,Theft,Male,0-12,2455,1408,1047,2008,447
2003,Rural,Uttarakhand,Property Crime,Burglary,Male,18-30,4723,3081,1642,4241,482
2008,Rural,Bihar,Crime Against Men,Assault,Female,31-45,5951,1015,4936,1991,3960
2007,Urban,Uttar Pradesh,Crime Against Children,Trafficking,Female,60+,7743,975,6768,5893,1850
2004,Urban,Chhattisgarh,Other Crimes,Drug Offense,Male,60+,7720,7285,435,7316,404
2001,Urban,Delhi,Other Crimes,Corruption,Female,18-30,749,20,729,235,514
2007,Urban,Punjab,Crime Against Women,Dowry Deaths,Female,31-45,7780,1683,6097,5721,2059
2005,Rural,Nagaland,Crime Against Women,Domestic Violence,Male,31-45,8844,1141,7703,6643,2201
2002,Urban,Himachal Pradesh,Property Crime,Vandalism,Female,31-45,7067,3771,3296,4347,2720
2006,Rural,Manipur,Crime Against Men,Extortion,Female,46-60,2942,2077,865,2748,194
2009,Rural,Madhya Pradesh,Crime Against Women,Dowry Deaths,Female,46-60,5412,1993,3419,4600,812
2003,Urban,Uttar Pradesh,Other Crimes,Fraud,Male,31-45,5257,2059,3198,4526,731
2005,Urban,Rajasthan,Other Crimes,Fraud,Male,13-17,8721,2193,6528,3873,4848
2010,Urban,Goa,Property Crime,Arson,Female,13-17,5370,5129,241,5355,15
2006,Rural,Himachal Pradesh,Crime Against Women,Domestic Violence,Male,46-60,4104,2517,1587,2966,1138
2006,Urban,Nagaland,Property Crime,Burglary,Male,46-60,6191,751,5440,4194,1997
2002,Urban,Andhra Pradesh,Crime Against Men,Murder,Male,60+,3529,315,3214,3359,170
2001,Urban,Rajasthan,Other Crimes,Drug Offense,Female,31-45,7035,5015,2020,5697,1338
2003,Urban,Jharkhand,Property Crime,Arson,Male,60+,5757,3579,2178,4469,1288
2006,Urban,Gujarat,Crime Against Children,Child Labor,Male,60+,6187,5820,367,6076,111
2007,Urban,Jammu & Kashmir,Property Crime,Burglary,Male,31-45,8192,6304,1888,6950,1242
2005,Rural,Gujarat,Crime Against Children,Trafficking,Male,60+,6354,181,6173,1985,4369
2002,Rural,West Bengal,Other Crimes,Corruption,Female,31-45,6770,3938,2832,5059,1711
2010,Urban,Himachal Pradesh,Crime Against Children,Child Labor,Female,60+,5260,2155,3105,2341,2919
2010,Rural,Madhya Pradesh,Property Crime,Vandalism,Female,18-30,4188,1943,2245,3296,892
2002,Urban,Mizoram,Property Crime,Arson,Male,46-60,4440,2849,1591,3281,1159
2006,Urban,Jammu & Kashmir,Crime Against Children,Trafficking,Female,13-17,1552,1245,307,1313,239
2005,Urban,Arunachal Pradesh,Crime Against Children,Child Abuse,Female,46-60,4168,3117,1051,3563,605
2005,Urban,Assam,Crime Against Children,Child Abuse,Female,60+,1933,990,943,1007,926
2007,Rural,Telangana,Property Crime,Burglary,Male,31-45,8511,2706,5805,7814,697
2005,Urban,Andhra Pradesh,Property Crime,Burglary,Female,18-30,6148,4239,1909,4344,1804
2002,Urban,Manipur,Crime Against Men,Extortion,Male,13-17,8676,6929,1747,8633,43
2001,Urban,Meghalaya,Crime Against Men,Extortion,Female,60+,1890,529,1361,1741,149
2005,Urban,Odisha,Property Crime,Theft,Male,60+,9569,5710,3859,6914,2655
2004,Urban,Gujarat,Other Crimes,Corruption,Female,60+,2953,876,2077,1160,1793
2003,Urban,Jharkhand,Other Crimes,Drug Offense,Male,0-12,3195,1483,1712,1568,1627
2001,Urban,Punjab,Other Crimes,Cyber Crime,Female,0-12,6632,4867,1765,5842,790
2007,Urban,Assam,Crime Against Men,Extortion,Female,18-30,9322,8647,675,8652,670
2004,Rural,Karnataka,Crime Against Men,Extortion,Male,13-17,1377,241,1136,1343,34
2005,Rural,Nagaland,Crime Against Men,Murder,Female,0-12,5968,5743,225,5780,188
2004,Rural,Meghalaya,Crime Against Men,Assault,Male,31-45,2830,1785,1045,2159,671
2002,Urban,Telangana,Crime Against Men,Extortion,Male,18-30,5321,3750,1571,4051,1270
2006,Rural,Tripura,Property Crime,Theft,Female,13-17,2980,2001,979,2546,434
2005,Urban,Himachal Pradesh,Other Crimes,Drug Offense,Male,0-12,259,24,235,83,176
2004,Urban,Arunachal Pradesh,Property Crime,Theft,Male,46-60,927,164,763,884,43
2003,Rural,Meghalaya,Property Crime,Vandalism,Male,46-60,7641,296,7345,4687,2954
2010,Rural,Meghalaya,Crime Against Women,Domestic Violence,Male,0-12,9254,5647,3607,6074,3180
2001,Urban,Madhya Pradesh,Crime Against Children,Child Labor,Female,13-17,3317,1312,2005,1535,1782
2009,Rural,Punjab,Crime Against Children,Child Abuse,Female,31-45,4879,1799,3080,4116,763
2001,Rural,Mizoram,Property Crime,Theft,Male,18-30,9750,322,9428,6632,3118
2002,Rural,Jammu & Kashmir,Crime Against Women,Domestic Violence,Female,18-30,9618,4021,5597,8488,1130
2007,Urban,Haryana,Other Crimes,Drug Offense,Female,0-12,6493,2047,4446,4537,1956
2006,Urban,Rajasthan,Property Crime,Theft,Male,18-30,6466,3630,2836,4435,2031
2006,Rural,Jharkhand,Crime Against Children,Kidnapping,Female,46-60,5704,3275,2429,3567,2137
2007,Rural,Chhattisgarh,Crime Against Men,Murder,Female,60+,535,383,152,469,66
2009,Rural,Sikkim,Crime Against Women,Rape,Male,0-12,4259,1231,3028,2349,1910
2003,Rural,Andhra Pradesh,Crime Against Men,Murder,Female,46-60,6157,2739,3418,5052,1105
2007,Urban,Telangana,Other Crimes,Drug Offense,Male,60+,4086,2692,1394,3750,336
2005,Rural,Jharkhand,Other Crimes,Fraud,Male,31-45,3004,1418,1586,2164,840
2006,Rural,Gujarat,Crime Against Men,Murder,Male,46-60,4699,769,3930,4333,366
2004,Urban,Gujarat,Crime Against Women,Domestic Violence,Female,0-12,7300,1880,5420,6758,542
2005,Rural,Mizoram,Crime Against Men,Robbery,Male,31-45,362,15,347,226,136
2007,Rural,Odisha,Property Crime,Vandalism,Male,60+,9066,2621,6445,6503,2563
2009,Urban,Goa,Other Crimes,Drug Offense,Male,60+,9666,4710,4956,5784,3882
2003,Urban,Sikkim,Crime Against Men,Murder,Female,46-60,1178,792,386,1037,141
2005,Urban,Himachal Pradesh,Property Crime,Theft,Female,46-60,4957,2684,2273,3101,1856
2009,Urban,Meghalaya,Crime Against Men,Assault,Male,60+,7992,4077,3915,6153,1839
2010,Rural,Arunachal Pradesh,Crime Against Men,Extortion,Male,13-17,5499,2144,3355,3865,1634
2005,Rural,Karnataka,Crime Against Children,Trafficking,Male,60+,8124,4841,3283,6191,1933
2001,Urban,Andhra Pradesh,Other Crimes,Corruption,Female,13-17,2031,1646,385,1787,244
2008,Rural,Manipur,Property Crime,Burglary,Female,13-17,894,305,589,385,509
2008,Rural,Haryana,Crime Against Women,Molestation,Female,13-17,9133,4027,5106,6078,3055
2002,Urban,Karnataka,Crime Against Men,Robbery,Male,13-17,3064,1595,1469,2083,981
2005,Urban,Odisha,Crime Against Children,Kidnapping,Female,13-17,2609,1725,884,1766,843
2007,Urban,West Bengal,Crime Against Men,Murder,Male,13-17,5113,3670,1443,3897,1216
2009,Rural,Karnataka,Crime Against Men,Assault,Female,31-45,154,41,113,43,111
2003,Urban,Sikkim,Other Crimes,Drug Offense,Female,60+,5804,5020,784,5727,77
2003,Rural,Karnataka,Property Crime,Burglary,Male,46-60,3764,3528,236,3728,36
2008,Rural,Meghalaya,Crime Against Women,Molestation,Male,0-12,637,102,535,389,248
2009,Urban,Uttarakhand,Other Crimes,Fraud,Female,0-12,5078,3717,1361,4142,936
2001,Rural,Mizoram,Other Crimes,Corruption,Male,13-17,4386,4263,123,4346,40
2009,Rural,Delhi,Property Crime,Theft,Female,0-12,767,738,29,764,3
2003,Rural,Assam,Other Crimes,Drug Offense,Female,46-60,168,25,143,151,17
2008,Urban,Jharkhand,Crime Against Women,Dowry Deaths,Female,31-45,4240,3495,745,3620,620
2003,Urban,Tripura,Crime Against Children,Child Labor,Female,0-12,7415,1122,6293,5272,2143
2008,Urban,Andhra Pradesh,Crime Against Children,Child Abuse,Female,31-45,2614,948,1666,1979,635
2008,Rural,Odisha,Crime Against Men,Robbery,Male,46-60,7760,6175,1585,6880,880
2003,Urban,Sikkim,Property Crime,Burglary,Female,13-17,4009,3182,827,3661,348
2008,Urban,Delhi,Other Crimes,Corruption,Male,0-12,8278,3992,4286,8112,166
2006,Urban,Maharashtra,Other Crimes,Fraud,Female,0-12,1706,1349,357,1679,27
2005,Rural,Uttar Pradesh,Crime Against Children,Kidnapping,Male,31-45,2054,1874,180,2051,3
2002,Rural,Uttar Pradesh,Other Crimes,Drug Offense,Female,31-45,1454,157,1297,930,524
2004,Urban,Odisha,Crime Against Children,Kidnapping,Male,46-60,2656,0,2656,21,2635
2002,Urban,Himachal Pradesh,Crime Against Men,Murder,Female,18-30,6447,5884,563,5892,555
2004,Rural,Tamil Nadu,Crime Against Men,Extortion,Male,46-60,371,207,164,357,14
2001,Rural,Karnataka,Crime Against Men,Assault,Female,60+,4165,1620,2545,3867,298
2009,Urban,Kerala,Crime Against Children,Kidnapping,Male,18-30,3186,2972,214,3134,52
2001,Urban,Madhya Pradesh,Crime Against Children,Child Labor,Female,0-12,2584,893,1691,1277,1307
2009,Urban,Telangana,Crime Against Children,Kidnapping,Male,18-30,630,55,575,143,487
2006,Rural,Manipur,Other Crimes,Corruption,Female,31-45,6923,3508,3415,5605,1318
2004,Rural,West Bengal,Other Crimes,Fraud,Male,60+,1831,377,1454,1044,787
2005,Urban,Haryana,Property Crime,Burglary,Female,0-12,4066,261,3805,447,3619
2006,Rural,Manipur,Crime Against Children,Child Abuse,Male,0-12,8241,1610,6631,7814,427
2002,Rural,Andhra Pradesh,Other Crimes,Cyber Crime,Male,18-30,6341,2432,3909,5024,1317
2008,Urban,Odisha,Other Crimes,Fraud,Male,60+,824,689,135,701,123
2006,Urban,Manipur,Other Crimes,Cyber Crime,Female,31-45,6691,2639,4052,3357,3334
2005,Urban,Sikkim,Crime Against Men,Robbery,Female,18-30,2847,1354,1493,1607,1240
2002,Rural,Jammu & Kashmir,Crime Against Children,Trafficking,Male,60+,4816,508,4308,611,4205
2010,Rural,Telangana,Property Crime,Burglary,Male,60+,8313,179,8134,5177,3136
2004,Rural,Meghalaya,Crime Against Women,Dowry Deaths,Female,13-17,509,27,482,129,380
2010,Urban,Goa,Crime Against Men,Extortion,Female,0-12,623,484,139,601,22
2008,Urban,Karnataka,Property Crime,Burglary,Female,18-30,8691,4835,3856,5045,3646
2008,Rural,Andhra Pradesh,Crime Against Women,Dowry Deaths,Male,13-17,1771,1531,240,1645,126
2002,Rural,Kerala,Crime Against Men,Murder,Female,0-12,8137,3604,4533,7245,892
2001,Rural,Maharashtra,Crime Against Men,Robbery,Female,18-30,5769,3847,1922,3996,1773
2010,Urban,Delhi,Crime Against Men,Assault,Female,0-12,9499,1467,8032,4003,5496
2008,Rural,Mizoram,Property Crime,Vandalism,Male,31-45,7113,4475,2638,4792,2321
2005,Rural,Telangana,Crime Against Children,Child Abuse,Female,13-17,3738,1424,2314,3045,693
2003,Urban,Delhi,Other Crimes,Cyber Crime,Female,46-60,5969,4680,1289,5152,817
2008,Urban,Chhattisgarh,Crime Against Children,Kidnapping,Male,18-30,7826,921,6905,6147,1679
2003,Rural,Madhya Pradesh,Crime Against Men,Murder,Male,18-30,479,207,272,363,116
2010,Rural,Meghalaya,Other Crimes,Fraud,Female,13-17,1440,911,529,1235,205
2007,Urban,Meghalaya,Crime Against Men,Robbery,Male,31-45,3605,899,2706,1029,2576
2004,Rural,Odisha,Crime Against Children,Trafficking,Female,0-12,1445,1230,215,1295,150
2004,Rural,Gujarat,Crime Against Women,Rape,Female,18-30,617,229,388,384,233
2010,Urban,Assam,Other Crimes,Fraud,Female,31-45,4495,700,3795,1631,2864
2005,Rural,Karnataka,Crime Against Men,Assault,Female,60+,6732,5015,1717,5980,752
2010,Urban,Kerala,Other Crimes,Corruption,Male,31-45,7328,5285,2043,7187,141
2003,Rural,Tamil Nadu,Other Crimes,Corruption,Male,31-45,1719,1056,663,1604,115
2007,Rural,Nagaland,Property Crime,Theft,Female,60+,1884,1493,391,1830,54
2004,Urban,Telangana,Other Crimes,Drug Offense,Female,0-12,5541,117,5424,4278,1263
2001,Rural,Uttar Pradesh,Other Crimes,Fraud,Male,18-30,2541,965,1576,2373,168
2002,Urban,Arunachal Pradesh,Crime Against Children,Child Labor,Female,46-60,4937,1395,3542,4515,422
2007,Rural,Mizoram,Crime Against Men,Murder,Male,18-30,8842,5110,3732,5807,3035
2005,Rural,Nagaland,Property Crime,Burglary,Female,31-45,674,553,121,629,45
2001,Urban,Assam,Other Crimes,Cyber Crime,Female,46-60,2766,2410,356,2545,221
2002,Rural,Telangana,Crime Against Women,Dowry Deaths,Female,46-60,1024,397,627,803,221
2001,Rural,Jharkhand,Crime Against Women,Dowry Deaths,Female,46-60,2115,235,1880,1470,645
2009,Urban,Chhattisgarh,Crime Against Children,Child Labor,Female,0-12,6752,3286,3466,5697,1055
2006,Rural,Madhya Pradesh,Crime Against Men,Robbery,Female,18-30,719,465,254,673,46
2010,Rural,Tamil Nadu,Crime Against Children,Trafficking,Male,60+,3037,147,2890,1433,1604
2010,Urban,Gujarat,Property Crime,Burglary,Male,13-17,3327,2117,1210,3024,303
2004,Rural,Jharkhand,Crime Against Women,Rape,Male,60+,3498,1729,1769,3429,69
2006,Urban,Delhi,Other Crimes,Corruption,Male,0-12,1420,694,726,1313,107
2010,Urban,Odisha,Property Crime,Arson,Male,13-17,4942,869,4073,1080,3862
2002,Rural,Manipur,Crime Against Men,Extortion,Female,13-17,4127,2432,1695,2437,1690
2004,Rural,Gujarat,Crime Against Men,Assault,Female,60+,5848,4570,1278,4606,1242
2008,Rural,Sikkim,Crime Against Women,Dowry Deaths,Female,31-45,1752,270,1482,463,1289
2005,Rural,Himachal Pradesh,Property Crime,Arson,Female,60+,4153,3282,871,3576,577
2005,Urban,Uttar Pradesh,Crime Against Children,Trafficking,Male,13-17,1520,788,732,1231,289
2005,Urban,Tamil Nadu,Crime Against Men,Assault,Male,13-17,7024,1277,5747,5020,2004
2006,Urban,Telangana,Property Crime,Arson,Male,0-12,2049,1169,880,2014,35
2006,Rural,Tamil Nadu,Crime Against Children,Kidnapping,Female,13-17,4918,2773,2145,4322,596
2008,Rural,West Bengal,Crime Against Men,Extortion,Male,0-12,9748,283,9465,3294,6454
2006,Rural,Assam,Property Crime,Burglary,Male,60+,4316,3607,709,3766,550
2006,Rural,Bihar,Property Crime,Arson,Female,18-30,488,190,298,404,84
2004,Rural,Arunachal Pradesh,Crime Against Women,Rape,Female,18-30,5403,1747,3656,4791,612
2004,Rural,Kerala,Crime Against Men,Extortion,Male,60+,7080,3005,4075,3120,3960
2007,Urban,Uttar Pradesh,Property Crime,Theft,Male,31-45,6460,3612,2848,3741,2719
2003,Urban,Madhya Pradesh,Property Crime,Theft,Female,31-45,1277,325,952,986,291
2007,Rural,Kerala,Crime Against Men,Robbery,Male,13-17,6003,5010,993,5189,814
2010,Urban,Assam,Crime Against Children,Child Abuse,Female,13-17,3541,2114,1427,3435,106
2003,Rural,Haryana,Other Crimes,Fraud,Female,46-60,4855,2025,2830,2988,1867
2010,Urban,Sikkim,Crime Against Children,Kidnapping,Female,60+,6292,2400,3892,5716,576
2003,Urban,Rajasthan,Other Crimes,Corruption,Female,0-12,1639,1003,636,1296,343
2009,Rural,Meghalaya,Crime Against Children,Kidnapping,Male,46-60,9330,6750,2580,8009,1321
2008,Urban,Uttarakhand,Crime Against Women,Domestic Violence,Female,18-30,5433,4689,744,4860,573
2003,Rural,Uttarakhand,Crime Against Women,Dowry Deaths,Male,60+,8466,5313,3153,5997,2469
2001,Rural,Odisha,Crime Against Children,Child Labor,Male,0-12,1945,688,1257,1813,132
2005,Rural,Chhattisgarh,Crime Against Men,Murder,Female,0-12,6584,675,5909,1142,5442
2006,Rural,Haryana,Other Crimes,Cyber Crime,Male,0-12,2824,1209,1615,2725,99
2004,Urban,Meghalaya,Crime Against Men,Extortion,Male,46-60,2337,2199,138,2288,49
2005,Rural,Chhattisgarh,Property Crime,Burglary,Male,0-12,3132,2663,469,2932,200
2005,Urban,Telangana,Other Crimes,Fraud,Female,60+,1543,971,572,1439,104
2003,Rural,Himachal Pradesh,Crime Against Children,Child Labor,Female,46-60,955,272,683,798,157
2004,Rural,Goa,Crime Against Men,Assault,Male,31-45,5338,3760,1578,3824,1514
2001,Urban,Meghalaya,Crime Against Women,Dowry Deaths,Male,18-30,9760,1526,8234,2944,6816
2001,Urban,Meghalaya,Property Crime,Theft,Male,0-12,6417,426,5991,1984,4433
2007,Urban,Tripura,Other Crimes,Cyber Crime,Male,0-12,7073,1735,5338,7029,44
2008,Rural,Mizoram,Crime Against Children,Child Labor,Female,18-30,8659,6277,2382,6876,1783
2006,Rural,West Bengal,Other Crimes,Fraud,Male,0-12,252,0,252,239,13
2005,Rural,Andhra Pradesh,Crime Against Children,Trafficking,Male,31-45,9732,5977,3755,6893,2839
2002,Rural,Delhi,Crime Against Women,Domestic Violence,Female,31-45,944,297,647,386,558
2007,Rural,Manipur,Other Crimes,Drug Offense,Female,46-60,1915,597,1318,1683,232
2005,Urban,Karnataka,Other Crimes,Drug Offense,Female,0-12,8701,2679,6022,7874,827
2003,Rural,Arunachal Pradesh,Crime Against Women,Domestic Violence,Female,13-17,5035,2712,2323,4649,386
2008,Urban,Uttarakhand,Property Crime,Arson,Female,13-17,8931,4323,4608,7342,1589
2009,Rural,Karnataka,Crime Against Men,Extortion,Male,0-12,7641,249,7392,4852,2789
2010,Urban,Meghalaya,Crime Against Children,Kidnapping,Male,31-45,4517,4288,229,4296,221
2006,Rural,Rajasthan,Property Crime,Vandalism,Male,46-60,2961,100,2861,2283,678
2001,Rural,Uttarakhand,Property Crime,Burglary,Male,13-17,1208,1079,129,1080,128
2006,Urban,Bihar,Crime Against Women,Domestic Violence,Female,18-30,5881,4482,1399,4963,918
2007,Rural,Karnataka,Other Crimes,Drug Offense,Male,18-30,3569,2321,1248,2381,1188
2005,Rural,Tamil Nadu,Crime Against Women,Molestation,Male,18-30,1568,1108,460,1475,93
2001,Rural,Jharkhand,Crime Against Men,Extortion,Male,31-45,863,499,364,675,188
2003,Rural,Arunachal Pradesh,Property Crime,Burglary,Male,0-12,6247,4799,1448,4912,1335
2007,Urban,Uttar Pradesh,Crime Against Women,Dowry Deaths,Female,60+,278,197,81,220,58
2002,Urban,Himachal Pradesh,Crime Against Women,Rape,Female,0-12,515,42,473,360,155
2004,Rural,Uttarakhand,Other Crimes,Corruption,Male,13-17,9684,8675,1009,8971,713
2005,Rural,Nagaland,Crime Against Men,Extortion,Male,60+,9079,3207,5872,8688,391
2004,Rural,Maharashtra,Property Crime,Vandalism,Female,46-60,2871,2721,150,2779,92
2009,Rural,Arunachal Pradesh,Property Crime,Theft,Female,18-30,4889,4511,378,4529,360
2009,Urban,Punjab,Other Crimes,Cyber Crime,Female,46-60,271,157,114,252,19
2007,Urban,Madhya Pradesh,Crime Against Children,Child Labor,Male,46-60,1074,519,555,820,254
2001,Urban,Rajasthan,Crime Against Women,Dowry Deaths,Female,46-60,6103,3992,2111,5123,980
2003,Rural,Assam,Property Crime,Theft,Male,31-45,451,13,438,354,97
2003,Rural,Maharashtra,Property Crime,Vandalism,Female,31-45,9270,6444,2826,6699,2571
2006,Urban,Delhi,Crime Against Men,Murder,Male,13-17,7595,505,7090,3564,4031
2007,Rural,Telangana,Other Crimes,Fraud,Female,31-45,4591,4351,240,4357,234
2003,Rural,Telangana,Property Crime,Arson,Female,0-12,7820,2912,4908,4006,3814
2009,Urban,Goa,Crime Against Women,Dowry Deaths,Male,46-60,5233,3440,1793,4889,344
2005,Rural,Goa,Other Crimes,Corruption,Male,31-45,3044,1616,1428,2274,770
2002,Urban,Karnataka,Crime Against Children,Trafficking,Male,31-45,261,226,35,255,6
2006,Rural,Goa,Crime Against Women,Molestation,Female,13-17,9510,6020,3490,7220,2290
2010,Urban,Madhya Pradesh,Crime Against Women,Dowry Deaths,Female,13-17,7761,1867,5894,6774,987
2007,Rural,Delhi,Crime Against Children,Trafficking,Female,46-60,1136,146,990,978,158
2010,Urban,Gujarat,Other Crimes,Fraud,Female,18-30,619,369,250,571,48
2007,Rural,Kerala,Crime Against Women,Domestic Violence,Female,0-12,5253,477,4776,2422,2831
2006,Rural,Tamil Nadu,Crime Against Children,Kidnapping,Male,0-12,7139,4491,2648,5815,1324
2008,Rural,Meghalaya,Crime Against Women,Dowry Deaths,Female,46-60,6697,3318,3379,3550,3147
2007,Urban,Nagaland,Crime Against Men,Assault,Male,13-17,7578,2568,5010,2615,4963
2009,Urban,Manipur,Crime Against Children,Trafficking,Male,31-45,537,174,363,357,180
2005,Rural,Arunachal Pradesh,Crime Against Women,Molestation,Female,0-12,2381,532,1849,2066,315
2004,Rural,Arunachal Pradesh,Other Crimes,Fraud,Female,0-12,3625,3001,624,3358,267
2010,Rural,Sikkim,Crime Against Men,Extortion,Female,46-60,3016,391,2625,2309,707
2009,Urban,Chhattisgarh,Crime Against Men,Assault,Female,13-17,1920,1628,292,1806,114
2001,Rural,Delhi,Other Crimes,Fraud,Male,18-30,4970,1257,3713,4824,146
2004,Urban,Madhya Pradesh,Other Crimes,Cyber Crime,Male,60+,9720,7127,2593,7712,2008
2008,Urban,Gujarat,Crime Against Men,Robbery,Male,0-12,4236,2058,2178,2325,1911
2010,Rural,Punjab,Property Crime,Arson,Female,46-60,4384,3939,445,4193,191
2002,Urban,Himachal Pradesh,Other Crimes,Drug Offense,Female,13-17,3954,2394,1560,2848,1106
2005,Urban,Telangana,Crime Against Children,Trafficking,Female,60+,1449,858,591,1276,173
2007,Urban,Jammu & Kashmir,Other Crimes,Corruption,Female,18-30,7061,384,6677,6176,885
2006,Rural,Punjab,Crime Against Children,Kidnapping,Male,13-17,6720,454,6266,1183,5537
2008,Urban,Mizoram,Property Crime,Theft,Female,13-17,7583,4033,3550,6652,931
2008,Rural,Telangana,Crime Against Men,Extortion,Female,60+,1051,775,276,1035,16
2009,Rural,Haryana,Crime Against Men,Robbery,Female,0-12,4635,959,3676,4326,309
2001,Urban,West Bengal,Crime Against Women,Molestation,Female,60+,1881,217,1664,824,1057
2009,Urban,Andhra Pradesh,Property Crime,Burglary,Male,31-45,9459,722,8737,5221,4238
2010,Urban,Telangana,Other Crimes,Drug Offense,Female,13-17,374,135,239,212,162
2010,Rural,Rajasthan,Crime Against Children,Child Abuse,Male,0-12,7237,3849,3388,6434,803
2008,Urban,Haryana,Crime Against Women,Domestic Violence,Male,18-30,6824,4053,2771,6350,474
2007,Urban,Mizoram,Other Crimes,Cyber Crime,Female,0-12,6272,2498,3774,5800,472
2002,Rural,West Bengal,Other Crimes,Corruption,Male,0-12,9609,3797,5812,9435,174
2008,Rural,Tamil Nadu,Crime Against Women,Dowry Deaths,Female,13-17,8286,1248,7038,5846,2440
2010,Rural,Mizoram,Crime Against Women,Domestic Violence,Male,46-60,412,380,32,390,22
2004,Rural,Mizoram,Other Crimes,Drug Offense,Male,0-12,8147,2125,6022,6421,1726
2001,Urban,Punjab,Crime Against Men,Assault,Male,31-45,2396,1329,1067,1659,737
2001,Urban,Bihar,Other Crimes,Corruption,Female,31-45,7201,2043,5158,6374,827
2004,Urban,Andhra Pradesh,Property Crime,Arson,Female,0-12,9493,5314,4179,6529,2964
2010,Rural,Sikkim,Property Crime,Vandalism,Female,0-12,1322,1022,300,1236,86
2007,Urban,Telangana,Other Crimes,Drug Offense,Male,60+,3141,579,2562,2564,577
2003,Rural,Jharkhand,Crime Against Men,Murder,Male,13-17,1255,806,449,1155,100
2006,Rural,Meghalaya,Other Crimes,Drug Offense,Male,0-12,9284,5314,3970,9168,116
2010,Urban,West Bengal,Crime Against Men,Assault,Male,0-12,1605,522,1083,537,1068
2009,Urban,Jharkhand,Crime Against Children,Child Abuse,Female,0-12,2269,1292,977,1512,757
2004,Urban,Punjab,Crime Against Women,Rape,Male,18-30,2689,2538,151,2582,107
2006,Rural,Karnataka,Crime Against Women,Domestic Violence,Male,60+,3573,3114,459,3352,221
2004,Urban,Tamil Nadu,Property Crime,Arson,Male,31-45,5405,1477,3928,3247,2158
2009,Rural,Uttar Pradesh,Other Crimes,Corruption,Male,46-60,7993,6288,1705,7739,254
2007,Urban,Punjab,Crime Against Men,Murder,Female,60+,4506,963,3543,1687,2819
2004,Urban,Uttar Pradesh,Property Crime,Arson,Male,18-30,7247,2197,5050,4401,2846
2010,Rural,Madhya Pradesh,Crime Against Women,Rape,Male,13-17,7714,7343,371,7460,254
2001,Rural,Karnataka,Crime Against Men,Extortion,Female,13-17,704,616,88,701,3
2006,Rural,Nagaland,Other Crimes,Corruption,Female,18-30,5535,3222,2313,4738,797
2009,Urban,Uttarakhand,Crime Against Men,Robbery,Male,18-30,7964,2630,5334,4829,3135
2005,Urban,Rajasthan,Crime Against Women,Rape,Female,18-30,2219,33,2186,1136,1083
2005,Urban,Tamil Nadu,Crime Against Children,Child Abuse,Female,46-60,7460,1435,6025,1861,5599
2008,Rural,Delhi,Property Crime,Arson,Female,13-17,806,43,763,523,283
2008,Urban,Karnataka,Crime Against Women,Rape,Male,31-45,612,278,334,284,328
2010,Rural,Karnataka,Other Crimes,Cyber Crime,Male,13-17,8488,4728,3760,7610,878
2003,Rural,Goa,Crime Against Men,Murder,Male,46-60,473,283,190,429,44
2002,Urban,Kerala,Other Crimes,Corruption,Male,13-17,2333,2010,323,2014,319
2010,Urban,Chhattisgarh,Property Crime,Theft,Female,60+,8089,6756,1333,7648,441
2003,Rural,Rajasthan,Other Crimes,Cyber Crime,Female,0-12,2316,1206,1110,1763,553
2009,Rural,Telangana,Crime Against Women,Rape,Male,31-45,603,468,135,502,101
2009,Urban,Bihar,Crime Against Men,Murder,Female,60+,2655,1894,761,2288,367
2006,Urban,Bihar,Crime Against Men,Extortion,Female,46-60,8929,3409,5520,6047,2882
2008,Rural,Delhi,Crime Against Women,Domestic Violence,Male,18-30,1614,305,1309,1292,322
2005,Urban,Chhattisgarh,Crime Against Women,Molestation,Male,13-17,6281,1093,5188,5097,1184
2005,Urban,Manipur,Property Crime,Burglary,Male,13-17,2959,335,2624,927,2032
2009,Urban,Meghalaya,Crime Against Women,Domestic Violence,Female,46-60,8760,6290,2470,6308,2452
2009,Urban,Uttarakhand,Crime Against Men,Extortion,Female,18-30,1115,838,277,1020,95
2004,Rural,West Bengal,Other Crimes,Corruption,Female,46-60,2543,118,2425,563,1980
2010,Urban,Kerala,Crime Against Men,Robbery,Male,31-45,5168,1024,4144,4027,1141
2008,Rural,Uttar Pradesh,Crime Against Men,Murder,Male,31-45,512,114,398,407,105
2004,Urban,Delhi,Crime Against Men,Murder,Male,0-12,1237,202,1035,1115,122
2007,Urban,Bihar,Other Crimes,Cyber Crime,Male,13-17,4856,2959,1897,3181,1675
2010,Rural,Punjab,Crime Against Women,Dowry Deaths,Female,46-60,7615,5194,2421,5254,2361
2004,Urban,Delhi,Crime Against Women,Domestic Violence,Female,0-12,5091,972,4119,1765,3326
2002,Rural,Arunachal Pradesh,Crime Against Women,Rape,Male,0-12,4069,1179,2890,1937,2132
2005,Rural,Tamil Nadu,Crime Against Men,Assault,Male,0-12,7100,5948,1152,6833,267
2001,Rural,Nagaland,Crime Against Men,Robbery,Female,60+,2014,1677,337,1694,320
2004,Rural,Punjab,Property Crime,Arson,Male,13-17,5311,1742,3569,4915,396
2007,Urban,Telangana,Property Crime,Burglary,Female,46-60,1527,516,1011,880,647
2010,Rural,Maharashtra,Property Crime,Burglary,Female,46-60,7507,2330,5177,6081,1426
2003,Rural,Telangana,Crime Against Women,Domestic Violence,Male,60+,2934,1511,1423,1684,1250
2006,Rural,Chhattisgarh,Other Crimes,Corruption,Male,60+,464,172,292,448,16
2009,Urban,Kerala,Crime Against Men,Robbery,Female,18-30,9104,3934,5170,7742,1362
2006,Rural,Uttarakhand,Property Crime,Vandalism,Female,60+,4567,220,4347,2452,2115
2001,Rural,Assam,Crime Against Men,Extortion,Female,13-17,7981,5771,2210,7496,485
2007,Urban,Uttar Pradesh,Crime Against Women,Molestation,Male,18-30,1070,807,263,1057,13
2010,Urban,Himachal Pradesh,Crime Against Men,Assault,Male,60+,4939,785,4154,4512,427
2009,Rural,Sikkim,Crime Against Women,Dowry Deaths,Male,18-30,3215,1121,2094,2626,589
2006,Rural,Chhattisgarh,Property Crime,Vandalism,Female,0-12,5600,432,5168,2541,3059
2009,Rural,Jammu & Kashmir,Other Crimes,Corruption,Female,46-60,9843,8004,1839,8269,1574
2009,Rural,Meghalaya,Crime Against Children,Trafficking,Female,0-12,423,251,172,265,158
2005,Urban,Haryana,Other Crimes,Cyber Crime,Female,46-60,9888,1714,8174,9382,506
2008,Urban,Assam,Crime Against Children,Trafficking,Female,31-45,4045,1304,2741,2095,1950
2010,Rural,Tripura,Crime Against Men,Assault,Female,18-30,7076,1961,5115,3940,3136
2003,Rural,Kerala,Crime Against Women,Domestic Violence,Male,60+,7390,4477,2913,6314,1076
2007,Rural,Maharashtra,Property Crime,Arson,Male,13-17,4912,865,4047,3247,1665
2009,Urban,Meghalaya,Other Crimes,Cyber Crime,Female,18-30,7512,7379,133,7406,106
2001,Urban,Madhya Pradesh,Property Crime,Vandalism,Female,0-12,5272,4281,991,5265,7
2003,Urban,Assam,Crime Against Men,Assault,Male,0-12,5639,4247,1392,5265,374
2007,Rural,West Bengal,Other Crimes,Corruption,Male,31-45,2146,1034,1112,1563,583
2008,Rural,Jammu & Kashmir,Crime Against Women,Dowry Deaths,Female,31-45,9980,7904,2076,9330,650
2005,Rural,Bihar,Property Crime,Theft,Female,13-17,4970,1936,3034,3051,1919
2003,Urban,Madhya Pradesh,Property Crime,Theft,Female,60+,1305,1305,0,1305,0
2010,Urban,Bihar,Crime Against Children,Child Abuse,Female,31-45,9571,1766,7805,9038,533
2008,Rural,Jharkhand,Other Crimes,Drug Offense,Male,60+,664,455,209,484,180
2003,Rural,West Bengal,Property Crime,Vandalism,Female,0-12,4193,1423,2770,1949,2244
2003,Rural,Mizoram,Property Crime,Arson,Male,60+,9490,3159,6331,4627,4863
2009,Urban,Telangana,Crime Against Children,Kidnapping,Male,60+,2018,1859,159,1960,58
2002,Urban,Jharkhand,Other Crimes,Fraud,Male,0-12,807,171,636,309,498
2004,Urban,Arunachal Pradesh,Crime Against Women,Molestation,Female,13-17,3264,1674,1590,2272,992
2007,Urban,Bihar,Other Crimes,Cyber Crime,Female,31-45,9227,2356,6871,5826,3401
2001,Urban,Arunachal Pradesh,Property Crime,Burglary,Male,46-60,1230,5,1225,696,534
2005,Urban,Arunachal Pradesh,Crime Against Children,Trafficking,Female,31-45,5099,968,4131,2611,2488
2008,Rural,Goa,Crime Against Children,Child Labor,Male,46-60,789,665,124,734,55
2005,Rural,Bihar,Crime Against Women,Rape,Female,31-45,1854,1082,772,1793,61
2003,Rural,Uttarakhand,Crime Against Men,Robbery,Male,13-17,2469,995,1474,2380,89
2007,Rural,Nagaland,Other Crimes,Cyber Crime,Female,13-17,3576,2691,885,2830,746
2009,Urban,West Bengal,Property Crime,Burglary,Male,18-30,5748,1766,3982,1981,3767
2005,Urban,Himachal Pradesh,Crime Against Men,Extortion,Male,0-12,7433,3179,4254,4857,2576
2002,Rural,Assam,Other Crimes,Fraud,Male,13-17,6863,1001,5862,2647,4216
2005,Rural,Haryana,Property Crime,Arson,Female,13-17,3050,1437,1613,1597,1453
2006,Rural,Arunachal Pradesh,Property Crime,Burglary,Male,13-17,4873,2563,2310,4676,197
2010,Urban,Tamil Nadu,Other Crimes,Drug Offense,Female,18-30,8399,6471,1928,8338,61
2003,Rural,Punjab,Crime Against Men,Murder,Female,13-17,5581,4989,592,5538,43
2002,Urban,Kerala,Property Crime,Vandalism,Male,13-17,6994,1252,5742,1605,5389
2001,Rural,Telangana,Crime Against Men,Assault,Male,18-30,156,22,134,116,40
2002,Rural,Manipur,Other Crimes,Cyber Crime,Male,18-30,6085,3934,2151,5589,496
2009,Rural,Nagaland,Property Crime,Arson,Male,0-12,1692,563,1129,1043,649
2002,Rural,Rajasthan,Crime Against Women,Domestic Violence,Male,60+,6676,2983,3693,5755,921
2001,Rural,Meghalaya,Crime Against Women,Domestic Violence,Female,18-30,4794,21,4773,2749,2045
2002,Urban,Kerala,Crime Against Women,Molestation,Male,13-17,355,172,183,338,17
2001,Rural,Odisha,Other Crimes,Drug Offense,Male,13-17,7355,2836,4519,4682,2673
2004,Urban,Assam,Crime Against Men,Robbery,Female,31-45,6099,5815,284,5976,123
2010,Urban,Bihar,Crime Against Children,Child Labor,Male,0-12,103,5,98,37,66
2004,Urban,Jammu & Kashmir,Crime Against Children,Trafficking,Female,18-30,5216,1389,3827,2048,3168
2009,Urban,Tamil Nadu,Property Crime,Arson,Male,46-60,6484,405,6079,1956,4528
2003,Urban,Jharkhand,Property Crime,Burglary,Female,46-60,4699,1295,3404,4285,414
2009,Urban,Chhattisgarh,Crime Against Women,Dowry Deaths,Female,13-17,7107,5485,1622,5665,1442
2008,Urban,Uttarakhand,Crime Against Men,Assault,Female,13-17,6345,4137,2208,5833,512
2006,Rural,Manipur,Crime Against Women,Molestation,Male,60+,4930,4284,646,4631,299
2003,Rural,Goa,Crime Against Children,Trafficking,Male,0-12,9701,120,9581,5627,4074
2010,Rural,Jharkhand,Crime Against Men,Robbery,Male,13-17,4338,3064,1274,4148,190
2007,Rural,Himachal Pradesh,Other Crimes,Cyber Crime,Male,18-30,7598,3954,3644,7177,421
2006,Urban,Telangana,Crime Against Women,Domestic Violence,Male,18-30,5418,4700,718,5215,203
2004,Urban,Jharkhand,Crime Against Men,Murder,Female,31-45,8184,3695,4489,5101,3083
2008,Rural,Arunachal Pradesh,Crime Against Men,Murder,Male,46-60,6457,1461,4996,3627,2830
2008,Rural,Punjab,Property Crime,Vandalism,Female,18-30,6911,346,6565,1528,5383
2004,Rural,Nagaland,Other Crimes,Corruption,Male,31-45,8517,1379,7138,6266,2251
2007,Urban,Assam,Crime Against Men,Murder,Male,18-30,9779,1316,8463,3508,6271
2010,Urban,Uttarakhand,Property Crime,Arson,Female,60+,8673,8633,40,8672,1
2005,Urban,Meghalaya,Crime Against Men,Extortion,Female,18-30,4249,2254,1995,3908,341
2007,Urban,Telangana,Crime Against Men,Murder,Female,46-60,8844,3965,4879,4682,4162
2001,Rural,Uttarakhand,Other Crimes,Corruption,Female,46-60,4552,4315,237,4398,154
2010,Urban,Meghalaya,Crime Against Men,Robbery,Female,60+,7436,1360,6076,5368,2068
2002,Rural,Nagaland,Crime Against Men,Assault,Male,60+,3233,2016,1217,2068,1165
2007,Rural,Nagaland,Crime Against Women,Dowry Deaths,Female,13-17,4466,3037,1429,3901,565
2002,Urban,Nagaland,Crime Against Children,Trafficking,Female,60+,7457,4370,3087,5997,1460
2007,Urban,West Bengal,Crime Against Men,Assault,Male,60+,2256,492,1764,509,1747
2007,Rural,Goa,Crime Against Women,Rape,Female,0-12,7269,4060,3209,4359,2910
2008,Urban,Kerala,Other Crimes,Corruption,Female,18-30,7512,5436,2076,6086,1426
2002,Urban,Haryana,Property Crime,Arson,Female,31-45,280,157,123,249,31
2002,Rural,Uttarakhand,Property Crime,Theft,Male,0-12,563,206,357,535,28
2006,Rural,Himachal Pradesh,Crime Against Children,Child Labor,Male,31-45,4467,2226,2241,3799,668
2004,Urban,Telangana,Crime Against Women,Molestation,Female,18-30,6851,11,6840,4232,2619
2008,Urban,West Bengal,Crime Against Men,Assault,Female,31-45,4023,157,3866,852,3171
2004,Urban,Punjab,Property Crime,Arson,Male,13-17,3041,2486,555,2980,61
2007,Urban,Assam,Crime Against Women,Dowry Deaths,Female,13-17,4443,2393,2050,4279,164
2008,Rural,Jharkhand,Other Crimes,Fraud,Female,13-17,8166,6119,2047,7211,955
2004,Rural,Goa,Property Crime,Burglary,Male,0-12,5271,5237,34,5262,9
2006,Rural,Meghalaya,Crime Against Men,Robbery,Female,0-12,9463,4285,5178,8218,1245
2007,Rural,Manipur,Other Crimes,Corruption,Female,13-17,5559,325,5234,2009,3550
2008,Rural,Mizoram,Property Crime,Arson,Male,60+,2549,2127,422,2160,389
2007,Rural,Arunachal Pradesh,Crime Against Children,Child Labor,Male,60+,5889,2152,3737,3468,2421
2002,Rural,Andhra Pradesh,Other Crimes,Corruption,Female,60+,3229,1950,1279,2016,1213
2002,Rural,Arunachal Pradesh,Crime Against Women,Domestic Violence,Male,31-45,2996,1593,1403,1939,1057
2005,Urban,Haryana,Other Crimes,Drug Offense,Female,18-30,9852,6366,3486,6612,3240
2010,Urban,Tripura,Crime Against Children,Child Abuse,Male,46-60,8035,6809,1226,7559,476
2007,Rural,Mizoram,Crime Against Children,Kidnapping,Male,31-45,9756,5251,4505,7723,2033
2007,Rural,Tamil Nadu,Other Crimes,Drug Offense,Female,0-12,1593,396,1197,502,1091
2002,Urban,Andhra Pradesh,Crime Against Women,Molestation,Male,31-45,4185,1785,2400,3223,962
2008,Urban,Maharashtra,Crime Against Children,Trafficking,Female,13-17,6211,864,5347,5129,1082
2007,Rural,West Bengal,Crime Against Women,Rape,Female,18-30,2660,1818,842,1933,727
2002,Rural,Tamil Nadu,Crime Against Women,Rape,Male,18-30,7257,5614,1643,6615,642
2010,Urban,Bihar,Crime Against Women,Molestation,Male,46-60,4718,1791,2927,4509,209
2001,Urban,Kerala,Crime Against Women,Rape,Female,0-12,4650,4318,332,4383,267
2006,Rural,Sikkim,Property Crime,Arson,Female,31-45,4998,3189,1809,4983,15
2006,Rural,Uttarakhand,Property Crime,Arson,Male,0-12,3259,2274,985,2941,318
2007,Rural,Maharashtra,Property Crime,Burglary,Male,46-60,7640,1448,6192,4722,2918
2005,Rural,Sikkim,Crime Against Men,Assault,Female,46-60,3353,272,3081,2710,643
2003,Rural,Manipur,Property Crime,Theft,Female,46-60,4894,174,4720,760,4134
2002,Urban,Uttar Pradesh,Other Crimes,Fraud,Male,0-12,7544,7269,275,7281,263
2001,Urban,Maharashtra,Property Crime,Burglary,Male,46-60,7741,1450,6291,2511,5230
2003,Rural,Uttarakhand,Property Crime,Vandalism,Female,46-60,5381,3416,1965,4497,884
2002,Rural,Chhattisgarh,Crime Against Men,Robbery,Male,18-30,51,45,6,50,1
2008,Rural,Madhya Pradesh,Crime Against Women,Rape,Male,60+,3491,2497,994,2892,599
2010,Urban,Gujarat,Other Crimes,Drug Offense,Male,18-30,2858,2675,183,2753,105
2001,Urban,Chhattisgarh,Other Crimes,Fraud,Female,18-30,6870,2271,4599,5079,1791
2002,Urban,Meghalaya,Other Crimes,Corruption,Male,13-17,566,134,432,353,213
2004,Urban,Uttar Pradesh,Other Crimes,Corruption,Female,0-12,8949,7439,1510,8483,466
2006,Rural,Andhra Pradesh,Other Crimes,Fraud,Male,13-17,5676,2227,3449,4856,820
2001,Urban,Tripura,Crime Against Men,Robbery,Male,46-60,7050,4826,2224,5587,1463
2007,Rural,Meghalaya,Property Crime,Burglary,Female,46-60,9434,920,8514,5645,3789
2003,Urban,Manipur,Crime Against Women,Dowry Deaths,Male,13-17,8794,4295,4499,8206,588
2002,Urban,Sikkim,Other Crimes,Cyber Crime,Male,0-12,4576,2453,2123,2668,1908
2007,Rural,Tamil Nadu,Crime Against Men,Assault,Male,46-60,4785,4719,66,4776,9
2006,Rural,Chhattisgarh,Crime Against Women,Dowry Deaths,Female,13-17,1385,1311,74,1328,57
2009,Urban,Rajasthan,Crime Against Women,Dowry Deaths,Male,0-12,4452,2254,2198,4180,272
2005,Rural,Arunachal Pradesh,Crime Against Children,Child Abuse,Female,60+,4027,1807,2220,3580,447
2005,Urban,Nagaland,Other Crimes,Fraud,Female,0-12,3735,2543,1192,3033,702
2006,Urban,Goa,Crime Against Women,Dowry Deaths,Male,60+,6917,2879,4038,4078,2839
2010,Rural,Meghalaya,Crime Against Men,Murder,Male,18-30,1710,499,1211,1563,147
2005,Rural,Chhattisgarh,Crime Against Women,Dowry Deaths,Female,13-17,4803,4777,26,4785,18
2010,Rural,Madhya Pradesh,Crime Against Children,Child Abuse,Male,18-30,692,39,653,142,550
2006,Urban,Himachal Pradesh,Crime Against Men,Murder,Female,31-45,601,205,396,303,298
2003,Rural,Jammu & Kashmir,Other Crimes,Fraud,Female,46-60,6379,4738,1641,5289,1090
2004,Urban,Mizoram,Property Crime,Arson,Male,31-45,5597,736,4861,2972,2625
2008,Urban,Haryana,Property Crime,Arson,Female,60+,8621,1434,7187,2371,6250
2003,Urban,Jammu & Kashmir,Crime Against Men,Extortion,Male,60+,2050,1745,305,1971,79
2010,Rural,Uttarakhand,Other Crimes,Cyber Crime,Male,0-12,7337,5889,1448,6518,819
2002,Urban,Sikkim,Crime Against Children,Child Labor,Male,13-17,904,756,148,758,146
2005,Urban,Madhya Pradesh,Crime Against Men,Murder,Male,31-45,8438,6914,1524,8311,127
2002,Rural,Madhya Pradesh,Crime Against Women,Domestic Violence,Female,13-17,9177,8689,488,9047,130
2001,Rural,Odisha,Property Crime,Burglary,Male,18-30,279,31,248,120,159
2008,Urban,Kerala,Crime Against Men,Extortion,Female,18-30,8046,4860,3186,7033,1013
2010,Urban,Andhra Pradesh,Crime Against Men,Extortion,Male,60+,6770,266,6504,1399,5371
2007,Urban,Uttarakhand,Property Crime,Vandalism,Female,60+,4836,4150,686,4156,680
2006,Urban,Kerala,Crime Against Children,Child Labor,Male,60+,6312,1278,5034,4806,1506
2002,Rural,Manipur,Crime Against Men,Murder,Male,18-30,2166,1706,460,1829,337
2010,Rural,Chhattisgarh,Crime Against Women,Dowry Deaths,Female,18-30,104,84,20,98,6
2010,Rural,Rajasthan,Other Crimes,Corruption,Male,13-17,5423,371,5052,2879,2544
2009,Urban,Assam,Crime Against Men,Robbery,Female,46-60,6126,52,6074,202,5924
2004,Urban,Arunachal Pradesh,Crime Against Women,Domestic Violence,Female,60+,5627,3444,2183,4967,660
2010,Rural,Arunachal Pradesh,Crime Against Men,Assault,Male,18-30,3703,1201,2502,3457,246
2005,Urban,Assam,Crime Against Men,Murder,Female,60+,5956,5519,437,5638,318
2009,Rural,Sikkim,Crime Against Children,Trafficking,Female,31-45,8342,7633,709,8014,328
2004,Rural,Manipur,Other Crimes,Fraud,Male,60+,1009,674,335,832,177
2002,Urban,West Bengal,Property Crime,Arson,Male,31-45,1782,1655,127,1694,88
2007,Urban,Odisha,Crime Against Children,Child Abuse,Female,60+,9222,3139,6083,6553,2669
2009,Rural,Tamil Nadu,Crime Against Women,Dowry Deaths,Male,18-30,9563,747,8816,4411,5152
2005,Rural,Delhi,Crime Against Children,Trafficking,Female,13-17,4748,2546,2202,4579,169
2002,Rural,Odisha,Property Crime,Burglary,Male,0-12,4507,2933,1574,3993,514
2010,Rural,Jammu & Kashmir,Property Crime,Vandalism,Male,18-30,5977,2418,3559,4280,1697
2001,Urban,Manipur,Other Crimes,Fraud,Male,0-12,8023,5530,2493,7016,1007
2007,Urban,Haryana,Property Crime,Arson,Female,46-60,5064,1528,3536,4324,740
2005,Rural,Chhattisgarh,Property Crime,Burglary,Female,0-12,7091,1051,6040,4379,2712
2007,Rural,West Bengal,Crime Against Children,Trafficking,Male,31-45,911,101,810,244,667
2002,Rural,Rajasthan,Other Crimes,Cyber Crime,Male,13-17,8873,8758,115,8832,41
2001,Urban,Punjab,Crime Against Women,Domestic Violence,Male,13-17,8546,301,8245,1096,7450
2010,Rural,Rajasthan,Crime Against Children,Kidnapping,Female,60+,767,507,260,570,197
2009,Rural,Andhra Pradesh,Crime Against Men,Extortion,Female,46-60,7346,2825,4521,3113,4233
2010,Urban,Meghalaya,Crime Against Men,Extortion,Male,18-30,9878,8325,1553,9616,262
2006,Urban,Arunachal Pradesh,Property Crime,Theft,Female,18-30,4116,2156,1960,3238,878
2001,Rural,Goa,Crime Against Men,Assault,Male,60+,6456,4265,2191,4850,1606
2001,Urban,Chhattisgarh,Property Crime,Burglary,Female,0-12,7500,3047,4453,4874,2626
2002,Urban,Chhattisgarh,Crime Against Children,Child Abuse,Male,46-60,2848,392,2456,1221,1627
2006,Urban,Gujarat,Property Crime,Burglary,Female,13-17,3100,980,2120,2128,972
2005,Rural,Maharashtra,Crime Against Men,Extortion,Female,31-45,7560,5871,1689,7407,153
2010,Urban,Uttarakhand,Crime Against Women,Dowry Deaths,Female,60+,2173,1241,932,1778,395
2005,Rural,Haryana,Other Crimes,Cyber Crime,Female,13-17,1249,28,1221,863,386
2004,Rural,Assam,Property Crime,Burglary,Male,18-30,5293,1684,3609,4479,814
2001,Rural,Tripura,Other Crimes,Corruption,Male,60+,3280,2706,574,3278,2
2002,Rural,Goa,Crime Against Men,Robbery,Female,60+,6560,1861,4699,5458,1102
2004,Urban,Karnataka,Crime Against Children,Child Abuse,Male,13-17,3146,2455,691,2913,233
2009,Rural,Sikkim,Property Crime,Theft,Female,18-30,6385,1358,5027,5325,1060
2001,Rural,Assam,Other Crimes,Corruption,Female,60+,437,255,182,365,72
2005,Urban,Bihar,Property Crime,Arson,Male,13-17,5107,1870,3237,4852,255
2010,Urban,Rajasthan,Crime Against Women,Domestic Violence,Male,18-30,4368,469,3899,2757,1611
2010,Rural,Bihar,Crime Against Men,Murder,Male,31-45,4031,3149,882,3586,445
2007,Urban,Madhya Pradesh,Property Crime,Arson,Female,13-17,2594,853,1741,1962,632
2010,Rural,Tamil Nadu,Crime Against Men,Robbery,Male,18-30,5300,673,4627,4118,1182
2004,Rural,Bihar,Crime Against Children,Child Labor,Male,46-60,7451,2768,4683,4299,3152
2010,Urban,Haryana,Other Crimes,Corruption,Male,46-60,5084,3178,1906,4489,595
2008,Urban,Andhra Pradesh,Crime Against Children,Child Labor,Female,13-17,2918,2266,652,2638,280
2002,Urban,Punjab,Property Crime,Theft,Male,13-17,5211,2485,2726,5135,76
2006,Urban,Uttarakhand,Property Crime,Vandalism,Male,13-17,5940,137,5803,4544,1396
2001,Rural,Jharkhand,Crime Against Women,Rape,Male,46-60,8924,8879,45,8890,34
2002,Rural,Telangana,Property Crime,Vandalism,Female,60+,7539,2783,4756,5457,2082
2002,Rural,Himachal Pradesh,Crime Against Children,Trafficking,Female,60+,2810,2725,85,2752,58
2008,Rural,Nagaland,Crime Against Children,Trafficking,Female,0-12,9785,5910,3875,9450,335
2001,Urban,Rajasthan,Property Crime,Theft,Male,46-60,7862,6839,1023,7779,83
2008,Urban,Tamil Nadu,Crime Against Women,Molestation,Male,18-30,3225,863,2362,1414,1811
2003,Rural,Chhattisgarh,Other Crimes,Corruption,Male,31-45,3667,3360,307,3441,226
2003,Urban,Jammu & Kashmir,Crime Against Men,Robbery,Female,13-17,7311,2067,5244,3926,3385
2009,Rural,Punjab,Crime Against Men,Extortion,Female,13-17,1286,877,409,1176,110
2010,Urban,Rajasthan,Property Crime,Vandalism,Female,18-30,1294,820,474,1223,71
2009,Rural,Himachal Pradesh,Crime Against Children,Kidnapping,Female,60+,4305,2374,1931,3039,1266
2010,Urban,Sikkim,Property Crime,Theft,Male,13-17,4396,4128,268,4387,9
2005,Rural,Punjab,Crime Against Men,Extortion,Female,46-60,988,363,625,751,237
2003,Rural,Punjab,Crime Against Children,Trafficking,Female,46-60,2353,1372,981,1617,736
2008,Rural,West Bengal,Other Crimes,Drug Offense,Male,46-60,5902,4054,1848,4558,1344
2008,Rural,Andhra Pradesh,Property Crime,Burglary,Female,31-45,6195,2420,3775,2546,3649
2007,Rural,Uttarakhand,Other Crimes,Cyber Crime,Female,18-30,6141,4744,1397,5431,710
2008,Rural,Odisha,Crime Against Men,Murder,Female,60+,5033,1661,3372,3240,1793
2002,Urban,Karnataka,Crime Against Men,Extortion,Female,13-17,3710,1280,2430,1672,2038
2007,Rural,Nagaland,Crime Against Women,Domestic Violence,Female,13-17,9300,3322,5978,7177,2123
2006,Rural,Gujarat,Crime Against Men,Assault,Female,31-45,8323,5609,2714,7291,1032
2002,Urban,West Bengal,Other Crimes,Cyber Crime,Male,60+,4481,1713,2768,3388,1093
2003,Urban,Tripura,Crime Against Men,Robbery,Female,31-45,4025,3627,398,3683,342
2008,Rural,Maharashtra,Crime Against Women,Dowry Deaths,Male,0-12,5192,2939,2253,5082,110
2002,Rural,Delhi,Other Crimes,Drug Offense,Female,60+,9645,762,8883,1919,7726
2010,Rural,Chhattisgarh,Other Crimes,Fraud,Female,13-17,2482,1178,1304,2075,407
2009,Urban,Chhattisgarh,Other Crimes,Cyber Crime,Female,60+,8124,3702,4422,6783,1341
2007,Urban,Jammu & Kashmir,Property Crime,Arson,Male,13-17,3692,2452,1240,3640,52
2001,Rural,Tripura,Crime Against Women,Rape,Male,46-60,6744,1412,5332,5129,1615
2006,Urban,Uttar Pradesh,Crime Against Children,Trafficking,Male,18-30,1224,121,1103,1080,144
2003,Urban,Uttarakhand,Crime Against Children,Child Abuse,Female,60+,5601,249,5352,3174,2427
2001,Rural,Odisha,Property Crime,Vandalism,Female,60+,5369,3907,1462,5261,108
2003,Urban,Tripura,Other Crimes,Drug Offense,Male,60+,2070,134,1936,842,1228
2005,Urban,Tamil Nadu,Crime Against Men,Extortion,Male,46-60,9203,2495,6708,6754,2449
2008,Rural,Gujarat,Other Crimes,Fraud,Female,0-12,1170,1152,18,1165,5
2003,Rural,Odisha,Crime Against Children,Trafficking,Male,0-12,2453,670,1783,713,1740
2001,Rural,Madhya Pradesh,Crime Against Women,Rape,Male,60+,2928,1762,1166,2909,19
2002,Rural,Maharashtra,Crime Against Children,Child Labor,Male,31-45,9137,3272,5865,4343,4794
2009,Urban,West Bengal,Property Crime,Theft,Female,13-17,3251,2766,485,3074,177
2007,Urban,Odisha,Crime Against Children,Kidnapping,Female,13-17,9004,5338,3666,7707,1297
2003,Urban,Himachal Pradesh,Crime Against Children,Child Abuse,Female,31-45,1969,1631,338,1910,59
2006,Urban,Jammu & Kashmir,Crime Against Men,Robbery,Male,18-30,7312,6763,549,6859,453
2010,Urban,Tamil Nadu,Other Crimes,Corruption,Male,18-30,3388,2551,837,3119,269
2007,Urban,Madhya Pradesh,Property Crime,Theft,Female,18-30,4716,2155,2561,2432,2284
2003,Rural,Tripura,Crime Against Men,Extortion,Female,0-12,5479,4375,1104,5083,396
2006,Urban,Manipur,Other Crimes,Cyber Crime,Female,18-30,1096,228,868,547,549
2007,Rural,Rajasthan,Property Crime,Theft,Female,0-12,260,183,77,187,73
2004,Rural,Arunachal Pradesh,Crime Against Men,Robbery,Male,13-17,2854,2834,20,2838,16
2001,Rural,Karnataka,Crime Against Women,Domestic Violence,Female,46-60,9200,1746,7454,8617,583
2003,Urban,Goa,Crime Against Women,Molestation,Male,31-45,6481,989,5492,4259,2222
2007,Rural,Tamil Nadu,Crime Against Women,Molestation,Female,0-12,8572,4308,4264,8176,396
2003,Rural,Punjab,Crime Against Men,Extortion,Male,31-45,5413,4841,572,5204,209
2004,Rural,Kerala,Property Crime,Burglary,Male,60+,4625,2900,1725,3074,1551
2008,Rural,Odisha,Property Crime,Burglary,Male,60+,2355,1824,531,1842,513
2002,Rural,West Bengal,Property Crime,Vandalism,Male,0-12,3563,1964,1599,3047,516
2010,Rural,Bihar,Crime Against Men,Murder,Female,46-60,1458,1262,196,1388,70
2010,Rural,Himachal Pradesh,Crime Against Men,Extortion,Female,60+,3296,1441,1855,3073,223
2005,Urban,Punjab,Crime Against Men,Assault,Male,13-17,804,129,675,137,667
2007,Rural,Delhi,Crime Against Children,Kidnapping,Female,31-45,7982,2593,5389,7819,163
2002,Urban,Bihar,Crime Against Men,Murder,Female,46-60,7181,747,6434,2595,4586
2009,Urban,Jammu & Kashmir,Crime Against Men,Extortion,Female,18-30,5263,3626,1637,3802,1461
2008,Urban,Bihar,Property Crime,Vandalism,Female,0-12,9923,9658,265,9674,249
2003,Rural,Bihar,Crime Against Children,Kidnapping,Female,13-17,6747,3720,3027,4283,2464
2006,Rural,Haryana,Property Crime,Burglary,Female,31-45,3494,2976,518,3035,459
2004,Urban,Odisha,Crime Against Men,Assault,Female,46-60,779,437,342,767,12
2001,Rural,Chhattisgarh,Crime Against Men,Murder,Male,46-60,7222,5467,1755,6839,383
2002,Urban,Haryana,Other Crimes,Fraud,Female,60+,7414,4203,3211,5998,1416
2006,Rural,Andhra Pradesh,Crime Against Women,Dowry Deaths,Male,18-30,9945,4070,5875,7478,2467
2003,Rural,Kerala,Crime Against Men,Extortion,Male,60+,4832,3888,944,4490,342
2003,Urban,Jammu & Kashmir,Property Crime,Theft,Male,46-60,7685,2925,4760,7312,373
2007,Rural,Sikkim,Crime Against Women,Molestation,Male,13-17,2780,843,1937,1370,1410
2010,Rural,Gujarat,Crime Against Men,Extortion,Female,0-12,8579,3120,5459,4354,4225
2007,Rural,Manipur,Other Crimes,Fraud,Female,18-30,9467,2164,7303,9153,314
2005,Rural,Chhattisgarh,Property Crime,Arson,Female,0-12,8559,2945,5614,4328,4231
2004,Rural,Arunachal Pradesh,Property Crime,Vandalism,Male,31-45,6101,5555,546,5571,530
2009,Urban,Gujarat,Crime Against Women,Domestic Violence,Female,0-12,1023,34,989,882,141
2006,Rural,Meghalaya,Crime Against Women,Dowry Deaths,Male,0-12,3586,3116,470,3181,405
2002,Urban,Arunachal Pradesh,Crime Against Children,Kidnapping,Female,0-12,7936,5477,2459,6336,1600
2009,Rural,Assam,Other Crimes,Drug Offense,Female,31-45,3583,669,2914,2590,993
2002,Urban,Assam,Property Crime,Arson,Male,60+,2575,669,1906,705,1870
2002,Rural,Tamil Nadu,Other Crimes,Corruption,Male,13-17,4842,4077,765,4435,407
2007,Rural,Manipur,Property Crime,Theft,Male,46-60,8994,7368,1626,8244,750
2004,Rural,Jharkhand,Property Crime,Vandalism,Female,13-17,3488,1572,1916,3239,249
2009,Urban,Arunachal Pradesh,Crime Against Children,Trafficking,Female,60+,5291,2969,2322,3764,1527
2002,Urban,Andhra Pradesh,Property Crime,Burglary,Male,0-12,5281,4982,299,5278,3
2006,Urban,Haryana,Crime Against Men,Robbery,Male,31-45,3094,2966,128,3012,82
2010,Rural,Sikkim,Property Crime,Vandalism,Male,31-45,2122,1932,190,1932,190
2007,Urban,Assam,Other Crimes,Fraud,Male,13-17,1334,761,573,1232,102
2003,Urban,Jammu & Kashmir,Property Crime,Vandalism,Female,18-30,5585,5106,479,5205,380
2003,Rural,Odisha,Crime Against Men,Extortion,Female,60+,5251,2730,2521,3445,1806
2002,Rural,Manipur,Crime Against Women,Dowry Deaths,Male,60+,3428,1438,1990,2904,524
2003,Urban,Maharashtra,Crime Against Men,Assault,Female,18-30,8707,4783,3924,8449,258
2003,Urban,Meghalaya,Property Crime,Arson,Female,13-17,2194,2045,149,2077,117
2001,Urban,Meghalaya,Crime Against Women,Dowry Deaths,Female,60+,1761,4,1757,954,807
2004,Urban,Haryana,Property Crime,Theft,Female,31-45,4757,1543,3214,1864,2893
2007,Rural,Delhi,Crime Against Men,Robbery,Female,31-45,6584,2103,4481,2599,3985
2007,Rural,Nagaland,Other Crimes,Cyber Crime,Female,60+,4704,3013,1691,3284,1420
2002,Urban,Goa,Crime Against Children,Child Abuse,Female,46-60,7373,200,7173,6753,620
2001,Urban,Jammu & Kashmir,Crime Against Women,Rape,Female,18-30,5748,3200,2548,3839,1909
2009,Urban,Delhi,Crime Against Women,Molestation,Male,31-45,3167,2880,287,3089,78
2005,Urban,Chhattisgarh,Property Crime,Arson,Female,18-30,1866,1259,607,1404,462
2004,Rural,Tamil Nadu,Other Crimes,Drug Offense,Female,0-12,6243,4257,1986,5225,1018
2007,Rural,Telangana,Property Crime,Vandalism,Male,60+,7648,3755,3893,5683,1965
2007,Urban,Punjab,Crime Against Men,Murder,Female,46-60,4292,386,3906,2736,1556
2002,Rural,Telangana,Crime Against Men,Robbery,Female,0-12,8132,6901,1231,7739,393
2005,Rural,Goa,Property Crime,Arson,Female,18-30,3220,239,2981,2626,594
2006,Urban,Haryana,Crime Against Women,Rape,Male,0-12,8016,3775,4241,7216,800
2006,Rural,Punjab,Other Crimes,Fraud,Male,60+,6295,776,5519,3224,3071
2005,Rural,Sikkim,Crime Against Children,Child Abuse,Male,0-12,1315,884,431,948,367
2002,Urban,West Bengal,Property Crime,Burglary,Male,18-30,4436,2024,2412,2647,1789
2006,Rural,Goa,Crime Against Children,Child Abuse,Male,0-12,2639,748,1891,1582,1057
2005,Urban,Himachal Pradesh,Crime Against Men,Assault,Male,18-30,8241,5508,2733,6782,1459
2003,Rural,Rajasthan,Property Crime,Vandalism,Male,31-45,5620,815,4805,2809,2811
2004,Rural,Assam,Crime Against Children,Child Labor,Female,0-12,333,244,89,329,4
2006,Rural,Chhattisgarh,Crime Against Men,Robbery,Female,60+,9583,8185,1398,8345,1238
2008,Urban,Delhi,Other Crimes,Cyber Crime,Male,13-17,7059,2165,4894,6613,446
2010,Urban,Uttarakhand,Other Crimes,Fraud,Male,60+,952,374,578,478,474
2010,Urban,Delhi,Property Crime,Vandalism,Male,18-30,1225,384,841,1140,85
2004,Urban,Uttar Pradesh,Other Crimes,Fraud,Male,0-12,4747,2378,2369,3028,1719
2005,Urban,Nagaland,Property Crime,Theft,Male,18-30,6928,4501,2427,6591,337
2007,Rural,Chhattisgarh,Crime Against Men,Robbery,Female,60+,3139,1163,1976,2852,287
2001,Rural,West Bengal,Crime Against Children,Child Labor,Male,0-12,3629,2256,1373,3385,244
2005,Rural,Goa,Other Crimes,Cyber Crime,Female,18-30,6182,2082,4100,2254,3928
2002,Rural,Chhattisgarh,Property Crime,Arson,Female,13-17,5695,483,5212,780,4915
2005,Rural,Chhattisgarh,Property Crime,Burglary,Female,13-17,1905,1882,23,1887,18
2005,Urban,Andhra Pradesh,Property Crime,Vandalism,Male,46-60,8942,4366,4576,6752,2190
2009,Rural,Uttar Pradesh,Crime Against Women,Rape,Male,0-12,2728,2227,501,2345,383
2007,Urban,Jammu & Kashmir,Other Crimes,Cyber Crime,Male,60+,5146,887,4259,2178,2968
2008,Urban,Nagaland,Other Crimes,Cyber Crime,Female,31-45,4559,2360,2199,4164,395
2004,Rural,Gujarat,Crime Against Children,Kidnapping,Female,31-45,6753,2461,4292,5542,1211
2003,Urban,Tripura,Crime Against Women,Dowry Deaths,Female,46-60,160,159,1,159,1
2005,Urban,Uttarakhand,Crime Against Women,Dowry Deaths,Male,0-12,4142,2282,1860,4068,74
2001,Rural,Mizoram,Crime Against Women,Dowry Deaths,Male,31-45,9385,373,9012,3338,6047
2008,Urban,Tripura,Crime Against Men,Assault,Female,31-45,4307,3259,1048,3743,564
2009,Urban,Karnataka,Property Crime,Burglary,Male,31-45,408,408,0,408,0
2009,Rural,Gujarat,Property Crime,Arson,Female,60+,5785,3163,2622,5199,586
2006,Rural,Kerala,Crime Against Women,Dowry Deaths,Female,13-17,5939,4339,1600,4667,1272
2003,Rural,Goa,Property Crime,Burglary,Female,46-60,4560,1846,2714,3422,1138
2009,Urban,Madhya Pradesh,Crime Against Men,Murder,Male,13-17,9227,9166,61,9181,46
2001,Rural,Meghalaya,Crime Against Children,Child Abuse,Female,18-30,1591,1348,243,1543,48
2005,Rural,Madhya Pradesh,Crime Against Children,Child Labor,Male,60+,9041,5690,3351,5975,3066
2004,Rural,Bihar,Crime Against Women,Rape,Male,60+,7579,1708,5871,1974,5605
2008,Rural,Jammu & Kashmir,Crime Against Men,Assault,Female,18-30,9761,6413,3348,9171,590
2010,Urban,Manipur,Crime Against Women,Rape,Male,46-60,7270,2778,4492,4274,2996
2008,Urban,Madhya Pradesh,Crime Against Men,Extortion,Female,18-30,118,115,3,115,3
2007,Urban,Tripura,Crime Against Women,Rape,Male,13-17,2516,2046,470,2388,128
2009,Rural,Maharashtra,Crime Against Men,Murder,Female,13-17,4569,931,3638,2548,2021
2007,Urban,Gujarat,Other Crimes,Cyber Crime,Male,0-12,6196,196,6000,2269,3927
2004,Rural,Telangana,Crime Against Men,Extortion,Female,31-45,5973,4986,987,5074,899
2010,Rural,Tamil Nadu,Property Crime,Burglary,Male,13-17,8863,2061,6802,7995,868
2002,Rural,Tripura,Crime Against Women,Dowry Deaths,Male,18-30,9277,7832,1445,9143,134
2006,Urban,Andhra Pradesh,Crime Against Women,Rape,Female,0-12,1624,1060,564,1376,248
2008,Rural,Meghalaya,Crime Against Women,Rape,Female,0-12,6881,1057,5824,5590,1291
2003,Urban,Punjab,Crime Against Men,Assault,Male,60+,3486,1932,1554,2137,1349
2006,Urban,Jharkhand,Crime Against Children,Child Labor,Female,31-45,2712,1728,984,1907,805
2008,Urban,Manipur,Property Crime,Theft,Female,0-12,8524,4703,3821,6035,2489
2006,Rural,Arunachal Pradesh,Crime Against Children,Kidnapping,Male,13-17,4925,4119,806,4849,76
2008,Urban,Uttar Pradesh,Crime Against Women,Domestic Violence,Male,60+,9618,7310,2308,8500,1118
2006,Rural,Nagaland,Other Crimes,Cyber Crime,Female,13-17,9582,5045,4537,9573,9
2001,Urban,Andhra Pradesh,Other Crimes,Drug Offense,Male,31-45,8901,4716,4185,8268,633
2006,Urban,Assam,Property Crime,Burglary,Female,18-30,3817,2957,860,3199,618
2009,Urban,Gujarat,Crime Against Children,Kidnapping,Male,0-12,6281,2442,3839,6267,14
2009,Urban,Bihar,Property Crime,Arson,Male,0-12,1864,971,893,1659,205
2008,Rural,Gujarat,Crime Against Men,Murder,Female,31-45,8094,28,8066,4869,3225
2002,Rural,Andhra Pradesh,Crime Against Men,Assault,Female,31-45,9600,4961,4639,6608,2992
2006,Urban,West Bengal,Crime Against Women,Rape,Female,31-45,7867,5035,2832,5105,2762
2008,Urban,Himachal Pradesh,Property Crime,Burglary,Male,60+,5834,1851,3983,2229,3605
2009,Urban,Andhra Pradesh,Crime Against Men,Extortion,Female,46-60,7761,4380,3381,6749,1012
2004,Urban,Telangana,Crime Against Women,Dowry Deaths,Male,18-30,2991,1756,1235,2536,455
2010,Rural,Sikkim,Crime Against Men,Robbery,Female,31-45,4782,3851,931,4085,697
2010,Urban,Uttar Pradesh,Crime Against Women,Domestic Violence,Male,31-45,1202,693,509,1168,34
2001,Rural,Karnataka,Crime Against Men,Assault,Female,46-60,2028,206,1822,550,1478
2002,Urban,Odisha,Crime Against Men,Extortion,Female,46-60,7671,5054,2617,6417,1254
2006,Rural,Kerala,Other Crimes,Corruption,Female,46-60,5575,3413,2162,3779,1796
2002,Rural,Maharashtra,Crime Against Men,Extortion,Female,13-17,9249,4908,4341,9056,193
2005,Urban,Kerala,Crime Against Women,Molestation,Female,60+,4545,2259,2286,3953,592
2005,Urban,Goa,Other Crimes,Corruption,Female,31-45,355,176,179,288,67
2009,Urban,Assam,Crime Against Children,Kidnapping,Female,31-45,1234,131,1103,953,281
2003,Rural,Assam,Crime Against Men,Extortion,Female,0-12,8271,2390,5881,2468,5803
2006,Urban,Gujarat,Crime Against Children,Trafficking,Male,31-45,4163,2794,1369,3252,911
2010,Rural,Goa,Crime Against Children,Child Abuse,Female,0-12,4090,1058,3032,2685,1405
2009,Urban,Uttar Pradesh,Other Crimes,Corruption,Female,18-30,7700,4209,3491,7345,355
2004,Rural,Gujarat,Crime Against Men,Robbery,Male,13-17,8141,6438,1703,6754,1387
2003,Rural,Odisha,Crime Against Children,Trafficking,Female,31-45,3017,253,2764,1455,1562
2009,Urban,Assam,Crime Against Men,Murder,Female,60+,9518,3942,5576,8300,1218
2006,Urban,Chhattisgarh,Crime Against Children,Kidnapping,Male,18-30,2586,1890,696,2147,439
2008,Rural,Chhattisgarh,Crime Against Children,Child Abuse,Male,60+,1021,166,855,308,713
2009,Rural,Mizoram,Other Crimes,Drug Offense,Male,18-30,840,244,596,441,399
2003,Urban,Punjab,Other Crimes,Fraud,Female,0-12,1926,48,1878,1370,556
2008,Rural,Tamil Nadu,Crime Against Children,Kidnapping,Male,0-12,6635,4144,2491,5156,1479
2007,Urban,Goa,Crime Against Men,Murder,Male,60+,3801,1409,2392,3248,553
2002,Urban,Arunachal Pradesh,Crime Against Women,Molestation,Female,31-45,299,294,5,294,5
2007,Urban,Maharashtra,Crime Against Children,Child Labor,Female,46-60,2638,857,1781,1958,680
2009,Rural,Goa,Crime Against Women,Domestic Violence,Male,18-30,4941,1207,3734,2221,2720
2008,Urban,Maharashtra,Crime Against Women,Molestation,Female,60+,6472,1932,4540,2377,4095
2003,Rural,Bihar,Property Crime,Burglary,Female,46-60,7732,2361,5371,5041,2691
2002,Urban,Assam,Crime Against Women,Molestation,Male,60+,9255,9210,45,9247,8
2006,Urban,Uttar Pradesh,Property Crime,Arson,Male,18-30,5320,1280,4040,5267,53
2008,Urban,Kerala,Property Crime,Vandalism,Male,46-60,3724,611,3113,1637,2087
2004,Rural,Gujarat,Crime Against Women,Dowry Deaths,Female,18-30,3594,705,2889,1426,2168
2004,Urban,Tripura,Crime Against Men,Extortion,Female,0-12,5217,3871,1346,4239,978
2003,Urban,Nagaland,Other Crimes,Corruption,Male,60+,7549,3176,4373,4818,2731
2009,Urban,Maharashtra,Crime Against Men,Assault,Female,46-60,1984,1222,762,1695,289
2009,Urban,Punjab,Crime Against Children,Child Labor,Female,13-17,7672,4037,3635,4450,3222
2003,Urban,Assam,Crime Against Children,Kidnapping,Male,31-45,5070,1959,3111,3836,1234
2008,Rural,Tamil Nadu,Other Crimes,Corruption,Female,46-60,3497,470,3027,3401,96
2001,Urban,Arunachal Pradesh,Crime Against Women,Rape,Female,31-45,2372,447,1925,1958,414
2003,Urban,Telangana,Other Crimes,Fraud,Female,13-17,9976,4067,5909,4164,5812
2009,Rural,West Bengal,Crime Against Women,Domestic Violence,Female,13-17,9533,794,8739,7336,2197
2008,Urban,Meghalaya,Crime Against Men,Extortion,Female,31-45,9242,3155,6087,6875,2367
2005,Urban,Goa,Other Crimes,Fraud,Female,31-45,60,4,56,17,43
2001,Rural,Jharkhand,Property Crime,Burglary,Male,13-17,1835,60,1775,1008,827
2007,Rural,Chhattisgarh,Crime Against Women,Domestic Violence,Female,0-12,3903,2210,1693,3595,308
2005,Rural,Assam,Crime Against Women,Dowry Deaths,Male,60+,1809,454,1355,1050,759
2005,Urban,Madhya Pradesh,Property Crime,Burglary,Female,46-60,3500,2802,698,3485,15
2007,Rural,Goa,Crime Against Women,Molestation,Male,46-60,245,20,225,96,149
2001,Rural,Meghalaya,Crime Against Women,Rape,Male,18-30,2786,2775,11,2779,7
2007,Urban,Madhya Pradesh,Crime Against Children,Kidnapping,Male,31-45,7991,6424,1567,6758,1233
2005,Rural,Arunachal Pradesh,Other Crimes,Fraud,Male,60+,2942,826,2116,1074,1868
2008,Rural,Mizoram,Crime Against Men,Robbery,Male,0-12,7079,2925,4154,5083,1996
2002,Urban,Manipur,Crime Against Children,Child Labor,Male,13-17,6264,4563,1701,4712,1552
2002,Rural,Tripura,Crime Against Men,Robbery,Female,60+,3199,887,2312,1131,2068
2001,Rural,Madhya Pradesh,Crime Against Men,Murder,Male,0-12,6430,6207,223,6232,198
2002,Rural,Bihar,Crime Against Women,Molestation,Female,31-45,3830,1305,2525,2821,1009
2009,Rural,Nagaland,Crime Against Children,Child Abuse,Female,60+,5488,5266,222,5317,171
2009,Rural,Telangana,Crime Against Children,Trafficking,Female,60+,7211,640,6571,6259,952
2007,Rural,Delhi,Crime Against Women,Rape,Male,31-45,3855,3429,426,3573,282
2005,Rural,Himachal Pradesh,Crime Against Children,Kidnapping,Female,18-30,6009,75,5934,5455,554
2009,Urban,Andhra Pradesh,Other Crimes,Drug Offense,Female,0-12,6749,2312,4437,6183,566
2007,Urban,Andhra Pradesh,Crime Against Children,Child Labor,Male,31-45,7468,5920,1548,7004,464
2007,Urban,Kerala,Other Crimes,Corruption,Male,13-17,6792,1554,5238,4804,1988
2004,Urban,Kerala,Crime Against Women,Rape,Female,0-12,6070,3246,2824,5203,867
2003,Rural,Telangana,Crime Against Children,Trafficking,Female,60+,3963,2435,1528,3615,348
2008,Rural,Meghalaya,Other Crimes,Cyber Crime,Male,31-45,173,10,163,94,79
2001,Rural,West Bengal,Crime Against Men,Murder,Female,18-30,9107,2163,6944,2201,6906
2002,Rural,Arunachal Pradesh,Other Crimes,Corruption,Female,0-12,269,66,203,85,184
2002,Urban,Punjab,Other Crimes,Drug Offense,Female,13-17,6546,3906,2640,5835,711
2002,Urban,Arunachal Pradesh,Crime Against Men,Extortion,Female,13-17,5088,1703,3385,3471,1617
2003,Urban,Andhra Pradesh,Other Crimes,Corruption,Male,18-30,5871,1014,4857,3503,2368
2002,Urban,Madhya Pradesh,Property Crime,Burglary,Male,0-12,7444,2722,4722,5243,2201
2009,Rural,Uttar Pradesh,Crime Against Children,Kidnapping,Male,46-60,882,536,346,579,303
2002,Rural,Meghalaya,Property Crime,Theft,Male,31-45,3824,716,3108,3811,13
2002,Urban,Chhattisgarh,Crime Against Women,Rape,Female,46-60,4588,2917,1671,4483,105
2010,Urban,Delhi,Crime Against Men,Murder,Male,46-60,2161,1691,470,1814,347
2008,Urban,Sikkim,Crime Against Men,Murder,Male,13-17,1797,1749,48,1773,24
2004,Rural,Mizoram,Property Crime,Arson,Female,0-12,7693,6501,1192,6982,711
2003,Rural,Goa,Property Crime,Arson,Male,60+,5792,2789,3003,4906,886
2004,Urban,Himachal Pradesh,Property Crime,Theft,Female,46-60,5241,3468,1773,3885,1356
2007,Rural,Kerala,Other Crimes,Cyber Crime,Female,31-45,9029,5042,3987,8185,844
2007,Rural,Kerala,Crime Against Men,Murder,Female,18-30,1609,1090,519,1308,301
2003,Rural,Madhya Pradesh,Crime Against Women,Rape,Female,0-12,5530,4187,1343,5399,131
2009,Rural,Manipur,Crime Against Men,Assault,Male,0-12,8769,5252,3517,8071,698
2005,Rural,Arunachal Pradesh,Crime Against Children,Kidnapping,Female,31-45,1710,290,1420,1392,318
2010,Urban,Delhi,Property Crime,Vandalism,Male,18-30,514,317,197,403,111
2004,Rural,Arunachal Pradesh,Crime Against Women,Domestic Violence,Female,0-12,8229,6107,2122,7032,1197
2006,Urban,Jharkhand,Crime Against Children,Child Abuse,Female,13-17,7725,5592,2133,6675,1050
2004,Rural,Karnataka,Other Crimes,Fraud,Female,0-12,5575,2216,3359,4709,866
2003,Urban,Haryana,Crime Against Men,Robbery,Female,13-17,2653,2485,168,2503,150
2007,Urban,Sikkim,Crime Against Women,Dowry Deaths,Male,0-12,3130,1487,1643,2097,1033
2003,Urban,Uttar Pradesh,Crime Against Women,Molestation,Female,31-45,3027,2177,850,2231,796
2007,Urban,Himachal Pradesh,Crime Against Men,Robbery,Female,13-17,358,264,94,267,91
2005,Urban,Uttar Pradesh,Other Crimes,Fraud,Female,46-60,9848,6717,3131,6877,2971
2001,Rural,Maharashtra,Crime Against Women,Rape,Male,13-17,8316,3165,5151,7853,463
2009,Rural,Haryana,Crime Against Children,Trafficking,Male,46-60,8820,8414,406,8490,330
2006,Urban,Goa,Other Crimes,Corruption,Male,46-60,9356,6958,2398,8778,578
2004,Rural,Jharkhand,Other Crimes,Corruption,Female,18-30,4898,1023,3875,3100,1798
2008,Rural,Jammu & Kashmir,Crime Against Children,Child Labor,Female,18-30,753,572,181,688,65
2001,Rural,Odisha,Other Crimes,Cyber Crime,Male,46-60,9155,6813,2342,8539,616
2004,Urban,Madhya Pradesh,Crime Against Women,Dowry Deaths,Male,13-17,6954,1204,5750,3766,3188
2009,Rural,Uttarakhand,Crime Against Men,Extortion,Female,0-12,366,46,320,175,191
2010,Urban,Odisha,Crime Against Men,Extortion,Male,18-30,690,393,297,454,236
2004,Rural,Kerala,Crime Against Men,Murder,Male,46-60,3929,3350,579,3578,351
2010,Urban,Meghalaya,Crime Against Men,Robbery,Male,13-17,8843,7337,1506,7863,980
2009,Rural,Himachal Pradesh,Property Crime,Vandalism,Male,60+,2882,2207,675,2714,168
2003,Urban,Mizoram,Other Crimes,Drug Offense,Female,18-30,5919,3913,2006,5225,694
2006,Rural,Kerala,Other Crimes,Drug Offense,Female,60+,3085,913,2172,1496,1589
2001,Rural,Telangana,Crime Against Women,Rape,Male,60+,1416,264,1152,1277,139
2007,Urban,Himachal Pradesh,Crime Against Women,Molestation,Male,13-17,842,340,502,450,392
2003,Rural,Punjab,Property Crime,Arson,Female,46-60,8035,1299,6736,3965,4070
2007,Urban,Odisha,Crime Against Men,Robbery,Female,13-17,8451,5243,3208,7640,811
2007,Rural,Jharkhand,Crime Against Children,Child Abuse,Male,18-30,4578,2367,2211,4038,540
2005,Urban,Manipur,Other Crimes,Cyber Crime,Female,13-17,4206,3803,403,4078,128
2007,Rural,Meghalaya,Other Crimes,Fraud,Male,13-17,4271,929,3342,2813,1458
2004,Rural,Meghalaya,Other Crimes,Cyber Crime,Male,0-12,1139,339,800,1013,126
2002,Rural,Uttar Pradesh,Property Crime,Arson,Female,13-17,6465,4861,1604,5349,1116
2005,Urban,Nagaland,Crime Against Children,Trafficking,Female,0-12,7882,339,7543,4847,3035
2008,Rural,West Bengal,Other Crimes,Fraud,Female,60+,3207,1563,1644,1709,1498
2004,Rural,Jammu & Kashmir,Crime Against Women,Molestation,Female,46-60,1493,1029,464,1069,424
2001,Urban,Arunachal Pradesh,Crime Against Children,Child Abuse,Female,31-45,7017,5514,1503,6810,207
2002,Rural,Bihar,Crime Against Men,Extortion,Male,0-12,5109,4870,239,5016,93
2010,Urban,Meghalaya,Crime Against Children,Child Abuse,Male,18-30,5575,1586,3989,3929,1646
2010,Urban,Punjab,Crime Against Women,Molestation,Male,60+,5362,2968,2394,3213,2149
2003,Urban,Telangana,Crime Against Children,Child Labor,Male,31-45,7895,5417,2478,7536,359
2008,Rural,Meghalaya,Property Crime,Theft,Female,60+,4045,2351,1694,3741,304
2001,Urban,Uttar Pradesh,Crime Against Men,Extortion,Male,31-45,5704,2847,2857,3869,1835
2008,Urban,Gujarat,Crime Against Women,Dowry Deaths,Female,13-17,8727,4630,4097,6662,2065
2008,Urban,Haryana,Other Crimes,Drug Offense,Male,31-45,4197,3422,775,4150,47
2001,Rural,Uttarakhand,Crime Against Children,Kidnapping,Female,46-60,3187,2807,380,3104,83
2005,Urban,Kerala,Crime Against Men,Robbery,Female,13-17,8870,7926,944,8300,570
2003,Urban,Nagaland,Other Crimes,Corruption,Male,46-60,7651,5889,1762,6692,959
2007,Urban,Karnataka,Other Crimes,Cyber Crime,Male,0-12,6182,1979,4203,4032,2150
2001,Urban,Uttarakhand,Property Crime,Arson,Female,60+,2764,564,2200,1803,961
2007,Urban,Karnataka,Crime Against Men,Extortion,Female,13-17,8676,2183,6493,3476,5200
2009,Rural,Manipur,Crime Against Women,Domestic Violence,Female,46-60,2332,880,1452,1096,1236
2003,Rural,Jammu & Kashmir,Crime Against Children,Trafficking,Female,31-45,5275,289,4986,3877,1398
2001,Urban,Tamil Nadu,Crime Against Children,Trafficking,Female,60+,2974,718,2256,1417,1557
2006,Rural,Madhya Pradesh,Crime Against Women,Molestation,Female,46-60,3893,2353,1540,3503,390
2002,Urban,Meghalaya,Crime Against Men,Assault,Female,0-12,4314,3662,652,3975,339
2010,Urban,Karnataka,Crime Against Children,Child Labor,Male,60+,3244,2933,311,3239,5
2010,Urban,Tamil Nadu,Other Crimes,Cyber Crime,Male,18-30,887,400,487,485,402
2008,Rural,Nagaland,Other Crimes,Cyber Crime,Female,0-12,8814,2179,6635,7162,1652
2009,Rural,Bihar,Other Crimes,Cyber Crime,Female,13-17,1292,481,811,724,568
2008,Urban,Haryana,Crime Against Children,Kidnapping,Male,18-30,2202,1823,379,1963,239
2002,Urban,Tripura,Other Crimes,Cyber Crime,Female,13-17,8798,811,7987,2996,5802
2006,Rural,Chhattisgarh,Property Crime,Arson,Male,0-12,8738,8500,238,8675,63
2009,Urban,Bihar,Property Crime,Vandalism,Female,46-60,6968,2407,4561,4505,2463
2002,Urban,Meghalaya,Property Crime,Theft,Male,13-17,6620,3340,3280,5339,1281
2008,Urban,Nagaland,Crime Against Women,Dowry Deaths,Male,13-17,9192,1276,7916,4856,4336
2008,Urban,Odisha,Other Crimes,Cyber Crime,Male,46-60,9196,3030,6166,4926,4270
2009,Urban,Manipur,Crime Against Women,Domestic Violence,Female,13-17,3024,874,2150,1827,1197
2001,Urban,Haryana,Crime Against Children,Child Abuse,Male,31-45,9936,1254,8682,8399,1537
2005,Rural,Telangana,Property Crime,Vandalism,Male,46-60,5956,1452,4504,3219,2737
2004,Urban,Telangana,Property Crime,Vandalism,Female,46-60,9083,7805,1278,8866,217
2008,Rural,Bihar,Other Crimes,Corruption,Female,18-30,7136,4955,2181,5952,1184
2001,Rural,Assam,Other Crimes,Corruption,Female,46-60,3944,2714,1230,3416,528
2008,Rural,Chhattisgarh,Other Crimes,Fraud,Female,13-17,3665,1713,1952,1914,1751
2006,Urban,Kerala,Crime Against Children,Kidnapping,Female,46-60,2955,1989,966,2045,910
2006,Urban,Meghalaya,Crime Against Children,Trafficking,Male,31-45,8205,5888,2317,6457,1748
2001,Rural,Nagaland,Other Crimes,Fraud,Female,31-45,1198,351,847,427,771
2002,Urban,Meghalaya,Other Crimes,Fraud,Male,18-30,8646,5926,2720,7769,877
2010,Rural,Kerala,Property Crime,Theft,Female,31-45,3776,2245,1531,3166,610
2009,Urban,Himachal Pradesh,Crime Against Children,Child Abuse,Female,31-45,1344,1039,305,1266,78
2002,Rural,Kerala,Crime Against Children,Trafficking,Female,13-17,9239,989,8250,4888,4351
2005,Urban,Gujarat,Crime Against Women,Domestic Violence,Male,31-45,1882,775,1107,1789,93
2007,Rural,Madhya Pradesh,Property Crime,Arson,Male,31-45,1065,322,743,798,267
2003,Urban,Gujarat,Crime Against Children,Child Abuse,Female,46-60,9670,1762,7908,4999,4671
2006,Rural,Jharkhand,Other Crimes,Corruption,Male,0-12,3280,174,3106,1998,1282
2007,Rural,Jharkhand,Crime Against Women,Molestation,Female,0-12,2346,260,2086,731,1615
2005,Urban,West Bengal,Crime Against Women,Molestation,Male,0-12,5530,4008,1522,5212,318
2009,Rural,West Bengal,Crime Against Men,Extortion,Male,60+,2859,1061,1798,2411,448
2001,Urban,Nagaland,Other Crimes,Drug Offense,Female,13-17,4672,4654,18,4659,13
2001,Urban,Jharkhand,Property Crime,Arson,Male,31-45,1167,430,737,836,331
2009,Rural,Telangana,Property Crime,Vandalism,Male,18-30,3111,879,2232,1616,1495
2003,Urban,Bihar,Crime Against Women,Molestation,Female,0-12,7579,5088,2491,5568,2011
2007,Rural,Tripura,Crime Against Men,Robbery,Male,31-45,7572,4858,2714,6604,968
2003,Rural,Odisha,Crime Against Men,Extortion,Male,13-17,3782,3046,736,3239,543
2006,Rural,Haryana,Crime Against Men,Robbery,Male,46-60,4173,3730,443,4030,143
2004,Urban,Haryana,Property Crime,Theft,Female,60+,271,75,196,80,191
2008,Urban,Meghalaya,Property Crime,Vandalism,Female,60+,9411,6038,3373,7815,1596
2002,Rural,Jharkhand,Property Crime,Burglary,Male,46-60,3135,2718,417,3072,63
2007,Urban,West Bengal,Crime Against Women,Dowry Deaths,Female,46-60,1805,78,1727,1118,687
2003,Rural,West Bengal,Property Crime,Burglary,Male,0-12,1081,948,133,1038,43
2008,Urban,Odisha,Property Crime,Vandalism,Male,31-45,7692,5335,2357,6618,1074
2010,Urban,Kerala,Crime Against Children,Child Labor,Female,13-17,4460,1540,2920,2101,2359
2008,Urban,Kerala,Other Crimes,Cyber Crime,Female,0-12,6407,3475,2932,3909,2498
2005,Urban,Tamil Nadu,Crime Against Women,Domestic Violence,Female,46-60,7167,6331,836,6561,606
2002,Rural,Sikkim,Crime Against Women,Dowry Deaths,Female,31-45,3236,2652,584,2918,318
2003,Urban,Jharkhand,Other Crimes,Cyber Crime,Female,18-30,6609,1853,4756,3624,2985
2007,Rural,Bihar,Crime Against Children,Trafficking,Female,18-30,2850,1079,1771,2229,621
2009,Rural,Maharashtra,Crime Against Children,Trafficking,Female,31-45,7311,5941,1370,7211,100
2008,Urban,Meghalaya,Crime Against Women,Molestation,Male,60+,7706,3962,3744,6861,845
2008,Rural,Delhi,Other Crimes,Cyber Crime,Male,0-12,5044,3330,1714,3380,1664
2007,Rural,Assam,Crime Against Children,Trafficking,Female,0-12,4727,3616,1111,4612,115
2009,Rural,Nagaland,Crime Against Men,Assault,Female,46-60,4516,177,4339,1664,2852
2010,Rural,Tamil Nadu,Crime Against Children,Child Abuse,Male,31-45,3518,1013,2505,3409,109
2005,Rural,Uttar Pradesh,Crime Against Children,Kidnapping,Female,13-17,152,20,132,85,67
2004,Rural,Assam,Crime Against Men,Extortion,Male,46-60,7597,72,7525,3181,4416
2006,Rural,Mizoram,Crime Against Children,Child Labor,Female,46-60,2286,1742,544,2134,152
2010,Rural,Haryana,Other Crimes,Drug Offense,Male,18-30,8725,4344,4381,4876,3849
2006,Rural,Maharashtra,Other Crimes,Fraud,Female,0-12,6563,3819,2744,3947,2616
2002,Urban,Telangana,Property Crime,Arson,Male,0-12,3080,623,2457,625,2455
2001,Urban,Madhya Pradesh,Crime Against Women,Domestic Violence,Male,0-12,2161,2155,6,2157,4
2010,Urban,Gujarat,Property Crime,Arson,Female,0-12,9788,1680,8108,3971,5817
2003,Rural,Jharkhand,Crime Against Men,Assault,Male,31-45,3176,151,3025,2938,238
2003,Rural,Mizoram,Other Crimes,Fraud,Female,31-45,7307,5665,1642,6423,884
2004,Urban,Himachal Pradesh,Crime Against Men,Murder,Female,60+,2820,1128,1692,1535,1285
2001,Rural,Jharkhand,Crime Against Women,Molestation,Female,60+,4210,1413,2797,2185,2025
2001,Rural,Assam,Crime Against Children,Kidnapping,Female,31-45,7283,3061,4222,6232,1051
2004,Rural,Goa,Crime Against Men,Extortion,Male,60+,2990,1444,1546,2541,449
2005,Rural,Kerala,Property Crime,Vandalism,Female,60+,2596,1044,1552,1851,745
2003,Rural,Telangana,Crime Against Men,Assault,Male,46-60,8418,4800,3618,6546,1872
2001,Rural,Nagaland,Other Crimes,Drug Offense,Female,13-17,3917,2414,1503,3150,767
2007,Rural,Assam,Other Crimes,Fraud,Male,46-60,3327,1418,1909,2635,692
2005,Rural,Kerala,Property Crime,Arson,Female,18-30,7619,6482,1137,6581,1038
2004,Urban,West Bengal,Crime Against Men,Extortion,Male,13-17,2409,2137,272,2171,238
2001,Rural,Himachal Pradesh,Other Crimes,Drug Offense,Female,31-45,6265,1193,5072,5734,531
2006,Urban,Karnataka,Other Crimes,Corruption,Male,0-12,1570,1263,307,1540,30
2004,Rural,Maharashtra,Other Crimes,Fraud,Female,0-12,1760,1526,234,1740,20
2001,Rural,Kerala,Crime Against Men,Robbery,Male,46-60,7717,2119,5598,3915,3802
2008,Rural,Delhi,Crime Against Children,Child Labor,Male,31-45,9154,7024,2130,8470,684
2005,Rural,Himachal Pradesh,Property Crime,Burglary,Female,31-45,5723,5331,392,5379,344
2007,Urban,Haryana,Other Crimes,Cyber Crime,Female,13-17,6951,5089,1862,6949,2
2002,Rural,Jammu & Kashmir,Crime Against Men,Assault,Male,31-45,2095,786,1309,1921,174
2002,Rural,Mizoram,Crime Against Women,Molestation,Male,31-45,4414,1651,2763,3455,959
2009,Urban,Himachal Pradesh,Crime Against Children,Trafficking,Male,18-30,1896,490,1406,1744,152
2010,Rural,Mizoram,Property Crime,Theft,Male,60+,3088,222,2866,2452,636
2006,Rural,Gujarat,Property Crime,Vandalism,Male,13-17,8212,6386,1826,7651,561
2001,Urban,Jammu & Kashmir,Other Crimes,Corruption,Male,18-30,7530,2105,5425,4204,3326
2008,Rural,Sikkim,Crime Against Women,Rape,Female,13-17,8015,5438,2577,5808,2207
2004,Rural,Chhattisgarh,Crime Against Women,Domestic Violence,Male,18-30,6836,2569,4267,3314,3522
2007,Urban,Nagaland,Property Crime,Burglary,Female,18-30,6692,4347,2345,4686,2006
2007,Rural,Meghalaya,Other Crimes,Fraud,Female,60+,6046,5830,216,5975,71
2004,Urban,Telangana,Crime Against Women,Molestation,Male,31-45,1195,864,331,905,290
2010,Urban,Telangana,Property Crime,Burglary,Female,60+,2849,1799,1050,1825,1024
2010,Rural,Karnataka,Crime Against Children,Child Labor,Male,31-45,5776,5210,566,5535,241
2001,Rural,Odisha,Crime Against Men,Robbery,Male,31-45,2287,1647,640,2154,133
2001,Urban,Mizoram,Crime Against Children,Kidnapping,Male,46-60,2857,503,2354,2597,260
2010,Urban,West Bengal,Crime Against Men,Extortion,Female,0-12,3441,1703,1738,2107,1334
2009,Urban,Himachal Pradesh,Crime Against Women,Molestation,Male,18-30,6664,3227,3437,5612,1052
2001,Rural,Punjab,Property Crime,Burglary,Female,31-45,265,192,73,199,66
2001,Rural,Haryana,Crime Against Women,Dowry Deaths,Female,31-45,8630,1820,6810,8064,566
2008,Urban,Odisha,Crime Against Men,Robbery,Male,31-45,4126,2442,1684,3371,755
2006,Urban,Assam,Other Crimes,Drug Offense,Male,18-30,6110,2747,3363,4974,1136
2010,Rural,Andhra Pradesh,Crime Against Women,Rape,Female,0-12,2219,737,1482,995,1224
2006,Urban,Arunachal Pradesh,Property Crime,Theft,Female,13-17,4755,2985,1770,4720,35
2009,Urban,Arunachal Pradesh,Crime Against Women,Rape,Male,31-45,9013,4452,4561,6603,2410
2010,Urban,Bihar,Other Crimes,Fraud,Male,18-30,6413,4913,1500,5954,459
2006,Urban,Gujarat,Property Crime,Arson,Female,18-30,7429,3397,4032,7247,182
2010,Urban,Maharashtra,Crime Against Women,Rape,Female,60+,987,558,429,824,163
2009,Urban,Punjab,Crime Against Men,Assault,Male,46-60,5209,477,4732,2866,2343
2009,Urban,Delhi,Crime Against Men,Robbery,Female,0-12,9546,8155,1391,9104,442
2001,Urban,Manipur,Other Crimes,Fraud,Female,60+,233,71,162,187,46
2008,Urban,Bihar,Other Crimes,Cyber Crime,Female,46-60,4159,767,3392,2002,2157
2008,Urban,Telangana,Crime Against Men,Assault,Female,0-12,8451,1089,7362,6082,2369
2004,Rural,Tripura,Crime Against Women,Molestation,Male,13-17,772,72,700,517,255
2007,Urban,Karnataka,Other Crimes,Cyber Crime,Female,18-30,4182,109,4073,1242,2940
2010,Rural,Odisha,Crime Against Women,Dowry Deaths,Female,18-30,9784,2317,7467,3995,5789
2009,Urban,Assam,Crime Against Children,Child Labor,Female,18-30,4846,4831,15,4839,7
2006,Urban,Kerala,Crime Against Children,Child Abuse,Male,60+,8532,1184,7348,6753,1779
2003,Rural,Karnataka,Other Crimes,Cyber Crime,Female,46-60,3152,835,2317,1125,2027
2009,Urban,Odisha,Crime Against Children,Kidnapping,Male,0-12,2711,1352,1359,1991,720
2009,Urban,Delhi,Other Crimes,Cyber Crime,Female,31-45,874,494,380,575,299
2002,Urban,Bihar,Crime Against Children,Child Labor,Female,13-17,6816,4545,2271,5513,1303
2003,Urban,Karnataka,Property Crime,Theft,Female,13-17,4219,3578,641,3978,241
2002,Rural,Manipur,Other Crimes,Fraud,Female,60+,3843,263,3580,1488,2355
2010,Rural,Mizoram,Crime Against Children,Kidnapping,Male,0-12,72,30,42,59,13
2002,Urban,Sikkim,Other Crimes,Fraud,Male,31-45,2263,1842,421,2053,210
2004,Urban,Rajasthan,Crime Against Children,Trafficking,Male,46-60,794,512,282,638,156
2004,Urban,Kerala,Other Crimes,Cyber Crime,Female,60+,420,186,234,273,147
2005,Urban,Sikkim,Crime Against Children,Kidnapping,Male,0-12,7625,452,7173,3266,4359
2006,Urban,Manipur,Property Crime,Burglary,Female,13-17,5337,5110,227,5317,20
2006,Urban,Haryana,Property Crime,Burglary,Female,13-17,6200,4038,2162,4498,1702
2005,Rural,Mizoram,Other Crimes,Corruption,Male,46-60,1017,377,640,655,362
2002,Rural,Nagaland,Crime Against Men,Murder,Female,46-60,3939,3048,891,3153,786
2005,Urban,Meghalaya,Crime Against Men,Murder,Male,0-12,9819,9249,570,9376,443
2002,Rural,Karnataka,Crime Against Men,Extortion,Female,46-60,6409,1857,4552,2617,3792
2006,Urban,Punjab,Crime Against Children,Kidnapping,Male,0-12,9809,8526,1283,8543,1266
2006,Rural,Jharkhand,Other Crimes,Cyber Crime,Female,46-60,213,21,192,131,82
2002,Urban,Uttarakhand,Crime Against Women,Dowry Deaths,Female,31-45,4431,56,4375,143,4288
2010,Rural,Kerala,Crime Against Men,Assault,Female,13-17,837,588,249,639,198
2010,Urban,Telangana,Crime Against Children,Child Abuse,Male,13-17,4051,2700,1351,3256,795
2008,Rural,Meghalaya,Crime Against Children,Child Abuse,Male,31-45,7688,2952,4736,7511,177
2009,Rural,Uttarakhand,Crime Against Women,Molestation,Female,18-30,3946,2205,1741,2458,1488
2005,Rural,Goa,Property Crime,Arson,Male,18-30,5845,4563,1282,5281,564
2005,Urban,Haryana,Crime Against Women,Dowry Deaths,Female,60+,6733,6371,362,6666,67
2004,Urban,Goa,Crime Against Children,Child Labor,Male,13-17,5514,4499,1015,4711,803
2001,Urban,Gujarat,Property Crime,Arson,Male,0-12,1407,1020,387,1252,155
2006,Urban,Jharkhand,Crime Against Men,Assault,Female,0-12,8935,4184,4751,4396,4539
2005,Urban,Jammu & Kashmir,Other Crimes,Fraud,Male,60+,5364,872,4492,4494,870
2009,Urban,Assam,Crime Against Men,Assault,Female,31-45,6755,330,6425,6205,550
2004,Rural,Mizoram,Crime Against Women,Molestation,Male,0-12,2463,1948,515,2243,220
2008,Rural,Manipur,Crime Against Children,Trafficking,Male,18-30,7524,1,7523,4545,2979
2009,Urban,Mizoram,Crime Against Men,Murder,Male,0-12,9266,4842,4424,5738,3528
2002,Urban,Assam,Other Crimes,Drug Offense,Female,31-45,7680,5248,2432,6746,934
2010,Urban,Meghalaya,Crime Against Children,Child Abuse,Female,31-45,9991,2190,7801,2247,7744
2008,Urban,Andhra Pradesh,Property Crime,Vandalism,Female,31-45,8351,2264,6087,3688,4663
2001,Urban,Mizoram,Other Crimes,Drug Offense,Male,46-60,3357,682,2675,3308,49
2001,Rural,Karnataka,Crime Against Women,Rape,Female,18-30,8874,4869,4005,8183,691
2008,Rural,Tripura,Crime Against Children,Kidnapping,Male,46-60,1350,416,934,851,499
2001,Urban,Goa,Crime Against Men,Robbery,Female,31-45,3393,3325,68,3366,27
2006,Rural,Bihar,Property Crime,Arson,Male,60+,8367,1222,7145,3049,5318
2005,Rural,Rajasthan,Other Crimes,Corruption,Male,60+,9723,2759,6964,4151,5572
2005,Rural,Madhya Pradesh,Crime Against Women,Dowry Deaths,Male,46-60,7374,4348,3026,5440,1934
2005,Rural,Goa,Crime Against Children,Child Labor,Male,60+,567,535,32,535,32
2009,Rural,Odisha,Property Crime,Burglary,Female,13-17,1936,359,1577,1336,600
2002,Rural,Nagaland,Other Crimes,Corruption,Female,18-30,1323,964,359,1055,268
2003,Urban,Jharkhand,Other Crimes,Drug Offense,Female,60+,7972,12,7960,1185,6787
2009,Urban,Bihar,Crime Against Men,Robbery,Female,0-12,7800,4513,3287,6640,1160
2003,Urban,Nagaland,Crime Against Men,Robbery,Male,60+,746,33,713,736,10
2001,Rural,Haryana,Crime Against Children,Child Labor,Female,13-17,2036,1803,233,1896,140
2007,Urban,Telangana,Crime Against Children,Kidnapping,Female,60+,7800,5061,2739,6813,987
2006,Rural,Rajasthan,Property Crime,Burglary,Female,0-12,3130,622,2508,1318,1812
2006,Rural,Manipur,Crime Against Children,Trafficking,Female,31-45,8373,1826,6547,3678,4695
2009,Rural,Rajasthan,Other Crimes,Corruption,Male,60+,6548,1312,5236,4922,1626
2001,Urban,Mizoram,Crime Against Women,Rape,Male,0-12,4950,4095,855,4603,347
2009,Rural,Telangana,Crime Against Women,Molestation,Male,0-12,7077,1145,5932,6906,171
2001,Rural,Mizoram,Crime Against Children,Child Abuse,Female,31-45,8330,5965,2365,6049,2281
2005,Urban,Meghalaya,Crime Against Men,Extortion,Female,31-45,9001,7459,1542,7876,1125
2006,Rural,Mizoram,Property Crime,Theft,Male,60+,9242,4876,4366,5599,3643
2005,Urban,Karnataka,Other Crimes,Cyber Crime,Female,46-60,424,375,49,395,29
2001,Rural,Uttar Pradesh,Other Crimes,Drug Offense,Female,46-60,900,820,80,876,24
2008,Urban,West Bengal,Crime Against Men,Murder,Male,18-30,4426,177,4249,3229,1197
2010,Rural,Goa,Crime Against Men,Assault,Male,0-12,5905,5173,732,5854,51
2004,Urban,Jharkhand,Other Crimes,Fraud,Male,46-60,481,256,225,342,139
2002,Rural,Gujarat,Crime Against Women,Molestation,Male,18-30,3395,811,2584,2550,845
2005,Urban,Arunachal Pradesh,Property Crime,Arson,Male,13-17,7882,866,7016,886,6996
2010,Urban,Odisha,Crime Against Children,Child Abuse,Male,46-60,1202,831,371,885,317
2003,Urban,Arunachal Pradesh,Property Crime,Vandalism,Female,18-30,6618,690,5928,4392,2226
2001,Rural,Arunachal Pradesh,Crime Against Men,Murder,Female,31-45,4779,2434,2345,3277,1502
2008,Rural,Telangana,Property Crime,Burglary,Male,0-12,7012,137,6875,5179,1833
2007,Urban,Rajasthan,Property Crime,Arson,Female,60+,9502,4031,5471,8025,1477
2009,Rural,Punjab,Crime Against Children,Kidnapping,Female,60+,2848,943,1905,2439,409
2004,Urban,Assam,Property Crime,Burglary,Male,60+,2229,1755,474,1982,247
2005,Urban,Bihar,Crime Against Women,Dowry Deaths,Male,0-12,3180,0,3180,352,2828
2002,Urban,Jammu & Kashmir,Other Crimes,Fraud,Female,18-30,3970,1608,2362,2021,1949
2007,Rural,Delhi,Crime Against Women,Dowry Deaths,Male,60+,5502,3749,1753,5037,465
2008,Urban,Mizoram,Crime Against Men,Extortion,Female,60+,5726,2116,3610,5333,393
2006,Rural,Assam,Property Crime,Burglary,Male,46-60,3704,2339,1365,2577,1127
2003,Rural,Manipur,Other Crimes,Corruption,Female,13-17,7222,307,6915,4546,2676
2010,Urban,Uttarakhand,Crime Against Men,Robbery,Female,31-45,3303,464,2839,2608,695
2010,Rural,Chhattisgarh,Crime Against Children,Kidnapping,Female,13-17,4447,4272,175,4389,58
2004,Rural,Madhya Pradesh,Crime Against Women,Molestation,Male,0-12,9906,6956,2950,8826,1080
2009,Urban,Himachal Pradesh,Crime Against Men,Assault,Male,13-17,5662,1111,4551,3164,2498
2005,Urban,Kerala,Crime Against Women,Domestic Violence,Male,31-45,4667,2676,1991,3568,1099
2001,Urban,Jharkhand,Other Crimes,Drug Offense,Female,18-30,1668,470,1198,960,708
2010,Rural,Tripura,Property Crime,Burglary,Male,18-30,8810,1420,7390,6573,2237
2008,Rural,Maharashtra,Crime Against Men,Robbery,Male,31-45,3015,2222,793,2321,694
2004,Rural,Bihar,Crime Against Men,Robbery,Male,0-12,374,372,2,373,1
2002,Urban,Goa,Crime Against Children,Child Abuse,Female,60+,984,196,788,390,594
2001,Rural,Mizoram,Crime Against Women,Domestic Violence,Female,60+,1946,657,1289,1120,826
2003,Rural,Haryana,Crime Against Men,Assault,Female,18-30,1318,714,604,1070,248
2003,Urban,Odisha,Other Crimes,Corruption,Male,31-45,9121,7603,1518,8986,135
2010,Rural,Odisha,Property Crime,Arson,Male,0-12,7875,4006,3869,4661,3214
2009,Rural,Gujarat,Crime Against Children,Kidnapping,Male,18-30,6383,4624,1759,5437,946
2005,Rural,Kerala,Property Crime,Arson,Female,0-12,919,178,741,626,293
2007,Rural,Sikkim,Crime Against Men,Robbery,Male,18-30,6231,5758,473,6021,210
2008,Rural,Arunachal Pradesh,Crime Against Women,Dowry Deaths,Male,46-60,8987,7820,1167,7863,1124
2002,Urban,Tripura,Crime Against Children,Child Labor,Female,13-17,8673,2388,6285,8326,347
2007,Urban,Andhra Pradesh,Property Crime,Theft,Male,46-60,8289,6691,1598,7165,1124
2007,Rural,Bihar,Property Crime,Vandalism,Female,13-17,642,11,631,269,373
2006,Urban,West Bengal,Crime Against Women,Dowry Deaths,Female,13-17,4341,3184,1157,4293,48
2010,Urban,Andhra Pradesh,Crime Against Women,Rape,Female,60+,403,364,39,368,35
2002,Urban,Gujarat,Crime Against Men,Robbery,Female,46-60,7711,825,6886,3596,4115
2005,Urban,Haryana,Crime Against Men,Robbery,Male,18-30,4146,958,3188,1814,2332
2010,Rural,Madhya Pradesh,Crime Against Children,Child Abuse,Male,46-60,7991,3926,4065,5400,2591
2003,Rural,Gujarat,Crime Against Women,Dowry Deaths,Female,0-12,7350,5321,2029,5911,1439
2002,Urban,Andhra Pradesh,Other Crimes,Corruption,Female,0-12,7754,2519,5235,7614,140
2009,Urban,Jharkhand,Property Crime,Arson,Male,18-30,4801,3017,1784,3591,1210
2006,Rural,Rajasthan,Crime Against Women,Molestation,Female,60+,1711,1416,295,1647,64
2004,Rural,Tripura,Crime Against Women,Dowry Deaths,Male,13-17,6169,1190,4979,1566,4603
2002,Urban,Manipur,Crime Against Women,Domestic Violence,Female,0-12,168,146,22,157,11
2004,Urban,Sikkim,Crime Against Men,Assault,Male,46-60,7207,2865,4342,5480,1727
2009,Urban,Jharkhand,Property Crime,Arson,Female,13-17,7076,4946,2130,6859,217
2003,Urban,Meghalaya,Crime Against Men,Assault,Female,31-45,1718,630,1088,852,866
2008,Rural,Tripura,Crime Against Men,Murder,Female,60+,4737,486,4251,3438,1299
2010,Urban,Gujarat,Crime Against Children,Kidnapping,Male,46-60,2526,2256,270,2325,201
2006,Urban,Tamil Nadu,Crime Against Women,Domestic Violence,Female,31-45,2710,226,2484,2104,606
2007,Urban,Punjab,Property Crime,Burglary,Male,0-12,4782,1252,3530,2574,2208
2005,Urban,Bihar,Property Crime,Theft,Male,13-17,1507,631,876,1121,386
2007,Urban,Gujarat,Other Crimes,Fraud,Female,60+,3229,2311,918,3012,217
2010,Urban,Karnataka,Crime Against Women,Rape,Male,31-45,3354,1671,1683,2588,766
2007,Urban,Punjab,Other Crimes,Corruption,Female,46-60,3676,2621,1055,3522,154
2008,Urban,Punjab,Crime Against Men,Assault,Female,60+,9948,1740,8208,2750,7198
2005,Rural,Nagaland,Other Crimes,Drug Offense,Male,13-17,9293,5634,3659,8747,546
2007,Urban,Delhi,Crime Against Children,Kidnapping,Male,60+,4463,1083,3380,3743,720
2003,Urban,Uttarakhand,Crime Against Children,Child Abuse,Male,13-17,5119,4777,342,4801,318
2004,Rural,Haryana,Crime Against Men,Assault,Female,46-60,793,134,659,577,216
2005,Rural,Rajasthan,Other Crimes,Corruption,Male,18-30,9303,7863,1440,8463,840
2006,Rural,Rajasthan,Crime Against Women,Dowry Deaths,Male,31-45,5668,837,4831,4183,1485
2001,Rural,Nagaland,Property Crime,Theft,Male,31-45,1506,368,1138,737,769
2003,Urban,Goa,Property Crime,Theft,Female,18-30,3476,2838,638,2900,576
2006,Rural,Assam,Crime Against Children,Child Abuse,Female,31-45,2322,1474,848,2193,129
2002,Rural,Uttarakhand,Crime Against Men,Assault,Female,31-45,7231,6820,411,7208,23
2008,Rural,Uttarakhand,Crime Against Women,Domestic Violence,Male,31-45,9425,7094,2331,8840,585
2001,Rural,Haryana,Other Crimes,Drug Offense,Male,13-17,8631,2099,6532,2518,6113
2001,Rural,Odisha,Other Crimes,Drug Offense,Male,31-45,9063,1512,7551,6223,2840
2003,Urban,Madhya Pradesh,Crime Against Children,Trafficking,Male,60+,2768,2022,746,2304,464
2010,Rural,Madhya Pradesh,Crime Against Children,Child Abuse,Male,0-12,3342,900,2442,3255,87
2004,Rural,Goa,Other Crimes,Corruption,Female,31-45,584,266,318,553,31
2008,Urban,Telangana,Other Crimes,Fraud,Male,13-17,6474,3614,2860,5769,705
2010,Urban,Tamil Nadu,Crime Against Men,Assault,Female,60+,2945,1471,1474,1518,1427
2007,Rural,Mizoram,Property Crime,Arson,Male,0-12,9130,4304,4826,5501,3629
2002,Rural,Tripura,Other Crimes,Cyber Crime,Female,46-60,8287,6787,1500,7406,881
2006,Urban,Karnataka,Crime Against Children,Child Labor,Male,18-30,7280,1683,5597,2428,4852
2004,Rural,Uttar Pradesh,Other Crimes,Fraud,Female,46-60,6678,3898,2780,4114,2564
2006,Rural,Assam,Crime Against Women,Rape,Female,60+,8571,7275,1296,7585,986
2002,Urban,Rajasthan,Property Crime,Burglary,Male,13-17,9062,3784,5278,4794,4268
2005,Urban,Arunachal Pradesh,Other Crimes,Corruption,Female,13-17,9402,5289,4113,5730,3672
2002,Rural,Himachal Pradesh,Property Crime,Theft,Male,60+,1089,719,370,838,251
2004,Rural,Karnataka,Crime Against Children,Child Labor,Female,18-30,1130,834,296,905,225
2009,Urban,Nagaland,Crime Against Children,Kidnapping,Female,60+,9169,6528,2641,8980,189
2008,Rural,Assam,Crime Against Women,Dowry Deaths,Male,0-12,5359,743,4616,1805,3554
2003,Urban,Haryana,Crime Against Children,Child Labor,Female,31-45,8499,3771,4728,5143,3356
2010,Rural,Jharkhand,Other Crimes,Fraud,Female,0-12,1207,604,603,918,289
2002,Rural,Madhya Pradesh,Crime Against Children,Child Labor,Male,60+,1312,972,340,1252,60
2010,Urban,Odisha,Crime Against Men,Assault,Female,46-60,8502,2732,5770,6991,1511
2007,Urban,Uttarakhand,Crime Against Women,Domestic Violence,Female,46-60,3489,3402,87,3484,5
2005,Urban,Uttarakhand,Other Crimes,Drug Offense,Female,13-17,9645,558,9087,973,8672
2006,Rural,Madhya Pradesh,Other Crimes,Drug Offense,Female,0-12,6879,6022,857,6140,739
2010,Rural,Jammu & Kashmir,Crime Against Children,Child Abuse,Female,46-60,1586,2,1584,783,803
2004,Rural,Telangana,Other Crimes,Drug Offense,Female,60+,8021,5838,2183,6436,1585
2002,Urban,Goa,Crime Against Women,Domestic Violence,Male,46-60,3221,823,2398,1936,1285
2004,Urban,Haryana,Crime Against Women,Molestation,Female,31-45,1163,227,936,876,287
2006,Urban,Uttar Pradesh,Property Crime,Arson,Male,46-60,940,210,730,449,491
2009,Urban,Manipur,Property Crime,Burglary,Female,13-17,2509,399,2110,1500,1009
2005,Urban,Meghalaya,Crime Against Children,Child Abuse,Female,13-17,2085,981,1104,2072,13
2009,Urban,Chhattisgarh,Property Crime,Theft,Male,46-60,5096,2669,2427,4981,115
2005,Rural,Uttar Pradesh,Property Crime,Vandalism,Female,18-30,8716,8398,318,8613,103
2002,Rural,Goa,Property Crime,Arson,Female,60+,6450,555,5895,729,5721
2001,Urban,Himachal Pradesh,Crime Against Children,Child Abuse,Female,0-12,883,610,273,833,50
2004,Rural,Rajasthan,Other Crimes,Cyber Crime,Male,46-60,3625,1934,1691,3440,185
2002,Urban,Delhi,Other Crimes,Corruption,Male,0-12,3172,1228,1944,2349,823
2007,Urban,Karnataka,Crime Against Men,Robbery,Female,0-12,9555,4628,4927,8732,823
2005,Urban,Chhattisgarh,Crime Against Men,Murder,Male,46-60,7986,63,7923,2740,5246
2006,Urban,Nagaland,Crime Against Men,Extortion,Male,31-45,8293,2189,6104,3447,4846
2002,Urban,West Bengal,Crime Against Men,Murder,Female,0-12,8676,1224,7452,7662,1014
2004,Urban,Kerala,Crime Against Men,Robbery,Female,31-45,8468,8188,280,8436,32
2001,Urban,Haryana,Property Crime,Vandalism,Female,60+,9598,7807,1791,9562,36
2003,Rural,West Bengal,Crime Against Men,Robbery,Female,0-12,2579,1243,1336,1420,1159
2002,Rural,Haryana,Crime Against Men,Extortion,Male,13-17,7384,987,6397,5179,2205
2005,Urban,Gujarat,Property Crime,Theft,Male,13-17,5848,5215,633,5220,628
2001,Urban,Telangana,Property Crime,Theft,Female,60+,7761,242,7519,1030,6731
2004,Urban,Telangana,Property Crime,Burglary,Male,13-17,1479,78,1401,788,691
2001,Rural,Jharkhand,Property Crime,Burglary,Male,31-45,9037,7722,1315,7952,1085
2009,Urban,Maharashtra,Crime Against Women,Dowry Deaths,Female,18-30,1479,647,832,1386,93
2008,Rural,Karnataka,Other Crimes,Drug Offense,Male,18-30,7052,3931,3121,6019,1033
2007,Rural,Chhattisgarh,Crime Against Children,Kidnapping,Male,60+,2854,2586,268,2685,169
2003,Rural,Chhattisgarh,Crime Against Men,Extortion,Male,13-17,856,821,35,832,24
2006,Urban,Tripura,Crime Against Women,Domestic Violence,Female,31-45,531,430,101,509,22
2007,Rural,Manipur,Crime Against Women,Domestic Violence,Female,31-45,7385,105,7280,4292,3093
2001,Rural,Punjab,Crime Against Children,Child Abuse,Male,31-45,5542,3567,1975,4551,991
2003,Rural,Tamil Nadu,Crime Against Children,Trafficking,Male,18-30,1435,537,898,950,485
2007,Rural,Goa,Crime Against Children,Child Labor,Female,18-30,1867,675,1192,1835,32
2009,Urban,Chhattisgarh,Other Crimes,Corruption,Female,60+,3038,1607,1431,2029,1009
2008,Rural,Gujarat,Crime Against Men,Extortion,Female,46-60,2869,1429,1440,1752,1117
2009,Rural,Kerala,Crime Against Women,Molestation,Male,60+,2714,2480,234,2498,216
2004,Rural,Bihar,Other Crimes,Cyber Crime,Male,46-60,597,356,241,496,101
2001,Urban,Haryana,Property Crime,Vandalism,Male,31-45,5880,4717,1163,4997,883
2009,Urban,Karnataka,Crime Against Children,Child Abuse,Male,60+,1326,315,1011,704,622
2003,Rural,Nagaland,Property Crime,Arson,Female,60+,2452,1355,1097,2354,98
2005,Urban,Manipur,Crime Against Men,Extortion,Female,31-45,3241,3004,237,3150,91
2009,Rural,Tripura,Property Crime,Arson,Male,46-60,2127,1350,777,1406,721
2004,Urban,Assam,Property Crime,Arson,Male,60+,2568,17,2551,1130,1438
2001,Rural,Jammu & Kashmir,Crime Against Men,Murder,Male,18-30,6379,5590,789,6036,343
2002,Urban,Gujarat,Other Crimes,Corruption,Male,60+,5016,4581,435,4973,43
2003,Rural,Haryana,Crime Against Women,Dowry Deaths,Female,18-30,1145,649,496,887,258
2007,Rural,Odisha,Crime Against Men,Extortion,Male,31-45,6304,4990,1314,5956,348
2005,Rural,Nagaland,Crime Against Children,Child Labor,Male,13-17,2468,2414,54,2465,3
2009,Rural,Gujarat,Crime Against Women,Rape,Female,0-12,8844,4220,4624,8345,499
2004,Urban,Manipur,Other Crimes,Fraud,Female,0-12,2093,1636,457,1944,149
2008,Urban,Mizoram,Crime Against Children,Kidnapping,Female,0-12,923,913,10,922,1
2010,Rural,Tripura,Property Crime,Burglary,Male,13-17,8400,3865,4535,5658,2742
2008,Urban,Andhra Pradesh,Other Crimes,Fraud,Female,13-17,8916,5927,2989,6110,2806
2005,Urban,Rajasthan,Crime Against Children,Child Labor,Male,0-12,4440,4276,164,4413,27
2002,Rural,Andhra Pradesh,Crime Against Women,Molestation,Male,13-17,125,125,0,125,0
2010,Rural,Chhattisgarh,Property Crime,Theft,Female,46-60,190,139,51,140,50
2009,Rural,Meghalaya,Crime Against Women,Domestic Violence,Female,60+,7052,5521,1531,6151,901
2004,Urban,Bihar,Property Crime,Burglary,Female,0-12,7891,331,7560,3133,4758
2004,Rural,Bihar,Crime Against Men,Robbery,Male,46-60,803,242,561,411,392
2009,Urban,Andhra Pradesh,Crime Against Men,Murder,Female,60+,5560,3928,1632,3928,1632
2002,Rural,Meghalaya,Crime Against Women,Rape,Male,13-17,6109,1218,4891,2435,3674
2003,Urban,Himachal Pradesh,Other Crimes,Drug Offense,Female,18-30,7006,6635,371,6692,314
2001,Rural,Rajasthan,Property Crime,Arson,Male,0-12,1268,98,1170,146,1122
2002,Urban,Nagaland,Crime Against Men,Extortion,Female,18-30,9275,2301,6974,4275,5000
2009,Urban,Mizoram,Crime Against Men,Murder,Female,0-12,7616,5978,1638,6089,1527
2009,Rural,Tamil Nadu,Property Crime,Burglary,Male,31-45,4563,2968,1595,4158,405
2007,Rural,Manipur,Crime Against Men,Murder,Male,18-30,4522,1210,3312,4325,197
2007,Rural,Manipur,Crime Against Children,Child Labor,Female,46-60,1826,276,1550,1568,258
2008,Rural,Rajasthan,Crime Against Women,Molestation,Male,31-45,5946,3085,2861,4575,1371
2004,Urban,Assam,Crime Against Women,Rape,Female,18-30,9061,4537,4524,8184,877
2004,Rural,Tripura,Crime Against Children,Trafficking,Male,31-45,1674,1608,66,1667,7
2003,Rural,Karnataka,Crime Against Children,Trafficking,Female,60+,8508,757,7751,8195,313
2009,Rural,Rajasthan,Crime Against Men,Extortion,Female,60+,8899,2741,6158,5672,3227
2006,Rural,Uttar Pradesh,Crime Against Women,Domestic Violence,Male,60+,7286,7238,48,7277,9
2003,Rural,Andhra Pradesh,Property Crime,Arson,Male,31-45,293,285,8,285,8
2003,Urban,Punjab,Crime Against Women,Dowry Deaths,Female,46-60,4800,322,4478,3061,1739
2010,Urban,Chhattisgarh,Crime Against Women,Rape,Female,13-17,6942,5063,1879,5118,1824
2010,Rural,Bihar,Crime Against Children,Child Abuse,Male,46-60,3326,3210,116,3257,69
2002,Urban,Madhya Pradesh,Crime Against Women,Molestation,Male,18-30,3412,1520,1892,2550,862
2007,Rural,Manipur,Crime Against Women,Molestation,Male,13-17,9244,4792,4452,4856,4388
2001,Rural,Madhya Pradesh,Other Crimes,Drug Offense,Female,13-17,1517,276,1241,404,1113
2006,Rural,Sikkim,Other Crimes,Fraud,Male,46-60,3249,1694,1555,2611,638
2008,Urban,Tamil Nadu,Property Crime,Burglary,Male,60+,5700,5042,658,5451,249
2004,Rural,Kerala,Crime Against Women,Molestation,Male,60+,559,362,197,441,118
2005,Urban,Chhattisgarh,Property Crime,Vandalism,Female,13-17,1622,738,884,886,736
2010,Rural,Haryana,Crime Against Men,Robbery,Female,18-30,1522,604,918,1520,2
2007,Rural,Tamil Nadu,Crime Against Women,Domestic Violence,Female,31-45,3214,2152,1062,2201,1013
2006,Rural,Goa,Property Crime,Theft,Male,18-30,6625,4912,1713,5774,851
2009,Urban,Telangana,Crime Against Children,Trafficking,Male,31-45,7529,736,6793,1281,6248
2006,Rural,Bihar,Crime Against Men,Assault,Female,31-45,8942,1020,7922,2551,6391
2002,Urban,Uttarakhand,Property Crime,Arson,Male,0-12,6747,584,6163,851,5896
2003,Rural,Nagaland,Crime Against Women,Molestation,Female,0-12,5820,5503,317,5569,251
2004,Urban,Arunachal Pradesh,Crime Against Men,Murder,Male,13-17,941,641,300,829,112
2006,Rural,Uttarakhand,Crime Against Children,Kidnapping,Female,0-12,5597,5017,580,5548,49
2009,Urban,Karnataka,Crime Against Women,Rape,Male,13-17,3370,901,2469,1629,1741
2006,Urban,Kerala,Crime Against Women,Rape,Female,18-30,5886,24,5862,4364,1522
2006,Rural,Chhattisgarh,Crime Against Men,Murder,Female,0-12,6018,317,5701,3188,2830
2009,Rural,Haryana,Property Crime,Arson,Female,60+,6083,2904,3179,4227,1856
2008,Urban,Arunachal Pradesh,Property Crime,Burglary,Female,46-60,5371,1001,4370,2492,2879
2003,Rural,Meghalaya,Crime Against Men,Robbery,Male,31-45,3131,1401,1730,1509,1622
2005,Rural,Assam,Crime Against Children,Kidnapping,Male,46-60,1407,462,945,464,943
2003,Rural,Sikkim,Crime Against Men,Murder,Female,31-45,656,605,51,642,14
2001,Urban,Punjab,Crime Against Men,Assault,Male,31-45,5231,798,4433,2872,2359
2003,Rural,Jharkhand,Other Crimes,Fraud,Female,0-12,3670,1964,1706,3437,233
2008,Rural,Odisha,Property Crime,Burglary,Male,0-12,4089,4082,7,4083,6
2002,Urban,West Bengal,Property Crime,Burglary,Female,13-17,2015,760,1255,1565,450
2002,Rural,Odisha,Property Crime,Arson,Male,46-60,3055,104,2951,536,2519
2006,Rural,Meghalaya,Other Crimes,Cyber Crime,Female,31-45,6520,102,6418,6520,0
2001,Urban,Punjab,Crime Against Women,Molestation,Male,18-30,795,714,81,727,68
2003,Urban,Nagaland,Other Crimes,Cyber Crime,Male,13-17,1990,591,1399,1351,639
2005,Rural,Bihar,Other Crimes,Corruption,Female,0-12,9221,2810,6411,9197,24
2003,Urban,Sikkim,Crime Against Children,Child Abuse,Male,18-30,4531,78,4453,3860,671
2009,Rural,Arunachal Pradesh,Property Crime,Burglary,Female,13-17,7502,6793,709,7377,125
2008,Rural,West Bengal,Crime Against Children,Child Labor,Male,13-17,1463,659,804,1237,226
2003,Rural,West Bengal,Crime Against Children,Kidnapping,Male,60+,8865,4680,4185,8419,446
2004,Rural,Madhya Pradesh,Property Crime,Theft,Male,13-17,5316,5256,60,5280,36
2001,Rural,Tripura,Property Crime,Burglary,Male,60+,1697,380,1317,896,801
2002,Rural,Mizoram,Other Crimes,Corruption,Female,46-60,8682,8431,251,8485,197
2002,Rural,Andhra Pradesh,Crime Against Men,Robbery,Male,18-30,8013,5147,2866,6620,1393
2006,Rural,Manipur,Crime Against Men,Extortion,Male,46-60,5603,3948,1655,5280,323
2005,Rural,Odisha,Crime Against Men,Assault,Female,31-45,395,233,162,263,132
2004,Urban,Manipur,Other Crimes,Cyber Crime,Female,60+,5064,1871,3193,1978,3086
2002,Rural,Telangana,Property Crime,Vandalism,Male,60+,6600,2360,4240,2449,4151
2006,Urban,Uttar Pradesh,Crime Against Men,Extortion,Female,46-60,7742,5056,2686,7251,491
2005,Rural,Meghalaya,Crime Against Women,Rape,Female,60+,1564,376,1188,1131,433
2010,Rural,Haryana,Crime Against Children,Child Labor,Female,46-60,3356,1260,2096,2336,1020
2003,Urban,Delhi,Crime Against Men,Murder,Female,46-60,2457,2075,382,2083,374
2002,Urban,Mizoram,Crime Against Men,Murder,Female,31-45,3084,2148,936,2590,494
2009,Rural,Delhi,Crime Against Men,Murder,Female,46-60,2379,1700,679,1713,666
2007,Rural,Chhattisgarh,Property Crime,Arson,Female,18-30,6873,6587,286,6609,264
2008,Rural,Kerala,Crime Against Women,Dowry Deaths,Female,13-17,2327,1289,1038,1656,671
2002,Urban,Arunachal Pradesh,Crime Against Men,Murder,Female,31-45,3503,835,2668,1157,2346
2003,Urban,Bihar,Other Crimes,Fraud,Female,18-30,5112,2982,2130,5084,28
2002,Rural,Goa,Property Crime,Theft,Female,18-30,7084,4656,2428,5549,1535
2008,Urban,Tamil Nadu,Property Crime,Burglary,Female,0-12,5809,3318,2491,5570,239
2006,Rural,Arunachal Pradesh,Other Crimes,Drug Offense,Female,46-60,1793,1544,249,1575,218
2007,Rural,Chhattisgarh,Property Crime,Arson,Female,46-60,7808,2847,4961,6314,1494
2009,Rural,West Bengal,Crime Against Women,Domestic Violence,Male,13-17,2909,2378,531,2628,281
2009,Urban,Arunachal Pradesh,Crime Against Children,Trafficking,Female,60+,240,49,191,85,155
2006,Rural,Odisha,Crime Against Men,Robbery,Male,18-30,2652,1710,942,2157,495
2004,Rural,Mizoram,Crime Against Children,Child Labor,Male,13-17,6350,4716,1634,4949,1401
2003,Rural,Mizoram,Crime Against Women,Dowry Deaths,Female,0-12,831,309,522,814,17
2004,Rural,Himachal Pradesh,Crime Against Children,Kidnapping,Female,46-60,6796,6350,446,6581,215
2008,Urban,Manipur,Crime Against Women,Dowry Deaths,Male,18-30,7678,3532,4146,4188,3490
2003,Urban,Nagaland,Crime Against Children,Kidnapping,Male,13-17,1000,708,292,770,230
2007,Rural,Jammu & Kashmir,Crime Against Women,Domestic Violence,Male,0-12,7679,467,7212,7314,365
2006,Rural,Madhya Pradesh,Crime Against Women,Rape,Female,46-60,4162,1844,2318,3200,962
2007,Rural,Arunachal Pradesh,Property Crime,Vandalism,Female,31-45,844,709,135,769,75
2007,Urban,Andhra Pradesh,Property Crime,Theft,Female,0-12,8186,3737,4449,5679,2507
2005,Rural,Jharkhand,Crime Against Men,Extortion,Male,18-30,8251,4857,3394,7076,1175
2004,Rural,Jharkhand,Crime Against Men,Extortion,Female,46-60,2769,2538,231,2634,135
2004,Urban,Telangana,Property Crime,Theft,Male,46-60,4435,3284,1151,3986,449
2002,Urban,Karnataka,Crime Against Women,Domestic Violence,Female,18-30,1891,828,1063,1028,863
2005,Urban,Goa,Crime Against Women,Rape,Female,0-12,4272,2394,1878,3168,1104
2005,Rural,West Bengal,Property Crime,Arson,Female,31-45,4142,3346,796,3954,188
2003,Urban,Punjab,Crime Against Children,Child Labor,Female,31-45,2162,5,2157,1164,998
2007,Rural,Nagaland,Crime Against Children,Kidnapping,Female,13-17,4719,1022,3697,2048,2671
2002,Urban,Manipur,Crime Against Children,Child Labor,Female,0-12,8273,3042,5231,4070,4203
2007,Urban,Maharashtra,Crime Against Men,Robbery,Female,31-45,9331,355,8976,1497,7834
2001,Urban,Arunachal Pradesh,Crime Against Men,Murder,Female,13-17,3910,261,3649,3710,200
2006,Rural,Tamil Nadu,Crime Against Men,Extortion,Female,31-45,4558,125,4433,2901,1657
2005,Urban,Kerala,Property Crime,Vandalism,Male,60+,8107,412,7695,5082,3025
2008,Urban,Goa,Property Crime,Burglary,Female,60+,9741,2564,7177,8548,1193
2010,Urban,Sikkim,Other Crimes,Drug Offense,Female,13-17,565,83,482,379,186
2008,Rural,Tripura,Crime Against Men,Robbery,Female,13-17,4985,89,4896,3353,1632
2005,Urban,Sikkim,Crime Against Women,Rape,Female,13-17,9613,6082,3531,6545,3068
2010,Rural,Jharkhand,Property Crime,Theft,Female,18-30,9842,5175,4667,9049,793
2002,Rural,Tripura,Crime Against Men,Murder,Female,0-12,7473,297,7176,5981,1492
2002,Rural,Mizoram,Other Crimes,Cyber Crime,Male,31-45,2839,2603,236,2722,117
2009,Urban,Kerala,Other Crimes,Drug Offense,Female,60+,8294,6017,2277,7940,354
2005,Urban,Uttarakhand,Crime Against Children,Trafficking,Male,60+,4864,1808,3056,1996,2868
2005,Rural,Himachal Pradesh,Crime Against Men,Robbery,Male,18-30,7330,4424,2906,6683,647
2009,Urban,Rajasthan,Property Crime,Arson,Male,18-30,3909,3720,189,3862,47
2006,Rural,Punjab,Property Crime,Burglary,Female,13-17,2159,1591,568,2078,81
2002,Rural,Goa,Other Crimes,Fraud,Male,60+,1110,680,430,831,279
2010,Urban,Uttarakhand,Property Crime,Vandalism,Female,31-45,454,45,409,238,216
2003,Rural,Sikkim,Crime Against Men,Assault,Female,18-30,4438,3223,1215,3436,1002
2010,Rural,Assam,Crime Against Women,Domestic Violence,Male,31-45,2053,1084,969,1220,833
2004,Urban,Uttarakhand,Crime Against Men,Extortion,Female,60+,8844,8384,460,8830,14
2005,Urban,Punjab,Other Crimes,Fraud,Female,46-60,6892,6510,382,6858,34
2006,Rural,Maharashtra,Property Crime,Vandalism,Male,0-12,7799,794,7005,4419,3380
2003,Rural,Odisha,Crime Against Children,Trafficking,Female,13-17,3261,1868,1393,2910,351
2006,Urban,Delhi,Crime Against Children,Kidnapping,Female,31-45,6560,2696,3864,4719,1841
2005,Rural,Punjab,Other Crimes,Drug Offense,Male,18-30,7795,2174,5621,7195,600
2009,Rural,Uttar Pradesh,Crime Against Women,Rape,Male,0-12,8467,8428,39,8449,18
2001,Urban,Delhi,Other Crimes,Cyber Crime,Female,13-17,6774,1531,5243,3331,3443
2010,Urban,Delhi,Property Crime,Burglary,Male,31-45,3823,3691,132,3693,130
2001,Rural,Goa,Property Crime,Theft,Female,60+,8537,1856,6681,5443,3094
2009,Rural,Jharkhand,Crime Against Children,Child Abuse,Female,60+,2501,1135,1366,1709,792
2006,Rural,Uttarakhand,Other Crimes,Cyber Crime,Male,0-12,8470,479,7991,4171,4299
2005,Rural,Telangana,Other Crimes,Drug Offense,Male,31-45,2742,1060,1682,1130,1612
2005,Urban,Mizoram,Crime Against Children,Child Abuse,Male,13-17,3172,1694,1478,2564,608
2001,Urban,Uttarakhand,Crime Against Women,Dowry Deaths,Male,60+,7894,2579,5315,7052,842
2009,Urban,Sikkim,Other Crimes,Drug Offense,Male,0-12,9969,3933,6036,6895,3074
2010,Urban,Madhya Pradesh,Crime Against Men,Murder,Female,18-30,1368,981,387,1353,15
2001,Urban,Manipur,Crime Against Women,Dowry Deaths,Female,46-60,7500,4923,2577,7434,66
2007,Rural,Uttar Pradesh,Crime Against Men,Murder,Female,0-12,1568,387,1181,1241,327
2009,Urban,Haryana,Crime Against Children,Kidnapping,Male,46-60,3571,1182,2389,2209,1362
2008,Rural,Jammu & Kashmir,Other Crimes,Corruption,Female,0-12,5132,498,4634,3674,1458
2005,Urban,Jammu & Kashmir,Crime Against Children,Kidnapping,Male,46-60,358,121,237,143,215
2009,Rural,Assam,Other Crimes,Corruption,Female,18-30,7705,4864,2841,7580,125
2004,Urban,Karnataka,Crime Against Men,Robbery,Male,60+,2784,45,2739,1042,1742
2003,Rural,Sikkim,Crime Against Children,Trafficking,Male,60+,5758,3657,2101,4636,1122
2005,Urban,Meghalaya,Other Crimes,Fraud,Female,18-30,2101,2081,20,2085,16
2004,Rural,Assam,Property Crime,Theft,Male,46-60,6272,2503,3769,4552,1720
2001,Urban,Delhi,Other Crimes,Fraud,Female,31-45,4018,124,3894,3957,61
2008,Urban,Arunachal Pradesh,Other Crimes,Corruption,Female,60+,6715,5809,906,5989,726
2009,Urban,Himachal Pradesh,Property Crime,Vandalism,Female,18-30,8604,2831,5773,6066,2538
2003,Rural,Punjab,Property Crime,Theft,Male,46-60,7235,660,6575,2342,4893
2009,Rural,Assam,Other Crimes,Corruption,Female,0-12,1300,247,1053,959,341
2005,Rural,Delhi,Property Crime,Theft,Male,31-45,7987,1752,6235,6863,1124
2010,Urban,Delhi,Crime Against Men,Assault,Female,18-30,7399,7179,220,7332,67
2007,Rural,Tripura,Crime Against Women,Domestic Violence,Female,31-45,7698,1510,6188,4458,3240
2008,Urban,Haryana,Crime Against Men,Assault,Female,60+,6793,6089,704,6790,3
2005,Rural,Arunachal Pradesh,Crime Against Children,Kidnapping,Male,18-30,8081,3857,4224,5614,2467
2007,Rural,Punjab,Crime Against Women,Dowry Deaths,Male,0-12,4949,540,4409,2270,2679
2007,Rural,Uttarakhand,Crime Against Women,Dowry Deaths,Female,31-45,2286,931,1355,1523,763
2010,Urban,Madhya Pradesh,Property Crime,Vandalism,Female,18-30,9024,5571,3453,8927,97
2010,Rural,Chhattisgarh,Other Crimes,Cyber Crime,Male,13-17,3726,469,3257,1819,1907
2008,Urban,Himachal Pradesh,Crime Against Children,Child Labor,Male,60+,8655,7597,1058,8606,49
2001,Urban,Punjab,Crime Against Women,Rape,Female,46-60,9766,9466,300,9655,111
2002,Rural,Uttarakhand,Other Crimes,Fraud,Male,0-12,7811,1903,5908,4582,3229
2004,Rural,Delhi,Property Crime,Burglary,Female,13-17,968,296,672,628,340
2002,Urban,West Bengal,Crime Against Women,Rape,Male,60+,8934,6534,2400,7826,1108
2002,Rural,Uttar Pradesh,Property Crime,Burglary,Male,0-12,2641,2512,129,2640,1
2003,Urban,Chhattisgarh,Crime Against Women,Dowry Deaths,Female,31-45,1758,901,857,916,842
2007,Rural,Kerala,Property Crime,Burglary,Female,60+,4975,920,4055,3871,1104
2004,Urban,Gujarat,Property Crime,Burglary,Female,46-60,4260,3871,389,4156,104
2010,Rural,Meghalaya,Crime Against Men,Robbery,Female,31-45,7421,163,7258,5219,2202
2008,Urban,Tripura,Crime Against Women,Dowry Deaths,Female,0-12,1473,760,713,1426,47
2008,Rural,Gujarat,Crime Against Children,Kidnapping,Male,46-60,548,32,516,408,140
2004,Rural,Haryana,Other Crimes,Cyber Crime,Female,31-45,7574,4571,3003,5838,1736
2008,Urban,Nagaland,Crime Against Men,Extortion,Male,31-45,7297,5921,1376,5961,1336
2004,Rural,Manipur,Property Crime,Vandalism,Female,0-12,8823,7158,1665,8666,157
2003,Rural,Himachal Pradesh,Property Crime,Arson,Male,46-60,8773,6499,2274,8161,612
2010,Urban,Gujarat,Crime Against Women,Rape,Female,31-45,4742,4019,723,4065,677
2009,Urban,Telangana,Crime Against Children,Child Abuse,Male,60+,3493,3152,341,3248,245
2008,Rural,Kerala,Crime Against Women,Dowry Deaths,Male,18-30,5670,3066,2604,4628,1042
2002,Urban,Andhra Pradesh,Crime Against Women,Domestic Violence,Male,0-12,9581,4110,5471,4930,4651
2009,Rural,Himachal Pradesh,Crime Against Children,Kidnapping,Male,46-60,2847,2307,540,2823,24
2010,Urban,Bihar,Crime Against Men,Extortion,Male,31-45,9907,1519,8388,3639,6268
2010,Rural,Delhi,Crime Against Men,Extortion,Male,46-60,5182,5096,86,5153,29
2006,Rural,Mizoram,Crime Against Children,Child Abuse,Male,46-60,3740,1763,1977,2147,1593
2008,Urban,Arunachal Pradesh,Crime Against Children,Trafficking,Female,60+,3563,1325,2238,2732,831
2009,Urban,Manipur,Crime Against Women,Domestic Violence,Female,18-30,8732,8544,188,8586,146
2002,Rural,Chhattisgarh,Crime Against Children,Child Abuse,Female,18-30,2343,2050,293,2248,95
2006,Urban,Madhya Pradesh,Crime Against Men,Extortion,Male,18-30,9933,3778,6155,6249,3684
2009,Rural,Sikkim,Other Crimes,Corruption,Female,31-45,9775,243,9532,4970,4805
2002,Urban,Madhya Pradesh,Other Crimes,Cyber Crime,Female,0-12,668,140,528,239,429
2001,Rural,Chhattisgarh,Crime Against Children,Child Abuse,Male,60+,9313,7463,1850,7943,1370
2006,Urban,Delhi,Property Crime,Burglary,Male,46-60,3569,997,2572,3488,81
2008,Rural,Manipur,Other Crimes,Fraud,Male,13-17,6302,1209,5093,3022,3280
2009,Urban,Haryana,Property Crime,Burglary,Male,0-12,8183,1554,6629,1754,6429
2002,Urban,Delhi,Crime Against Children,Kidnapping,Male,18-30,8961,8533,428,8568,393
2006,Rural,Rajasthan,Property Crime,Arson,Male,46-60,7472,6185,1287,7299,173
2004,Rural,Sikkim,Other Crimes,Cyber Crime,Female,0-12,9375,5078,4297,6457,2918
2008,Rural,Tamil Nadu,Other Crimes,Corruption,Female,31-45,5320,1533,3787,3055,2265
2004,Rural,Tripura,Crime Against Men,Extortion,Male,60+,3837,2375,1462,3007,830
2006,Urban,Assam,Other Crimes,Fraud,Male,13-17,6817,421,6396,5599,1218
2004,Rural,Manipur,Crime Against Women,Dowry Deaths,Female,13-17,1681,362,1319,722,959
2004,Rural,Sikkim,Crime Against Women,Molestation,Female,60+,6052,1145,4907,4170,1882
2009,Urban,Manipur,Property Crime,Arson,Female,60+,6615,1964,4651,5675,940
2005,Rural,Tamil Nadu,Other Crimes,Drug Offense,Male,31-45,9890,7552,2338,9144,746
2004,Rural,Jammu & Kashmir,Other Crimes,Drug Offense,Female,13-17,2699,2033,666,2234,465
2001,Urban,Kerala,Crime Against Men,Murder,Female,18-30,9565,1927,7638,7413,2152
2002,Urban,Tripura,Crime Against Women,Molestation,Female,13-17,1452,892,560,1283,169
2005,Rural,Nagaland,Other Crimes,Drug Offense,Female,46-60,8228,6541,1687,7924,304
2002,Urban,Andhra Pradesh,Crime Against Men,Extortion,Male,0-12,9546,1282,8264,3578,5968
2006,Urban,Arunachal Pradesh,Crime Against Women,Molestation,Female,13-17,8824,3290,5534,4749,4075
2009,Urban,Mizoram,Other Crimes,Drug Offense,Male,46-60,3528,904,2624,3467,61
2006,Rural,Tamil Nadu,Other Crimes,Drug Offense,Female,60+,7803,4582,3221,6489,1314
2010,Rural,Tamil Nadu,Crime Against Men,Assault,Female,46-60,1706,1681,25,1691,15
2001,Urban,Andhra Pradesh,Crime Against Men,Assault,Male,46-60,8645,4199,4446,8036,609
2003,Urban,Punjab,Crime Against Children,Kidnapping,Female,31-45,8029,5048,2981,6685,1344
2001,Rural,Jharkhand,Crime Against Women,Domestic Violence,Female,18-30,3581,1329,2252,1866,1715
2006,Rural,Mizoram,Other Crimes,Fraud,Male,0-12,7414,2187,5227,4108,3306
2008,Rural,Jammu & Kashmir,Crime Against Men,Murder,Female,31-45,4483,741,3742,1684,2799
2008,Urban,Tamil Nadu,Crime Against Men,Assault,Male,13-17,4906,1911,2995,1952,2954
2008,Rural,Karnataka,Property Crime,Theft,Female,13-17,3421,380,3041,437,2984
2006,Rural,Kerala,Other Crimes,Cyber Crime,Female,46-60,5896,4156,1740,5844,52
2009,Rural,Jammu & Kashmir,Crime Against Men,Robbery,Male,13-17,8228,7482,746,7689,539
2002,Urban,Manipur,Property Crime,Theft,Female,60+,8789,3166,5623,4684,4105
2004,Rural,Uttar Pradesh,Other Crimes,Fraud,Male,0-12,7375,1162,6213,1949,5426
2003,Urban,Telangana,Crime Against Women,Molestation,Male,13-17,7657,5094,2563,5569,2088
2003,Urban,Jammu & Kashmir,Crime Against Women,Molestation,Male,0-12,8768,8649,119,8709,59
2008,Rural,Assam,Crime Against Women,Molestation,Female,18-30,3895,840,3055,1652,2243
2001,Urban,Rajasthan,Crime Against Women,Dowry Deaths,Male,0-12,1908,1625,283,1840,68
2004,Rural,Assam,Crime Against Women,Molestation,Male,18-30,547,114,433,426,121
2003,Urban,Tamil Nadu,Other Crimes,Cyber Crime,Male,60+,1178,214,964,530,648
2006,Rural,Chhattisgarh,Other Crimes,Drug Offense,Male,18-30,1107,170,937,604,503
2009,Rural,Madhya Pradesh,Property Crime,Vandalism,Male,0-12,1751,1029,722,1397,354
2008,Rural,Delhi,Crime Against Women,Rape,Female,18-30,9013,8359,654,8942,71
2004,Urban,Meghalaya,Property Crime,Vandalism,Male,46-60,4897,3330,1567,4075,822
2002,Urban,Meghalaya,Other Crimes,Fraud,Male,18-30,2211,660,1551,1329,882
2006,Rural,Goa,Crime Against Men,Robbery,Male,18-30,1603,413,1190,1445,158
2010,Rural,Telangana,Other Crimes,Cyber Crime,Female,60+,7101,4832,2269,6017,1084
2010,Rural,Sikkim,Crime Against Men,Assault,Male,0-12,6494,2631,3863,6022,472
2002,Urban,Meghalaya,Crime Against Men,Robbery,Female,31-45,9655,9158,497,9431,224
2005,Rural,Jharkhand,Other Crimes,Drug Offense,Female,60+,9096,7019,2077,9039,57
2004,Rural,Uttarakhand,Property Crime,Theft,Female,60+,604,587,17,594,10
2004,Rural,Haryana,Property Crime,Arson,Male,46-60,534,328,206,528,6
2002,Rural,Maharashtra,Crime Against Children,Child Abuse,Male,13-17,153,48,105,87,66
2006,Urban,Bihar,Crime Against Children,Trafficking,Female,13-17,9542,2155,7387,8866,676
2006,Urban,Tripura,Crime Against Men,Assault,Female,60+,2292,1481,811,1756,536
2003,Rural,Goa,Crime Against Women,Rape,Male,18-30,2098,218,1880,1452,646
2009,Rural,Andhra Pradesh,Other Crimes,Cyber Crime,Female,31-45,9989,2387,7602,5721,4268
2001,Rural,Assam,Other Crimes,Corruption,Male,0-12,8638,6824,1814,7380,1258
2001,Rural,Uttar Pradesh,Crime Against Children,Kidnapping,Male,13-17,64,62,2,64,0
2004,Rural,Uttarakhand,Crime Against Children,Kidnapping,Male,18-30,7612,6256,1356,7543,69
2004,Rural,Mizoram,Other Crimes,Cyber Crime,Female,13-17,5232,1673,3559,1791,3441
2002,Rural,Uttarakhand,Crime Against Men,Robbery,Male,18-30,1998,1509,489,1631,367
2006,Rural,Gujarat,Crime Against Children,Child Labor,Female,0-12,5369,885,4484,3651,1718
2005,Rural,Uttar Pradesh,Other Crimes,Cyber Crime,Male,18-30,7886,7546,340,7865,21
2005,Rural,Uttar Pradesh,Other Crimes,Drug Offense,Female,31-45,1562,1090,472,1230,332
2001,Urban,Delhi,Other Crimes,Cyber Crime,Female,31-45,3959,3500,459,3678,281
2005,Urban,Punjab,Crime Against Women,Rape,Female,60+,8610,2423,6187,4646,3964
2008,Urban,Tamil Nadu,Property Crime,Theft,Female,31-45,9357,2849,6508,5641,3716
2009,Rural,Mizoram,Property Crime,Burglary,Female,60+,765,33,732,544,221
2001,Urban,Rajasthan,Crime Against Men,Extortion,Male,60+,237,72,165,80,157
2005,Urban,Karnataka,Crime Against Children,Kidnapping,Male,18-30,1253,546,707,815,438
2007,Rural,Kerala,Crime Against Women,Domestic Violence,Male,13-17,2606,911,1695,1908,698
2009,Urban,Kerala,Crime Against Children,Child Labor,Male,0-12,1956,1899,57,1956,0
2004,Urban,Sikkim,Crime Against Men,Murder,Male,31-45,2108,908,1200,1435,673
2003,Urban,Karnataka,Crime Against Men,Murder,Male,13-17,7492,6415,1077,6848,644
2007,Urban,Goa,Other Crimes,Fraud,Female,0-12,6200,4535,1665,4922,1278
2008,Rural,Uttarakhand,Property Crime,Burglary,Female,60+,7516,1211,6305,2377,5139
2008,Rural,Tripura,Crime Against Children,Trafficking,Female,13-17,7634,3311,4323,6506,1128
2002,Urban,Manipur,Other Crimes,Cyber Crime,Male,13-17,5468,3535,1933,5058,410
2004,Rural,Goa,Crime Against Men,Robbery,Female,31-45,8625,6151,2474,6454,2171
2002,Urban,Madhya Pradesh,Other Crimes,Corruption,Male,60+,1920,1747,173,1908,12
2004,Rural,Gujarat,Crime Against Men,Robbery,Female,46-60,8767,1743,7024,6804,1963
2008,Rural,Jharkhand,Crime Against Men,Robbery,Male,0-12,2681,874,1807,1407,1274
2008,Urban,Karnataka,Crime Against Children,Trafficking,Male,60+,1425,831,594,1403,22
2010,Rural,Chhattisgarh,Crime Against Children,Kidnapping,Female,18-30,5529,72,5457,1029,4500
2009,Rural,Jammu & Kashmir,Crime Against Women,Domestic Violence,Female,0-12,7793,1412,6381,7426,367
2009,Rural,Gujarat,Other Crimes,Corruption,Male,60+,2741,978,1763,1441,1300
2003,Rural,Uttarakhand,Crime Against Children,Kidnapping,Female,18-30,9397,4752,4645,5410,3987
2001,Rural,Kerala,Crime Against Children,Trafficking,Male,31-45,6514,5725,789,5917,597
2008,Rural,Goa,Crime Against Men,Assault,Male,46-60,8893,7498,1395,8676,217
2009,Urban,Karnataka,Other Crimes,Cyber Crime,Female,46-60,9009,8818,191,8829,180
2002,Rural,Manipur,Crime Against Women,Rape,Female,18-30,8440,4660,3780,5204,3236
2005,Urban,Jammu & Kashmir,Property Crime,Burglary,Female,0-12,8220,1017,7203,5516,2704
2005,Urban,Meghalaya,Property Crime,Vandalism,Male,18-30,813,623,190,717,96
2009,Rural,Telangana,Crime Against Children,Trafficking,Male,18-30,5734,534,5200,2805,2929
2002,Rural,Andhra Pradesh,Other Crimes,Cyber Crime,Female,0-12,7151,1549,5602,2411,4740
2009,Rural,Mizoram,Crime Against Women,Molestation,Male,13-17,1682,10,1672,749,933
2010,Urban,Chhattisgarh,Crime Against Children,Kidnapping,Female,0-12,4800,98,4702,2836,1964
2009,Urban,Kerala,Other Crimes,Corruption,Female,18-30,9939,1081,8858,5849,4090
2005,Urban,Sikkim,Crime Against Men,Assault,Male,0-12,7288,6347,941,6885,403
2004,Rural,Chhattisgarh,Crime Against Women,Dowry Deaths,Female,0-12,4448,414,4034,3338,1110
2006,Rural,Uttar Pradesh,Crime Against Children,Child Abuse,Female,13-17,7273,7191,82,7195,78
2002,Rural,Andhra Pradesh,Other Crimes,Corruption,Female,0-12,9065,5343,3722,6930,2135
2004,Rural,Haryana,Property Crime,Theft,Female,0-12,6661,1373,5288,3475,3186
2002,Urban,Jharkhand,Other Crimes,Drug Offense,Male,18-30,6885,6779,106,6878,7
2008,Rural,Haryana,Crime Against Men,Extortion,Female,0-12,6941,353,6588,752,6189
2001,Urban,Andhra Pradesh,Crime Against Women,Rape,Male,60+,4494,646,3848,1581,2913
2008,Urban,Jharkhand,Property Crime,Vandalism,Male,60+,2415,1485,930,2207,208
2003,Rural,Nagaland,Crime Against Women,Rape,Female,18-30,6739,5236,1503,5283,1456
2008,Urban,Gujarat,Crime Against Children,Child Abuse,Female,60+,5765,2970,2795,3282,2483
2005,Urban,Karnataka,Crime Against Women,Rape,Male,13-17,7659,5943,1716,6014,1645
2002,Urban,Gujarat,Crime Against Children,Kidnapping,Male,31-45,8539,3259,5280,5179,3360
2010,Urban,Uttarakhand,Crime Against Men,Robbery,Female,46-60,3272,145,3127,2921,351
2002,Urban,Kerala,Other Crimes,Cyber Crime,Female,60+,8075,3850,4225,6719,1356
2004,Urban,Punjab,Crime Against Men,Murder,Male,13-17,3222,3147,75,3209,13
2005,Urban,Punjab,Crime Against Men,Murder,Male,18-30,6760,2975,3785,6214,546
2001,Urban,Uttar Pradesh,Other Crimes,Corruption,Female,18-30,8127,845,7282,6796,1331
2005,Rural,Andhra Pradesh,Crime Against Women,Molestation,Male,0-12,6255,5588,667,6071,184
2010,Urban,Karnataka,Property Crime,Burglary,Female,0-12,3477,2768,709,3257,220
2002,Urban,Sikkim,Other Crimes,Fraud,Male,0-12,9870,1804,8066,4228,5642
2008,Rural,Andhra Pradesh,Other Crimes,Fraud,Male,60+,2769,1440,1329,2331,438
2005,Urban,Tripura,Crime Against Men,Extortion,Female,60+,9620,6923,2697,7576,2044
2004,Rural,Tamil Nadu,Crime Against Men,Extortion,Female,60+,9417,1579,7838,3245,6172
2009,Urban,Manipur,Crime Against Children,Child Abuse,Male,13-17,8119,4539,3580,5720,2399
2008,Urban,Goa,Crime Against Women,Rape,Female,13-17,100,34,66,89,11
2010,Rural,Bihar,Crime Against Men,Extortion,Female,13-17,3590,1022,2568,2774,816
2004,Rural,Rajasthan,Crime Against Women,Domestic Violence,Female,18-30,6813,6286,527,6581,232
2010,Urban,Sikkim,Other Crimes,Cyber Crime,Female,13-17,1079,540,539,662,417
2009,Urban,Arunachal Pradesh,Crime Against Men,Robbery,Male,0-12,2872,420,2452,2840,32
2001,Rural,Andhra Pradesh,Crime Against Women,Dowry Deaths,Female,46-60,8084,7876,208,8035,49
2001,Rural,Uttarakhand,Other Crimes,Corruption,Male,18-30,4221,2223,1998,4182,39
2010,Urban,Chhattisgarh,Crime Against Men,Assault,Male,31-45,3404,190,3214,1562,1842
2006,Urban,Jammu & Kashmir,Crime Against Women,Dowry Deaths,Female,46-60,1807,1609,198,1760,47
2001,Rural,Kerala,Other Crimes,Drug Offense,Female,0-12,4682,3474,1208,4237,445
2001,Rural,Uttarakhand,Crime Against Children,Child Abuse,Male,18-30,4245,1473,2772,2776,1469
2003,Urban,Arunachal Pradesh,Crime Against Women,Dowry Deaths,Male,18-30,3079,2032,1047,3009,70
2007,Rural,Andhra Pradesh,Crime Against Children,Child Labor,Male,13-17,4762,931,3831,1458,3304
2006,Rural,West Bengal,Crime Against Women,Domestic Violence,Female,31-45,2687,438,2249,485,2202
2008,Urban,Maharashtra,Other Crimes,Cyber Crime,Male,18-30,7379,4430,2949,5774,1605
2001,Urban,Haryana,Other Crimes,Cyber Crime,Female,60+,3550,962,2588,3085,465
2008,Rural,Kerala,Crime Against Women,Domestic Violence,Female,46-60,5992,3437,2555,5683,309
2005,Urban,Tripura,Property Crime,Vandalism,Female,13-17,6566,3836,2730,6063,503
2001,Urban,Sikkim,Crime Against Women,Molestation,Female,18-30,8723,4438,4285,7537,1186
2005,Urban,Rajasthan,Other Crimes,Cyber Crime,Female,0-12,486,107,379,168,318
2010,Urban,Madhya Pradesh,Other Crimes,Drug Offense,Female,46-60,8691,5472,3219,6126,2565
2007,Rural,Karnataka,Property Crime,Theft,Female,0-12,4683,172,4511,3824,859
2003,Rural,Nagaland,Crime Against Children,Child Labor,Male,0-12,5716,1838,3878,5600,116
2008,Rural,Arunachal Pradesh,Crime Against Women,Dowry Deaths,Male,46-60,2211,1848,363,2165,46
2003,Urban,Karnataka,Crime Against Women,Domestic Violence,Female,18-30,7998,5354,2644,6510,1488
2001,Urban,Uttarakhand,Property Crime,Burglary,Female,31-45,4846,2420,2426,4470,376
2004,Rural,Chhattisgarh,Crime Against Children,Child Abuse,Female,18-30,7179,3074,4105,6579,600
2001,Rural,Telangana,Property Crime,Arson,Female,31-45,6280,3430,2850,5685,595
2007,Urban,Sikkim,Property Crime,Theft,Female,31-45,1136,341,795,796,340
2007,Urban,Nagaland,Other Crimes,Fraud,Female,60+,9454,7949,1505,8817,637
2005,Urban,Manipur,Property Crime,Theft,Female,18-30,2121,598,1523,1729,392
2001,Urban,Odisha,Other Crimes,Corruption,Male,46-60,2609,1436,1173,1718,891
2004,Urban,Goa,Crime Against Children,Trafficking,Male,60+,3893,771,3122,3138,755
2007,Rural,Odisha,Crime Against Men,Assault,Female,18-30,1831,1817,14,1828,3
2002,Urban,Mizoram,Crime Against Men,Assault,Female,0-12,1528,159,1369,702,826
2004,Urban,Andhra Pradesh,Crime Against Women,Rape,Male,46-60,8743,751,7992,7057,1686
2006,Rural,Madhya Pradesh,Other Crimes,Cyber Crime,Male,18-30,431,405,26,420,11
2010,Urban,Andhra Pradesh,Crime Against Women,Rape,Female,31-45,4409,1409,3000,1511,2898
2001,Urban,Goa,Property Crime,Burglary,Female,46-60,4814,1792,3022,2488,2326
2010,Rural,Rajasthan,Crime Against Men,Assault,Female,0-12,2188,814,1374,2180,8
2008,Rural,Assam,Property Crime,Theft,Male,0-12,7106,3590,3516,4925,2181
2003,Rural,Madhya Pradesh,Crime Against Men,Extortion,Male,60+,1996,316,1680,926,1070
2003,Urban,Chhattisgarh,Other Crimes,Drug Offense,Female,31-45,6958,1607,5351,6284,674
2004,Rural,Jammu & Kashmir,Property Crime,Burglary,Female,0-12,4631,4200,431,4277,354
2010,Rural,Karnataka,Crime Against Children,Child Labor,Male,46-60,7057,1819,5238,4387,2670
2008,Rural,Jharkhand,Crime Against Children,Child Abuse,Female,46-60,4360,1348,3012,1601,2759
2009,Urban,Punjab,Crime Against Children,Child Abuse,Male,31-45,5581,3638,1943,4513,1068
2009,Rural,Assam,Crime Against Children,Child Labor,Female,46-60,2403,2191,212,2250,153
2004,Rural,Jammu & Kashmir,Crime Against Men,Murder,Female,46-60,1861,1019,842,1066,795
2005,Urban,Assam,Other Crimes,Drug Offense,Female,18-30,9913,8474,1439,9256,657
2009,Urban,Himachal Pradesh,Crime Against Men,Murder,Female,13-17,4502,2067,2435,3286,1216
2002,Rural,Punjab,Crime Against Women,Rape,Male,13-17,7415,4885,2530,7327,88
2008,Urban,Goa,Crime Against Men,Robbery,Female,31-45,2827,925,1902,2625,202
2004,Rural,Delhi,Crime Against Women,Dowry Deaths,Male,31-45,80,51,29,66,14
2008,Rural,Gujarat,Property Crime,Vandalism,Female,31-45,5336,4322,1014,4867,469
2006,Rural,Manipur,Property Crime,Theft,Male,46-60,2855,990,1865,1080,1775
2005,Urban,Telangana,Crime Against Children,Child Abuse,Female,18-30,4243,1132,3111,2042,2201
2006,Rural,Rajasthan,Crime Against Children,Kidnapping,Female,31-45,8761,6786,1975,7168,1593
2008,Urban,Jharkhand,Crime Against Children,Trafficking,Female,31-45,3228,1712,1516,2410,818
2006,Urban,Rajasthan,Crime Against Children,Child Labor,Female,0-12,9821,5808,4013,9044,777
2002,Urban,Maharashtra,Property Crime,Vandalism,Female,18-30,4772,4371,401,4491,281
2010,Rural,West Bengal,Crime Against Men,Robbery,Male,60+,587,477,110,577,10
2010,Rural,Himachal Pradesh,Other Crimes,Fraud,Male,31-45,8892,1217,7675,8363,529
2005,Rural,Punjab,Crime Against Women,Molestation,Male,18-30,5167,2996,2171,3815,1352
2005,Urban,Meghalaya,Crime Against Women,Molestation,Male,46-60,2143,21,2122,796,1347
2002,Urban,Haryana,Crime Against Children,Child Abuse,Male,18-30,9761,7700,2061,9008,753
2008,Rural,Arunachal Pradesh,Other Crimes,Drug Offense,Female,0-12,9119,5863,3256,8279,840
2005,Urban,Tripura,Property Crime,Theft,Female,31-45,5682,2029,3653,3185,2497
2009,Rural,Jharkhand,Property Crime,Theft,Female,0-12,6796,5145,1651,5641,1155
2007,Rural,Tamil Nadu,Other Crimes,Corruption,Female,31-45,9452,2241,7211,2853,6599
2004,Rural,Meghalaya,Crime Against Women,Rape,Male,18-30,3410,2837,573,3200,210
2010,Urban,Punjab,Crime Against Women,Rape,Female,18-30,6586,3223,3363,5079,1507
2002,Rural,Odisha,Crime Against Children,Child Labor,Female,46-60,7134,3383,3751,4831,2303
2007,Urban,Uttar Pradesh,Crime Against Women,Rape,Male,46-60,4968,3933,1035,4467,501
2002,Rural,Bihar,Other Crimes,Fraud,Female,0-12,4518,1250,3268,2005,2513
2006,Urban,Tamil Nadu,Crime Against Women,Domestic Violence,Female,46-60,3899,664,3235,2725,1174
2003,Urban,Punjab,Crime Against Men,Extortion,Male,0-12,8425,6751,1674,7493,932
2003,Rural,Telangana,Crime Against Women,Rape,Female,31-45,552,134,418,260,292
2010,Urban,West Bengal,Crime Against Men,Robbery,Male,31-45,8559,113,8446,5386,3173
2005,Urban,Maharashtra,Crime Against Men,Extortion,Female,0-12,2178,2173,5,2176,2
2010,Rural,Chhattisgarh,Property Crime,Arson,Female,60+,2162,1165,997,1389,773
2008,Urban,Tamil Nadu,Crime Against Women,Dowry Deaths,Male,31-45,2961,1260,1701,1957,1004
2007,Urban,West Bengal,Crime Against Men,Robbery,Female,46-60,8043,1913,6130,8005,38
2008,Rural,Delhi,Other Crimes,Corruption,Male,13-17,6842,6285,557,6788,54
2006,Rural,Assam,Crime Against Women,Dowry Deaths,Male,46-60,6319,4859,1460,5192,1127
2001,Urban,Uttar Pradesh,Property Crime,Arson,Male,31-45,3006,2026,980,2299,707
2006,Urban,Gujarat,Crime Against Men,Murder,Female,31-45,1514,249,1265,1121,393
2009,Urban,Madhya Pradesh,Crime Against Men,Extortion,Female,18-30,1616,352,1264,1454,162
2001,Rural,Gujarat,Crime Against Men,Assault,Female,46-60,5120,4408,712,4457,663
2005,Urban,Manipur,Crime Against Children,Child Labor,Male,18-30,3973,3277,696,3613,360
2005,Rural,Tamil Nadu,Other Crimes,Fraud,Female,31-45,5884,1966,3918,5128,756
2004,Urban,Chhattisgarh,Property Crime,Burglary,Female,0-12,1460,911,549,985,475
2010,Urban,Rajasthan,Other Crimes,Cyber Crime,Male,31-45,9272,7791,1481,9113,159
2002,Rural,Punjab,Crime Against Women,Rape,Female,31-45,9172,2776,6396,3779,5393
2007,Urban,Delhi,Other Crimes,Corruption,Male,46-60,9565,4190,5375,4918,4647
2001,Rural,Rajasthan,Crime Against Children,Trafficking,Female,60+,9146,8514,632,9030,116
2003,Rural,Arunachal Pradesh,Crime Against Women,Dowry Deaths,Female,60+,5499,5293,206,5374,125
2002,Urban,Tamil Nadu,Crime Against Women,Rape,Female,31-45,9781,5283,4498,8803,978
2003,Urban,Sikkim,Property Crime,Burglary,Male,18-30,2161,1740,421,2038,123
2003,Urban,Jammu & Kashmir,Other Crimes,Fraud,Female,18-30,6047,4049,1998,5539,508
2010,Urban,Punjab,Crime Against Women,Rape,Male,46-60,2031,114,1917,527,1504
2004,Urban,Chhattisgarh,Crime Against Children,Trafficking,Female,13-17,6891,3689,3202,6152,739
2003,Rural,Karnataka,Property Crime,Arson,Female,46-60,4926,4057,869,4881,45
2007,Rural,Chhattisgarh,Property Crime,Theft,Female,60+,9959,5298,4661,9742,217
2008,Urban,Tamil Nadu,Property Crime,Vandalism,Male,60+,4869,3402,1467,4827,42
2010,Rural,Rajasthan,Property Crime,Vandalism,Female,0-12,3195,2822,373,2860,335
2009,Urban,Bihar,Other Crimes,Corruption,Male,18-30,7971,3864,4107,5921,2050
2004,Urban,Haryana,Crime Against Women,Dowry Deaths,Female,60+,2869,2780,89,2837,32
2009,Urban,Andhra Pradesh,Crime Against Women,Dowry Deaths,Male,60+,1166,971,195,1092,74
2009,Rural,Chhattisgarh,Property Crime,Vandalism,Male,60+,8549,2871,5678,6740,1809
2009,Urban,Tripura,Crime Against Men,Murder,Female,13-17,9582,2671,6911,3737,5845
2006,Urban,Telangana,Crime Against Women,Domestic Violence,Female,31-45,9471,6806,2665,8701,770
2002,Rural,Punjab,Other Crimes,Drug Offense,Male,0-12,4157,1628,2529,2518,1639
2005,Rural,Assam,Crime Against Men,Extortion,Male,0-12,7417,17,7400,7156,261
2001,Rural,Delhi,Crime Against Children,Child Labor,Female,31-45,9343,8323,1020,9182,161
2008,Rural,West Bengal,Crime Against Children,Kidnapping,Male,60+,4813,3193,1620,4203,610
2003,Rural,Jharkhand,Other Crimes,Drug Offense,Female,18-30,7320,2735,4585,5505,1815
2005,Urban,Assam,Crime Against Children,Child Abuse,Male,13-17,918,343,575,422,496
2004,Urban,Uttar Pradesh,Crime Against Men,Extortion,Male,0-12,6738,3057,3681,6475,263
2007,Urban,Tripura,Property Crime,Burglary,Female,18-30,1387,450,937,834,553
2004,Rural,Jammu & Kashmir,Crime Against Women,Domestic Violence,Female,46-60,6705,3316,3389,6366,339
2005,Rural,Kerala,Crime Against Men,Murder,Female,46-60,6618,1406,5212,2599,4019
2005,Rural,Uttar Pradesh,Property Crime,Arson,Female,0-12,2404,205,2199,2251,153
2006,Rural,Assam,Crime Against Women,Molestation,Male,60+,8040,1353,6687,3147,4893
2004,Rural,Haryana,Crime Against Men,Robbery,Female,60+,9483,6132,3351,8169,1314
2004,Urban,Sikkim,Property Crime,Arson,Female,13-17,186,169,17,170,16
2010,Urban,Punjab,Other Crimes,Corruption,Male,13-17,5127,1542,3585,3229,1898
2010,Urban,West Bengal,Crime Against Men,Extortion,Male,46-60,2343,149,2194,1386,957
2002,Rural,Mizoram,Crime Against Men,Assault,Female,31-45,1093,294,799,410,683
2001,Urban,Uttar Pradesh,Other Crimes,Fraud,Female,31-45,5482,4086,1396,4548,934
2005,Urban,Andhra Pradesh,Crime Against Children,Kidnapping,Female,18-30,6820,706,6114,5528,1292
2003,Urban,Jharkhand,Crime Against Women,Dowry Deaths,Female,60+,1532,1013,519,1142,390
2001,Urban,Himachal Pradesh,Crime Against Men,Robbery,Female,0-12,7352,3744,3608,4523,2829
2010,Urban,Arunachal Pradesh,Other Crimes,Corruption,Male,60+,8258,4361,3897,7896,362
2007,Rural,Chhattisgarh,Crime Against Men,Robbery,Male,60+,9857,7947,1910,8106,1751
2006,Rural,Madhya Pradesh,Other Crimes,Drug Offense,Female,13-17,1499,1371,128,1433,66
2008,Urban,Mizoram,Crime Against Men,Extortion,Female,31-45,8099,5032,3067,5402,2697
2010,Rural,Uttarakhand,Crime Against Men,Robbery,Female,46-60,9505,510,8995,3326,6179
2009,Urban,Karnataka,Crime Against Men,Assault,Female,46-60,7284,7272,12,7278,6
2003,Urban,Bihar,Other Crimes,Corruption,Male,18-30,3220,3057,163,3072,148
2009,Urban,Manipur,Crime Against Women,Dowry Deaths,Female,18-30,8276,4830,3446,7629,647
2010,Rural,Goa,Crime Against Men,Assault,Female,46-60,4415,3546,869,4024,391
2005,Rural,Assam,Other Crimes,Cyber Crime,Male,60+,6723,832,5891,2386,4337
2003,Rural,Uttarakhand,Crime Against Women,Molestation,Female,60+,590,376,214,530,60
2001,Urban,Meghalaya,Property Crime,Vandalism,Male,31-45,1784,153,1631,622,1162
2006,Urban,Himachal Pradesh,Crime Against Men,Extortion,Female,0-12,6372,2884,3488,5511,861
2008,Urban,Jharkhand,Crime Against Men,Assault,Male,31-45,2347,69,2278,533,1814
2006,Rural,Maharashtra,Crime Against Men,Murder,Male,18-30,1608,893,715,964,644
2010,Urban,Goa,Crime Against Women,Rape,Female,46-60,6255,6051,204,6189,66
2003,Rural,Rajasthan,Other Crimes,Drug Offense,Female,31-45,1255,38,1217,623,632
2005,Rural,Karnataka,Crime Against Women,Dowry Deaths,Female,46-60,2635,2573,62,2614,21
2007,Urban,West Bengal,Other Crimes,Cyber Crime,Female,0-12,4099,2142,1957,3361,738
2009,Rural,Gujarat,Crime Against Women,Domestic Violence,Male,46-60,8882,1621,7261,4329,4553
2004,Urban,Kerala,Other Crimes,Drug Offense,Female,46-60,7331,4575,2756,4866,2465
2009,Urban,Kerala,Other Crimes,Drug Offense,Female,31-45,1386,1325,61,1373,13
2005,Urban,Arunachal Pradesh,Other Crimes,Drug Offense,Male,13-17,2431,855,1576,1097,1334
2004,Rural,Maharashtra,Other Crimes,Drug Offense,Male,60+,5721,1239,4482,2623,3098
2002,Rural,Himachal Pradesh,Crime Against Women,Dowry Deaths,Male,46-60,8415,1755,6660,6147,2268
2009,Urban,Uttarakhand,Crime Against Men,Murder,Male,13-17,9603,5253,4350,6528,3075
2003,Rural,Goa,Crime Against Women,Rape,Male,18-30,459,196,263,276,183
2010,Urban,Maharashtra,Crime Against Men,Assault,Female,31-45,3911,440,3471,1249,2662
2007,Urban,Rajasthan,Crime Against Men,Murder,Female,0-12,9833,3389,6444,4361,5472
2005,Urban,Himachal Pradesh,Other Crimes,Drug Offense,Male,46-60,5006,2164,2842,2720,2286
2008,Rural,Odisha,Crime Against Children,Kidnapping,Female,46-60,2190,1124,1066,1442,748
2003,Urban,Himachal Pradesh,Other Crimes,Cyber Crime,Female,60+,541,517,24,537,4
2005,Rural,Sikkim,Crime Against Women,Molestation,Female,13-17,6140,4684,1456,5963,177
2009,Urban,Haryana,Other Crimes,Fraud,Male,31-45,5211,2398,2813,3904,1307
2008,Urban,Madhya Pradesh,Crime Against Children,Kidnapping,Female,46-60,4856,4395,461,4441,415
2009,Urban,Tripura,Other Crimes,Drug Offense,Male,60+,5741,1520,4221,4812,929
2003,Rural,West Bengal,Property Crime,Vandalism,Female,31-45,2650,285,2365,1662,988
2010,Rural,Sikkim,Crime Against Children,Child Labor,Male,0-12,9301,2744,6557,5493,3808
2006,Rural,Rajasthan,Crime Against Children,Trafficking,Female,46-60,5945,5126,819,5542,403
2003,Urban,Andhra Pradesh,Crime Against Men,Robbery,Male,60+,7564,2709,4855,6218,1346
2004,Urban,Arunachal Pradesh,Property Crime,Theft,Female,18-30,5785,3024,2761,4351,1434
2007,Urban,Uttar Pradesh,Other Crimes,Corruption,Male,0-12,9451,889,8562,8749,702
2004,Urban,Jharkhand,Crime Against Men,Extortion,Male,46-60,4962,3951,1011,4131,831
2001,Urban,Tamil Nadu,Crime Against Children,Kidnapping,Female,31-45,9362,6449,2913,7279,2083
2008,Urban,Gujarat,Other Crimes,Fraud,Male,31-45,1957,292,1665,537,1420
2010,Rural,Delhi,Crime Against Children,Child Abuse,Male,31-45,3201,952,2249,2573,628
2004,Urban,Madhya Pradesh,Crime Against Children,Child Labor,Female,0-12,8321,5888,2433,6122,2199
2005,Rural,Odisha,Other Crimes,Corruption,Female,46-60,8193,2903,5290,3569,4624
2008,Rural,Rajasthan,Crime Against Men,Robbery,Female,0-12,6259,4846,1413,5571,688
2005,Rural,Tripura,Crime Against Women,Dowry Deaths,Female,60+,4101,987,3114,4064,37
2006,Urban,Tamil Nadu,Crime Against Children,Trafficking,Male,60+,5355,4469,886,5315,40
2005,Urban,Uttar Pradesh,Crime Against Men,Assault,Female,18-30,4005,1248,2757,2649,1356
2001,Urban,Mizoram,Other Crimes,Cyber Crime,Male,60+,7185,3136,4049,5157,2028
2002,Urban,Odisha,Other Crimes,Corruption,Male,31-45,753,35,718,564,189
2005,Urban,Uttarakhand,Other Crimes,Cyber Crime,Female,46-60,4859,2892,1967,3361,1498
2005,Rural,Bihar,Property Crime,Vandalism,Female,31-45,3758,2545,1213,2835,923
2002,Urban,Mizoram,Crime Against Children,Trafficking,Female,18-30,5727,5580,147,5637,90
2002,Rural,Jharkhand,Crime Against Children,Kidnapping,Male,31-45,7720,4359,3361,4725,2995
2006,Rural,Uttar Pradesh,Crime Against Children,Kidnapping,Female,13-17,2170,1823,347,2095,75
2004,Urban,Nagaland,Crime Against Women,Rape,Female,13-17,1737,1454,283,1613,124
2006,Rural,Bihar,Other Crimes,Fraud,Female,60+,3404,3378,26,3390,14
2009,Urban,Arunachal Pradesh,Other Crimes,Fraud,Male,31-45,6924,2928,3996,3642,3282
2002,Urban,Punjab,Crime Against Men,Extortion,Male,13-17,5683,4598,1085,5220,463
2002,Rural,Punjab,Crime Against Children,Kidnapping,Male,31-45,1530,666,864,990,540
2005,Urban,Odisha,Crime Against Children,Child Labor,Female,18-30,1101,833,268,966,135
2005,Rural,Manipur,Crime Against Children,Child Labor,Female,13-17,4419,1785,2634,3479,940
2002,Urban,Mizoram,Crime Against Women,Domestic Violence,Female,13-17,8015,935,7080,6772,1243
2002,Urban,West Bengal,Crime Against Women,Molestation,Female,31-45,7083,862,6221,3003,4080
2008,Rural,Manipur,Crime Against Children,Trafficking,Male,46-60,5313,4637,676,4737,576
2010,Urban,Arunachal Pradesh,Crime Against Men,Extortion,Female,60+,6772,865,5907,2918,3854
2005,Urban,Bihar,Crime Against Men,Robbery,Female,46-60,8969,5148,3821,6769,2200
2007,Rural,Punjab,Crime Against Men,Murder,Male,13-17,2061,669,1392,1338,723
2004,Urban,Meghalaya,Other Crimes,Fraud,Female,0-12,5538,2390,3148,4145,1393
2010,Rural,Rajasthan,Crime Against Children,Child Labor,Female,13-17,8225,3903,4322,7843,382
2007,Rural,Karnataka,Crime Against Children,Child Labor,Male,31-45,9123,8236,887,8957,166
2010,Rural,Arunachal Pradesh,Crime Against Children,Child Labor,Male,13-17,297,188,109,259,38
2002,Urban,Rajasthan,Crime Against Men,Assault,Male,60+,2834,1472,1362,2437,397
2009,Urban,Delhi,Crime Against Children,Trafficking,Female,13-17,5631,4942,689,5604,27
2006,Urban,Gujarat,Other Crimes,Cyber Crime,Male,18-30,3766,1180,2586,3161,605
2003,Rural,Karnataka,Property Crime,Theft,Male,0-12,8435,7000,1435,8426,9
2010,Urban,Maharashtra,Crime Against Men,Robbery,Male,60+,8800,5383,3417,8260,540
2004,Rural,Gujarat,Other Crimes,Cyber Crime,Male,13-17,2963,1591,1372,2719,244
2004,Urban,Chhattisgarh,Crime Against Men,Robbery,Male,31-45,6684,1488,5196,1838,4846
2008,Urban,Karnataka,Crime Against Women,Molestation,Female,60+,7291,4849,2442,7065,226
2005,Urban,Arunachal Pradesh,Crime Against Women,Domestic Violence,Male,13-17,6069,2403,3666,4246,1823
2004,Rural,Tamil Nadu,Crime Against Children,Child Abuse,Male,60+,8307,820,7487,2495,5812
2006,Urban,Bihar,Other Crimes,Cyber Crime,Female,46-60,8520,1496,7024,7900,620
2008,Rural,Jammu & Kashmir,Property Crime,Vandalism,Female,60+,8141,5807,2334,5886,2255
2002,Rural,Punjab,Crime Against Men,Assault,Male,18-30,7374,6292,1082,6787,587
2007,Rural,Andhra Pradesh,Other Crimes,Corruption,Female,13-17,3908,292,3616,3524,384
2006,Urban,Karnataka,Crime Against Women,Rape,Female,46-60,5653,1970,3683,5593,60
2001,Urban,Karnataka,Other Crimes,Cyber Crime,Female,0-12,2222,884,1338,1643,579
2003,Urban,Odisha,Crime Against Women,Molestation,Male,0-12,1391,358,1033,547,844
2003,Urban,Himachal Pradesh,Property Crime,Arson,Female,31-45,9442,9366,76,9378,64
2003,Urban,Chhattisgarh,Crime Against Children,Child Abuse,Female,18-30,3029,2664,365,2862,167
2004,Rural,Manipur,Crime Against Women,Rape,Female,18-30,6868,6059,809,6693,175
2008,Rural,Odisha,Other Crimes,Corruption,Male,46-60,7173,4809,2364,7150,23
2001,Rural,West Bengal,Property Crime,Theft,Female,13-17,7585,5858,1727,6188,1397
2001,Urban,Chhattisgarh,Crime Against Children,Kidnapping,Male,13-17,1472,1056,416,1199,273
2002,Rural,Odisha,Crime Against Children,Kidnapping,Male,46-60,4165,2349,1816,2804,1361
2007,Urban,Uttarakhand,Crime Against Women,Dowry Deaths,Female,31-45,6549,5270,1279,5970,579
2003,Rural,Tripura,Crime Against Men,Robbery,Male,31-45,6873,3802,3071,4812,2061
2008,Urban,Chhattisgarh,Property Crime,Theft,Male,18-30,8185,16,8169,1661,6524
2003,Urban,Tripura,Crime Against Children,Kidnapping,Female,46-60,302,42,260,243,59
2009,Urban,Bihar,Crime Against Children,Kidnapping,Male,46-60,9086,105,8981,8647,439
2003,Urban,Punjab,Other Crimes,Corruption,Female,31-45,4700,109,4591,3517,1183
2004,Rural,West Bengal,Crime Against Women,Rape,Male,0-12,7883,5060,2823,7828,55
2008,Rural,Assam,Crime Against Women,Molestation,Male,18-30,8867,5793,3074,7739,1128
2005,Rural,Gujarat,Crime Against Men,Assault,Female,31-45,5793,2807,2986,4935,858
2008,Rural,Kerala,Crime Against Women,Rape,Male,46-60,5927,726,5201,1538,4389
2006,Rural,Kerala,Crime Against Men,Assault,Male,0-12,1153,204,949,334,819
2008,Rural,Mizoram,Property Crime,Arson,Male,46-60,4563,4404,159,4536,27
2002,Urban,Manipur,Crime Against Men,Robbery,Female,18-30,8762,2932,5830,7454,1308
2003,Urban,Tripura,Other Crimes,Drug Offense,Male,13-17,4006,3555,451,3870,136
2010,Rural,Goa,Crime Against Men,Extortion,Female,13-17,53,18,35,25,28
2006,Urban,Uttarakhand,Crime Against Men,Murder,Male,31-45,2205,1904,301,2164,41
2006,Urban,Nagaland,Crime Against Women,Rape,Female,13-17,7363,7124,239,7143,220
2007,Urban,Uttarakhand,Property Crime,Vandalism,Female,0-12,6824,5487,1337,6610,214
2009,Urban,Maharashtra,Crime Against Women,Domestic Violence,Female,31-45,7679,756,6923,5512,2167
2003,Rural,Manipur,Property Crime,Arson,Male,0-12,9266,8407,859,9046,220
2009,Urban,Uttarakhand,Property Crime,Theft,Male,0-12,2113,1660,453,1952,161
2004,Rural,Chhattisgarh,Other Crimes,Drug Offense,Female,46-60,5991,1795,4196,3254,2737
2004,Urban,Assam,Other Crimes,Corruption,Male,18-30,1577,1322,255,1414,163
2003,Urban,Nagaland,Property Crime,Theft,Female,46-60,8082,5295,2787,5706,2376
2003,Rural,Delhi,Crime Against Women,Rape,Female,18-30,4866,2814,2052,3492,1374
2007,Rural,Meghalaya,Crime Against Men,Murder,Male,13-17,6215,4801,1414,5039,1176
2009,Urban,Gujarat,Other Crimes,Drug Offense,Female,60+,1319,366,953,914,405
2002,Rural,Karnataka,Property Crime,Burglary,Female,18-30,1097,615,482,762,335
2005,Urban,Karnataka,Crime Against Women,Dowry Deaths,Female,18-30,2055,581,1474,1898,157
2002,Rural,Odisha,Property Crime,Arson,Female,60+,2969,2208,761,2630,339
2004,Rural,Andhra Pradesh,Crime Against Men,Murder,Female,31-45,7206,3813,3393,4239,2967
2009,Urban,Himachal Pradesh,Crime Against Children,Kidnapping,Female,18-30,3234,747,2487,944,2290
2002,Rural,Uttarakhand,Crime Against Children,Child Labor,Female,0-12,9347,3312,6035,7361,1986
2008,Urban,Arunachal Pradesh,Crime Against Women,Rape,Male,13-17,2629,875,1754,1092,1537
2001,Rural,Tripura,Other Crimes,Corruption,Male,60+,9531,1483,8048,5361,4170
2006,Urban,Tripura,Property Crime,Arson,Female,13-17,1051,558,493,969,82
2001,Rural,Gujarat,Crime Against Children,Child Abuse,Male,13-17,9301,8965,336,9255,46
2003,Urban,Uttar Pradesh,Crime Against Children,Child Labor,Male,31-45,1318,804,514,981,337
2001,Rural,Jharkhand,Crime Against Women,Rape,Male,0-12,3216,2561,655,2853,363
2010,Urban,Jammu & Kashmir,Crime Against Men,Robbery,Male,31-45,7766,3572,4194,4875,2891
2005,Urban,Uttarakhand,Crime Against Men,Murder,Male,13-17,7354,4528,2826,6005,1349
2006,Urban,Punjab,Other Crimes,Drug Offense,Female,31-45,9951,7726,2225,8553,1398
2001,Urban,Jharkhand,Other Crimes,Cyber Crime,Female,18-30,3781,3761,20,3764,17
2008,Urban,Haryana,Crime Against Men,Assault,Female,60+,4343,251,4092,1297,3046
2008,Urban,Nagaland,Property Crime,Burglary,Female,31-45,5460,4368,1092,4435,1025
2004,Urban,Haryana,Property Crime,Vandalism,Male,60+,3956,3348,608,3361,595
2003,Rural,Karnataka,Crime Against Men,Murder,Female,31-45,6101,4666,1435,5377,724
2004,Rural,Jammu & Kashmir,Crime Against Children,Kidnapping,Male,46-60,1035,4,1031,60,975
2001,Urban,Delhi,Crime Against Men,Murder,Female,0-12,401,96,305,313,88
2010,Urban,Gujarat,Crime Against Women,Molestation,Male,18-30,6622,6452,170,6620,2
2010,Rural,Arunachal Pradesh,Property Crime,Arson,Male,13-17,6164,2494,3670,4801,1363
2003,Rural,Andhra Pradesh,Crime Against Children,Child Labor,Female,46-60,2104,1302,802,1761,343
2009,Urban,Telangana,Crime Against Women,Dowry Deaths,Female,13-17,7034,2872,4162,2879,4155
2005,Rural,Rajasthan,Crime Against Children,Child Labor,Male,18-30,3363,1719,1644,2020,1343
2006,Urban,Chhattisgarh,Crime Against Children,Child Abuse,Female,60+,9616,1013,8603,1304,8312
2009,Rural,Andhra Pradesh,Crime Against Women,Domestic Violence,Female,31-45,3419,1054,2365,3353,66
2008,Rural,Goa,Crime Against Children,Kidnapping,Female,46-60,6088,418,5670,1972,4116
2003,Rural,Goa,Property Crime,Theft,Male,18-30,390,371,19,376,14
2006,Urban,Manipur,Crime Against Women,Dowry Deaths,Male,46-60,8065,1028,7037,4798,3267
2001,Urban,Chhattisgarh,Other Crimes,Drug Offense,Female,18-30,1537,22,1515,136,1401
2005,Urban,Himachal Pradesh,Property Crime,Burglary,Female,18-30,9311,9062,249,9111,200
2009,Urban,Rajasthan,Property Crime,Burglary,Female,60+,1306,124,1182,1090,216
2010,Urban,Delhi,Other Crimes,Corruption,Female,18-30,4933,619,4314,3839,1094
2007,Urban,Manipur,Crime Against Women,Rape,Female,13-17,4091,3097,994,3203,888
2001,Urban,Gujarat,Crime Against Men,Robbery,Female,31-45,161,76,85,119,42
2001,Rural,Delhi,Other Crimes,Cyber Crime,Female,31-45,8866,83,8783,8007,859
2003,Rural,Haryana,Crime Against Men,Murder,Female,18-30,9300,3278,6022,6342,2958
2003,Urban,Telangana,Crime Against Men,Extortion,Female,60+,7908,627,7281,2542,5366
2007,Urban,Madhya Pradesh,Other Crimes,Cyber Crime,Male,18-30,1103,1060,43,1078,25
2009,Urban,Mizoram,Crime Against Men,Murder,Female,13-17,607,502,105,603,4
2001,Rural,Manipur,Crime Against Women,Molestation,Male,46-60,7232,5269,1963,6636,596
2007,Urban,Maharashtra,Property Crime,Arson,Female,0-12,2536,1173,1363,1623,913
2008,Urban,Meghalaya,Other Crimes,Drug Offense,Male,60+,2022,1545,477,1784,238
2009,Urban,Himachal Pradesh,Crime Against Women,Molestation,Male,0-12,2976,1697,1279,2725,251
2001,Rural,Manipur,Other Crimes,Cyber Crime,Male,31-45,6436,2036,4400,2972,3464
2001,Rural,Nagaland,Crime Against Men,Extortion,Female,13-17,1263,227,1036,947,316
2009,Urban,Karnataka,Crime Against Men,Robbery,Female,31-45,1635,1512,123,1562,73
2010,Urban,Assam,Crime Against Children,Child Abuse,Female,0-12,7132,639,6493,3340,3792
2006,Rural,Assam,Other Crimes,Drug Offense,Male,18-30,9093,4843,4250,6243,2850
2009,Rural,Kerala,Property Crime,Arson,Female,60+,9716,8570,1146,9228,488
2008,Urban,Manipur,Other Crimes,Corruption,Male,60+,9213,132,9081,486,8727
2001,Urban,Tamil Nadu,Crime Against Women,Molestation,Female,31-45,4119,60,4059,2602,1517
2001,Urban,Odisha,Crime Against Children,Trafficking,Male,13-17,3889,1310,2579,3748,141
2001,Rural,Goa,Other Crimes,Drug Offense,Female,60+,7737,2554,5183,3407,4330
2010,Rural,Chhattisgarh,Other Crimes,Cyber Crime,Female,18-30,639,616,23,622,17
2006,Rural,Haryana,Crime Against Children,Kidnapping,Male,18-30,6993,1184,5809,3470,3523
2006,Urban,Manipur,Other Crimes,Fraud,Female,46-60,2250,882,1368,1698,552
2001,Urban,Sikkim,Crime Against Women,Domestic Violence,Male,0-12,6676,2606,4070,3364,3312
2009,Rural,Tripura,Crime Against Men,Robbery,Female,13-17,2082,1759,323,2010,72
2001,Rural,Tripura,Crime Against Men,Extortion,Female,18-30,1216,202,1014,666,550
2008,Urban,West Bengal,Other Crimes,Cyber Crime,Male,13-17,5443,3948,1495,4530,913
2004,Urban,Bihar,Crime Against Women,Domestic Violence,Female,60+,1964,1844,120,1846,118
2006,Rural,Andhra Pradesh,Property Crime,Theft,Male,31-45,8908,6510,2398,6798,2110
2003,Rural,Telangana,Crime Against Women,Domestic Violence,Male,13-17,4856,3197,1659,4509,347
2008,Urban,Uttar Pradesh,Crime Against Men,Robbery,Female,46-60,8828,4698,4130,6219,2609
2002,Urban,Uttar Pradesh,Crime Against Women,Domestic Violence,Female,31-45,9498,7886,1612,8642,856
2007,Rural,Meghalaya,Crime Against Children,Child Labor,Female,60+,2926,2077,849,2389,537
2002,Urban,Punjab,Crime Against Children,Child Labor,Female,18-30,6289,5685,604,5724,565
2007,Urban,Madhya Pradesh,Property Crime,Vandalism,Female,13-17,3789,344,3445,559,3230
2007,Rural,Manipur,Crime Against Men,Murder,Female,18-30,4923,3958,965,4800,123
2010,Rural,Goa,Property Crime,Theft,Female,31-45,8121,2635,5486,4508,3613
2009,Urban,Goa,Crime Against Women,Rape,Male,13-17,9977,9132,845,9816,161
2003,Rural,Tamil Nadu,Property Crime,Burglary,Male,31-45,1088,275,813,452,636
2007,Urban,Jharkhand,Crime Against Men,Assault,Female,13-17,3690,3451,239,3546,144
2004,Urban,Madhya Pradesh,Crime Against Women,Dowry Deaths,Female,31-45,3040,885,2155,1269,1771
2006,Rural,Arunachal Pradesh,Crime Against Children,Child Labor,Female,46-60,2039,1841,198,1886,153
2005,Urban,Haryana,Other Crimes,Cyber Crime,Female,60+,765,122,643,628,137
2010,Rural,Himachal Pradesh,Property Crime,Arson,Male,13-17,8626,2095,6531,5846,2780
2005,Urban,Madhya Pradesh,Crime Against Men,Murder,Female,13-17,3479,2583,896,2861,618
2008,Urban,Odisha,Crime Against Women,Domestic Violence,Female,18-30,7830,3160,4670,4671,3159
2001,Rural,Delhi,Crime Against Men,Assault,Female,0-12,389,236,153,361,28
2005,Rural,Karnataka,Crime Against Men,Extortion,Male,46-60,3209,1043,2166,1829,1380
2007,Urban,Mizoram,Property Crime,Arson,Male,46-60,9910,8435,1475,9431,479
2006,Rural,Meghalaya,Crime Against Children,Child Labor,Male,0-12,9423,5366,4057,6859,2564
2009,Rural,Punjab,Crime Against Children,Child Labor,Female,31-45,3509,2787,722,3434,75
2004,Urban,Maharashtra,Crime Against Women,Dowry Deaths,Female,18-30,5665,1437,4228,3184,2481
2010,Rural,Meghalaya,Crime Against Children,Child Labor,Male,13-17,7655,4774,2881,6701,954
2005,Urban,Haryana,Crime Against Children,Child Labor,Male,46-60,1921,619,1302,1595,326
2009,Urban,Uttarakhand,Property Crime,Burglary,Male,60+,8400,1054,7346,4433,3967
2003,Urban,Jharkhand,Crime Against Women,Molestation,Male,13-17,8877,6097,2780,8329,548
2008,Urban,Haryana,Crime Against Children,Trafficking,Female,0-12,1435,1188,247,1242,193
2010,Rural,Madhya Pradesh,Crime Against Men,Extortion,Female,0-12,1289,881,408,1194,95
2001,Urban,Jharkhand,Other Crimes,Drug Offense,Male,46-60,1664,773,891,1627,37
2003,Urban,Madhya Pradesh,Crime Against Men,Murder,Female,0-12,1463,493,970,1181,282
2004,Rural,Jharkhand,Other Crimes,Drug Offense,Female,0-12,5786,1511,4275,3426,2360
2004,Rural,Tripura,Crime Against Men,Murder,Female,13-17,7601,6015,1586,7517,84
2002,Urban,Nagaland,Crime Against Women,Rape,Female,18-30,9764,4089,5675,9121,643
2004,Rural,Tamil Nadu,Crime Against Children,Child Labor,Male,18-30,8099,2719,5380,4715,3384
2002,Rural,Andhra Pradesh,Crime Against Children,Child Labor,Female,0-12,7303,6011,1292,6575,728
2010,Rural,Jammu & Kashmir,Property Crime,Arson,Female,18-30,7130,1234,5896,6508,622
2007,Urban,Manipur,Other Crimes,Corruption,Male,60+,4598,1265,3333,2139,2459
2007,Urban,Jammu & Kashmir,Other Crimes,Drug Offense,Female,46-60,6701,3943,2758,4490,2211
2004,Urban,Punjab,Other Crimes,Drug Offense,Male,60+,3496,308,3188,1132,2364
2005,Rural,Maharashtra,Crime Against Women,Molestation,Male,31-45,9144,8153,991,8346,798
2008,Urban,Arunachal Pradesh,Crime Against Men,Assault,Male,0-12,8896,2342,6554,7617,1279
2004,Rural,Nagaland,Crime Against Children,Child Labor,Female,0-12,9145,7706,1439,8466,679
2005,Urban,Maharashtra,Crime Against Children,Child Labor,Female,31-45,1226,267,959,1075,151
2009,Rural,Uttarakhand,Crime Against Men,Assault,Female,18-30,2715,2326,389,2593,122
2003,Urban,Himachal Pradesh,Other Crimes,Drug Offense,Female,46-60,5443,3079,2364,4837,606
2001,Rural,West Bengal,Other Crimes,Corruption,Male,0-12,4385,3129,1256,3215,1170
2006,Urban,Gujarat,Crime Against Men,Assault,Male,31-45,5479,4592,887,5393,86
2005,Urban,Telangana,Crime Against Women,Rape,Male,13-17,3142,1741,1401,2218,924
2010,Urban,Maharashtra,Crime Against Women,Domestic Violence,Female,31-45,9586,6969,2617,8929,657
2006,Urban,Rajasthan,Property Crime,Vandalism,Male,13-17,5170,1680,3490,3958,1212
2003,Rural,Chhattisgarh,Property Crime,Vandalism,Female,46-60,2329,1788,541,2304,25
2002,Urban,Karnataka,Crime Against Women,Rape,Male,60+,8722,6668,2054,8428,294
2001,Rural,Rajasthan,Crime Against Children,Kidnapping,Female,31-45,2568,428,2140,1665,903
2010,Rural,Haryana,Other Crimes,Cyber Crime,Female,18-30,7358,1185,6173,6212,1146
2008,Rural,Telangana,Crime Against Women,Dowry Deaths,Female,18-30,4657,4373,284,4592,65
2009,Urban,Gujarat,Property Crime,Burglary,Male,18-30,7222,5477,1745,6558,664
2008,Rural,Kerala,Crime Against Women,Rape,Female,18-30,3120,1572,1548,2302,818
2010,Rural,West Bengal,Crime Against Men,Murder,Male,60+,2366,80,2286,1838,528
2005,Urban,Meghalaya,Other Crimes,Fraud,Male,13-17,516,374,142,382,134
2001,Urban,Odisha,Crime Against Children,Kidnapping,Male,60+,5240,1205,4035,1318,3922
2007,Rural,Punjab,Other Crimes,Drug Offense,Female,13-17,237,18,219,180,57
2002,Rural,Bihar,Crime Against Women,Dowry Deaths,Female,13-17,7302,6628,674,7084,218
2009,Rural,Assam,Property Crime,Burglary,Female,18-30,5662,3944,1718,4448,1214
2009,Rural,Rajasthan,Other Crimes,Fraud,Male,46-60,2196,1615,581,2036,160
2008,Urban,Assam,Crime Against Men,Robbery,Female,18-30,5586,5168,418,5459,127
2002,Rural,Rajasthan,Crime Against Women,Domestic Violence,Male,31-45,8468,6959,1509,8192,276
2007,Rural,Tripura,Crime Against Women,Dowry Deaths,Female,60+,2839,924,1915,2565,274
2009,Rural,Jammu & Kashmir,Property Crime,Arson,Female,31-45,4507,3162,1345,4059,448
2009,Urban,Punjab,Property Crime,Theft,Male,60+,7279,5726,1553,6690,589
2010,Rural,Telangana,Other Crimes,Fraud,Male,0-12,458,426,32,444,14
2002,Urban,Kerala,Crime Against Children,Child Abuse,Male,31-45,9233,4421,4812,5628,3605
2003,Rural,Bihar,Crime Against Women,Domestic Violence,Male,46-60,4829,793,4036,3929,900
2006,Urban,Kerala,Crime Against Men,Assault,Male,13-17,8696,7517,1179,7633,1063
2004,Rural,Uttar Pradesh,Property Crime,Burglary,Female,46-60,4235,1108,3127,2221,2014
2009,Rural,Jammu & Kashmir,Other Crimes,Fraud,Female,46-60,2708,2610,98,2692,16
2002,Urban,Uttar Pradesh,Property Crime,Theft,Male,60+,7783,2488,5295,4963,2820
2005,Rural,Telangana,Crime Against Children,Child Abuse,Female,13-17,6893,5564,1329,6247,646
2001,Rural,Tripura,Crime Against Children,Child Abuse,Female,60+,2197,593,1604,1061,1136
2003,Rural,Andhra Pradesh,Crime Against Women,Dowry Deaths,Male,18-30,2655,2365,290,2419,236
2005,Rural,Manipur,Crime Against Men,Assault,Male,18-30,4043,3012,1031,3777,266
2010,Rural,Uttar Pradesh,Crime Against Children,Child Labor,Female,0-12,8789,2034,6755,7634,1155
2006,Rural,Telangana,Crime Against Women,Rape,Male,0-12,7278,1580,5698,6202,1076
2006,Urban,West Bengal,Crime Against Children,Trafficking,Male,46-60,8498,2628,5870,3410,5088
2003,Rural,Kerala,Property Crime,Burglary,Female,46-60,557,293,264,328,229
2010,Urban,Tamil Nadu,Crime Against Women,Domestic Violence,Male,18-30,6469,4212,2257,4618,1851
2008,Rural,Chhattisgarh,Crime Against Women,Dowry Deaths,Male,46-60,7734,674,7060,6408,1326
2008,Urban,Bihar,Crime Against Men,Assault,Female,18-30,5797,1549,4248,4184,1613
2003,Rural,Nagaland,Crime Against Children,Child Abuse,Female,60+,8581,85,8496,807,7774
2001,Rural,Mizoram,Other Crimes,Fraud,Male,13-17,829,346,483,451,378
2009,Urban,Sikkim,Crime Against Children,Child Abuse,Female,46-60,257,135,122,203,54
2008,Rural,Punjab,Crime Against Men,Assault,Female,46-60,7931,850,7081,3077,4854
2008,Urban,Uttarakhand,Other Crimes,Fraud,Female,31-45,6988,3388,3600,6521,467
2002,Rural,Madhya Pradesh,Other Crimes,Drug Offense,Male,13-17,7262,7091,171,7251,11
2005,Rural,Odisha,Crime Against Children,Kidnapping,Female,18-30,4172,48,4124,1714,2458
2007,Urban,Arunachal Pradesh,Property Crime,Theft,Female,13-17,4256,1504,2752,3081,1175
2010,Urban,Uttarakhand,Other Crimes,Fraud,Male,31-45,3169,2717,452,2990,179
2006,Urban,Andhra Pradesh,Crime Against Women,Molestation,Female,18-30,9855,1539,8316,8228,1627
2009,Rural,Uttar Pradesh,Crime Against Children,Child Labor,Male,46-60,2368,2168,200,2172,196
2008,Rural,Arunachal Pradesh,Crime Against Men,Murder,Female,46-60,3398,932,2466,1943,1455
2009,Urban,Sikkim,Crime Against Men,Murder,Female,31-45,7731,1504,6227,7645,86
2003,Rural,Arunachal Pradesh,Other Crimes,Corruption,Female,46-60,9702,9652,50,9691,11
2008,Urban,Maharashtra,Crime Against Women,Domestic Violence,Male,60+,171,156,15,156,15
2007,Rural,Tripura,Other Crimes,Fraud,Male,0-12,6793,2533,4260,3907,2886
2002,Urban,Gujarat,Other Crimes,Cyber Crime,Female,60+,3936,2401,1535,2981,955
2006,Rural,Jharkhand,Crime Against Children,Trafficking,Male,13-17,6434,6291,143,6323,111
2009,Urban,Nagaland,Crime Against Men,Robbery,Female,13-17,555,55,500,141,414
2002,Rural,Uttarakhand,Crime Against Children,Child Abuse,Male,46-60,9603,4267,5336,6226,3377
2005,Rural,Madhya Pradesh,Other Crimes,Cyber Crime,Female,31-45,3561,2099,1462,3334,227
2010,Rural,Manipur,Property Crime,Theft,Male,31-45,9094,1240,7854,5956,3138
2009,Urban,Jharkhand,Crime Against Men,Murder,Male,0-12,4688,3729,959,3984,704
2006,Urban,Delhi,Crime Against Children,Trafficking,Female,18-30,4200,1221,2979,1534,2666
2005,Rural,Arunachal Pradesh,Crime Against Men,Robbery,Male,0-12,7607,6003,1604,6635,972
2008,Rural,Punjab,Crime Against Men,Murder,Female,0-12,495,491,4,492,3
2009,Urban,Jharkhand,Crime Against Children,Child Labor,Female,31-45,5259,3716,1543,3858,1401
2009,Rural,Manipur,Crime Against Children,Trafficking,Male,18-30,1593,820,773,981,612
2009,Rural,Nagaland,Crime Against Women,Domestic Violence,Female,46-60,8275,3206,5069,3392,4883
2008,Urban,Chhattisgarh,Crime Against Men,Extortion,Female,13-17,5060,4930,130,5033,27
2006,Rural,Sikkim,Crime Against Men,Robbery,Female,60+,2530,177,2353,1699,831
2003,Urban,Haryana,Crime Against Women,Domestic Violence,Female,0-12,3622,760,2862,3203,419
2004,Urban,Meghalaya,Other Crimes,Fraud,Male,60+,3667,1632,2035,3435,232
2006,Urban,Sikkim,Crime Against Children,Trafficking,Male,60+,2158,247,1911,558,1600
2002,Urban,Haryana,Crime Against Children,Kidnapping,Male,18-30,2331,122,2209,2234,97
2008,Urban,Goa,Crime Against Children,Kidnapping,Male,46-60,4369,1461,2908,3122,1247
2002,Rural,Karnataka,Crime Against Children,Trafficking,Male,46-60,5039,4741,298,4966,73
2003,Rural,Telangana,Other Crimes,Cyber Crime,Female,13-17,2252,144,2108,1055,1197
2009,Rural,Punjab,Crime Against Children,Kidnapping,Male,60+,3534,2753,781,2775,759
2009,Urban,Tripura,Other Crimes,Cyber Crime,Female,13-17,2946,2586,360,2900,46
2008,Rural,Assam,Property Crime,Theft,Female,0-12,2214,665,1549,759,1455
2004,Rural,West Bengal,Other Crimes,Corruption,Female,18-30,1678,1191,487,1259,419
2002,Urban,West Bengal,Crime Against Children,Child Abuse,Female,13-17,50,23,27,43,7
2003,Rural,Arunachal Pradesh,Crime Against Men,Murder,Female,18-30,7576,6268,1308,7055,521
2002,Rural,Uttar Pradesh,Crime Against Children,Child Abuse,Male,0-12,6135,1680,4455,3533,2602
2006,Urban,Tamil Nadu,Other Crimes,Cyber Crime,Female,13-17,3575,367,3208,759,2816
2004,Rural,Tripura,Crime Against Children,Trafficking,Female,46-60,8416,2713,5703,7134,1282
2005,Urban,Meghalaya,Crime Against Children,Child Abuse,Female,46-60,2687,237,2450,260,2427
2002,Rural,Maharashtra,Crime Against Women,Domestic Violence,Female,60+,5280,1744,3536,4729,551
2004,Urban,Gujarat,Crime Against Women,Rape,Male,0-12,6808,2045,4763,4771,2037
2010,Urban,Madhya Pradesh,Other Crimes,Drug Offense,Male,18-30,7646,7356,290,7436,210
2009,Rural,Uttarakhand,Crime Against Children,Kidnapping,Female,31-45,800,474,326,569,231
2009,Rural,Sikkim,Property Crime,Vandalism,Male,60+,8958,8087,871,8738,220
2006,Urban,Uttar Pradesh,Crime Against Children,Child Abuse,Male,46-60,3888,1572,2316,3435,453
2006,Rural,Punjab,Other Crimes,Drug Offense,Female,60+,5912,5046,866,5640,272
2002,Urban,Nagaland,Property Crime,Vandalism,Male,0-12,3844,682,3162,1616,2228
2009,Urban,Maharashtra,Crime Against Women,Molestation,Male,31-45,5304,682,4622,3559,1745
2003,Urban,Haryana,Crime Against Women,Rape,Female,46-60,3057,2433,624,2603,454
2006,Rural,Chhattisgarh,Crime Against Men,Murder,Female,18-30,9142,6995,2147,8343,799
2007,Rural,Punjab,Other Crimes,Fraud,Female,18-30,2786,1617,1169,2731,55
2001,Rural,Sikkim,Crime Against Men,Extortion,Male,46-60,7630,7499,131,7583,47
2006,Urban,Delhi,Crime Against Women,Molestation,Male,60+,4028,1454,2574,2177,1851
2006,Rural,Mizoram,Crime Against Children,Child Labor,Male,18-30,2759,2599,160,2629,130
2001,Rural,Chhattisgarh,Crime Against Women,Domestic Violence,Female,13-17,7393,6630,763,6841,552
2007,Urban,Goa,Crime Against Women,Domestic Violence,Female,31-45,7116,6614,502,6885,231
2008,Urban,Meghalaya,Crime Against Children,Child Abuse,Female,60+,6551,6170,381,6416,135
2001,Urban,Uttar Pradesh,Crime Against Children,Child Abuse,Female,31-45,6274,4612,1662,4865,1409
2002,Rural,Rajasthan,Crime Against Women,Domestic Violence,Male,60+,2649,2263,386,2435,214
2001,Rural,Gujarat,Crime Against Women,Dowry Deaths,Male,0-12,8235,8198,37,8205,30
2007,Urban,Jharkhand,Property Crime,Vandalism,Male,18-30,1496,1454,42,1455,41
2002,Urban,Uttarakhand,Crime Against Men,Robbery,Male,60+,3251,2995,256,3233,18
2004,Rural,Goa,Crime Against Men,Murder,Male,60+,1129,739,390,1057,72
2002,Rural,Tripura,Crime Against Men,Extortion,Female,31-45,2449,1084,1365,1169,1280
2007,Rural,Telangana,Crime Against Men,Assault,Male,18-30,5561,5445,116,5479,82
2002,Rural,Assam,Crime Against Children,Kidnapping,Female,31-45,8864,3672,5192,7791,1073
2003,Rural,Odisha,Crime Against Women,Molestation,Male,46-60,6156,76,6080,5911,245
2005,Urban,Meghalaya,Crime Against Men,Robbery,Male,18-30,1580,977,603,1180,400
2007,Urban,Uttar Pradesh,Crime Against Women,Dowry Deaths,Male,60+,6158,151,6007,947,5211
2005,Rural,Nagaland,Crime Against Men,Murder,Female,18-30,4328,570,3758,2271,2057
2003,Rural,Chhattisgarh,Property Crime,Vandalism,Male,0-12,443,359,84,403,40
2008,Rural,Telangana,Other Crimes,Corruption,Female,31-45,2268,1290,978,1862,406
2005,Urban,Chhattisgarh,Crime Against Children,Child Abuse,Male,60+,8958,2923,6035,7889,1069
2007,Rural,Jharkhand,Property Crime,Vandalism,Female,60+,230,169,61,222,8
2006,Rural,Odisha,Crime Against Women,Molestation,Male,46-60,3530,1025,2505,1622,1908
2004,Rural,Jharkhand,Crime Against Men,Robbery,Male,0-12,4777,1576,3201,3182,1595
2007,Rural,Manipur,Crime Against Men,Robbery,Female,13-17,8647,5391,3256,5507,3140
2005,Rural,Bihar,Crime Against Men,Assault,Female,46-60,3079,1769,1310,2847,232
2004,Rural,Delhi,Crime Against Children,Child Abuse,Male,60+,7460,6846,614,7348,112
2005,Urban,Nagaland,Crime Against Women,Molestation,Female,46-60,185,109,76,183,2
2007,Rural,Arunachal Pradesh,Property Crime,Theft,Female,0-12,3958,2088,1870,3855,103
2008,Urban,Assam,Crime Against Women,Domestic Violence,Female,31-45,3081,1446,1635,1536,1545
2008,Urban,Mizoram,Property Crime,Vandalism,Female,46-60,2226,236,1990,514,1712
2006,Urban,Mizoram,Property Crime,Vandalism,Male,0-12,5739,2274,3465,3525,2214
2006,Urban,Maharashtra,Other Crimes,Corruption,Male,0-12,4284,3437,847,4215,69
2004,Rural,Bihar,Crime Against Children,Kidnapping,Male,46-60,703,340,363,404,299
2005,Urban,Bihar,Crime Against Children,Child Abuse,Male,13-17,8512,5263,3249,5469,3043
2004,Rural,Telangana,Other Crimes,Cyber Crime,Male,31-45,9148,8607,541,8738,410
2010,Rural,Sikkim,Crime Against Men,Extortion,Female,0-12,1839,984,855,1017,822
2008,Rural,Tripura,Crime Against Men,Robbery,Male,18-30,7858,7428,430,7820,38
2003,Rural,Kerala,Crime Against Women,Rape,Female,18-30,6431,4658,1773,4709,1722
2010,Rural,Bihar,Crime Against Children,Child Abuse,Female,31-45,9417,5406,4011,7341,2076
2004,Urban,Tripura,Other Crimes,Fraud,Male,0-12,4683,3062,1621,3906,777
2002,Rural,Kerala,Property Crime,Vandalism,Male,60+,3402,1273,2129,3137,265
2007,Rural,Telangana,Crime Against Women,Molestation,Female,60+,2480,1817,663,2028,452
2007,Urban,Rajasthan,Crime Against Children,Child Labor,Male,46-60,642,401,241,499,143
2001,Urban,Haryana,Crime Against Men,Robbery,Male,18-30,5098,2550,2548,3931,1167
2007,Urban,Jammu & Kashmir,Crime Against Children,Trafficking,Female,60+,4662,1265,3397,2745,1917
2002,Rural,Himachal Pradesh,Crime Against Men,Robbery,Female,31-45,8977,6011,2966,8083,894
2006,Urban,Jammu & Kashmir,Crime Against Children,Child Abuse,Female,0-12,1437,418,1019,1228,209
2010,Urban,Kerala,Crime Against Men,Assault,Male,60+,7652,3242,4410,6942,710
2007,Rural,Manipur,Crime Against Women,Molestation,Male,46-60,2168,3,2165,1143,1025
2008,Urban,Goa,Other Crimes,Drug Offense,Male,60+,3960,1288,2672,2883,1077
2002,Urban,Punjab,Other Crimes,Drug Offense,Female,13-17,175,46,129,104,71
2008,Urban,Maharashtra,Crime Against Women,Dowry Deaths,Male,31-45,3026,1409,1617,2408,618
2001,Urban,Nagaland,Crime Against Men,Robbery,Female,60+,266,29,237,259,7
2006,Rural,West Bengal,Crime Against Children,Child Abuse,Female,31-45,6910,1248,5662,5514,1396
2005,Rural,Assam,Other Crimes,Cyber Crime,Male,46-60,5046,1483,3563,2531,2515
2010,Rural,West Bengal,Property Crime,Vandalism,Male,31-45,4091,1469,2622,3028,1063
2003,Rural,Gujarat,Crime Against Children,Trafficking,Female,31-45,4210,4196,14,4203,7
2009,Urban,Telangana,Crime Against Men,Robbery,Female,0-12,6488,233,6255,2642,3846
2009,Urban,Telangana,Crime Against Men,Assault,Female,46-60,3440,1171,2269,2038,1402
2005,Rural,Andhra Pradesh,Crime Against Women,Molestation,Female,18-30,5235,4995,240,5141,94
2006,Rural,Kerala,Other Crimes,Corruption,Female,46-60,2031,2014,17,2014,17
2003,Rural,Maharashtra,Crime Against Children,Child Abuse,Male,60+,8973,1037,7936,4059,4914
2002,Rural,Goa,Property Crime,Theft,Female,18-30,3448,1327,2121,1735,1713
2007,Urban,Haryana,Property Crime,Burglary,Male,31-45,5544,560,4984,3260,2284
2008,Urban,Odisha,Property Crime,Burglary,Female,13-17,8887,3172,5715,3190,5697
2006,Urban,Mizoram,Property Crime,Arson,Female,18-30,4528,4499,29,4511,17
2006,Rural,Himachal Pradesh,Crime Against Children,Kidnapping,Male,18-30,2496,505,1991,1727,769
2010,Urban,Haryana,Crime Against Women,Rape,Female,31-45,6209,5531,678,5981,228
2005,Urban,Karnataka,Crime Against Men,Robbery,Male,31-45,2185,1861,324,2039,146
2010,Rural,Jharkhand,Other Crimes,Fraud,Female,18-30,505,283,222,341,164
2007,Urban,West Bengal,Crime Against Men,Extortion,Male,31-45,7536,3016,4520,7002,534
2004,Rural,Jharkhand,Crime Against Women,Molestation,Female,60+,9178,8267,911,8870,308
2007,Urban,Chhattisgarh,Crime Against Children,Trafficking,Female,31-45,9687,2925,6762,3960,5727
2004,Rural,Punjab,Crime Against Children,Child Abuse,Male,60+,176,105,71,142,34
2005,Urban,Telangana,Crime Against Children,Trafficking,Female,13-17,5359,3141,2218,5019,340
2005,Rural,Arunachal Pradesh,Property Crime,Vandalism,Female,60+,1830,1172,658,1550,280
2004,Urban,Telangana,Other Crimes,Drug Offense,Male,60+,9449,7649,1800,7716,1733
2003,Urban,Karnataka,Other Crimes,Corruption,Female,18-30,4471,1687,2784,2030,2441
2001,Rural,Maharashtra,Crime Against Children,Kidnapping,Female,31-45,828,620,208,725,103
2009,Rural,Odisha,Crime Against Men,Assault,Male,13-17,5824,4774,1050,5330,494
2008,Rural,Uttar Pradesh,Property Crime,Vandalism,Female,31-45,9113,1374,7739,5933,3180
2007,Urban,Kerala,Other Crimes,Cyber Crime,Male,13-17,4602,4431,171,4598,4
2006,Urban,Punjab,Crime Against Men,Robbery,Male,46-60,1703,820,883,1523,180
2008,Urban,Punjab,Other Crimes,Drug Offense,Male,60+,9518,4058,5460,8645,873
2005,Rural,Rajasthan,Crime Against Women,Rape,Male,0-12,9172,8753,419,8828,344
2002,Urban,Sikkim,Other Crimes,Corruption,Male,60+,3739,2562,1177,3468,271
2009,Rural,Himachal Pradesh,Crime Against Women,Dowry Deaths,Male,46-60,5941,1756,4185,4161,1780
2002,Rural,Meghalaya,Property Crime,Vandalism,Male,18-30,4752,1309,3443,2055,2697
2004,Rural,Chhattisgarh,Other Crimes,Cyber Crime,Male,13-17,2386,1393,993,1885,501
2008,Rural,Bihar,Crime Against Children,Trafficking,Male,0-12,1901,840,1061,878,1023
2006,Urban,Meghalaya,Other Crimes,Drug Offense,Female,0-12,2862,476,2386,1767,1095
2009,Urban,Uttar Pradesh,Crime Against Children,Trafficking,Male,0-12,68,22,46,36,32
2006,Urban,Jharkhand,Crime Against Women,Molestation,Male,31-45,6904,18,6886,1684,5220
2004,Urban,Tripura,Other Crimes,Cyber Crime,Male,0-12,839,443,396,652,187
2005,Rural,West Bengal,Crime Against Men,Robbery,Male,0-12,5151,449,4702,3372,1779
2006,Urban,Jharkhand,Crime Against Women,Molestation,Male,60+,5669,1479,4190,5654,15
2001,Rural,Jammu & Kashmir,Crime Against Men,Murder,Female,18-30,2990,460,2530,784,2206
2003,Rural,Uttarakhand,Crime Against Children,Trafficking,Male,18-30,4316,65,4251,952,3364
2002,Urban,Himachal Pradesh,Other Crimes,Drug Offense,Female,18-30,9055,5782,3273,6956,2099
2007,Rural,Tripura,Crime Against Men,Murder,Male,13-17,5593,4907,686,5492,101
2005,Rural,Rajasthan,Property Crime,Burglary,Male,18-30,5925,843,5082,1413,4512
2005,Rural,Jammu & Kashmir,Crime Against Men,Assault,Female,0-12,3378,9,3369,2518,860
2006,Urban,Tripura,Property Crime,Vandalism,Male,31-45,7778,2982,4796,3056,4722
2004,Urban,Jammu & Kashmir,Other Crimes,Corruption,Female,18-30,8603,6267,2336,7447,1156
2007,Urban,Madhya Pradesh,Other Crimes,Drug Offense,Female,31-45,4631,3359,1272,3429,1202
2008,Urban,Karnataka,Crime Against Women,Dowry Deaths,Female,60+,2934,1310,1624,2513,421
2010,Rural,West Bengal,Crime Against Men,Extortion,Male,0-12,8856,1678,7178,5212,3644
2009,Rural,Karnataka,Crime Against Men,Extortion,Male,0-12,3266,557,2709,3132,134
2009,Urban,Haryana,Other Crimes,Corruption,Female,0-12,5738,3928,1810,5393,345
2004,Urban,Haryana,Other Crimes,Drug Offense,Male,31-45,1982,1680,302,1887,95
2010,Urban,Maharashtra,Crime Against Children,Child Abuse,Male,18-30,4302,4162,140,4290,12
2007,Urban,Meghalaya,Crime Against Women,Dowry Deaths,Male,13-17,5668,5008,660,5436,232
2008,Urban,Chhattisgarh,Other Crimes,Fraud,Female,60+,4227,1592,2635,2596,1631
2003,Urban,Rajasthan,Property Crime,Vandalism,Male,13-17,8148,665,7483,5985,2163
2004,Rural,Assam,Crime Against Children,Child Labor,Male,13-17,3098,179,2919,2022,1076
2001,Rural,Sikkim,Property Crime,Burglary,Female,13-17,259,39,220,248,11
2004,Urban,Punjab,Other Crimes,Cyber Crime,Female,13-17,3333,2703,630,3198,135
2010,Rural,Gujarat,Property Crime,Vandalism,Male,46-60,8188,772,7416,4058,4130
2006,Urban,Telangana,Crime Against Children,Child Abuse,Male,31-45,176,13,163,25,151
2005,Rural,Gujarat,Other Crimes,Drug Offense,Female,31-45,5860,2103,3757,2266,3594
2007,Rural,Nagaland,Crime Against Men,Robbery,Male,31-45,9080,4063,5017,4996,4084
2008,Urban,Manipur,Crime Against Women,Domestic Violence,Male,18-30,3967,2994,973,3003,964
2002,Urban,Uttar Pradesh,Crime Against Women,Domestic Violence,Female,60+,2970,1914,1056,2236,734
2002,Rural,Karnataka,Property Crime,Vandalism,Female,31-45,7555,5297,2258,7362,193
2007,Urban,Haryana,Crime Against Men,Murder,Female,0-12,7455,1699,5756,2241,5214
2008,Rural,Uttarakhand,Crime Against Men,Robbery,Female,31-45,943,406,537,837,106
2004,Rural,Tripura,Property Crime,Arson,Female,0-12,9911,6265,3646,8603,1308
2007,Urban,West Bengal,Property Crime,Vandalism,Male,0-12,2035,1610,425,1649,386
2002,Rural,Odisha,Other Crimes,Drug Offense,Male,46-60,278,173,105,278,0
2008,Rural,Telangana,Other Crimes,Drug Offense,Male,46-60,680,275,405,352,328
2008,Urban,Haryana,Property Crime,Theft,Female,18-30,4192,1107,3085,2205,1987
2007,Urban,Punjab,Other Crimes,Cyber Crime,Female,60+,6248,3370,2878,5691,557
2008,Urban,Himachal Pradesh,Crime Against Men,Robbery,Female,13-17,7967,3136,4831,6081,1886
2010,Urban,Himachal Pradesh,Crime Against Men,Robbery,Female,46-60,524,185,339,388,136
2001,Urban,Nagaland,Crime Against Men,Murder,Male,18-30,323,195,128,314,9
2002,Urban,Himachal Pradesh,Property Crime,Theft,Female,13-17,5157,2283,2874,4578,579
2002,Urban,Tripura,Other Crimes,Fraud,Female,60+,9512,7386,2126,7756,1756
2008,Urban,Arunachal Pradesh,Crime Against Men,Murder,Male,46-60,5763,3393,2370,3693,2070
2008,Urban,Assam,Other Crimes,Corruption,Female,13-17,4770,1072,3698,1270,3500
2006,Rural,Chhattisgarh,Crime Against Men,Murder,Female,46-60,5087,1770,3317,4879,208
2007,Rural,Maharashtra,Crime Against Men,Robbery,Male,13-17,8670,4106,4564,7485,1185
2010,Rural,Meghalaya,Crime Against Women,Rape,Male,46-60,6978,4563,2415,6501,477
2001,Urban,Kerala,Crime Against Women,Domestic Violence,Male,13-17,705,12,693,231,474
2006,Urban,Maharashtra,Other Crimes,Cyber Crime,Female,60+,5244,2251,2993,4943,301
2007,Urban,Assam,Other Crimes,Corruption,Female,0-12,5529,59,5470,5137,392
2001,Rural,Odisha,Crime Against Men,Murder,Female,60+,6943,134,6809,1958,4985
2007,Rural,Kerala,Crime Against Women,Rape,Male,13-17,9563,2088,7475,7520,2043
2002,Rural,Himachal Pradesh,Crime Against Men,Extortion,Male,31-45,3891,2354,1537,3349,542
2006,Urban,Jharkhand,Crime Against Men,Assault,Male,0-12,9000,7166,1834,7460,1540
2010,Urban,Maharashtra,Crime Against Children,Child Abuse,Male,60+,8591,6539,2052,7390,1201
2003,Rural,Goa,Crime Against Children,Child Abuse,Male,0-12,2254,514,1740,632,1622
2002,Rural,Uttar Pradesh,Crime Against Women,Domestic Violence,Female,31-45,8632,432,8200,2253,6379
2007,Urban,Manipur,Crime Against Children,Child Abuse,Female,31-45,7617,4631,2986,7361,256
2008,Rural,Meghalaya,Other Crimes,Corruption,Male,0-12,6914,1966,4948,2657,4257
2004,Urban,Goa,Crime Against Men,Assault,Male,31-45,5670,906,4764,4344,1326
2010,Rural,Tripura,Crime Against Women,Domestic Violence,Female,31-45,720,555,165,688,32
2003,Urban,Assam,Property Crime,Arson,Female,0-12,6362,4480,1882,4538,1824
2004,Rural,Tripura,Crime Against Women,Domestic Violence,Male,13-17,3092,2655,437,2853,239
2007,Urban,Kerala,Crime Against Children,Kidnapping,Male,18-30,4169,1954,2215,3951,218
2005,Rural,Manipur,Crime Against Men,Extortion,Male,0-12,8747,42,8705,930,7817
2002,Urban,Manipur,Crime Against Men,Murder,Female,31-45,3855,880,2975,2540,1315
2009,Rural,Uttarakhand,Crime Against Children,Kidnapping,Female,13-17,9324,8555,769,9080,244
2005,Urban,Uttarakhand,Property Crime,Arson,Female,18-30,1471,998,473,1107,364
2009,Rural,West Bengal,Crime Against Women,Dowry Deaths,Male,46-60,8656,1803,6853,2593,6063
2004,Rural,Telangana,Crime Against Children,Trafficking,Male,46-60,8719,4170,4549,5991,2728
2006,Rural,Karnataka,Other Crimes,Drug Offense,Female,31-45,6149,833,5316,4206,1943
2008,Urban,Haryana,Crime Against Children,Child Abuse,Female,0-12,1897,101,1796,867,1030
2010,Rural,Bihar,Property Crime,Burglary,Male,46-60,4357,3362,995,4282,75
2004,Urban,Rajasthan,Crime Against Men,Murder,Male,46-60,1184,1036,148,1143,41
2007,Rural,Madhya Pradesh,Crime Against Men,Murder,Female,60+,3598,676,2922,2748,850
2008,Rural,Meghalaya,Other Crimes,Drug Offense,Male,18-30,1779,391,1388,791,988
2006,Urban,Rajasthan,Crime Against Children,Child Labor,Female,60+,9750,2909,6841,5391,4359
2001,Urban,Rajasthan,Crime Against Men,Murder,Male,13-17,3483,2439,1044,3144,339
2008,Urban,Maharashtra,Other Crimes,Fraud,Male,60+,5532,832,4700,898,4634
2005,Urban,Sikkim,Crime Against Children,Kidnapping,Female,46-60,5946,5772,174,5846,100
2003,Rural,Himachal Pradesh,Crime Against Children,Child Abuse,Male,31-45,9647,3676,5971,6532,3115
2004,Rural,Chhattisgarh,Other Crimes,Drug Offense,Male,0-12,6139,1154,4985,3122,3017
2002,Rural,Jammu & Kashmir,Other Crimes,Cyber Crime,Female,31-45,6009,3075,2934,3438,2571
2004,Urban,Jammu & Kashmir,Other Crimes,Fraud,Female,46-60,7735,1575,6160,6454,1281
2007,Rural,Haryana,Crime Against Women,Molestation,Female,0-12,329,304,25,322,7
2010,Urban,Rajasthan,Other Crimes,Fraud,Female,60+,6049,1332,4717,2298,3751
2008,Rural,Tripura,Crime Against Children,Child Labor,Male,60+,2733,1029,1704,1170,1563
2009,Rural,Kerala,Crime Against Children,Trafficking,Female,31-45,997,118,879,851,146
2007,Rural,Manipur,Crime Against Men,Assault,Female,46-60,3653,3181,472,3199,454
2010,Urban,Punjab,Crime Against Women,Molestation,Male,13-17,9600,2511,7089,4996,4604
2007,Urban,Odisha,Crime Against Children,Child Labor,Male,18-30,4670,2966,1704,3022,1648
2003,Urban,Chhattisgarh,Crime Against Children,Child Abuse,Male,13-17,2953,1744,1209,2174,779
2005,Urban,Tripura,Other Crimes,Drug Offense,Female,18-30,7103,88,7015,3764,3339
2010,Rural,Mizoram,Crime Against Women,Dowry Deaths,Male,0-12,996,354,642,707,289
2007,Rural,Haryana,Crime Against Women,Rape,Male,0-12,2189,6,2183,1262,927
2007,Urban,Maharashtra,Other Crimes,Fraud,Female,18-30,1747,1504,243,1515,232
2007,Urban,Bihar,Crime Against Men,Assault,Male,46-60,5268,1894,3374,5240,28
2003,Rural,Uttar Pradesh,Property Crime,Vandalism,Male,0-12,6243,1636,4607,4095,2148
2002,Urban,Nagaland,Crime Against Children,Kidnapping,Female,18-30,6957,3407,3550,3742,3215
2006,Urban,Odisha,Other Crimes,Corruption,Female,31-45,6929,2587,4342,5741,1188
2001,Rural,Punjab,Crime Against Children,Child Abuse,Male,13-17,2199,1081,1118,1761,438
2007,Rural,Bihar,Crime Against Women,Dowry Deaths,Male,0-12,7952,6366,1586,7126,826
2009,Urban,Manipur,Other Crimes,Corruption,Male,46-60,6322,1529,4793,5242,1080
2009,Urban,Chhattisgarh,Other Crimes,Drug Offense,Male,0-12,1987,1498,489,1534,453
2001,Rural,Manipur,Other Crimes,Fraud,Male,18-30,6714,3312,3402,4319,2395
2006,Rural,Maharashtra,Crime Against Men,Extortion,Female,60+,9342,5240,4102,6297,3045
2009,Urban,Arunachal Pradesh,Crime Against Women,Rape,Female,60+,1059,15,1044,216,843
2010,Urban,Uttar Pradesh,Other Crimes,Cyber Crime,Female,18-30,9385,9341,44,9365,20
2006,Urban,West Bengal,Crime Against Women,Dowry Deaths,Female,18-30,4356,1447,2909,2468,1888
2006,Urban,Haryana,Property Crime,Burglary,Female,46-60,2941,1528,1413,2769,172
2001,Urban,Andhra Pradesh,Property Crime,Burglary,Male,13-17,5050,1033,4017,3426,1624
2002,Urban,Odisha,Other Crimes,Fraud,Female,0-12,9648,8225,1423,9608,40
2003,Rural,Bihar,Property Crime,Theft,Female,0-12,4581,1895,2686,2210,2371
2004,Urban,Tripura,Property Crime,Burglary,Female,0-12,5630,2456,3174,2560,3070
2007,Urban,Punjab,Crime Against Men,Murder,Male,31-45,390,235,155,288,102
2004,Rural,Punjab,Crime Against Men,Robbery,Female,13-17,569,249,320,460,109
2006,Rural,Telangana,Crime Against Women,Domestic Violence,Female,46-60,4322,1302,3020,3341,981
2003,Urban,Telangana,Crime Against Children,Child Abuse,Female,60+,9152,4639,4513,7576,1576
2004,Urban,Andhra Pradesh,Crime Against Men,Assault,Female,13-17,4426,2943,1483,3923,503
2003,Rural,Manipur,Crime Against Children,Child Labor,Male,13-17,6190,2057,4133,2707,3483
2001,Rural,Goa,Crime Against Women,Dowry Deaths,Male,18-30,4718,139,4579,3855,863
2007,Rural,Sikkim,Crime Against Men,Extortion,Male,60+,9596,2527,7069,5237,4359
2004,Rural,Gujarat,Other Crimes,Fraud,Female,13-17,143,29,114,73,70
2009,Rural,Arunachal Pradesh,Property Crime,Vandalism,Male,46-60,5713,4393,1320,4938,775
2006,Urban,Gujarat,Crime Against Men,Assault,Female,46-60,8300,5701,2599,7656,644
2001,Urban,Karnataka,Other Crimes,Cyber Crime,Female,31-45,5496,4798,698,5079,417
2009,Urban,Telangana,Crime Against Women,Rape,Female,31-45,7214,132,7082,4190,3024
2009,Urban,Gujarat,Crime Against Men,Extortion,Female,46-60,8632,5362,3270,7094,1538
2010,Rural,Punjab,Crime Against Children,Child Abuse,Male,0-12,7961,934,7027,1247,6714
2008,Urban,Telangana,Crime Against Women,Rape,Female,0-12,71,36,35,67,4
2001,Rural,Chhattisgarh,Crime Against Men,Assault,Male,31-45,609,581,28,595,14
2002,Urban,Nagaland,Property Crime,Theft,Female,46-60,3226,1557,1669,1967,1259
2008,Urban,Meghalaya,Property Crime,Arson,Male,13-17,4953,4278,675,4295,658
2001,Rural,Odisha,Property Crime,Arson,Female,46-60,106,27,79,36,70
2008,Urban,Haryana,Crime Against Women,Rape,Male,0-12,4633,1400,3233,1807,2826
2008,Urban,Maharashtra,Other Crimes,Corruption,Male,13-17,2516,1627,889,2429,87
2006,Urban,Odisha,Other Crimes,Cyber Crime,Female,0-12,9970,6362,3608,7730,2240
2002,Urban,Gujarat,Property Crime,Vandalism,Female,60+,7384,5505,1879,7003,381
2004,Urban,Odisha,Property Crime,Arson,Female,31-45,4483,1501,2982,3899,584
2010,Urban,Tripura,Crime Against Children,Trafficking,Male,18-30,9952,2209,7743,2355,7597
2004,Urban,Chhattisgarh,Other Crimes,Cyber Crime,Male,31-45,7616,5631,1985,7531,85
2004,Urban,Tripura,Crime Against Women,Domestic Violence,Female,0-12,5215,1324,3891,2720,2495
2005,Urban,Delhi,Crime Against Men,Murder,Female,46-60,9907,3648,6259,6644,3263
2008,Urban,Jammu & Kashmir,Property Crime,Theft,Female,18-30,7121,5803,1318,6628,493
2006,Urban,Jharkhand,Other Crimes,Fraud,Female,46-60,182,71,111,138,44
2004,Urban,Manipur,Other Crimes,Corruption,Male,31-45,1906,727,1179,1885,21
2007,Urban,Kerala,Crime Against Women,Dowry Deaths,Female,60+,2084,292,1792,1118,966
2009,Rural,West Bengal,Other Crimes,Fraud,Female,60+,2545,1112,1433,1578,967
2010,Urban,Bihar,Crime Against Men,Robbery,Male,18-30,9609,549,9060,8093,1516
2003,Rural,Andhra Pradesh,Other Crimes,Cyber Crime,Female,60+,2570,1528,1042,2417,153
2006,Urban,Tamil Nadu,Crime Against Children,Trafficking,Female,46-60,2791,1310,1481,1541,1250
2009,Urban,Manipur,Crime Against Children,Child Labor,Male,60+,6108,5162,946,5528,580
2003,Urban,Manipur,Crime Against Men,Assault,Female,13-17,9760,617,9143,9308,452
2002,Urban,Punjab,Other Crimes,Corruption,Male,0-12,7018,4027,2991,4293,2725
2010,Rural,Manipur,Crime Against Children,Trafficking,Female,46-60,7407,1913,5494,2266,5141
2002,Rural,Mizoram,Crime Against Men,Assault,Male,60+,7026,3148,3878,6419,607
2009,Urban,West Bengal,Crime Against Women,Domestic Violence,Male,0-12,886,762,124,826,60
2010,Rural,Andhra Pradesh,Crime Against Men,Assault,Female,13-17,9339,1824,7515,3444,5895
2006,Rural,Mizoram,Property Crime,Burglary,Male,13-17,4031,2241,1790,3916,115
2001,Urban,Mizoram,Crime Against Children,Kidnapping,Male,13-17,5985,4516,1469,5954,31
2001,Rural,Nagaland,Crime Against Women,Molestation,Female,31-45,1250,599,651,1204,46
2004,Rural,Arunachal Pradesh,Crime Against Children,Kidnapping,Male,18-30,857,649,208,672,185
2007,Urban,Uttar Pradesh,Property Crime,Arson,Male,31-45,3842,3278,564,3487,355
2006,Urban,Haryana,Property Crime,Theft,Female,13-17,6276,4020,2256,5837,439
2006,Rural,Kerala,Property Crime,Vandalism,Female,46-60,3288,577,2711,2651,637
2007,Rural,Arunachal Pradesh,Crime Against Children,Child Abuse,Male,46-60,7139,2019,5120,6363,776
2010,Urban,Madhya Pradesh,Crime Against Women,Domestic Violence,Female,18-30,7328,6791,537,6938,390
2001,Urban,Kerala,Crime Against Children,Child Labor,Male,0-12,2469,1902,567,2193,276
2005,Rural,Uttarakhand,Crime Against Women,Dowry Deaths,Male,18-30,4270,4086,184,4225,45
2007,Urban,Mizoram,Other Crimes,Fraud,Male,60+,6785,867,5918,5452,1333
2002,Urban,Jharkhand,Property Crime,Arson,Male,18-30,4175,462,3713,1673,2502
2006,Urban,Uttarakhand,Other Crimes,Fraud,Female,46-60,8262,4384,3878,5044,3218
2003,Rural,Sikkim,Crime Against Women,Rape,Female,18-30,5587,4298,1289,4923,664
2006,Urban,Jharkhand,Other Crimes,Fraud,Female,0-12,5689,1452,4237,2547,3142
2008,Rural,Haryana,Property Crime,Arson,Male,0-12,9914,3360,6554,6180,3734
2001,Rural,Meghalaya,Other Crimes,Corruption,Female,0-12,7188,3886,3302,4941,2247
2009,Urban,Meghalaya,Crime Against Men,Assault,Female,18-30,2087,672,1415,837,1250
2006,Rural,Odisha,Property Crime,Theft,Male,60+,5592,5532,60,5584,8
2009,Urban,Odisha,Crime Against Children,Child Abuse,Female,31-45,260,58,202,186,74
2001,Rural,Punjab,Crime Against Women,Molestation,Male,46-60,9656,2170,7486,4125,5531
2005,Rural,Assam,Crime Against Children,Child Abuse,Female,31-45,5899,1069,4830,5336,563
2007,Urban,Jharkhand,Property Crime,Arson,Female,18-30,7256,2391,4865,6318,938
2001,Urban,Assam,Crime Against Men,Robbery,Female,46-60,2525,707,1818,2256,269
2002,Rural,Uttarakhand,Property Crime,Theft,Male,31-45,8370,7036,1334,7280,1090
2010,Rural,Goa,Crime Against Women,Domestic Violence,Female,60+,3197,627,2570,2931,266
2006,Urban,Kerala,Property Crime,Burglary,Male,13-17,8324,3428,4896,8092,232
2009,Rural,Maharashtra,Other Crimes,Corruption,Female,0-12,166,28,138,161,5
2005,Urban,Chhattisgarh,Property Crime,Burglary,Male,31-45,1413,825,588,848,565
2001,Rural,Manipur,Crime Against Men,Murder,Female,31-45,6171,1580,4591,2628,3543
2003,Urban,Andhra Pradesh,Crime Against Women,Molestation,Male,46-60,4149,475,3674,2146,2003
2005,Rural,Bihar,Crime Against Children,Trafficking,Female,31-45,1644,1237,407,1424,220
2003,Urban,West Bengal,Other Crimes,Cyber Crime,Male,18-30,253,35,218,35,218
2009,Rural,Andhra Pradesh,Other Crimes,Drug Offense,Female,31-45,7650,2514,5136,7505,145
2008,Urban,Kerala,Property Crime,Vandalism,Female,13-17,8301,7862,439,8072,229
2008,Urban,West Bengal,Crime Against Women,Domestic Violence,Female,31-45,3619,1308,2311,1548,2071
2007,Urban,Assam,Property Crime,Burglary,Female,13-17,2967,2036,931,2371,596
2003,Rural,West Bengal,Property Crime,Theft,Female,13-17,1164,617,547,1127,37
2004,Rural,Chhattisgarh,Property Crime,Vandalism,Male,46-60,1730,324,1406,611,1119
2004,Urban,Himachal Pradesh,Crime Against Men,Assault,Female,18-30,1719,65,1654,199,1520
2005,Urban,Tripura,Crime Against Women,Molestation,Male,18-30,7386,4661,2725,7320,66
2001,Urban,Kerala,Crime Against Children,Trafficking,Female,31-45,7155,2981,4174,4683,2472
2002,Rural,Jammu & Kashmir,Other Crimes,Cyber Crime,Female,31-45,4119,3330,789,3779,340
2010,Urban,Assam,Crime Against Children,Child Labor,Male,13-17,375,35,340,288,87
2001,Rural,West Bengal,Crime Against Men,Robbery,Male,60+,7373,1290,6083,6069,1304
2010,Rural,Tripura,Other Crimes,Corruption,Male,18-30,7635,3450,4185,4430,3205
2004,Rural,Telangana,Crime Against Men,Extortion,Male,46-60,6453,6089,364,6320,133
2004,Urban,Goa,Property Crime,Vandalism,Male,18-30,625,134,491,289,336
2005,Urban,Punjab,Crime Against Women,Dowry Deaths,Male,60+,7745,5753,1992,6122,1623
2003,Urban,Assam,Other Crimes,Drug Offense,Male,13-17,7921,7053,868,7474,447
2009,Urban,Rajasthan,Crime Against Women,Dowry Deaths,Male,31-45,9278,6098,3180,8360,918
2004,Rural,Jammu & Kashmir,Crime Against Children,Child Labor,Male,46-60,7932,3230,4702,7526,406
2004,Urban,Kerala,Crime Against Women,Rape,Female,13-17,6823,2664,4159,5257,1566
2006,Rural,Mizoram,Crime Against Men,Extortion,Female,31-45,2899,1900,999,2548,351
2010,Urban,Jammu & Kashmir,Property Crime,Arson,Female,60+,3081,1851,1230,2463,618
2010,Urban,Uttarakhand,Other Crimes,Fraud,Female,13-17,3142,1938,1204,2365,777
2004,Urban,Haryana,Crime Against Children,Trafficking,Female,18-30,353,305,48,339,14
2004,Urban,Himachal Pradesh,Crime Against Women,Rape,Female,46-60,2426,717,1709,1419,1007
2003,Rural,Bihar,Crime Against Men,Assault,Male,46-60,1922,1826,96,1911,11
2006,Rural,Haryana,Crime Against Women,Domestic Violence,Female,31-45,4040,2233,1807,3276,764
2005,Rural,Tripura,Crime Against Men,Murder,Male,60+,9683,7774,1909,8152,1531
2008,Rural,Andhra Pradesh,Crime Against Children,Kidnapping,Male,60+,6670,571,6099,5930,740
2008,Rural,Maharashtra,Crime Against Children,Trafficking,Male,18-30,6647,4797,1850,6268,379
2002,Rural,Uttar Pradesh,Crime Against Children,Child Labor,Female,13-17,8255,1087,7168,7869,386
2009,Urban,Punjab,Crime Against Men,Assault,Male,31-45,6412,73,6339,5288,1124
2004,Urban,Maharashtra,Crime Against Women,Dowry Deaths,Male,18-30,8341,1510,6831,5250,3091
2008,Rural,Andhra Pradesh,Property Crime,Arson,Female,46-60,3987,3650,337,3668,319
2007,Urban,Odisha,Other Crimes,Corruption,Male,13-17,7425,6034,1391,7117,308
2009,Urban,Tamil Nadu,Other Crimes,Cyber Crime,Male,0-12,6882,697,6185,3435,3447
2002,Urban,Arunachal Pradesh,Crime Against Women,Dowry Deaths,Female,0-12,3509,1110,2399,2623,886
2003,Rural,Meghalaya,Crime Against Children,Child Labor,Male,60+,7928,335,7593,2404,5524
2003,Urban,Punjab,Crime Against Men,Extortion,Male,60+,2480,1743,737,2066,414
2004,Urban,Goa,Crime Against Men,Assault,Female,18-30,1616,605,1011,1360,256
2010,Rural,Nagaland,Crime Against Men,Extortion,Female,18-30,8656,5206,3450,6553,2103
2007,Rural,Jharkhand,Other Crimes,Fraud,Male,0-12,9681,6576,3105,7399,2282
2002,Urban,Madhya Pradesh,Property Crime,Theft,Female,31-45,7242,69,7173,276,6966
2008,Rural,Uttarakhand,Property Crime,Vandalism,Female,18-30,2130,651,1479,1473,657
2003,Rural,Nagaland,Other Crimes,Fraud,Male,13-17,6913,1447,5466,4455,2458
2008,Urban,Rajasthan,Crime Against Children,Trafficking,Female,0-12,3412,1453,1959,2052,1360
2004,Urban,Odisha,Crime Against Children,Trafficking,Female,31-45,3370,617,2753,2383,987
2010,Urban,Rajasthan,Crime Against Children,Child Labor,Female,31-45,3731,1909,1822,3321,410
2003,Rural,Chhattisgarh,Crime Against Women,Molestation,Female,18-30,9271,4940,4331,7050,2221
2008,Urban,Goa,Crime Against Children,Child Labor,Female,13-17,6389,192,6197,5873,516
2008,Rural,Nagaland,Property Crime,Burglary,Male,46-60,7592,6549,1043,6637,955
2002,Rural,Telangana,Crime Against Children,Child Labor,Male,0-12,7100,3229,3871,4364,2736
2001,Rural,Himachal Pradesh,Crime Against Women,Molestation,Female,46-60,5443,3147,2296,3325,2118
2005,Urban,Jammu & Kashmir,Crime Against Men,Assault,Male,46-60,3788,268,3520,1210,2578
2009,Rural,Karnataka,Crime Against Children,Kidnapping,Male,0-12,5925,1566,4359,2097,3828
2009,Urban,Uttar Pradesh,Crime Against Men,Robbery,Male,18-30,9240,8633,607,8923,317
2001,Rural,Maharashtra,Crime Against Women,Molestation,Female,18-30,5055,4398,657,4948,107
2007,Rural,Sikkim,Crime Against Men,Robbery,Male,13-17,9141,480,8661,1655,7486
2007,Rural,Kerala,Property Crime,Theft,Male,13-17,9793,7950,1843,8243,1550
2008,Rural,Himachal Pradesh,Crime Against Children,Child Abuse,Male,13-17,5030,1034,3996,1449,3581
2006,Rural,Telangana,Property Crime,Arson,Male,13-17,7553,5170,2383,5554,1999
2006,Urban,Gujarat,Crime Against Women,Molestation,Male,18-30,9535,4287,5248,5356,4179
2006,Urban,Bihar,Property Crime,Arson,Female,46-60,6968,1036,5932,2432,4536
2009,Urban,Tamil Nadu,Other Crimes,Corruption,Male,46-60,4816,4582,234,4761,55
2002,Rural,Haryana,Crime Against Men,Extortion,Male,18-30,9251,4008,5243,8945,306
2001,Urban,Tripura,Other Crimes,Drug Offense,Female,46-60,3267,969,2298,1976,1291
2004,Urban,Telangana,Other Crimes,Corruption,Female,46-60,3883,3791,92,3794,89
2009,Urban,Assam,Crime Against Men,Assault,Male,0-12,4213,3457,756,3705,508
2007,Rural,Uttarakhand,Property Crime,Vandalism,Female,18-30,9871,4651,5220,7858,2013
2008,Rural,Odisha,Crime Against Women,Rape,Male,0-12,3398,1665,1733,2164,1234
2007,Urban,Meghalaya,Crime Against Men,Extortion,Male,13-17,2742,361,2381,609,2133
2003,Rural,Assam,Property Crime,Theft,Male,18-30,1041,461,580,555,486
2001,Rural,Manipur,Other Crimes,Cyber Crime,Female,0-12,6171,2408,3763,3055,3116
2004,Rural,Manipur,Property Crime,Theft,Female,13-17,8946,7742,1204,8382,564
2010,Urban,Nagaland,Crime Against Children,Trafficking,Male,18-30,736,616,120,657,79
2010,Urban,Himachal Pradesh,Other Crimes,Fraud,Female,0-12,2652,2041,611,2239,413
2004,Urban,Tamil Nadu,Other Crimes,Drug Offense,Male,46-60,9396,4471,4925,7492,1904
2003,Urban,Goa,Property Crime,Vandalism,Male,13-17,9409,3014,6395,3679,5730
2010,Urban,Jammu & Kashmir,Crime Against Children,Trafficking,Male,13-17,3039,343,2696,1957,1082
2008,Rural,Chhattisgarh,Crime Against Women,Molestation,Male,31-45,1024,522,502,946,78
2001,Urban,Delhi,Property Crime,Vandalism,Male,13-17,9769,5303,4466,7370,2399
2009,Rural,Maharashtra,Crime Against Women,Molestation,Male,18-30,7393,2886,4507,3197,4196
2005,Rural,Tripura,Crime Against Women,Rape,Male,0-12,8719,8463,256,8478,241
2005,Urban,Andhra Pradesh,Crime Against Women,Dowry Deaths,Female,0-12,9088,7313,1775,8267,821
2005,Rural,Telangana,Crime Against Children,Trafficking,Female,18-30,6443,3499,2944,3867,2576
2004,Rural,Uttarakhand,Crime Against Children,Kidnapping,Male,60+,4842,2353,2489,4194,648
2010,Rural,Mizoram,Crime Against Women,Rape,Female,0-12,6544,2298,4246,3022,3522
2005,Rural,Manipur,Other Crimes,Cyber Crime,Female,0-12,2334,1635,699,2275,59
2010,Urban,Punjab,Property Crime,Arson,Female,60+,3214,326,2888,1346,1868
2001,Rural,Sikkim,Crime Against Women,Rape,Male,46-60,9327,2231,7096,8627,700
2005,Urban,Uttarakhand,Other Crimes,Fraud,Male,31-45,1756,1587,169,1676,80
2004,Rural,Chhattisgarh,Crime Against Women,Rape,Female,13-17,2538,750,1788,1946,592
2008,Rural,Madhya Pradesh,Crime Against Men,Murder,Male,31-45,1201,161,1040,172,1029
2001,Urban,West Bengal,Other Crimes,Corruption,Male,46-60,7970,4663,3307,5852,2118
2006,Urban,Uttar Pradesh,Crime Against Men,Robbery,Female,0-12,768,178,590,671,97
2006,Rural,Kerala,Other Crimes,Drug Offense,Female,0-12,8440,1809,6631,4259,4181
2010,Rural,Uttarakhand,Property Crime,Burglary,Male,46-60,5021,4059,962,4385,636
2007,Rural,Chhattisgarh,Property Crime,Theft,Male,0-12,596,48,548,565,31
2008,Urban,Manipur,Crime Against Children,Kidnapping,Female,18-30,2742,779,1963,1168,1574
2001,Urban,Gujarat,Other Crimes,Fraud,Male,13-17,4086,612,3474,2429,1657
2003,Rural,Himachal Pradesh,Crime Against Men,Extortion,Male,0-12,4792,310,4482,1391,3401
2009,Urban,Sikkim,Property Crime,Vandalism,Male,60+,5942,1675,4267,4226,1716
2003,Urban,Tamil Nadu,Crime Against Women,Dowry Deaths,Male,60+,3381,551,2830,2600,781
2008,Urban,Himachal Pradesh,Crime Against Women,Dowry Deaths,Male,31-45,863,145,718,409,454
2001,Urban,Tripura,Property Crime,Vandalism,Male,13-17,6682,297,6385,2411,4271
2002,Urban,Himachal Pradesh,Crime Against Women,Domestic Violence,Female,60+,5233,1069,4164,4381,852
2005,Urban,Odisha,Crime Against Women,Domestic Violence,Male,0-12,7530,29,7501,3693,3837
2003,Rural,Bihar,Crime Against Women,Dowry Deaths,Male,31-45,6865,3881,2984,3944,2921
2006,Rural,Himachal Pradesh,Other Crimes,Cyber Crime,Male,31-45,4935,3347,1588,3965,970
2009,Urban,Uttarakhand,Crime Against Women,Domestic Violence,Male,46-60,6672,5120,1552,6493,179
2001,Rural,Punjab,Crime Against Women,Rape,Male,31-45,6665,32,6633,4809,1856
2007,Urban,Madhya Pradesh,Crime Against Women,Domestic Violence,Male,46-60,7435,3683,3752,3820,3615
2009,Rural,Sikkim,Crime Against Men,Extortion,Male,0-12,8855,7100,1755,8054,801
2001,Urban,Nagaland,Property Crime,Burglary,Female,13-17,1474,529,945,876,598
2004,Rural,Rajasthan,Crime Against Men,Assault,Male,0-12,8945,295,8650,2964,5981
2002,Urban,Rajasthan,Property Crime,Burglary,Male,13-17,4908,4291,617,4524,384
2008,Urban,Madhya Pradesh,Crime Against Men,Assault,Male,60+,6297,5782,515,6268,29
2010,Rural,Arunachal Pradesh,Property Crime,Vandalism,Female,0-12,4528,2206,2322,3741,787
2010,Rural,Assam,Property Crime,Burglary,Male,31-45,3261,1824,1437,2095,1166
2005,Urban,Mizoram,Crime Against Children,Child Abuse,Female,31-45,7682,66,7616,1716,5966
2008,Urban,Meghalaya,Property Crime,Burglary,Male,0-12,2839,2228,611,2256,583
2003,Rural,Maharashtra,Property Crime,Burglary,Female,60+,7603,394,7209,1895,5708
2003,Urban,Madhya Pradesh,Crime Against Women,Molestation,Male,60+,9185,1304,7881,3785,5400
2008,Rural,Mizoram,Other Crimes,Cyber Crime,Male,60+,3926,3266,660,3864,62
2008,Rural,Jharkhand,Other Crimes,Corruption,Male,31-45,3658,2699,959,3600,58
2004,Urban,Himachal Pradesh,Crime Against Men,Murder,Male,60+,5189,2662,2527,4868,321
2003,Urban,Kerala,Property Crime,Vandalism,Female,46-60,3613,2601,1012,3296,317
2005,Rural,Tamil Nadu,Crime Against Men,Robbery,Female,60+,1481,928,553,1182,299
2003,Urban,Chhattisgarh,Crime Against Men,Assault,Male,13-17,816,91,725,565,251
2002,Urban,Uttarakhand,Other Crimes,Drug Offense,Female,0-12,1708,279,1429,724,984
2001,Urban,Tripura,Property Crime,Arson,Female,18-30,4269,828,3441,3017,1252
2003,Urban,Mizoram,Crime Against Children,Child Labor,Female,13-17,9332,4331,5001,7719,1613
2002,Urban,Chhattisgarh,Other Crimes,Corruption,Female,46-60,3637,2545,1092,2853,784
2008,Rural,Andhra Pradesh,Other Crimes,Cyber Crime,Male,31-45,9742,6245,3497,6385,3357
2003,Rural,Chhattisgarh,Crime Against Children,Trafficking,Male,31-45,8243,5355,2888,5806,2437
2008,Urban,Goa,Crime Against Children,Child Labor,Male,31-45,5716,3082,2634,4715,1001
2008,Rural,Odisha,Crime Against Children,Child Abuse,Female,46-60,6113,4352,1761,5350,763
2005,Urban,Maharashtra,Crime Against Men,Murder,Male,31-45,5128,2720,2408,3406,1722
2003,Rural,Manipur,Crime Against Men,Murder,Male,46-60,3944,1232,2712,1445,2499
2006,Urban,Karnataka,Property Crime,Arson,Female,13-17,2049,1685,364,2038,11
2008,Rural,West Bengal,Property Crime,Theft,Female,0-12,925,642,283,761,164
2009,Rural,Manipur,Crime Against Men,Extortion,Female,31-45,6451,125,6326,1795,4656
2008,Urban,Odisha,Property Crime,Theft,Female,46-60,3955,1215,2740,2856,1099
2005,Rural,West Bengal,Crime Against Women,Molestation,Male,13-17,9158,6543,2615,8415,743
2005,Urban,Meghalaya,Crime Against Women,Molestation,Male,13-17,9902,6092,3810,9066,836
2005,Urban,Haryana,Crime Against Men,Murder,Female,0-12,5702,1134,4568,2308,3394
2010,Urban,Punjab,Crime Against Men,Robbery,Female,60+,7013,3998,3015,5030,1983
2005,Rural,Andhra Pradesh,Property Crime,Burglary,Male,46-60,2389,626,1763,2063,326
2002,Urban,Bihar,Crime Against Children,Trafficking,Male,13-17,5972,5419,553,5923,49
2006,Rural,Manipur,Property Crime,Vandalism,Male,46-60,3505,2099,1406,2932,573
2010,Urban,Mizoram,Property Crime,Vandalism,Female,18-30,685,539,146,613,72
2001,Urban,Himachal Pradesh,Property Crime,Vandalism,Male,46-60,4987,3108,1879,4682,305
2002,Urban,Haryana,Crime Against Children,Child Labor,Female,46-60,1372,189,1183,1154,218
2002,Rural,Himachal Pradesh,Crime Against Men,Robbery,Male,0-12,7937,6230,1707,6723,1214
2002,Rural,Rajasthan,Property Crime,Vandalism,Male,18-30,5237,1132,4105,3180,2057
2008,Rural,Meghalaya,Other Crimes,Corruption,Female,0-12,6338,5004,1334,6318,20
2005,Rural,Punjab,Crime Against Women,Molestation,Male,31-45,1574,548,1026,1518,56
2002,Urban,Maharashtra,Property Crime,Burglary,Female,18-30,5654,617,5037,3189,2465
2007,Rural,Andhra Pradesh,Other Crimes,Corruption,Male,60+,6704,5862,842,5973,731
2007,Urban,Himachal Pradesh,Crime Against Men,Assault,Male,60+,2036,86,1950,1409,627
2009,Urban,Bihar,Property Crime,Arson,Female,46-60,5508,4473,1035,4921,587
2009,Urban,Punjab,Crime Against Children,Trafficking,Male,60+,6512,4530,1982,5453,1059
2010,Urban,Uttar Pradesh,Property Crime,Theft,Female,13-17,9951,8850,1101,9368,583
2007,Urban,Tripura,Crime Against Men,Robbery,Female,46-60,3346,2432,914,2635,711
2007,Rural,Karnataka,Crime Against Children,Kidnapping,Female,46-60,5035,832,4203,1131,3904
2004,Rural,Madhya Pradesh,Crime Against Children,Child Labor,Female,31-45,9861,7479,2382,8336,1525
2010,Rural,Rajasthan,Other Crimes,Drug Offense,Female,0-12,1975,1816,159,1836,139
2006,Rural,Karnataka,Crime Against Men,Assault,Male,0-12,5947,5790,157,5915,32
2008,Urban,Telangana,Property Crime,Vandalism,Female,13-17,1535,501,1034,1380,155
2008,Urban,Bihar,Crime Against Women,Rape,Male,0-12,4336,2165,2171,3945,391
2006,Urban,Assam,Property Crime,Vandalism,Male,18-30,4629,1091,3538,3912,717
2003,Rural,Uttarakhand,Other Crimes,Drug Offense,Male,60+,479,379,100,469,10
2006,Rural,Assam,Property Crime,Burglary,Female,13-17,1045,171,874,545,500
2003,Urban,Rajasthan,Crime Against Women,Rape,Female,31-45,3407,2818,589,2889,518
2001,Urban,West Bengal,Crime Against Women,Domestic Violence,Male,0-12,1983,1550,433,1651,332
2005,Rural,Chhattisgarh,Crime Against Children,Child Abuse,Female,31-45,9932,8694,1238,8725,1207
2003,Urban,Karnataka,Crime Against Children,Trafficking,Female,46-60,7777,1308,6469,7765,12
2003,Urban,Goa,Crime Against Children,Child Abuse,Male,0-12,4226,3264,962,3344,882
2009,Urban,Rajasthan,Property Crime,Vandalism,Male,18-30,8096,3194,4902,4064,4032
2003,Rural,Meghalaya,Property Crime,Theft,Male,0-12,9936,412,9524,8500,1436
2008,Rural,Manipur,Crime Against Children,Child Abuse,Female,60+,8980,7410,1570,7882,1098
2006,Rural,Manipur,Crime Against Men,Robbery,Male,60+,6517,1919,4598,4037,2480
2007,Rural,Andhra Pradesh,Crime Against Men,Assault,Male,0-12,3858,1016,2842,2001,1857
2009,Urban,Rajasthan,Crime Against Men,Murder,Male,13-17,3693,1949,1744,1965,1728
2004,Urban,Himachal Pradesh,Crime Against Men,Murder,Male,13-17,2963,1199,1764,2714,249
2010,Urban,Arunachal Pradesh,Other Crimes,Drug Offense,Female,18-30,5167,1840,3327,3904,1263
2006,Urban,Uttarakhand,Crime Against Children,Child Abuse,Male,31-45,9574,6594,2980,9277,297
2002,Urban,Tripura,Crime Against Men,Assault,Male,0-12,1247,876,371,1128,119
2010,Urban,Chhattisgarh,Crime Against Men,Robbery,Male,60+,2378,1812,566,1909,469
2008,Urban,West Bengal,Crime Against Men,Assault,Male,0-12,808,210,598,386,422
2004,Rural,Kerala,Property Crime,Vandalism,Male,31-45,5327,2854,2473,4788,539
2004,Rural,Haryana,Other Crimes,Cyber Crime,Male,13-17,8700,6265,2435,6369,2331
2005,Rural,Sikkim,Crime Against Men,Murder,Male,18-30,6754,737,6017,4557,2197
2004,Rural,Haryana,Crime Against Children,Trafficking,Male,0-12,5425,4402,1023,4502,923
2003,Rural,Mizoram,Crime Against Women,Dowry Deaths,Male,46-60,6177,5871,306,6175,2
2001,Rural,Delhi,Crime Against Women,Domestic Violence,Female,0-12,522,491,31,508,14
2006,Rural,Maharashtra,Crime Against Men,Assault,Female,60+,605,327,278,373,232
2004,Urban,Manipur,Crime Against Women,Domestic Violence,Male,31-45,4791,1425,3366,4404,387
2007,Urban,Maharashtra,Crime Against Children,Child Labor,Female,0-12,2205,1367,838,1949,256
2009,Rural,Mizoram,Property Crime,Burglary,Male,18-30,6648,2958,3690,5092,1556
2007,Urban,Chhattisgarh,Property Crime,Vandalism,Male,18-30,2101,732,1369,1368,733
2005,Rural,Kerala,Crime Against Men,Assault,Male,0-12,9972,3583,6389,5361,4611
2003,Rural,Assam,Other Crimes,Fraud,Female,46-60,9352,7117,2235,8938,414
2001,Urban,Tamil Nadu,Property Crime,Burglary,Male,46-60,4816,2502,2314,4568,248
2009,Urban,Andhra Pradesh,Property Crime,Burglary,Male,0-12,9652,1551,8101,3465,6187
2004,Urban,Arunachal Pradesh,Other Crimes,Fraud,Male,0-12,171,80,91,136,35
2008,Urban,Chhattisgarh,Crime Against Children,Child Abuse,Female,13-17,233,163,70,220,13
2005,Urban,Uttar Pradesh,Crime Against Children,Child Abuse,Female,0-12,876,89,787,680,196
2008,Urban,Telangana,Crime Against Women,Dowry Deaths,Male,46-60,2900,624,2276,2533,367
2010,Rural,Uttar Pradesh,Crime Against Women,Dowry Deaths,Female,0-12,5309,1248,4061,2734,2575
2010,Rural,Gujarat,Crime Against Women,Rape,Male,60+,477,212,265,452,25
2008,Urban,Andhra Pradesh,Other Crimes,Fraud,Male,0-12,7810,2755,5055,5810,2000
2007,Rural,Andhra Pradesh,Property Crime,Theft,Female,60+,8151,459,7692,5590,2561
2005,Rural,Maharashtra,Property Crime,Arson,Male,13-17,3362,1392,1970,2658,704
2007,Urban,Bihar,Crime Against Women,Dowry Deaths,Female,31-45,8149,4751,3398,4800,3349
2004,Urban,Punjab,Other Crimes,Corruption,Male,46-60,5433,432,5001,3205,2228
2004,Urban,Arunachal Pradesh,Other Crimes,Corruption,Male,0-12,7391,1027,6364,3713,3678
2008,Rural,Mizoram,Crime Against Women,Dowry Deaths,Male,0-12,8564,180,8384,1204,7360
2010,Rural,Gujarat,Property Crime,Theft,Female,0-12,6516,4,6512,2320,4196
2006,Rural,Meghalaya,Crime Against Men,Murder,Female,60+,495,102,393,305,190
2003,Rural,Bihar,Other Crimes,Cyber Crime,Female,18-30,2756,1853,903,2400,356
2005,Rural,Assam,Crime Against Women,Rape,Female,18-30,6390,2106,4284,4019,2371
2010,Urban,Meghalaya,Other Crimes,Corruption,Female,18-30,4030,3027,1003,3805,225
2006,Urban,Jharkhand,Crime Against Children,Trafficking,Female,18-30,9778,2453,7325,8619,1159
2009,Rural,Punjab,Property Crime,Theft,Female,46-60,7324,2985,4339,3548,3776
2006,Rural,Odisha,Other Crimes,Cyber Crime,Male,0-12,2181,1182,999,1376,805
2006,Rural,Bihar,Property Crime,Vandalism,Female,46-60,2112,1282,830,1417,695
2007,Rural,Manipur,Crime Against Children,Kidnapping,Female,46-60,653,166,487,308,345
2005,Rural,Mizoram,Property Crime,Burglary,Male,31-45,706,604,102,629,77
2008,Urban,Punjab,Crime Against Men,Extortion,Male,60+,8118,6292,1826,7787,331
2005,Rural,Jharkhand,Other Crimes,Corruption,Female,31-45,2125,589,1536,1277,848
2008,Rural,Jammu & Kashmir,Property Crime,Theft,Female,31-45,130,121,9,125,5
2010,Rural,Maharashtra,Crime Against Women,Rape,Female,31-45,2385,1063,1322,1189,1196
2007,Urban,Goa,Crime Against Men,Assault,Male,60+,9057,1126,7931,8116,941
2008,Urban,Assam,Crime Against Children,Child Labor,Female,46-60,5356,1356,4000,4835,521
2005,Urban,Punjab,Crime Against Men,Robbery,Male,13-17,9533,8356,1177,9016,517
2005,Urban,Andhra Pradesh,Property Crime,Burglary,Female,60+,6759,2578,4181,3461,3298
2002,Urban,Uttar Pradesh,Crime Against Children,Child Abuse,Male,46-60,1121,958,163,970,151
2002,Urban,Gujarat,Crime Against Children,Child Abuse,Male,18-30,5224,2993,2231,2994,2230
2001,Urban,Goa,Crime Against Men,Murder,Male,46-60,4791,3615,1176,3615,1176
2009,Urban,Nagaland,Property Crime,Arson,Male,46-60,4942,1521,3421,3108,1834
2005,Urban,Tripura,Property Crime,Arson,Female,13-17,8440,150,8290,2002,6438
2002,Rural,Rajasthan,Other Crimes,Cyber Crime,Female,31-45,8918,1573,7345,8586,332
2009,Urban,Punjab,Other Crimes,Cyber Crime,Male,0-12,5819,3594,2225,4581,1238
2005,Rural,Telangana,Crime Against Men,Extortion,Male,46-60,9471,2846,6625,3654,5817
2009,Rural,Karnataka,Property Crime,Theft,Male,31-45,5944,976,4968,3177,2767
2008,Rural,Mizoram,Crime Against Children,Kidnapping,Female,46-60,5269,5169,100,5232,37
2005,Urban,Odisha,Crime Against Children,Child Abuse,Male,18-30,3080,3065,15,3074,6
2007,Urban,Karnataka,Crime Against Men,Assault,Male,0-12,1760,121,1639,594,1166
2008,Urban,Uttar Pradesh,Crime Against Children,Kidnapping,Female,18-30,2160,1492,668,1642,518
2005,Urban,Maharashtra,Property Crime,Arson,Female,46-60,2609,469,2140,553,2056
2010,Rural,Sikkim,Property Crime,Arson,Female,18-30,9481,3534,5947,9087,394
2008,Urban,Gujarat,Other Crimes,Corruption,Male,31-45,1186,1118,68,1160,26
2005,Urban,Tripura,Property Crime,Vandalism,Male,60+,4597,3812,785,4312,285
2003,Urban,Sikkim,Crime Against Women,Molestation,Male,46-60,9977,6926,3051,9420,557
2010,Rural,Karnataka,Property Crime,Arson,Male,46-60,7332,4647,2685,5131,2201
2003,Urban,Assam,Other Crimes,Fraud,Male,46-60,3477,2641,836,3098,379
2001,Urban,Tripura,Crime Against Men,Murder,Female,13-17,1625,48,1577,543,1082
2001,Urban,Gujarat,Property Crime,Arson,Female,0-12,8765,4645,4120,7835,930
2005,Rural,Telangana,Other Crimes,Fraud,Female,31-45,8290,4271,4019,8172,118
2001,Urban,Jharkhand,Crime Against Women,Molestation,Female,0-12,384,280,104,285,99
2007,Rural,Kerala,Crime Against Children,Kidnapping,Male,0-12,806,667,139,750,56
2003,Urban,Telangana,Crime Against Children,Child Labor,Male,0-12,7700,1865,5835,6062,1638
2004,Rural,Goa,Other Crimes,Cyber Crime,Female,31-45,1477,818,659,978,499
2009,Rural,Goa,Property Crime,Burglary,Female,60+,5176,5067,109,5100,76
2002,Rural,Odisha,Crime Against Men,Murder,Female,31-45,9202,5816,3386,7705,1497
2002,Urban,Assam,Other Crimes,Fraud,Female,46-60,9899,5159,4740,9142,757
2006,Urban,Andhra Pradesh,Crime Against Women,Molestation,Female,18-30,7496,3255,4241,4898,2598
2007,Rural,Assam,Crime Against Men,Extortion,Male,60+,914,291,623,369,545
2006,Urban,Tripura,Crime Against Men,Robbery,Male,18-30,1986,1645,341,1899,87
2006,Urban,Telangana,Crime Against Women,Molestation,Male,0-12,4105,204,3901,756,3349
2009,Rural,West Bengal,Crime Against Children,Child Abuse,Female,18-30,7773,3773,4000,6713,1060
2010,Rural,Chhattisgarh,Property Crime,Vandalism,Male,31-45,6413,587,5826,2408,4005
2003,Rural,Jammu & Kashmir,Crime Against Children,Trafficking,Female,60+,519,80,439,483,36
2009,Rural,Sikkim,Crime Against Women,Dowry Deaths,Female,18-30,292,20,272,192,100
2010,Urban,Madhya Pradesh,Crime Against Women,Rape,Female,60+,798,514,284,608,190
2009,Urban,Jammu & Kashmir,Crime Against Children,Kidnapping,Female,0-12,7490,1874,5616,4199,3291
2003,Rural,Haryana,Crime Against Children,Child Abuse,Male,31-45,4119,3562,557,3618,501
2008,Rural,Chhattisgarh,Crime Against Men,Murder,Female,0-12,1527,332,1195,799,728
2001,Rural,Sikkim,Crime Against Men,Robbery,Male,13-17,1026,531,495,844,182
2005,Urban,Himachal Pradesh,Property Crime,Theft,Male,18-30,7698,1895,5803,7694,4
2010,Urban,Punjab,Other Crimes,Cyber Crime,Male,0-12,3501,2549,952,3016,485
2008,Rural,Tripura,Crime Against Women,Molestation,Female,31-45,9764,6839,2925,7949,1815
2006,Urban,Tripura,Crime Against Children,Child Labor,Male,18-30,6415,3988,2427,5943,472
2009,Rural,Uttar Pradesh,Other Crimes,Fraud,Male,60+,1832,1752,80,1831,1
2004,Urban,Mizoram,Property Crime,Burglary,Male,46-60,5631,4457,1174,4846,785
2008,Urban,Punjab,Other Crimes,Cyber Crime,Female,46-60,5982,4829,1153,5900,82
2007,Rural,Telangana,Crime Against Women,Domestic Violence,Female,13-17,143,93,50,128,15
2009,Rural,West Bengal,Crime Against Women,Rape,Male,13-17,9319,3744,5575,3970,5349
2001,Rural,Sikkim,Crime Against Men,Extortion,Female,60+,5187,977,4210,1162,4025
2006,Rural,Bihar,Crime Against Men,Extortion,Male,13-17,5580,1613,3967,5029,551
2007,Rural,Delhi,Crime Against Men,Robbery,Female,60+,4231,726,3505,3268,963
2006,Rural,Bihar,Crime Against Children,Kidnapping,Female,31-45,5865,3995,1870,5746,119
2001,Rural,Odisha,Crime Against Women,Dowry Deaths,Male,13-17,3855,3343,512,3846,9
2010,Rural,Telangana,Crime Against Women,Dowry Deaths,Male,0-12,1120,443,677,668,452
2005,Urban,Haryana,Crime Against Women,Dowry Deaths,Male,31-45,5181,427,4754,4403,778
2010,Rural,Himachal Pradesh,Crime Against Women,Domestic Violence,Female,0-12,6498,1625,4873,4169,2329
2010,Urban,Jammu & Kashmir,Crime Against Children,Trafficking,Female,13-17,2662,735,1927,1701,961
2005,Urban,Jammu & Kashmir,Property Crime,Burglary,Male,18-30,7267,2005,5262,2480,4787
2003,Urban,Karnataka,Other Crimes,Cyber Crime,Female,60+,7511,5217,2294,6623,888
2002,Rural,Odisha,Crime Against Men,Robbery,Female,18-30,7254,2794,4460,4123,3131
2009,Urban,Assam,Other Crimes,Drug Offense,Male,13-17,3812,2507,1305,2904,908
2002,Urban,Sikkim,Crime Against Children,Child Abuse,Male,0-12,3208,2657,551,2995,213
2003,Rural,Nagaland,Property Crime,Theft,Male,60+,2048,993,1055,1785,263
2009,Urban,West Bengal,Crime Against Men,Extortion,Male,31-45,6011,2359,3652,5476,535
2010,Rural,Manipur,Crime Against Men,Assault,Female,46-60,8475,4517,3958,7802,673
2007,Urban,Odisha,Crime Against Men,Murder,Male,0-12,4205,2753,1452,2903,1302
2007,Urban,Himachal Pradesh,Other Crimes,Fraud,Male,18-30,3301,3273,28,3281,20
2007,Rural,Delhi,Crime Against Children,Child Labor,Female,31-45,2348,421,1927,2343,5
2008,Rural,Goa,Other Crimes,Cyber Crime,Male,60+,3364,926,2438,2371,993
2004,Rural,Mizoram,Crime Against Women,Dowry Deaths,Male,13-17,790,680,110,689,101
2005,Rural,Rajasthan,Crime Against Women,Rape,Female,46-60,4119,1559,2560,2243,1876
2002,Rural,Madhya Pradesh,Crime Against Men,Assault,Male,13-17,9494,4854,4640,6451,3043
2003,Urban,Madhya Pradesh,Crime Against Children,Trafficking,Female,60+,6432,2821,3611,5909,523
2004,Rural,Punjab,Crime Against Men,Extortion,Male,18-30,4132,911,3221,2980,1152
2009,Rural,Goa,Crime Against Children,Child Labor,Male,60+,8168,2760,5408,6363,1805
2002,Urban,Maharashtra,Crime Against Women,Domestic Violence,Male,13-17,2529,308,2221,2020,509
2005,Urban,Himachal Pradesh,Crime Against Women,Rape,Male,31-45,3922,1226,2696,3566,356
2005,Rural,Maharashtra,Crime Against Children,Trafficking,Male,60+,2504,187,2317,878,1626
2003,Rural,Telangana,Crime Against Women,Dowry Deaths,Female,31-45,3452,2010,1442,2765,687
2005,Urban,Jammu & Kashmir,Crime Against Children,Child Abuse,Male,0-12,9661,9014,647,9430,231
2002,Rural,Nagaland,Crime Against Men,Robbery,Male,13-17,9219,7277,1942,8659,560
2008,Urban,Goa,Other Crimes,Cyber Crime,Male,18-30,3663,3086,577,3434,229
2010,Urban,Haryana,Crime Against Men,Assault,Male,18-30,1213,586,627,743,470
2002,Urban,Tamil Nadu,Property Crime,Vandalism,Male,60+,7693,4466,3227,7504,189
2005,Urban,Punjab,Crime Against Men,Assault,Male,46-60,7549,5035,2514,5915,1634
2006,Urban,Punjab,Crime Against Women,Rape,Female,0-12,1154,1014,140,1150,4
2004,Urban,Gujarat,Crime Against Women,Molestation,Female,60+,5249,541,4708,2195,3054
2001,Urban,Himachal Pradesh,Crime Against Women,Dowry Deaths,Male,46-60,5679,395,5284,2107,3572
2007,Rural,Rajasthan,Crime Against Children,Child Abuse,Male,0-12,3444,1456,1988,2356,1088
2007,Rural,Meghalaya,Property Crime,Arson,Male,31-45,3525,1297,2228,2663,862
2001,Urban,Jharkhand,Crime Against Women,Domestic Violence,Female,13-17,5971,1558,4413,3275,2696
2003,Urban,Chhattisgarh,Other Crimes,Fraud,Female,31-45,3820,3103,717,3802,18
2002,Rural,West Bengal,Other Crimes,Fraud,Male,13-17,9845,5683,4162,7263,2582
2001,Rural,Karnataka,Crime Against Men,Robbery,Male,18-30,3739,1029,2710,1705,2034
2006,Urban,Chhattisgarh,Crime Against Children,Kidnapping,Male,0-12,2147,1701,446,1915,232
2008,Urban,Jammu & Kashmir,Other Crimes,Drug Offense,Male,31-45,5713,836,4877,2917,2796
2008,Rural,Manipur,Crime Against Men,Assault,Female,18-30,9608,2172,7436,2256,7352
2009,Urban,Karnataka,Crime Against Women,Rape,Female,46-60,8174,3392,4782,6292,1882
2007,Rural,Chhattisgarh,Property Crime,Vandalism,Female,31-45,8191,1044,7147,4604,3587
2006,Rural,Chhattisgarh,Other Crimes,Cyber Crime,Female,0-12,3685,2991,694,3181,504
2002,Urban,Assam,Crime Against Women,Dowry Deaths,Female,18-30,5704,3645,2059,5309,395
2006,Urban,Odisha,Crime Against Men,Extortion,Female,60+,1687,978,709,1481,206
2010,Urban,Mizoram,Crime Against Women,Rape,Female,13-17,9634,6515,3119,7404,2230
2010,Urban,Delhi,Crime Against Men,Murder,Female,31-45,2898,2525,373,2739,159
2007,Urban,Punjab,Property Crime,Burglary,Female,0-12,1340,839,501,899,441
2004,Rural,Uttarakhand,Crime Against Men,Assault,Male,31-45,1440,565,875,915,525
2002,Urban,Chhattisgarh,Crime Against Men,Assault,Male,46-60,5510,4653,857,5054,456
2006,Urban,Karnataka,Crime Against Children,Child Abuse,Female,60+,3969,2467,1502,3320,649
2003,Rural,Uttarakhand,Property Crime,Burglary,Male,60+,8354,3133,5221,5109,3245
2002,Urban,Odisha,Crime Against Men,Extortion,Female,13-17,3259,731,2528,1043,2216
2002,Urban,Rajasthan,Other Crimes,Fraud,Male,60+,8600,1650,6950,7648,952
2004,Rural,Bihar,Crime Against Men,Robbery,Male,46-60,9865,9666,199,9728,137
2004,Rural,Arunachal Pradesh,Crime Against Men,Robbery,Female,0-12,5913,2647,3266,3626,2287
2004,Rural,Chhattisgarh,Crime Against Women,Dowry Deaths,Female,46-60,6851,4537,2314,5370,1481
2009,Urban,Arunachal Pradesh,Property Crime,Burglary,Female,46-60,7083,1784,5299,3510,3573
2007,Rural,Bihar,Other Crimes,Drug Offense,Male,13-17,6391,5296,1095,5522,869
2005,Urban,Kerala,Crime Against Women,Rape,Female,60+,3690,1879,1811,2219,1471
2008,Urban,Arunachal Pradesh,Property Crime,Theft,Female,31-45,9765,9699,66,9742,23
2004,Rural,Delhi,Crime Against Children,Kidnapping,Female,13-17,2585,48,2537,1658,927
2010,Rural,Chhattisgarh,Crime Against Children,Child Labor,Female,0-12,9332,6828,2504,7588,1744
2001,Urban,Assam,Crime Against Women,Rape,Female,46-60,4861,258,4603,639,4222
2005,Urban,Telangana,Crime Against Men,Robbery,Male,46-60,8358,2805,5553,6979,1379
2005,Rural,Uttar Pradesh,Crime Against Women,Domestic Violence,Male,13-17,8691,1610,7081,3886,4805
2006,Rural,Tamil Nadu,Crime Against Women,Domestic Violence,Female,46-60,3974,2940,1034,3928,46
2003,Rural,Delhi,Crime Against Children,Child Abuse,Female,31-45,6099,2297,3802,3181,2918
2006,Urban,Sikkim,Crime Against Men,Extortion,Female,46-60,7453,4194,3259,6994,459
2009,Urban,Punjab,Crime Against Men,Murder,Female,31-45,7358,1493,5865,3579,3779
2003,Urban,Odisha,Crime Against Men,Assault,Female,60+,8032,6773,1259,7412,620
2001,Rural,Karnataka,Other Crimes,Drug Offense,Female,13-17,6732,6616,116,6686,46
2008,Urban,West Bengal,Other Crimes,Cyber Crime,Female,46-60,7587,489,7098,4014,3573
2007,Urban,Sikkim,Property Crime,Theft,Female,0-12,1333,1241,92,1282,51
2005,Urban,Jammu & Kashmir,Crime Against Children,Trafficking,Female,46-60,759,70,689,682,77
2008,Urban,Chhattisgarh,Other Crimes,Drug Offense,Male,46-60,1179,988,191,1088,91
2002,Rural,West Bengal,Property Crime,Vandalism,Male,31-45,8273,2224,6049,6550,1723
2010,Rural,Uttarakhand,Crime Against Men,Assault,Male,0-12,5575,3515,2060,3610,1965
2002,Rural,Goa,Crime Against Children,Child Labor,Female,13-17,8992,8119,873,8455,537
2002,Urban,Delhi,Other Crimes,Cyber Crime,Male,31-45,7120,6330,790,7023,97
2001,Rural,Sikkim,Crime Against Women,Dowry Deaths,Female,18-30,7990,1833,6157,3743,4247
2005,Rural,Odisha,Property Crime,Burglary,Female,13-17,1418,1401,17,1410,8
2005,Rural,Uttarakhand,Property Crime,Arson,Female,60+,2102,627,1475,1162,940
2002,Urban,Bihar,Crime Against Men,Assault,Female,0-12,6027,179,5848,4932,1095
2007,Urban,Jammu & Kashmir,Crime Against Children,Child Labor,Male,60+,2983,1691,1292,2775,208
2001,Rural,Delhi,Property Crime,Theft,Male,18-30,1597,24,1573,1447,150
2004,Urban,Karnataka,Crime Against Women,Molestation,Male,31-45,5307,2660,2647,4667,640
2003,Urban,Mizoram,Property Crime,Burglary,Female,46-60,6796,5674,1122,5738,1058
2001,Rural,Bihar,Crime Against Children,Child Abuse,Male,31-45,9560,6429,3131,9425,135
2008,Urban,Tamil Nadu,Crime Against Children,Child Abuse,Female,13-17,8104,3888,4216,5556,2548
2007,Urban,Nagaland,Other Crimes,Drug Offense,Male,18-30,2942,1642,1300,2390,552
2010,Urban,Kerala,Property Crime,Burglary,Male,18-30,9855,9014,841,9126,729
2008,Urban,Sikkim,Property Crime,Vandalism,Male,60+,8015,1793,6222,4202,3813
2001,Rural,Rajasthan,Other Crimes,Cyber Crime,Male,60+,8071,6251,1820,6541,1530
2004,Rural,Himachal Pradesh,Crime Against Women,Domestic Violence,Male,0-12,2369,2195,174,2197,172
2002,Urban,Telangana,Other Crimes,Cyber Crime,Female,60+,5293,136,5157,465,4828
2001,Urban,Karnataka,Other Crimes,Cyber Crime,Male,46-60,5891,820,5071,4293,1598
2002,Urban,Sikkim,Property Crime,Vandalism,Male,46-60,5570,5135,435,5447,123
2005,Urban,Karnataka,Crime Against Men,Extortion,Female,46-60,6618,2990,3628,6517,101
2004,Urban,Maharashtra,Crime Against Women,Molestation,Male,0-12,9165,8465,700,8483,682
2004,Rural,Manipur,Other Crimes,Drug Offense,Female,0-12,3274,2305,969,3057,217
2001,Rural,Himachal Pradesh,Other Crimes,Corruption,Female,46-60,6630,2254,4376,6522,108
2001,Rural,Andhra Pradesh,Other Crimes,Drug Offense,Male,0-12,8269,4895,3374,7487,782
2008,Rural,Madhya Pradesh,Crime Against Children,Child Abuse,Female,46-60,1701,1277,424,1571,130
2002,Urban,Goa,Crime Against Men,Robbery,Female,46-60,430,395,35,427,3
2007,Rural,Himachal Pradesh,Crime Against Men,Murder,Male,0-12,7128,5762,1366,6806,322
2002,Rural,Sikkim,Crime Against Men,Robbery,Male,60+,4174,2229,1945,4065,109
2001,Urban,Jharkhand,Other Crimes,Fraud,Male,60+,6073,468,5605,5615,458
2004,Rural,Tripura,Crime Against Women,Molestation,Female,60+,7704,3172,4532,5478,2226
2005,Rural,Jammu & Kashmir,Crime Against Women,Rape,Male,0-12,3973,1613,2360,2146,1827
2002,Urban,West Bengal,Other Crimes,Fraud,Male,46-60,9235,21,9214,3596,5639
2007,Rural,Kerala,Crime Against Children,Kidnapping,Male,18-30,6282,3851,2431,4288,1994
2005,Urban,West Bengal,Other Crimes,Cyber Crime,Male,13-17,3296,2830,466,3253,43
2001,Rural,Kerala,Crime Against Men,Extortion,Female,18-30,5284,4456,828,4569,715
2002,Urban,Kerala,Crime Against Women,Rape,Male,31-45,8187,1173,7014,6401,1786
2003,Urban,Madhya Pradesh,Property Crime,Arson,Female,18-30,9824,3021,6803,6927,2897
2010,Rural,Jharkhand,Crime Against Men,Extortion,Female,18-30,3778,1581,2197,3446,332
2008,Urban,Bihar,Crime Against Children,Child Abuse,Male,31-45,5221,1301,3920,3524,1697
2007,Rural,Chhattisgarh,Crime Against Men,Murder,Male,60+,7004,5768,1236,6458,546
2010,Rural,Rajasthan,Crime Against Children,Child Labor,Male,60+,7506,4426,3080,6812,694
2002,Rural,Assam,Crime Against Children,Child Labor,Male,13-17,7024,4073,2951,5404,1620
2003,Urban,Jammu & Kashmir,Crime Against Children,Trafficking,Male,31-45,8277,5178,3099,8071,206
2002,Rural,Nagaland,Property Crime,Theft,Female,46-60,1095,713,382,902,193
2007,Urban,Bihar,Other Crimes,Cyber Crime,Female,13-17,7511,4992,2519,6345,1166
2006,Urban,Haryana,Crime Against Men,Murder,Male,13-17,4759,62,4697,1262,3497
2008,Urban,Rajasthan,Crime Against Women,Domestic Violence,Male,46-60,4739,2999,1740,3606,1133
2004,Urban,Sikkim,Crime Against Women,Molestation,Male,46-60,6787,1656,5131,5265,1522
2008,Rural,Tamil Nadu,Crime Against Men,Murder,Female,60+,5711,3407,2304,4624,1087
2004,Urban,Mizoram,Crime Against Men,Robbery,Female,18-30,8585,5217,3368,8517,68
2006,Rural,Delhi,Crime Against Women,Domestic Violence,Male,31-45,2129,71,2058,1931,198
2004,Urban,Manipur,Crime Against Children,Kidnapping,Male,31-45,2981,1027,1954,1177,1804
2010,Rural,Haryana,Crime Against Women,Domestic Violence,Female,13-17,6906,4661,2245,5906,1000
2010,Urban,Andhra Pradesh,Crime Against Children,Trafficking,Male,0-12,7025,6541,484,6716,309
2007,Rural,Haryana,Crime Against Children,Child Abuse,Female,13-17,2283,433,1850,695,1588
2005,Urban,Assam,Crime Against Children,Child Abuse,Female,46-60,688,612,76,654,34
2007,Rural,Telangana,Other Crimes,Fraud,Female,0-12,6809,6238,571,6320,489
2009,Rural,Haryana,Crime Against Women,Dowry Deaths,Male,0-12,9651,591,9060,5116,4535
2006,Urban,Sikkim,Crime Against Men,Extortion,Male,46-60,1954,1538,416,1852,102
2004,Rural,Jharkhand,Crime Against Men,Murder,Male,60+,8259,8120,139,8131,128
2005,Urban,Karnataka,Crime Against Men,Murder,Male,0-12,4649,289,4360,979,3670
2010,Rural,West Bengal,Property Crime,Burglary,Female,60+,4079,3676,403,3797,282
2001,Rural,Goa,Crime Against Men,Robbery,Male,31-45,7159,1410,5749,2821,4338
2004,Rural,Kerala,Crime Against Children,Trafficking,Female,31-45,8753,6246,2507,7097,1656
2003,Urban,Odisha,Crime Against Women,Domestic Violence,Female,46-60,2048,2036,12,2036,12
2007,Urban,Uttarakhand,Crime Against Women,Domestic Violence,Male,60+,5104,3691,1413,3802,1302
2008,Rural,Madhya Pradesh,Crime Against Women,Dowry Deaths,Male,46-60,4096,3100,996,3528,568
2007,Rural,Bihar,Other Crimes,Cyber Crime,Male,60+,2011,366,1645,1644,367
2005,Rural,Andhra Pradesh,Other Crimes,Corruption,Female,60+,7021,3834,3187,4392,2629
2002,Rural,Meghalaya,Crime Against Men,Murder,Female,60+,1368,1086,282,1121,247
2002,Urban,Nagaland,Crime Against Children,Child Abuse,Female,0-12,4961,4161,800,4519,442
2009,Rural,Bihar,Crime Against Men,Extortion,Female,60+,7272,1722,5550,4353,2919
2005,Urban,Haryana,Crime Against Women,Domestic Violence,Male,0-12,6364,1419,4945,6327,37
2010,Urban,Jharkhand,Other Crimes,Fraud,Male,13-17,1671,1560,111,1626,45
2004,Urban,Tamil Nadu,Crime Against Men,Murder,Female,31-45,5730,1394,4336,5337,393
2010,Rural,Gujarat,Crime Against Women,Rape,Female,46-60,2082,781,1301,1722,360
2009,Urban,Arunachal Pradesh,Other Crimes,Fraud,Male,46-60,6688,6394,294,6672,16
2004,Rural,Rajasthan,Crime Against Children,Kidnapping,Male,46-60,8733,6624,2109,7529,1204
2007,Urban,Jammu & Kashmir,Crime Against Women,Molestation,Female,18-30,227,116,111,129,98
2010,Rural,Delhi,Crime Against Women,Dowry Deaths,Male,60+,586,221,365,499,87
2001,Rural,Telangana,Property Crime,Arson,Male,31-45,7734,4111,3623,7535,199
2001,Urban,Arunachal Pradesh,Crime Against Women,Rape,Female,31-45,9584,1297,8287,5153,4431
2005,Urban,Chhattisgarh,Crime Against Women,Rape,Female,13-17,4994,968,4026,2515,2479
2005,Urban,Jharkhand,Property Crime,Arson,Male,46-60,8913,4630,4283,7160,1753
2003,Urban,Punjab,Other Crimes,Fraud,Female,13-17,9279,7769,1510,8387,892
2005,Rural,Haryana,Crime Against Men,Murder,Female,0-12,7292,705,6587,6988,304
2006,Urban,West Bengal,Other Crimes,Corruption,Male,31-45,9416,3495,5921,5143,4273
2009,Urban,Himachal Pradesh,Other Crimes,Cyber Crime,Male,31-45,7415,4657,2758,6698,717
2008,Urban,West Bengal,Crime Against Men,Assault,Female,18-30,7712,4420,3292,5518,2194
2005,Urban,Andhra Pradesh,Crime Against Men,Robbery,Female,13-17,4298,2997,1301,3267,1031
2005,Rural,Haryana,Property Crime,Vandalism,Male,60+,950,770,180,772,178
2007,Urban,Assam,Property Crime,Arson,Female,31-45,9722,139,9583,6072,3650
2003,Urban,Assam,Other Crimes,Cyber Crime,Male,46-60,4096,3510,586,3888,208
2008,Urban,Haryana,Other Crimes,Cyber Crime,Female,13-17,1564,1185,379,1282,282
2006,Rural,Sikkim,Crime Against Men,Extortion,Male,18-30,6826,3916,2910,4152,2674
2002,Rural,Uttarakhand,Crime Against Children,Child Abuse,Female,60+,7924,3702,4222,5885,2039
2005,Urban,Jammu & Kashmir,Other Crimes,Drug Offense,Female,13-17,2054,810,1244,1336,718
2003,Urban,Assam,Crime Against Children,Trafficking,Male,46-60,7989,5930,2059,6442,1547
2001,Rural,Himachal Pradesh,Other Crimes,Drug Offense,Male,46-60,5711,2081,3630,4836,875
2001,Urban,Mizoram,Crime Against Women,Molestation,Male,18-30,2660,1218,1442,1469,1191
2005,Urban,Mizoram,Other Crimes,Cyber Crime,Female,60+,9187,9016,171,9097,90
2004,Urban,Odisha,Crime Against Men,Robbery,Female,13-17,6026,4377,1649,5907,119
2007,Rural,Telangana,Crime Against Women,Dowry Deaths,Female,60+,5022,704,4318,1389,3633
2009,Rural,Bihar,Crime Against Children,Child Abuse,Female,18-30,4608,1261,3347,4522,86
2006,Rural,Tamil Nadu,Crime Against Men,Extortion,Male,18-30,6682,3388,3294,5500,1182
2002,Urban,Sikkim,Property Crime,Burglary,Female,60+,7550,2784,4766,6341,1209
2008,Rural,Bihar,Crime Against Men,Robbery,Male,13-17,1924,1716,208,1766,158
2009,Urban,Uttar Pradesh,Other Crimes,Drug Offense,Female,31-45,9914,8971,943,8986,928
2007,Urban,Uttarakhand,Crime Against Women,Molestation,Female,18-30,1074,367,707,805,269
2008,Rural,Jammu & Kashmir,Crime Against Women,Rape,Male,60+,1104,138,966,279,825
2005,Rural,Bihar,Crime Against Men,Assault,Male,0-12,4127,490,3637,3989,138
2001,Rural,Madhya Pradesh,Other Crimes,Corruption,Female,31-45,606,223,383,521,85
2005,Urban,Himachal Pradesh,Crime Against Men,Extortion,Male,31-45,2617,2431,186,2509,108
2007,Rural,Manipur,Crime Against Children,Child Abuse,Female,60+,2118,119,1999,1416,702
2003,Rural,Jharkhand,Crime Against Men,Assault,Male,18-30,4829,2924,1905,4123,706
2005,Urban,Delhi,Crime Against Men,Extortion,Female,60+,1565,469,1096,827,738
2009,Rural,Himachal Pradesh,Crime Against Women,Rape,Female,60+,8143,5623,2520,6225,1918
2001,Rural,Delhi,Other Crimes,Cyber Crime,Male,13-17,8091,705,7386,7029,1062
2002,Urban,Uttar Pradesh,Property Crime,Theft,Male,31-45,5193,3314,1879,4845,348
2001,Urban,Nagaland,Crime Against Women,Rape,Female,31-45,3268,2662,606,3121,147
2009,Urban,Karnataka,Crime Against Men,Murder,Female,46-60,8919,8537,382,8615,304
2004,Urban,Bihar,Other Crimes,Cyber Crime,Male,46-60,4295,2153,2142,2895,1400
2003,Rural,Bihar,Crime Against Women,Domestic Violence,Female,60+,8524,4716,3808,6455,2069
2007,Rural,Telangana,Crime Against Children,Child Labor,Male,0-12,475,89,386,332,143
2002,Rural,Tamil Nadu,Crime Against Men,Murder,Male,60+,2962,2833,129,2950,12
2006,Rural,Sikkim,Property Crime,Burglary,Female,18-30,6515,2182,4333,3261,3254
2009,Rural,West Bengal,Crime Against Women,Molestation,Male,0-12,8968,1475,7493,1551,7417
2007,Urban,Karnataka,Crime Against Children,Kidnapping,Female,13-17,2181,446,1735,1820,361
2004,Urban,Assam,Property Crime,Vandalism,Female,60+,2607,1587,1020,2240,367
2010,Urban,Sikkim,Property Crime,Arson,Female,0-12,549,158,391,413,136
2003,Rural,Andhra Pradesh,Crime Against Women,Dowry Deaths,Male,18-30,5424,4356,1068,4540,884
2004,Rural,Bihar,Crime Against Children,Kidnapping,Female,46-60,7103,6651,452,6755,348
2007,Urban,Nagaland,Property Crime,Vandalism,Female,13-17,4354,347,4007,1877,2477
2003,Urban,Kerala,Crime Against Women,Molestation,Male,31-45,3318,3036,282,3206,112
2004,Urban,West Bengal,Property Crime,Vandalism,Female,18-30,546,123,423,523,23
2001,Urban,West Bengal,Crime Against Children,Kidnapping,Female,13-17,4883,3514,1369,4831,52
2004,Urban,Jammu & Kashmir,Property Crime,Vandalism,Male,13-17,3758,686,3072,3559,199
2007,Rural,Telangana,Crime Against Women,Molestation,Male,46-60,9670,8008,1662,8224,1446
2003,Rural,Haryana,Other Crimes,Fraud,Female,0-12,8020,6126,1894,6529,1491
2001,Rural,Assam,Crime Against Children,Kidnapping,Male,13-17,152,96,56,141,11
2005,Urban,Chhattisgarh,Crime Against Men,Extortion,Male,31-45,7007,3037,3970,6196,811
2008,Rural,Punjab,Crime Against Men,Robbery,Male,0-12,6115,1229,4886,2901,3214
2004,Urban,Mizoram,Property Crime,Arson,Female,46-60,3578,89,3489,2354,1224
2005,Urban,Haryana,Other Crimes,Cyber Crime,Female,13-17,6889,3759,3130,4944,1945
2001,Urban,Jharkhand,Crime Against Women,Domestic Violence,Female,60+,9455,7568,1887,9199,256
2003,Rural,Andhra Pradesh,Crime Against Children,Child Labor,Female,60+,125,19,106,79,46
2007,Urban,Tamil Nadu,Property Crime,Arson,Male,46-60,9765,1373,8392,9392,373
2003,Rural,Delhi,Crime Against Children,Child Labor,Male,0-12,5552,4997,555,5043,509
2003,Rural,Tamil Nadu,Crime Against Women,Domestic Violence,Female,0-12,2893,5,2888,1557,1336
2001,Rural,Himachal Pradesh,Other Crimes,Drug Offense,Male,46-60,8242,7646,596,8055,187
2008,Rural,Delhi,Crime Against Women,Molestation,Female,46-60,6042,4100,1942,4958,1084
2007,Urban,Mizoram,Property Crime,Arson,Female,13-17,1958,1038,920,1851,107
2010,Rural,Arunachal Pradesh,Crime Against Children,Child Abuse,Female,18-30,1516,462,1054,1227,289
2010,Urban,Goa,Crime Against Women,Molestation,Male,13-17,8935,63,8872,1363,7572
2010,Rural,Tamil Nadu,Crime Against Women,Molestation,Female,13-17,1490,1466,24,1468,22
2005,Urban,West Bengal,Property Crime,Theft,Female,0-12,3923,3597,326,3611,312
2002,Rural,Andhra Pradesh,Crime Against Women,Domestic Violence,Male,0-12,986,780,206,821,165
2001,Urban,Delhi,Crime Against Children,Child Abuse,Male,60+,960,555,405,574,386
2008,Rural,Manipur,Crime Against Children,Kidnapping,Female,46-60,1212,499,713,1166,46
2001,Urban,Rajasthan,Crime Against Women,Rape,Female,13-17,8136,7907,229,7940,196
2010,Urban,Manipur,Other Crimes,Drug Offense,Male,60+,8933,6134,2799,6458,2475
2005,Rural,Chhattisgarh,Crime Against Women,Molestation,Male,46-60,7491,747,6744,873,6618
2004,Urban,Karnataka,Crime Against Children,Child Abuse,Female,0-12,650,538,112,579,71
2007,Urban,Meghalaya,Crime Against Men,Assault,Female,0-12,2352,1307,1045,2143,209
2009,Rural,Odisha,Property Crime,Theft,Male,0-12,3409,1199,2210,2464,945
2004,Rural,Andhra Pradesh,Crime Against Children,Child Abuse,Female,13-17,6408,4428,1980,4487,1921
2010,Urban,Nagaland,Other Crimes,Corruption,Female,0-12,8845,3471,5374,4686,4159
2006,Rural,Assam,Crime Against Women,Molestation,Female,46-60,3827,1974,1853,2974,853
2001,Rural,Jharkhand,Crime Against Men,Murder,Male,60+,3651,2111,1540,3321,330
2004,Rural,Odisha,Property Crime,Arson,Female,60+,9220,9031,189,9086,134
2005,Rural,Mizoram,Crime Against Women,Rape,Male,31-45,1452,998,454,1369,83
2001,Urban,West Bengal,Property Crime,Arson,Male,0-12,6213,3497,2716,3800,2413
2001,Rural,Tripura,Other Crimes,Fraud,Female,0-12,4126,779,3347,1243,2883
2002,Rural,Odisha,Crime Against Men,Robbery,Male,46-60,7874,3933,3941,5305,2569
2003,Urban,Arunachal Pradesh,Crime Against Children,Child Abuse,Female,0-12,3432,850,2582,1993,1439
2006,Rural,Manipur,Other Crimes,Corruption,Female,13-17,8217,7236,981,7345,872
2001,Rural,Nagaland,Crime Against Women,Molestation,Male,31-45,9491,4298,5193,6738,2753
2010,Urban,Haryana,Crime Against Men,Murder,Male,31-45,716,342,374,556,160
2005,Urban,Maharashtra,Crime Against Women,Rape,Male,60+,3008,2410,598,2932,76
2009,Rural,Tamil Nadu,Crime Against Men,Murder,Male,13-17,5629,1591,4038,2411,3218
2001,Urban,Bihar,Crime Against Women,Dowry Deaths,Male,31-45,8192,638,7554,5437,2755
2010,Urban,Jharkhand,Property Crime,Burglary,Female,46-60,1543,621,922,1287,256
2008,Rural,Kerala,Crime Against Women,Dowry Deaths,Male,46-60,5631,509,5122,1719,3912
2006,Urban,Odisha,Other Crimes,Cyber Crime,Male,60+,1572,1380,192,1527,45
2005,Urban,Gujarat,Property Crime,Vandalism,Female,0-12,1683,291,1392,553,1130
2003,Urban,Delhi,Other Crimes,Drug Offense,Male,18-30,3936,2691,1245,3034,902
2009,Urban,Tamil Nadu,Property Crime,Theft,Female,46-60,7871,124,7747,3803,4068
2009,Urban,Goa,Crime Against Men,Murder,Female,60+,7281,2246,5035,2292,4989
2001,Rural,Rajasthan,Crime Against Men,Assault,Female,0-12,9511,1374,8137,1879,7632
2007,Urban,Andhra Pradesh,Other Crimes,Corruption,Female,31-45,8226,1799,6427,2651,5575
2006,Urban,Punjab,Other Crimes,Drug Offense,Male,18-30,2849,392,2457,439,2410
2001,Rural,Maharashtra,Crime Against Men,Murder,Male,31-45,8088,8054,34,8055,33
2005,Urban,Andhra Pradesh,Crime Against Children,Trafficking,Female,60+,1019,566,453,662,357
2004,Rural,Madhya Pradesh,Crime Against Men,Murder,Male,0-12,3368,2666,702,3224,144
2005,Rural,Nagaland,Property Crime,Arson,Male,60+,5181,4175,1006,4435,746
2001,Rural,Manipur,Crime Against Children,Child Labor,Male,0-12,7341,6944,397,6987,354
2002,Urban,Odisha,Property Crime,Vandalism,Female,46-60,8167,3302,4865,3811,4356
2001,Rural,Uttar Pradesh,Property Crime,Vandalism,Female,18-30,9462,3546,5916,8162,1300
2009,Urban,Jharkhand,Crime Against Women,Rape,Male,60+,3637,165,3472,683,2954
2006,Urban,Himachal Pradesh,Property Crime,Burglary,Male,0-12,1956,1772,184,1782,174
2010,Rural,Sikkim,Crime Against Women,Molestation,Female,13-17,7677,1197,6480,6605,1072
2001,Rural,Himachal Pradesh,Property Crime,Theft,Female,46-60,2780,369,2411,1051,1729
2007,Rural,Jammu & Kashmir,Property Crime,Theft,Female,31-45,6223,5734,489,5985,238
2010,Urban,Haryana,Crime Against Children,Child Abuse,Female,13-17,2397,1106,1291,1215,1182
2003,Urban,Tripura,Crime Against Children,Child Abuse,Female,46-60,7174,1455,5719,5669,1505
2009,Rural,Uttar Pradesh,Property Crime,Vandalism,Male,46-60,2969,2036,933,2307,662
2005,Urban,Arunachal Pradesh,Crime Against Men,Extortion,Female,18-30,2077,1392,685,1529,548
2004,Rural,Jammu & Kashmir,Other Crimes,Corruption,Male,18-30,1639,200,1439,906,733
2002,Rural,Andhra Pradesh,Crime Against Men,Extortion,Male,46-60,1685,1478,207,1581,104
2001,Rural,Haryana,Other Crimes,Cyber Crime,Female,18-30,7143,5022,2121,6752,391
2003,Rural,Chhattisgarh,Crime Against Men,Robbery,Female,13-17,6690,6190,500,6308,382
2009,Rural,Uttar Pradesh,Crime Against Women,Dowry Deaths,Male,18-30,8249,2032,6217,7437,812
2004,Urban,Maharashtra,Other Crimes,Corruption,Female,0-12,3090,1156,1934,2456,634
2001,Rural,Uttar Pradesh,Other Crimes,Corruption,Male,46-60,4287,2125,2162,2623,1664
2006,Urban,Bihar,Property Crime,Arson,Female,18-30,4255,2442,1813,3904,351
2004,Rural,Haryana,Crime Against Children,Child Labor,Male,13-17,9714,3679,6035,6252,3462
2002,Rural,Mizoram,Crime Against Men,Extortion,Male,46-60,3505,298,3207,2472,1033
2002,Rural,Maharashtra,Crime Against Children,Trafficking,Male,13-17,2485,1901,584,1934,551
2008,Urban,Maharashtra,Crime Against Children,Trafficking,Female,18-30,8973,5729,3244,7044,1929
2003,Urban,Nagaland,Crime Against Women,Rape,Male,46-60,2013,1961,52,1963,50
2010,Urban,Maharashtra,Crime Against Children,Child Labor,Male,31-45,6509,2055,4454,2257,4252
2003,Urban,Rajasthan,Crime Against Men,Extortion,Male,60+,1807,1597,210,1694,113
2009,Urban,Punjab,Property Crime,Vandalism,Male,60+,1933,113,1820,648,1285
2007,Rural,Mizoram,Crime Against Children,Child Labor,Female,13-17,1188,926,262,1095,93
2005,Rural,Kerala,Property Crime,Theft,Female,0-12,979,789,190,853,126
2006,Rural,Jammu & Kashmir,Crime Against Women,Dowry Deaths,Female,46-60,2228,1591,637,2020,208
2001,Rural,Jharkhand,Other Crimes,Drug Offense,Female,31-45,478,53,425,71,407
2009,Rural,Tamil Nadu,Property Crime,Arson,Male,13-17,1679,515,1164,1604,75
2008,Rural,Haryana,Crime Against Men,Assault,Male,46-60,1473,1451,22,1458,15
2001,Urban,Mizoram,Other Crimes,Drug Offense,Female,18-30,3439,3144,295,3246,193
2001,Urban,Kerala,Crime Against Men,Extortion,Male,13-17,667,72,595,485,182
2005,Urban,Mizoram,Crime Against Children,Child Labor,Female,60+,1632,885,747,1102,530
2002,Urban,Uttarakhand,Crime Against Children,Child Labor,Male,13-17,1949,851,1098,1215,734
2009,Urban,Maharashtra,Crime Against Women,Dowry Deaths,Female,13-17,4494,741,3753,2802,1692
2009,Urban,Assam,Crime Against Women,Domestic Violence,Female,13-17,2160,969,1191,1291,869
2007,Rural,Manipur,Crime Against Children,Trafficking,Female,60+,9321,7829,1492,8682,639
2009,Urban,Bihar,Crime Against Men,Murder,Male,31-45,9718,4573,5145,6594,3124
2009,Urban,Arunachal Pradesh,Crime Against Women,Molestation,Male,46-60,7093,6638,455,7007,86
2003,Urban,Maharashtra,Other Crimes,Corruption,Female,13-17,8380,6201,2179,8378,2
2009,Urban,Jharkhand,Crime Against Children,Kidnapping,Female,18-30,9534,7391,2143,8720,814
2010,Urban,Punjab,Property Crime,Burglary,Female,18-30,4097,240,3857,3309,788
2008,Rural,Meghalaya,Crime Against Women,Dowry Deaths,Female,46-60,6542,2326,4216,3651,2891
2001,Rural,Jharkhand,Property Crime,Burglary,Male,46-60,5623,4203,1420,5530,93
2005,Urban,Manipur,Crime Against Women,Rape,Female,13-17,8656,1039,7617,7940,716
2009,Rural,Uttar Pradesh,Other Crimes,Corruption,Male,0-12,8103,5066,3037,6874,1229
2004,Rural,Madhya Pradesh,Crime Against Women,Dowry Deaths,Male,13-17,6748,3310,3438,4180,2568
2004,Urban,Jammu & Kashmir,Crime Against Children,Kidnapping,Male,46-60,1863,1234,629,1743,120
2006,Urban,Bihar,Crime Against Women,Molestation,Male,18-30,4710,4552,158,4589,121
2006,Urban,Assam,Crime Against Men,Murder,Male,46-60,7566,4886,2680,5055,2511
2007,Rural,Goa,Crime Against Men,Assault,Male,31-45,6142,1632,4510,2201,3941
2010,Rural,West Bengal,Crime Against Children,Trafficking,Female,60+,7735,3280,4455,7115,620
2007,Rural,Andhra Pradesh,Other Crimes,Drug Offense,Female,46-60,1528,734,794,803,725
2004,Rural,Karnataka,Crime Against Children,Trafficking,Male,60+,7676,4328,3348,7100,576
2002,Urban,Mizoram,Other Crimes,Corruption,Male,13-17,7173,437,6736,4105,3068
2006,Urban,Tamil Nadu,Property Crime,Vandalism,Male,18-30,5374,221,5153,2649,2725
2009,Urban,Andhra Pradesh,Crime Against Women,Rape,Male,0-12,3653,2686,967,3315,338
2005,Rural,Bihar,Crime Against Men,Assault,Female,60+,4928,2580,2348,4655,273
2005,Rural,Jharkhand,Crime Against Men,Robbery,Female,60+,752,342,410,492,260
2007,Urban,Himachal Pradesh,Property Crime,Theft,Female,31-45,5515,1716,3799,2978,2537
2006,Rural,Rajasthan,Other Crimes,Drug Offense,Female,31-45,3478,1138,2340,1447,2031
2006,Rural,Bihar,Other Crimes,Cyber Crime,Female,31-45,6276,5274,1002,5470,806
2010,Urban,Kerala,Crime Against Women,Rape,Male,60+,1001,75,926,766,235
2008,Rural,Jammu & Kashmir,Crime Against Children,Kidnapping,Female,0-12,637,313,324,371,266
2008,Rural,Andhra Pradesh,Crime Against Men,Assault,Male,13-17,4632,3407,1225,4148,484
2010,Urban,Jammu & Kashmir,Crime Against Children,Child Labor,Female,31-45,478,57,421,246,232
2010,Urban,Punjab,Crime Against Children,Child Labor,Female,13-17,5450,4907,543,5264,186
2010,Rural,Delhi,Crime Against Men,Extortion,Female,18-30,52,32,20,46,6
2005,Urban,Punjab,Property Crime,Arson,Female,18-30,7133,5616,1517,5768,1365
2009,Urban,Arunachal Pradesh,Property Crime,Arson,Female,46-60,1009,603,406,985,24
2005,Rural,Punjab,Crime Against Men,Assault,Male,18-30,5719,644,5075,2497,3222
2003,Rural,Tamil Nadu,Crime Against Children,Trafficking,Female,46-60,4693,2323,2370,3543,1150
2005,Rural,Sikkim,Property Crime,Theft,Female,46-60,4380,19,4361,2748,1632
2004,Rural,Telangana,Crime Against Women,Rape,Male,31-45,8406,5783,2623,8178,228
2007,Urban,Uttarakhand,Other Crimes,Fraud,Female,46-60,6973,5588,1385,6665,308
2009,Urban,Delhi,Crime Against Women,Rape,Female,0-12,2647,885,1762,2084,563
2003,Rural,Gujarat,Other Crimes,Drug Offense,Male,0-12,3611,3496,115,3598,13
2008,Rural,Arunachal Pradesh,Property Crime,Theft,Female,13-17,8948,3018,5930,6811,2137
2003,Rural,Manipur,Property Crime,Theft,Female,0-12,5295,4949,346,5167,128
2003,Rural,Delhi,Crime Against Children,Child Abuse,Male,18-30,146,136,10,138,8
2009,Rural,Bihar,Other Crimes,Corruption,Female,0-12,9019,2010,7009,2069,6950
2004,Rural,Madhya Pradesh,Crime Against Children,Trafficking,Female,13-17,9427,4234,5193,7061,2366
2008,Urban,Uttarakhand,Property Crime,Vandalism,Female,18-30,1340,1190,150,1192,148
2002,Rural,Nagaland,Crime Against Men,Extortion,Male,31-45,3241,2496,745,2585,656
2003,Rural,Himachal Pradesh,Other Crimes,Cyber Crime,Male,31-45,8620,1892,6728,3502,5118
2006,Urban,Punjab,Crime Against Men,Extortion,Female,31-45,7078,984,6094,6671,407
2004,Urban,Uttarakhand,Other Crimes,Cyber Crime,Male,18-30,3382,1055,2327,2324,1058
2008,Rural,Gujarat,Crime Against Women,Rape,Female,31-45,5660,3498,2162,5657,3
2003,Rural,Bihar,Crime Against Children,Child Abuse,Female,46-60,4236,297,3939,2399,1837
2007,Rural,Arunachal Pradesh,Other Crimes,Drug Offense,Female,13-17,4147,1850,2297,2405,1742
2001,Urban,Maharashtra,Other Crimes,Corruption,Male,60+,264,202,62,242,22
2008,Urban,Assam,Other Crimes,Drug Offense,Female,46-60,9041,2359,6682,4228,4813
2008,Urban,Gujarat,Property Crime,Burglary,Male,0-12,8466,1062,7404,5794,2672
2008,Rural,Karnataka,Crime Against Women,Domestic Violence,Male,60+,8375,5408,2967,5731,2644
2010,Urban,Karnataka,Crime Against Children,Trafficking,Female,46-60,8549,3353,5196,4825,3724
2008,Rural,Goa,Crime Against Men,Assault,Female,0-12,9219,3095,6124,6847,2372
2008,Urban,Tripura,Crime Against Men,Robbery,Male,18-30,2727,1324,1403,2597,130
2009,Urban,Telangana,Property Crime,Theft,Male,13-17,8272,1964,6308,2628,5644
2005,Rural,Telangana,Crime Against Women,Domestic Violence,Male,31-45,4448,4434,14,4447,1
2010,Rural,Uttarakhand,Property Crime,Vandalism,Male,18-30,4555,3652,903,3788,767
2010,Rural,Tamil Nadu,Crime Against Men,Extortion,Male,46-60,620,328,292,479,141
2009,Rural,Goa,Property Crime,Theft,Male,46-60,5798,4169,1629,4795,1003
2003,Rural,Uttar Pradesh,Crime Against Men,Murder,Male,60+,6402,2823,3579,6112,290
2007,Rural,Manipur,Crime Against Children,Kidnapping,Female,46-60,4840,2544,2296,3778,1062
2005,Urban,Bihar,Property Crime,Vandalism,Female,46-60,5674,1408,4266,1584,4090
2001,Rural,Chhattisgarh,Crime Against Men,Murder,Male,60+,5983,2027,3956,2771,3212
2004,Rural,Tripura,Crime Against Women,Dowry Deaths,Male,60+,757,513,244,647,110
2009,Rural,Karnataka,Crime Against Women,Dowry Deaths,Male,18-30,3763,939,2824,3339,424
2006,Urban,Gujarat,Crime Against Women,Molestation,Female,31-45,2788,859,1929,1049,1739
2004,Urban,Assam,Property Crime,Vandalism,Male,46-60,4118,2827,1291,3189,929
2002,Urban,Jharkhand,Crime Against Women,Dowry Deaths,Male,46-60,2759,1223,1536,1776,983
2008,Rural,Gujarat,Other Crimes,Cyber Crime,Female,0-12,3483,2074,1409,2117,1366
2003,Urban,Andhra Pradesh,Crime Against Men,Extortion,Male,13-17,1550,1080,470,1092,458
2003,Rural,Maharashtra,Crime Against Women,Molestation,Male,13-17,3708,3256,452,3382,326
2004,Urban,Bihar,Crime Against Children,Child Abuse,Male,31-45,9846,2815,7031,7985,1861
2007,Rural,Tamil Nadu,Property Crime,Burglary,Female,46-60,4034,1672,2362,3973,61
2009,Rural,Assam,Other Crimes,Drug Offense,Male,31-45,7973,6645,1328,7228,745
2008,Urban,Karnataka,Crime Against Men,Robbery,Male,60+,5067,245,4822,4692,375
2005,Rural,Chhattisgarh,Crime Against Women,Rape,Female,46-60,3804,17,3787,3513,291
2005,Urban,Arunachal Pradesh,Other Crimes,Cyber Crime,Female,13-17,9813,6450,3363,8318,1495
2005,Rural,Gujarat,Other Crimes,Cyber Crime,Female,13-17,5739,2379,3360,5596,143
2008,Urban,Tamil Nadu,Crime Against Men,Murder,Female,13-17,9051,4656,4395,8009,1042
2003,Urban,Odisha,Property Crime,Vandalism,Male,46-60,9800,5609,4191,7653,2147
2007,Rural,Kerala,Other Crimes,Cyber Crime,Male,60+,1719,885,834,1395,324
2007,Urban,Kerala,Other Crimes,Cyber Crime,Male,31-45,2023,820,1203,1850,173
2004,Rural,Maharashtra,Crime Against Men,Extortion,Male,18-30,238,30,208,204,34
2004,Urban,Sikkim,Property Crime,Burglary,Female,46-60,7484,762,6722,3400,4084
2004,Rural,Maharashtra,Crime Against Women,Domestic Violence,Male,0-12,7147,1960,5187,3083,4064
2004,Urban,Kerala,Crime Against Men,Extortion,Male,60+,4309,30,4279,3888,421
2003,Rural,Kerala,Other Crimes,Fraud,Male,60+,365,261,104,337,28
2001,Rural,Odisha,Other Crimes,Corruption,Female,46-60,7049,2063,4986,6325,724
2001,Urban,Tripura,Crime Against Men,Extortion,Female,31-45,4168,3717,451,3936,232
2008,Rural,Mizoram,Other Crimes,Fraud,Male,60+,3159,2962,197,3124,35
2003,Rural,Karnataka,Crime Against Children,Trafficking,Female,60+,9945,1823,8122,4486,5459
2009,Urban,Mizoram,Other Crimes,Fraud,Female,0-12,1487,811,676,1379,108
2008,Urban,West Bengal,Other Crimes,Fraud,Female,46-60,8323,4442,3881,4445,3878
2005,Urban,Chhattisgarh,Crime Against Men,Assault,Male,0-12,1965,1097,868,1564,401
2003,Rural,Uttar Pradesh,Crime Against Children,Child Abuse,Male,13-17,2629,1208,1421,2133,496
2010,Urban,Odisha,Crime Against Women,Domestic Violence,Female,46-60,2707,1989,718,2013,694
2002,Urban,Andhra Pradesh,Crime Against Women,Domestic Violence,Female,13-17,4518,2636,1882,3154,1364
2007,Rural,Karnataka,Other Crimes,Cyber Crime,Female,13-17,8890,7084,1806,7345,1545
2006,Rural,Odisha,Crime Against Men,Extortion,Female,31-45,1961,656,1305,958,1003
2006,Urban,Tripura,Property Crime,Theft,Male,18-30,6330,3279,3051,3568,2762
2002,Urban,Sikkim,Crime Against Men,Murder,Female,0-12,7133,4323,2810,5931,1202
2009,Urban,Telangana,Crime Against Children,Kidnapping,Female,13-17,5236,5071,165,5217,19
2008,Rural,Manipur,Crime Against Men,Extortion,Female,18-30,2577,268,2309,1198,1379
2006,Urban,Jharkhand,Crime Against Men,Assault,Male,31-45,5456,328,5128,1359,4097
2001,Rural,Punjab,Crime Against Men,Assault,Male,18-30,273,233,40,257,16
2007,Urban,Kerala,Other Crimes,Fraud,Female,46-60,308,158,150,196,112
2003,Urban,Gujarat,Other Crimes,Fraud,Male,0-12,2650,199,2451,702,1948
2009,Rural,Assam,Crime Against Children,Child Labor,Female,13-17,2056,334,1722,1939,117
2008,Urban,West Bengal,Crime Against Men,Robbery,Male,0-12,329,72,257,283,46
2006,Urban,Jammu & Kashmir,Crime Against Women,Domestic Violence,Female,18-30,9888,2368,7520,5794,4094
2006,Urban,Goa,Crime Against Men,Murder,Female,0-12,9451,5828,3623,6932,2519
2010,Urban,Chhattisgarh,Crime Against Women,Domestic Violence,Female,0-12,8314,1100,7214,5691,2623
2005,Rural,Karnataka,Other Crimes,Cyber Crime,Male,13-17,6361,5260,1101,5796,565
2006,Rural,Uttarakhand,Crime Against Men,Assault,Female,60+,7018,5025,1993,6901,117
2008,Rural,Tamil Nadu,Other Crimes,Drug Offense,Female,31-45,3302,2256,1046,2638,664
2003,Rural,Sikkim,Crime Against Men,Assault,Male,31-45,2346,1732,614,2239,107
2008,Rural,Tripura,Crime Against Men,Robbery,Female,13-17,3637,1029,2608,1341,2296
2002,Urban,Punjab,Crime Against Women,Rape,Female,18-30,4866,3587,1279,3928,938
2002,Urban,Assam,Crime Against Men,Robbery,Male,60+,4718,2451,2267,4034,684
2003,Urban,Himachal Pradesh,Crime Against Children,Child Labor,Male,0-12,5206,1266,3940,4247,959
2002,Rural,Nagaland,Crime Against Children,Kidnapping,Female,18-30,9292,5620,3672,7816,1476
2003,Urban,Kerala,Crime Against Women,Dowry Deaths,Male,0-12,8787,7485,1302,7873,914
2001,Urban,Goa,Crime Against Men,Murder,Female,31-45,4554,4308,246,4397,157
2010,Urban,Gujarat,Crime Against Men,Robbery,Male,31-45,2978,1397,1581,1583,1395
2009,Rural,Bihar,Crime Against Children,Kidnapping,Male,46-60,2139,203,1936,1214,925
2003,Urban,Odisha,Property Crime,Theft,Female,60+,7964,4251,3713,5907,2057
2002,Rural,Assam,Property Crime,Burglary,Female,60+,8753,1028,7725,3086,5667
2007,Urban,Nagaland,Other Crimes,Fraud,Female,31-45,2103,176,1927,995,1108
2005,Rural,West Bengal,Crime Against Men,Assault,Female,13-17,2712,224,2488,271,2441
2001,Rural,Bihar,Property Crime,Theft,Female,46-60,5206,3602,1604,4660,546
2007,Urban,Kerala,Other Crimes,Corruption,Male,18-30,7755,4500,3255,5867,1888
2001,Rural,West Bengal,Property Crime,Theft,Male,31-45,7657,678,6979,3084,4573
2005,Rural,Uttar Pradesh,Other Crimes,Corruption,Female,31-45,4624,783,3841,1854,2770
2006,Urban,Bihar,Crime Against Men,Extortion,Male,46-60,366,208,158,255,111
2006,Rural,Meghalaya,Crime Against Children,Child Abuse,Male,31-45,2162,251,1911,1918,244
2010,Urban,Himachal Pradesh,Crime Against Women,Molestation,Male,13-17,5879,1402,4477,3268,2611
2004,Rural,Bihar,Crime Against Men,Assault,Female,18-30,8157,4296,3861,4789,3368
2010,Rural,Delhi,Crime Against Men,Assault,Female,46-60,3625,1514,2111,2656,969
2001,Rural,Odisha,Crime Against Men,Extortion,Male,18-30,1657,1092,565,1097,560
2005,Rural,Haryana,Crime Against Children,Child Abuse,Male,0-12,7612,5923,1689,6445,1167
2008,Urban,Haryana,Crime Against Children,Child Abuse,Female,31-45,9267,9049,218,9176,91
2003,Rural,Maharashtra,Other Crimes,Drug Offense,Female,0-12,7665,5069,2596,6242,1423
2007,Urban,Tamil Nadu,Property Crime,Arson,Female,31-45,8010,7323,687,7910,100
2010,Urban,Telangana,Property Crime,Arson,Female,60+,3242,642,2600,921,2321
2006,Rural,Kerala,Crime Against Children,Trafficking,Male,46-60,6583,3551,3032,3947,2636
2010,Urban,Andhra Pradesh,Crime Against Women,Dowry Deaths,Male,13-17,7638,1339,6299,2563,5075
2006,Rural,Uttar Pradesh,Crime Against Men,Murder,Male,60+,1009,617,392,911,98
2005,Urban,Jammu & Kashmir,Crime Against Women,Rape,Female,18-30,8505,7815,690,8101,404
2005,Rural,Gujarat,Crime Against Men,Assault,Female,31-45,4051,2846,1205,3484,567
2003,Rural,Haryana,Crime Against Children,Child Labor,Male,0-12,5665,5036,629,5645,20
2004,Rural,Nagaland,Crime Against Men,Assault,Female,18-30,7293,3060,4233,3316,3977
2006,Rural,Rajasthan,Crime Against Children,Child Labor,Male,13-17,5254,2605,2649,2655,2599
2009,Rural,Jharkhand,Property Crime,Vandalism,Female,18-30,1484,379,1105,1383,101
2010,Rural,Kerala,Crime Against Men,Assault,Male,31-45,3835,3018,817,3415,420
2003,Urban,Nagaland,Crime Against Children,Kidnapping,Male,18-30,3389,323,3066,3090,299
2007,Rural,Karnataka,Crime Against Men,Extortion,Male,18-30,7901,810,7091,2070,5831
2006,Rural,Uttarakhand,Crime Against Children,Child Abuse,Male,18-30,5524,207,5317,1553,3971
2007,Rural,Jharkhand,Crime Against Men,Murder,Male,60+,4627,4120,507,4198,429
2010,Urban,Odisha,Crime Against Men,Extortion,Male,46-60,4615,3482,1133,3759,856
2004,Urban,Sikkim,Other Crimes,Corruption,Male,31-45,8171,6791,1380,7628,543
2009,Urban,Andhra Pradesh,Other Crimes,Fraud,Female,18-30,7074,226,6848,4737,2337
2003,Urban,Jammu & Kashmir,Property Crime,Vandalism,Female,60+,1318,173,1145,626,692
2005,Rural,Jammu & Kashmir,Property Crime,Vandalism,Female,31-45,9210,2588,6622,8326,884
2007,Urban,Punjab,Crime Against Children,Child Abuse,Female,0-12,7253,5,7248,5274,1979
2010,Rural,West Bengal,Other Crimes,Fraud,Female,60+,6699,6105,594,6580,119
2008,Rural,Nagaland,Crime Against Women,Dowry Deaths,Female,0-12,8463,3316,5147,5911,2552
2003,Rural,Sikkim,Property Crime,Theft,Male,46-60,3561,3263,298,3441,120
2003,Rural,West Bengal,Property Crime,Arson,Male,60+,264,50,214,244,20
2009,Urban,Arunachal Pradesh,Property Crime,Burglary,Female,31-45,6504,3416,3088,5360,1144
2002,Urban,Meghalaya,Other Crimes,Corruption,Female,46-60,6218,1189,5029,3802,2416
2010,Rural,Madhya Pradesh,Crime Against Children,Kidnapping,Male,60+,1697,230,1467,577,1120
2005,Urban,Odisha,Crime Against Women,Dowry Deaths,Female,31-45,2455,661,1794,1886,569
2009,Rural,Maharashtra,Crime Against Men,Robbery,Female,18-30,7478,5921,1557,7066,412
2010,Rural,Arunachal Pradesh,Crime Against Women,Rape,Female,0-12,7077,4852,2225,6286,791
2003,Rural,Manipur,Crime Against Men,Robbery,Male,18-30,1329,455,874,688,641
2006,Urban,Tamil Nadu,Crime Against Children,Kidnapping,Male,60+,1490,383,1107,1183,307
2008,Urban,Madhya Pradesh,Crime Against Men,Murder,Female,13-17,6186,4171,2015,5896,290
2002,Rural,Delhi,Other Crimes,Fraud,Female,60+,8644,6234,2410,6425,2219
2009,Rural,West Bengal,Other Crimes,Fraud,Female,31-45,7952,4844,3108,7030,922
2010,Rural,Sikkim,Crime Against Women,Domestic Violence,Female,0-12,3717,503,3214,2260,1457
2002,Urban,Rajasthan,Crime Against Men,Murder,Male,13-17,5293,4934,359,4950,343
2003,Urban,Tripura,Property Crime,Arson,Female,13-17,6842,1427,5415,2768,4074
2006,Urban,Himachal Pradesh,Other Crimes,Corruption,Male,46-60,8610,2111,6499,7684,926
2008,Rural,Himachal Pradesh,Other Crimes,Fraud,Male,46-60,321,261,60,308,13
2006,Urban,Arunachal Pradesh,Other Crimes,Corruption,Female,31-45,5953,314,5639,5494,459
2005,Urban,Madhya Pradesh,Property Crime,Burglary,Female,13-17,5640,4492,1148,4697,943
2002,Urban,Kerala,Property Crime,Vandalism,Female,46-60,3436,1665,1771,1976,1460
2005,Urban,West Bengal,Crime Against Women,Domestic Violence,Female,13-17,7464,6627,837,6981,483
2003,Rural,Tamil Nadu,Property Crime,Arson,Female,0-12,6205,2819,3386,4737,1468
2001,Rural,Punjab,Other Crimes,Fraud,Male,18-30,6951,881,6070,5968,983
2005,Urban,Goa,Crime Against Men,Murder,Female,0-12,8119,4536,3583,7042,1077
2009,Urban,Himachal Pradesh,Crime Against Women,Dowry Deaths,Male,18-30,5374,2694,2680,4023,1351
2010,Rural,Jharkhand,Other Crimes,Drug Offense,Female,0-12,7463,1964,5499,3048,4415
2003,Urban,Arunachal Pradesh,Crime Against Women,Dowry Deaths,Male,31-45,1245,526,719,531,714
2001,Rural,Meghalaya,Crime Against Children,Child Abuse,Male,46-60,9143,1951,7192,7519,1624
2004,Rural,Mizoram,Other Crimes,Cyber Crime,Female,60+,737,433,304,572,165
2009,Rural,Meghalaya,Other Crimes,Drug Offense,Male,18-30,9948,7824,2124,8544,1404
2007,Urban,Madhya Pradesh,Property Crime,Burglary,Female,18-30,5546,3823,1723,5182,364
2009,Rural,Madhya Pradesh,Other Crimes,Drug Offense,Male,0-12,6626,2802,3824,6589,37
2010,Urban,West Bengal,Other Crimes,Fraud,Male,31-45,2766,637,2129,1412,1354
2007,Rural,Jharkhand,Crime Against Men,Assault,Male,31-45,2232,939,1293,1469,763
2005,Urban,Tamil Nadu,Crime Against Children,Child Abuse,Female,46-60,8167,5492,2675,5655,2512
2002,Urban,West Bengal,Crime Against Men,Murder,Female,18-30,8005,7475,530,7993,12
2005,Urban,West Bengal,Property Crime,Vandalism,Female,18-30,4067,2756,1311,3524,543
2005,Urban,Uttar Pradesh,Crime Against Children,Child Abuse,Female,46-60,4777,3421,1356,3613,1164
2003,Rural,Uttar Pradesh,Crime Against Children,Child Abuse,Male,60+,5304,593,4711,3135,2169
2007,Rural,Goa,Property Crime,Vandalism,Female,60+,6934,1324,5610,5220,1714
2003,Rural,Himachal Pradesh,Crime Against Men,Assault,Female,60+,926,872,54,880,46
2004,Rural,Himachal Pradesh,Other Crimes,Fraud,Male,60+,2607,2502,105,2570,37
2001,Urban,Haryana,Crime Against Children,Child Labor,Male,60+,1398,865,533,1295,103
2006,Rural,Uttar Pradesh,Crime Against Men,Assault,Male,18-30,5543,1197,4346,1818,3725
2005,Rural,Sikkim,Crime Against Men,Murder,Female,46-60,7710,6896,814,7214,496
2008,Rural,Delhi,Crime Against Women,Dowry Deaths,Male,46-60,5051,475,4576,4385,666
2010,Urban,Nagaland,Property Crime,Theft,Male,13-17,8706,627,8079,5008,3698
2001,Rural,Jammu & Kashmir,Other Crimes,Cyber Crime,Female,31-45,9571,8439,1132,8636,935
2006,Rural,Rajasthan,Property Crime,Theft,Male,31-45,9964,3569,6395,6673,3291
2007,Rural,Manipur,Crime Against Women,Molestation,Male,31-45,8124,907,7217,5227,2897
2005,Rural,Maharashtra,Property Crime,Vandalism,Male,46-60,8112,6168,1944,7526,586
2003,Urban,Mizoram,Crime Against Women,Rape,Male,60+,8825,3752,5073,6198,2627
2001,Urban,Goa,Other Crimes,Corruption,Male,60+,418,233,185,335,83
2009,Rural,Meghalaya,Other Crimes,Corruption,Male,13-17,3956,2136,1820,3530,426
2001,Rural,Jharkhand,Crime Against Women,Rape,Female,0-12,1820,691,1129,1151,669
2003,Rural,Uttarakhand,Crime Against Women,Dowry Deaths,Male,31-45,863,610,253,666,197
2001,Rural,Nagaland,Crime Against Men,Robbery,Male,0-12,143,17,126,119,24
2003,Urban,Delhi,Other Crimes,Fraud,Male,18-30,2990,1609,1381,2479,511
2005,Urban,Haryana,Crime Against Women,Domestic Violence,Female,31-45,6790,2772,4018,5262,1528
2004,Urban,Manipur,Crime Against Men,Robbery,Male,31-45,3363,2419,944,2449,914
2001,Urban,Manipur,Property Crime,Arson,Male,13-17,7814,1379,6435,1437,6377
2009,Rural,Sikkim,Crime Against Women,Rape,Female,13-17,770,494,276,626,144
2003,Rural,Manipur,Other Crimes,Cyber Crime,Female,18-30,2158,1288,870,1699,459
2001,Rural,Sikkim,Crime Against Women,Domestic Violence,Female,13-17,1061,910,151,1043,18
2010,Urban,Kerala,Property Crime,Arson,Male,18-30,889,97,792,875,14
2009,Rural,Arunachal Pradesh,Crime Against Men,Robbery,Female,60+,5906,972,4934,3046,2860
2004,Rural,Tripura,Crime Against Women,Molestation,Female,46-60,4397,1160,3237,4341,56
2010,Urban,Tamil Nadu,Crime Against Children,Child Labor,Female,31-45,7198,3161,4037,3800,3398
2003,Urban,Arunachal Pradesh,Crime Against Men,Robbery,Female,31-45,822,24,798,32,790
2002,Rural,Uttar Pradesh,Crime Against Women,Molestation,Female,13-17,7019,4296,2723,5242,1777
2001,Rural,Bihar,Crime Against Children,Kidnapping,Male,0-12,9891,8681,1210,9403,488
2007,Urban,Tamil Nadu,Crime Against Children,Child Labor,Male,18-30,9542,1,9541,2243,7299
2002,Urban,Bihar,Crime Against Women,Molestation,Female,46-60,5256,4953,303,5040,216
2004,Rural,Bihar,Property Crime,Burglary,Male,31-45,2694,1264,1430,1710,984
2006,Rural,Uttarakhand,Property Crime,Theft,Female,60+,9489,5669,3820,7420,2069
2005,Rural,Bihar,Other Crimes,Corruption,Female,46-60,9248,3361,5887,4833,4415
2007,Urban,Bihar,Property Crime,Burglary,Female,46-60,7724,4447,3277,5600,2124
2005,Rural,Punjab,Crime Against Men,Murder,Female,31-45,9169,6454,2715,7141,2028
2007,Urban,Arunachal Pradesh,Property Crime,Arson,Male,18-30,7038,942,6096,7026,12
2006,Urban,Bihar,Crime Against Men,Assault,Female,18-30,4729,2495,2234,3913,816
2008,Urban,Odisha,Crime Against Women,Rape,Male,46-60,1071,608,463,1019,52
2010,Urban,Arunachal Pradesh,Crime Against Men,Murder,Male,46-60,6665,2305,4360,6656,9
2005,Rural,Assam,Property Crime,Arson,Female,31-45,5532,549,4983,748,4784
2009,Urban,Andhra Pradesh,Crime Against Men,Extortion,Female,0-12,5741,3531,2210,3577,2164
2008,Rural,Arunachal Pradesh,Other Crimes,Corruption,Male,31-45,8917,8490,427,8876,41
2006,Urban,Himachal Pradesh,Crime Against Men,Robbery,Female,0-12,5696,4007,1689,5570,126
2007,Urban,Telangana,Crime Against Women,Molestation,Male,0-12,4617,2157,2460,2610,2007
2007,Urban,Himachal Pradesh,Crime Against Men,Extortion,Male,31-45,5479,459,5020,1345,4134
2004,Rural,Karnataka,Crime Against Men,Murder,Male,18-30,5890,876,5014,4039,1851
2009,Rural,Mizoram,Crime Against Men,Extortion,Female,13-17,6698,3928,2770,4613,2085
2006,Rural,Chhattisgarh,Other Crimes,Fraud,Male,46-60,5649,567,5082,1579,4070
2004,Rural,Bihar,Crime Against Women,Domestic Violence,Female,46-60,3357,2264,1093,3145,212
2001,Rural,Tripura,Other Crimes,Cyber Crime,Male,18-30,51,5,46,48,3
2007,Rural,Assam,Crime Against Men,Murder,Male,0-12,206,81,125,131,75
2002,Rural,Madhya Pradesh,Property Crime,Theft,Female,13-17,9094,1529,7565,6130,2964
2002,Urban,Andhra Pradesh,Crime Against Children,Child Labor,Female,0-12,1236,39,1197,1186,50
2001,Urban,Tripura,Crime Against Men,Robbery,Male,13-17,556,104,452,172,384
2010,Urban,Gujarat,Property Crime,Vandalism,Female,31-45,3018,1701,1317,2280,738
2003,Rural,Arunachal Pradesh,Crime Against Men,Extortion,Female,60+,9064,4939,4125,8252,812
2007,Urban,Telangana,Crime Against Women,Rape,Male,31-45,7053,2623,4430,6860,193
2009,Urban,Himachal Pradesh,Crime Against Children,Child Labor,Male,13-17,7098,1386,5712,1699,5399
2004,Rural,Gujarat,Crime Against Women,Rape,Male,60+,4796,3575,1221,3760,1036
2004,Urban,Tripura,Crime Against Women,Domestic Violence,Male,13-17,2464,1738,726,2136,328
2007,Urban,West Bengal,Crime Against Women,Rape,Male,0-12,8494,7963,531,8163,331
2004,Rural,Bihar,Crime Against Women,Rape,Female,46-60,8661,1568,7093,4355,4306
2009,Urban,Punjab,Crime Against Children,Child Abuse,Female,18-30,2588,476,2112,1609,979
2003,Rural,Assam,Crime Against Men,Robbery,Male,31-45,1858,1133,725,1761,97
2009,Urban,Uttarakhand,Other Crimes,Drug Offense,Female,31-45,3995,51,3944,3416,579
2008,Urban,Tamil Nadu,Crime Against Men,Extortion,Male,0-12,2286,1989,297,2274,12
2001,Rural,Goa,Crime Against Men,Robbery,Female,31-45,6598,6371,227,6433,165
2010,Urban,Assam,Property Crime,Burglary,Male,60+,2070,1069,1001,1322,748
2003,Rural,Andhra Pradesh,Other Crimes,Cyber Crime,Male,46-60,9930,1726,8204,5173,4757
2004,Rural,Delhi,Other Crimes,Cyber Crime,Female,0-12,8845,6318,2527,8068,777
2009,Urban,Karnataka,Crime Against Children,Child Abuse,Male,13-17,4180,3807,373,3808,372
2005,Rural,Madhya Pradesh,Other Crimes,Corruption,Female,31-45,3701,3280,421,3612,89
2001,Rural,Tripura,Crime Against Children,Child Abuse,Female,13-17,2575,1519,1056,2291,284
2004,Urban,Tamil Nadu,Crime Against Men,Extortion,Female,18-30,1569,1017,552,1050,519
2001,Urban,Nagaland,Property Crime,Burglary,Male,13-17,2563,83,2480,1272,1291
2007,Rural,Uttar Pradesh,Crime Against Women,Domestic Violence,Male,46-60,1289,450,839,1067,222
2006,Urban,Madhya Pradesh,Crime Against Women,Rape,Male,0-12,7642,6025,1617,6480,1162
2005,Urban,Tamil Nadu,Other Crimes,Corruption,Male,31-45,9478,5585,3893,6092,3386
2009,Rural,Andhra Pradesh,Crime Against Women,Rape,Female,46-60,1231,739,492,803,428
2010,Rural,Gujarat,Other Crimes,Drug Offense,Female,46-60,1469,881,588,1273,196
2010,Rural,Tamil Nadu,Crime Against Children,Child Abuse,Female,60+,3106,1431,1675,1551,1555
2009,Urban,Jammu & Kashmir,Other Crimes,Fraud,Female,31-45,8374,5538,2836,7285,1089
2006,Urban,Tamil Nadu,Crime Against Children,Child Labor,Male,46-60,6046,1972,4074,3050,2996
2002,Urban,Punjab,Property Crime,Arson,Female,31-45,1060,224,836,239,821
2005,Rural,Tripura,Other Crimes,Drug Offense,Male,0-12,5754,821,4933,5423,331
2010,Rural,Jharkhand,Crime Against Men,Robbery,Male,46-60,9996,3507,6489,8884,1112
2003,Urban,Telangana,Property Crime,Vandalism,Female,46-60,3129,656,2473,1561,1568
2005,Urban,Uttarakhand,Crime Against Women,Dowry Deaths,Female,46-60,563,271,292,323,240
2002,Rural,Uttar Pradesh,Crime Against Women,Rape,Male,18-30,7907,7197,710,7265,642
2010,Rural,Tamil Nadu,Crime Against Men,Robbery,Male,13-17,9355,7333,2022,7580,1775
2004,Rural,Tripura,Crime Against Women,Dowry Deaths,Female,31-45,7440,1585,5855,2472,4968
2001,Rural,Assam,Property Crime,Theft,Female,60+,4778,4622,156,4699,79
2001,Urban,Haryana,Crime Against Children,Trafficking,Female,46-60,2810,1177,1633,2768,42
2007,Urban,Jharkhand,Other Crimes,Drug Offense,Female,31-45,5258,3353,1905,3470,1788
2006,Urban,Uttarakhand,Property Crime,Theft,Female,13-17,6050,5006,1044,5911,139
2006,Urban,Karnataka,Crime Against Women,Dowry Deaths,Female,60+,3664,3151,513,3320,344
2005,Urban,Tripura,Crime Against Men,Robbery,Male,0-12,8749,7578,1171,8726,23
2001,Urban,Delhi,Crime Against Women,Dowry Deaths,Female,60+,7102,3279,3823,4551,2551
2010,Urban,Himachal Pradesh,Other Crimes,Fraud,Male,60+,3839,2337,1502,3801,38
2006,Rural,Uttar Pradesh,Crime Against Women,Dowry Deaths,Female,13-17,5651,4901,750,5448,203
2006,Rural,Madhya Pradesh,Crime Against Children,Trafficking,Female,13-17,7454,4437,3017,4736,2718
2005,Urban,Madhya Pradesh,Crime Against Women,Dowry Deaths,Male,13-17,9740,1277,8463,1696,8044
2003,Rural,Gujarat,Other Crimes,Drug Offense,Male,60+,1529,938,591,1113,416
2008,Urban,Jharkhand,Crime Against Women,Domestic Violence,Female,46-60,3566,2638,928,3561,5
2004,Urban,Odisha,Crime Against Men,Murder,Male,0-12,3316,1065,2251,1815,1501
2003,Urban,Madhya Pradesh,Crime Against Women,Molestation,Male,60+,7953,3086,4867,3867,4086
2003,Urban,Arunachal Pradesh,Crime Against Women,Dowry Deaths,Male,0-12,5816,4472,1344,5471,345
2004,Rural,Punjab,Crime Against Women,Dowry Deaths,Female,0-12,5632,111,5521,2744,2888
2009,Urban,Nagaland,Crime Against Children,Kidnapping,Female,13-17,5253,2431,2822,2457,2796
2010,Urban,Gujarat,Other Crimes,Corruption,Female,46-60,5071,2698,2373,4025,1046
2005,Rural,Tripura,Crime Against Men,Extortion,Male,13-17,6512,2838,3674,6304,208
2003,Rural,Andhra Pradesh,Crime Against Women,Domestic Violence,Male,0-12,9358,7557,1801,8075,1283
2001,Rural,Arunachal Pradesh,Other Crimes,Fraud,Male,46-60,5741,5233,508,5385,356
2006,Rural,Karnataka,Property Crime,Burglary,Male,31-45,9433,6071,3362,9031,402
2006,Urban,Maharashtra,Crime Against Men,Extortion,Male,18-30,4586,2569,2017,3169,1417
2004,Rural,Tripura,Other Crimes,Fraud,Male,60+,8357,2161,6196,5490,2867
2007,Urban,Nagaland,Crime Against Women,Domestic Violence,Male,0-12,9945,3058,6887,7808,2137
2010,Rural,Tripura,Crime Against Children,Child Abuse,Female,0-12,4591,88,4503,2239,2352
2008,Urban,Goa,Crime Against Men,Assault,Male,46-60,1361,99,1262,1326,35
2010,Urban,Meghalaya,Crime Against Men,Assault,Male,18-30,2807,2113,694,2159,648
2006,Rural,Jharkhand,Crime Against Women,Dowry Deaths,Female,13-17,5881,523,5358,891,4990
2006,Urban,Madhya Pradesh,Crime Against Women,Domestic Violence,Male,0-12,8981,3969,5012,8338,643
2005,Urban,Mizoram,Property Crime,Burglary,Female,13-17,1953,1665,288,1747,206
2005,Urban,Bihar,Crime Against Women,Domestic Violence,Male,60+,2772,1833,939,2718,54
2005,Rural,Uttar Pradesh,Property Crime,Vandalism,Male,18-30,4425,2638,1787,4244,181
2005,Rural,Jammu & Kashmir,Property Crime,Arson,Male,46-60,8813,2039,6774,4025,4788
2008,Urban,Maharashtra,Property Crime,Burglary,Female,31-45,9196,684,8512,9003,193
2002,Urban,Telangana,Crime Against Men,Robbery,Female,60+,1526,50,1476,893,633
2001,Urban,Andhra Pradesh,Crime Against Men,Murder,Female,31-45,4151,3434,717,3790,361
2001,Rural,Andhra Pradesh,Property Crime,Burglary,Female,18-30,2063,434,1629,1340,723
2002,Urban,Mizoram,Crime Against Children,Child Labor,Male,18-30,8382,4668,3714,6123,2259
2006,Urban,West Bengal,Crime Against Men,Assault,Male,13-17,7202,974,6228,2706,4496
2002,Urban,Manipur,Crime Against Women,Domestic Violence,Male,0-12,3277,53,3224,406,2871
2004,Urban,West Bengal,Other Crimes,Cyber Crime,Female,0-12,8448,5304,3144,7891,557
2010,Urban,Goa,Other Crimes,Fraud,Female,13-17,8990,5944,3046,8861,129
2009,Rural,Karnataka,Crime Against Children,Trafficking,Female,13-17,8146,2144,6002,7768,378
2008,Urban,Tripura,Crime Against Men,Robbery,Male,46-60,1997,1016,981,1394,603
2007,Urban,Jharkhand,Crime Against Women,Domestic Violence,Male,13-17,947,121,826,277,670
2003,Urban,Uttarakhand,Crime Against Women,Rape,Female,60+,3855,3672,183,3743,112
2004,Rural,Tamil Nadu,Crime Against Children,Trafficking,Male,13-17,7915,2126,5789,3628,4287
2008,Rural,Andhra Pradesh,Crime Against Men,Robbery,Male,13-17,8878,5358,3520,7293,1585
2009,Rural,Uttar Pradesh,Property Crime,Vandalism,Female,60+,2313,1953,360,2151,162
2005,Rural,Chhattisgarh,Crime Against Men,Robbery,Female,31-45,6055,585,5470,3433,2622
2003,Rural,Gujarat,Property Crime,Theft,Male,13-17,8729,7330,1399,8143,586
2010,Rural,Karnataka,Crime Against Women,Domestic Violence,Female,18-30,4195,1911,2284,1949,2246
2003,Urban,Nagaland,Property Crime,Theft,Male,60+,8227,1450,6777,4895,3332
2002,Rural,Tamil Nadu,Property Crime,Arson,Female,31-45,728,92,636,583,145
2003,Rural,Karnataka,Crime Against Children,Child Labor,Male,13-17,7032,414,6618,4160,2872
2004,Urban,Madhya Pradesh,Crime Against Women,Rape,Female,13-17,7870,669,7201,1453,6417
2003,Urban,Uttar Pradesh,Crime Against Women,Rape,Male,0-12,8613,496,8117,1703,6910
2004,Urban,Manipur,Property Crime,Vandalism,Male,13-17,7768,7733,35,7739,29
2002,Urban,Uttar Pradesh,Crime Against Women,Molestation,Female,0-12,713,163,550,514,199
2005,Urban,Nagaland,Crime Against Women,Domestic Violence,Male,31-45,9445,158,9287,3227,6218
2009,Rural,Punjab,Crime Against Children,Trafficking,Male,60+,3373,2938,435,2960,413
2003,Urban,Sikkim,Crime Against Children,Kidnapping,Female,31-45,2788,524,2264,1822,966
2004,Urban,Arunachal Pradesh,Other Crimes,Fraud,Female,13-17,299,155,144,185,114
2005,Rural,Madhya Pradesh,Other Crimes,Fraud,Female,0-12,6550,4821,1729,5901,649
2007,Rural,Mizoram,Property Crime,Arson,Male,18-30,2715,948,1767,2690,25
2009,Rural,Tripura,Crime Against Women,Dowry Deaths,Female,46-60,9003,3824,5179,6160,2843
2002,Rural,Chhattisgarh,Crime Against Men,Murder,Female,13-17,8297,4873,3424,5685,2612
2010,Rural,Haryana,Other Crimes,Drug Offense,Male,60+,1696,1213,483,1418,278
2009,Urban,Tamil Nadu,Crime Against Women,Rape,Male,46-60,6062,4584,1478,4848,1214
2004,Urban,Haryana,Property Crime,Burglary,Male,18-30,6880,4367,2513,4670,2210
2008,Urban,Tamil Nadu,Other Crimes,Fraud,Male,46-60,4702,666,4036,2245,2457
2003,Rural,Uttarakhand,Other Crimes,Corruption,Female,60+,8530,2430,6100,2482,6048
2001,Urban,Manipur,Crime Against Women,Dowry Deaths,Male,46-60,1041,368,673,454,587
2002,Urban,Mizoram,Crime Against Men,Robbery,Female,46-60,5757,5036,721,5396,361
2010,Urban,Rajasthan,Other Crimes,Drug Offense,Female,13-17,8317,4031,4286,6590,1727
2001,Urban,Tripura,Crime Against Men,Robbery,Male,31-45,780,706,74,726,54
2002,Rural,Andhra Pradesh,Crime Against Women,Dowry Deaths,Male,46-60,6762,2956,3806,5529,1233
2010,Rural,Bihar,Crime Against Women,Dowry Deaths,Male,46-60,6786,865,5921,5079,1707
2004,Urban,Meghalaya,Property Crime,Vandalism,Female,31-45,8085,4893,3192,5898,2187
2001,Rural,Odisha,Crime Against Men,Murder,Male,0-12,5732,1070,4662,5108,624
2002,Rural,Punjab,Crime Against Children,Trafficking,Female,13-17,9419,9081,338,9392,27
2007,Rural,Nagaland,Crime Against Women,Rape,Female,46-60,8831,5071,3760,6144,2687
2003,Urban,Punjab,Crime Against Men,Murder,Female,13-17,3710,658,3052,1342,2368
2010,Urban,Sikkim,Property Crime,Arson,Female,31-45,9530,8498,1032,9201,329
2007,Urban,West Bengal,Crime Against Children,Child Labor,Female,60+,8730,1179,7551,6981,1749
2004,Urban,Nagaland,Crime Against Women,Molestation,Male,13-17,2975,530,2445,1695,1280
2007,Urban,Jammu & Kashmir,Property Crime,Arson,Female,0-12,5459,1564,3895,1793,3666
2002,Rural,Madhya Pradesh,Other Crimes,Fraud,Male,0-12,1948,1019,929,1073,875
2002,Urban,Uttarakhand,Property Crime,Burglary,Male,13-17,8193,441,7752,5432,2761
2001,Urban,Bihar,Crime Against Men,Murder,Male,46-60,7983,2988,4995,3340,4643
2007,Rural,Uttarakhand,Property Crime,Vandalism,Male,13-17,7794,38,7756,5539,2255
2006,Rural,Andhra Pradesh,Property Crime,Theft,Male,60+,6161,1046,5115,5886,275
2001,Urban,Haryana,Crime Against Men,Murder,Female,18-30,232,14,218,108,124
2009,Urban,Karnataka,Crime Against Men,Robbery,Female,31-45,7980,3925,4055,4563,3417
2010,Urban,Mizoram,Property Crime,Burglary,Male,18-30,9691,7451,2240,7556,2135
2009,Urban,Gujarat,Crime Against Children,Child Labor,Female,46-60,5953,4206,1747,5366,587
2010,Urban,Jammu & Kashmir,Property Crime,Theft,Male,46-60,9244,8719,525,9054,190
2007,Rural,Telangana,Crime Against Men,Extortion,Female,18-30,4343,2103,2240,2970,1373
2007,Urban,Sikkim,Other Crimes,Drug Offense,Male,46-60,8658,2730,5928,3331,5327
2007,Urban,Telangana,Other Crimes,Corruption,Female,18-30,813,376,437,737,76
2008,Rural,Delhi,Crime Against Men,Assault,Male,60+,8177,4705,3472,6414,1763
2001,Urban,Goa,Crime Against Children,Kidnapping,Female,18-30,6002,2638,3364,3751,2251
2001,Rural,Uttarakhand,Crime Against Women,Molestation,Male,0-12,2856,2720,136,2774,82
2001,Rural,Manipur,Property Crime,Burglary,Female,46-60,3398,1668,1730,2456,942
2006,Urban,Punjab,Other Crimes,Corruption,Female,31-45,5964,403,5561,1541,4423
2007,Rural,Uttar Pradesh,Crime Against Men,Robbery,Female,46-60,4256,151,4105,2440,1816
2009,Rural,Andhra Pradesh,Crime Against Men,Extortion,Female,0-12,2326,322,2004,1127,1199
2007,Rural,Maharashtra,Crime Against Men,Assault,Male,0-12,1158,191,967,711,447
2008,Rural,Gujarat,Crime Against Women,Dowry Deaths,Female,13-17,9252,5306,3946,6017,3235
2006,Rural,Mizoram,Other Crimes,Cyber Crime,Female,13-17,1841,11,1830,1675,166
2002,Urban,Punjab,Other Crimes,Fraud,Female,0-12,7903,4459,3444,6982,921
2007,Rural,Meghalaya,Crime Against Men,Extortion,Male,60+,3887,3098,789,3566,321
2007,Rural,Arunachal Pradesh,Property Crime,Theft,Male,18-30,4800,3213,1587,4429,371
2004,Urban,Punjab,Other Crimes,Cyber Crime,Male,0-12,3944,3081,863,3875,69
2006,Urban,Odisha,Crime Against Children,Child Labor,Male,60+,4773,4177,596,4722,51
2001,Rural,Manipur,Other Crimes,Drug Offense,Female,46-60,9368,7604,1764,9220,148
2002,Rural,Sikkim,Property Crime,Theft,Female,31-45,9379,1921,7458,2336,7043
2009,Urban,Assam,Crime Against Women,Molestation,Male,31-45,1825,226,1599,1304,521
2003,Urban,Rajasthan,Property Crime,Burglary,Female,18-30,847,766,81,827,20
2010,Urban,Maharashtra,Crime Against Women,Domestic Violence,Male,60+,1847,692,1155,936,911
2004,Urban,Punjab,Other Crimes,Cyber Crime,Female,0-12,3683,3361,322,3574,109
2005,Urban,Nagaland,Crime Against Women,Domestic Violence,Female,13-17,9446,218,9228,1564,7882
2006,Urban,Madhya Pradesh,Crime Against Women,Rape,Female,13-17,7870,3964,3906,7470,400
2010,Urban,Uttarakhand,Crime Against Children,Child Labor,Female,46-60,4753,3526,1227,4552,201
2001,Rural,Assam,Property Crime,Vandalism,Male,0-12,4864,1375,3489,3018,1846
2009,Rural,Karnataka,Crime Against Men,Robbery,Female,18-30,6065,644,5421,2005,4060
2008,Rural,Jammu & Kashmir,Crime Against Men,Assault,Female,60+,4968,176,4792,3417,1551
2003,Rural,Jharkhand,Crime Against Women,Molestation,Female,0-12,1200,656,544,775,425
2006,Rural,Haryana,Crime Against Children,Kidnapping,Female,0-12,2774,930,1844,2354,420
2004,Urban,Bihar,Crime Against Men,Assault,Male,46-60,5771,5040,731,5679,92
2009,Urban,Mizoram,Crime Against Men,Extortion,Male,0-12,5216,1353,3863,5018,198
2010,Urban,Manipur,Property Crime,Arson,Male,60+,8572,5570,3002,7555,1017
2008,Rural,Karnataka,Crime Against Children,Trafficking,Male,18-30,1611,1502,109,1592,19
2002,Urban,Telangana,Property Crime,Theft,Male,31-45,5576,2844,2732,3720,1856
2007,Rural,Goa,Property Crime,Vandalism,Male,18-30,3811,2732,1079,3700,111
2002,Rural,Telangana,Crime Against Women,Domestic Violence,Female,46-60,1348,1327,21,1332,16
2003,Rural,Assam,Crime Against Men,Robbery,Male,46-60,8897,5819,3078,6214,2683
2006,Rural,Telangana,Crime Against Women,Domestic Violence,Female,46-60,6134,2068,4066,5887,247
2004,Rural,Odisha,Other Crimes,Corruption,Female,46-60,4793,3595,1198,3823,970
2007,Urban,Punjab,Other Crimes,Cyber Crime,Female,60+,728,452,276,635,93
2007,Urban,Meghalaya,Crime Against Men,Murder,Female,46-60,3326,830,2496,1730,1596
2009,Rural,Kerala,Crime Against Men,Extortion,Female,13-17,2242,1189,1053,1984,258
2005,Urban,Uttar Pradesh,Other Crimes,Cyber Crime,Male,60+,1840,650,1190,762,1078
2005,Rural,Haryana,Other Crimes,Corruption,Male,18-30,9956,8631,1325,9011,945
2007,Urban,Telangana,Property Crime,Theft,Male,0-12,3283,2754,529,3154,129
2002,Rural,Goa,Crime Against Men,Assault,Female,13-17,6021,3866,2155,5481,540
2007,Rural,West Bengal,Crime Against Men,Robbery,Male,60+,4475,4196,279,4433,42
2003,Rural,Karnataka,Crime Against Men,Extortion,Female,60+,3793,824,2969,1236,2557
2009,Rural,Rajasthan,Crime Against Women,Dowry Deaths,Female,13-17,8240,1092,7148,6515,1725
2009,Rural,Telangana,Property Crime,Burglary,Male,46-60,3699,2876,823,3647,52
2010,Rural,Telangana,Property Crime,Arson,Female,31-45,2078,940,1138,1614,464
2005,Rural,Goa,Crime Against Women,Dowry Deaths,Male,31-45,7346,2924,4422,3468,3878
2006,Rural,Nagaland,Crime Against Children,Trafficking,Female,60+,4374,87,4287,4318,56
2004,Urban,Chhattisgarh,Property Crime,Burglary,Female,60+,1532,1275,257,1456,76
2003,Urban,Arunachal Pradesh,Crime Against Women,Rape,Female,0-12,5206,342,4864,4559,647
2007,Rural,Karnataka,Crime Against Women,Domestic Violence,Female,13-17,1760,691,1069,875,885
2005,Urban,Kerala,Crime Against Children,Child Labor,Male,0-12,7929,5081,2848,6571,1358
2007,Rural,Jammu & Kashmir,Property Crime,Burglary,Female,60+,1417,633,784,1415,2
2005,Urban,Uttar Pradesh,Other Crimes,Cyber Crime,Female,13-17,2918,446,2472,789,2129
2009,Urban,Himachal Pradesh,Other Crimes,Corruption,Male,13-17,1671,591,1080,943,728
2009,Rural,Punjab,Property Crime,Arson,Male,0-12,4409,2003,2406,3869,540
2010,Rural,Madhya Pradesh,Crime Against Children,Child Labor,Male,0-12,3411,3261,150,3261,150
2009,Urban,Punjab,Crime Against Children,Child Labor,Female,18-30,4160,36,4124,2023,2137
2008,Rural,Odisha,Other Crimes,Drug Offense,Male,13-17,8455,858,7597,8201,254
2002,Rural,Gujarat,Crime Against Men,Murder,Female,13-17,8347,2832,5515,5870,2477
2004,Rural,Himachal Pradesh,Crime Against Children,Trafficking,Male,31-45,7236,1861,5375,6463,773
2003,Urban,Delhi,Crime Against Men,Murder,Female,46-60,917,595,322,841,76
2005,Rural,Karnataka,Crime Against Women,Dowry Deaths,Female,13-17,131,1,130,78,53
2008,Urban,Uttar Pradesh,Crime Against Men,Robbery,Female,60+,2834,309,2525,1957,877
2005,Urban,Madhya Pradesh,Property Crime,Theft,Male,18-30,6661,958,5703,3584,3077
2005,Urban,Kerala,Crime Against Men,Robbery,Male,18-30,2192,858,1334,1732,460
2001,Urban,Rajasthan,Crime Against Men,Extortion,Female,46-60,7037,2891,4146,5326,1711
2002,Urban,Delhi,Other Crimes,Cyber Crime,Female,0-12,8644,5954,2690,6607,2037
2004,Rural,Bihar,Property Crime,Vandalism,Male,31-45,4909,3551,1358,4242,667
2003,Rural,Goa,Other Crimes,Fraud,Male,13-17,344,63,281,131,213
2001,Rural,Haryana,Other Crimes,Cyber Crime,Male,13-17,7741,373,7368,1015,6726
2005,Urban,Sikkim,Property Crime,Theft,Female,31-45,9909,8846,1063,9810,99
2007,Rural,Mizoram,Other Crimes,Cyber Crime,Female,13-17,1085,374,711,520,565
2010,Urban,Odisha,Crime Against Children,Child Abuse,Female,60+,7452,6848,604,7403,49
2010,Urban,Arunachal Pradesh,Crime Against Men,Assault,Female,0-12,5416,1700,3716,2122,3294
2001,Rural,Manipur,Property Crime,Vandalism,Female,46-60,8630,5680,2950,5692,2938
2010,Rural,Haryana,Property Crime,Burglary,Male,31-45,3617,738,2879,2561,1056
2002,Urban,Meghalaya,Crime Against Children,Child Labor,Male,18-30,3590,395,3195,2231,1359
2008,Rural,Haryana,Crime Against Women,Domestic Violence,Male,60+,3390,3108,282,3297,93
2007,Urban,Bihar,Crime Against Men,Robbery,Female,46-60,5736,3407,2329,3883,1853
2002,Urban,Meghalaya,Other Crimes,Corruption,Female,0-12,6711,537,6174,2251,4460
2002,Urban,Andhra Pradesh,Crime Against Children,Child Abuse,Female,31-45,4639,2058,2581,4001,638
2002,Rural,Tripura,Crime Against Children,Kidnapping,Female,18-30,2732,2364,368,2524,208
2004,Urban,Maharashtra,Property Crime,Vandalism,Male,18-30,3527,2673,854,3367,160
2005,Rural,Odisha,Crime Against Men,Murder,Male,0-12,4601,543,4058,3419,1182
2010,Urban,Chhattisgarh,Property Crime,Vandalism,Female,46-60,4208,3346,862,3591,617
2009,Urban,Telangana,Property Crime,Arson,Female,18-30,8315,4403,3912,4487,3828
2005,Urban,Telangana,Property Crime,Theft,Male,18-30,8218,3774,4444,6910,1308
2005,Rural,Jharkhand,Crime Against Children,Kidnapping,Male,46-60,8745,2797,5948,4627,4118
2005,Urban,Haryana,Crime Against Children,Trafficking,Male,31-45,2379,1537,842,2072,307
2007,Urban,Tamil Nadu,Crime Against Men,Extortion,Female,0-12,1373,34,1339,731,642
2008,Rural,Tamil Nadu,Crime Against Men,Assault,Female,60+,6281,985,5296,3350,2931
2010,Urban,Tripura,Other Crimes,Drug Offense,Male,60+,1231,307,924,843,388
2007,Urban,Delhi,Crime Against Children,Kidnapping,Male,0-12,2865,2562,303,2610,255
2003,Urban,Haryana,Crime Against Women,Rape,Male,31-45,3076,1844,1232,2053,1023
2003,Urban,Tamil Nadu,Other Crimes,Cyber Crime,Male,60+,2745,955,1790,2559,186
2006,Rural,Punjab,Crime Against Children,Child Abuse,Female,0-12,4077,935,3142,2491,1586
2004,Urban,Jharkhand,Other Crimes,Corruption,Male,0-12,5628,1573,4055,2734,2894
2002,Urban,Telangana,Other Crimes,Fraud,Male,18-30,6322,4102,2220,4693,1629
2007,Urban,Gujarat,Property Crime,Arson,Female,46-60,3271,1361,1910,1499,1772
2005,Urban,Manipur,Property Crime,Arson,Female,13-17,3753,2210,1543,2724,1029
2002,Urban,Assam,Crime Against Women,Domestic Violence,Female,60+,1208,831,377,979,229
2004,Urban,Telangana,Crime Against Women,Molestation,Male,13-17,2739,194,2545,1792,947
2004,Urban,Rajasthan,Property Crime,Vandalism,Female,18-30,5054,3702,1352,4095,959
2004,Rural,Delhi,Other Crimes,Fraud,Male,0-12,2135,233,1902,979,1156
2005,Rural,Odisha,Other Crimes,Drug Offense,Male,31-45,699,453,246,560,139
2007,Rural,Maharashtra,Property Crime,Vandalism,Female,31-45,1749,1302,447,1636,113
2008,Urban,Nagaland,Crime Against Women,Rape,Female,0-12,9275,6154,3121,7317,1958
2004,Rural,Uttar Pradesh,Other Crimes,Cyber Crime,Female,46-60,9653,5176,4477,7320,2333
2006,Urban,Haryana,Property Crime,Vandalism,Female,18-30,6239,5064,1175,5798,441
2007,Rural,Assam,Other Crimes,Cyber Crime,Male,18-30,2491,188,2303,503,1988
2007,Urban,West Bengal,Crime Against Women,Dowry Deaths,Female,13-17,2304,701,1603,1798,506
2001,Rural,Telangana,Crime Against Men,Robbery,Male,60+,9141,8377,764,8726,415
2004,Rural,Jharkhand,Property Crime,Arson,Female,13-17,8670,6534,2136,8345,325
2008,Rural,Tripura,Crime Against Children,Child Abuse,Male,13-17,1420,1269,151,1308,112
2006,Rural,Andhra Pradesh,Crime Against Children,Trafficking,Female,13-17,4015,1791,2224,3363,652
2009,Rural,Delhi,Property Crime,Theft,Female,31-45,6093,399,5694,5311,782
2003,Rural,Nagaland,Crime Against Women,Rape,Female,18-30,3329,819,2510,989,2340
2003,Urban,Madhya Pradesh,Crime Against Children,Child Abuse,Female,60+,8511,4663,3848,7741,770
2008,Rural,Gujarat,Property Crime,Arson,Female,0-12,5313,3372,1941,5213,100
2002,Urban,Karnataka,Crime Against Women,Molestation,Male,60+,9779,8821,958,8937,842
2006,Urban,Mizoram,Crime Against Men,Robbery,Female,18-30,4920,199,4721,3403,1517
2008,Urban,Arunachal Pradesh,Property Crime,Arson,Female,46-60,749,205,544,440,309
2004,Urban,Punjab,Property Crime,Burglary,Female,60+,3721,949,2772,2553,1168
2008,Urban,Uttar Pradesh,Crime Against Men,Assault,Female,13-17,1655,1592,63,1597,58
2010,Urban,West Bengal,Crime Against Men,Murder,Male,13-17,2759,2050,709,2447,312
2002,Rural,Himachal Pradesh,Property Crime,Burglary,Female,60+,2803,2690,113,2792,11
2005,Rural,Himachal Pradesh,Property Crime,Vandalism,Male,0-12,9941,6931,3010,7132,2809
2003,Rural,Madhya Pradesh,Crime Against Men,Robbery,Female,60+,6998,6340,658,6418,580
2007,Urban,Gujarat,Crime Against Men,Murder,Female,31-45,8921,2284,6637,7149,1772
2007,Urban,Himachal Pradesh,Crime Against Women,Rape,Male,18-30,6629,95,6534,3874,2755
2001,Urban,Arunachal Pradesh,Other Crimes,Fraud,Male,0-12,3186,1228,1958,1805,1381
2002,Rural,Jharkhand,Crime Against Women,Dowry Deaths,Female,31-45,2028,224,1804,422,1606
2008,Urban,Meghalaya,Crime Against Women,Rape,Female,31-45,5130,1072,4058,1727,3403
2005,Urban,Haryana,Other Crimes,Fraud,Male,0-12,9129,8069,1060,8284,845
2002,Urban,Odisha,Crime Against Men,Robbery,Male,18-30,5889,2467,3422,4474,1415
2004,Rural,Tamil Nadu,Crime Against Men,Assault,Female,0-12,3475,602,2873,1451,2024
2009,Rural,Haryana,Crime Against Women,Dowry Deaths,Male,60+,2005,1978,27,1991,14
2007,Rural,Goa,Crime Against Women,Domestic Violence,Male,60+,9284,4851,4433,5111,4173
2005,Rural,Telangana,Other Crimes,Cyber Crime,Male,0-12,9223,3983,5240,7057,2166
2002,Urban,Haryana,Other Crimes,Drug Offense,Female,13-17,1188,677,511,1158,30
2003,Rural,Uttarakhand,Crime Against Children,Child Labor,Female,31-45,6730,816,5914,5228,1502
2005,Rural,Jharkhand,Property Crime,Burglary,Male,31-45,177,136,41,166,11
2001,Urban,Jammu & Kashmir,Crime Against Men,Murder,Male,0-12,93,9,84,12,81
2007,Rural,Odisha,Property Crime,Burglary,Male,18-30,1580,988,592,1125,455
2002,Rural,Meghalaya,Crime Against Children,Trafficking,Male,46-60,7497,7382,115,7400,97
2008,Rural,Andhra Pradesh,Crime Against Men,Assault,Male,13-17,2889,1423,1466,1772,1117
2005,Urban,Haryana,Property Crime,Vandalism,Male,18-30,2499,1700,799,2219,280
2001,Rural,Bihar,Other Crimes,Drug Offense,Female,0-12,3008,2349,659,2448,560
2006,Rural,Kerala,Crime Against Men,Robbery,Male,18-30,3279,170,3109,2873,406
2010,Rural,Odisha,Crime Against Women,Dowry Deaths,Female,18-30,8191,7046,1145,7150,1041
2006,Urban,Jammu & Kashmir,Other Crimes,Fraud,Male,60+,7444,4009,3435,6627,817
2001,Urban,Meghalaya,Crime Against Women,Domestic Violence,Female,46-60,4599,238,4361,1559,3040
2010,Rural,Punjab,Other Crimes,Fraud,Female,0-12,6086,3954,2132,5034,1052
2006,Urban,Gujarat,Other Crimes,Corruption,Male,13-17,3984,1659,2325,1890,2094
2010,Urban,Goa,Property Crime,Vandalism,Male,46-60,537,278,259,373,164
2009,Urban,Chhattisgarh,Other Crimes,Corruption,Female,46-60,7668,5102,2566,6376,1292
2002,Rural,Bihar,Property Crime,Arson,Male,60+,1727,714,1013,1351,376
2005,Urban,Jharkhand,Crime Against Women,Molestation,Female,46-60,2436,2125,311,2198,238
2007,Urban,Nagaland,Property Crime,Vandalism,Male,31-45,8441,3849,4592,4665,3776
2006,Urban,Mizoram,Other Crimes,Fraud,Female,0-12,1836,1736,100,1807,29
2010,Rural,Haryana,Crime Against Men,Extortion,Male,18-30,9656,8341,1315,9277,379
2006,Rural,Punjab,Crime Against Children,Child Labor,Male,46-60,9470,5543,3927,5567,3903
2006,Urban,Jharkhand,Other Crimes,Corruption,Female,18-30,4458,4181,277,4418,40
2002,Urban,Gujarat,Property Crime,Arson,Female,13-17,1768,398,1370,932,836
2002,Rural,Bihar,Other Crimes,Corruption,Male,18-30,2913,193,2720,2823,90
2004,Rural,Tamil Nadu,Crime Against Children,Child Labor,Male,60+,3989,3597,392,3940,49
2008,Urban,Andhra Pradesh,Other Crimes,Cyber Crime,Female,31-45,7614,1087,6527,3905,3709
2008,Urban,Chhattisgarh,Property Crime,Arson,Male,31-45,888,294,594,525,363
2006,Urban,Manipur,Crime Against Men,Robbery,Male,46-60,8110,7214,896,7966,144
2005,Urban,Uttarakhand,Crime Against Women,Rape,Male,0-12,6162,6008,154,6060,102
2009,Rural,Odisha,Crime Against Men,Assault,Female,18-30,6718,5940,778,6017,701
2010,Rural,Odisha,Crime Against Women,Rape,Female,0-12,8177,5184,2993,6061,2116
2002,Rural,Maharashtra,Crime Against Women,Molestation,Male,46-60,7371,2788,4583,5018,2353
2006,Urban,Odisha,Crime Against Men,Robbery,Female,60+,5909,2861,3048,3024,2885
2002,Urban,Madhya Pradesh,Crime Against Children,Child Abuse,Female,18-30,7115,5537,1578,6855,260
2007,Urban,Andhra Pradesh,Crime Against Children,Trafficking,Male,60+,7715,1692,6023,2890,4825
2001,Urban,Jammu & Kashmir,Crime Against Women,Rape,Male,46-60,9377,2931,6446,5207,4170
2002,Rural,Gujarat,Crime Against Women,Molestation,Female,46-60,2328,1209,1119,1571,757
2004,Urban,Gujarat,Crime Against Men,Murder,Male,0-12,5594,5294,300,5493,101
2002,Urban,Telangana,Crime Against Men,Assault,Female,31-45,4195,287,3908,660,3535
2010,Rural,Jammu & Kashmir,Crime Against Children,Child Abuse,Female,0-12,201,130,71,166,35
2005,Urban,Arunachal Pradesh,Crime Against Women,Rape,Female,13-17,203,98,105,181,22
2001,Rural,Gujarat,Property Crime,Burglary,Female,18-30,5864,1329,4535,3599,2265
2005,Rural,Uttarakhand,Crime Against Children,Kidnapping,Female,60+,1928,777,1151,862,1066
2007,Rural,Jammu & Kashmir,Crime Against Women,Domestic Violence,Male,46-60,3998,1349,2649,3791,207
2001,Rural,Andhra Pradesh,Other Crimes,Drug Offense,Male,31-45,5827,2502,3325,5737,90
2001,Urban,Chhattisgarh,Crime Against Children,Kidnapping,Male,13-17,4256,2559,1697,3759,497
2005,Urban,Haryana,Property Crime,Theft,Male,60+,5885,3511,2374,4543,1342
2002,Urban,Madhya Pradesh,Crime Against Men,Extortion,Male,13-17,6470,1449,5021,3194,3276
2008,Urban,Chhattisgarh,Other Crimes,Drug Offense,Female,60+,4634,3376,1258,3469,1165
2008,Rural,Rajasthan,Crime Against Children,Child Labor,Male,0-12,1674,679,995,1670,4
2010,Rural,Himachal Pradesh,Crime Against Children,Kidnapping,Male,18-30,1945,1627,318,1885,60
2009,Rural,Manipur,Crime Against Women,Domestic Violence,Female,60+,192,148,44,169,23
2002,Rural,Arunachal Pradesh,Property Crime,Burglary,Male,46-60,5359,3406,1953,4800,559
2006,Rural,Tamil Nadu,Crime Against Children,Child Labor,Female,13-17,6215,4469,1746,5157,1058
2009,Rural,Madhya Pradesh,Crime Against Men,Assault,Female,31-45,3612,1210,2402,2512,1100
2001,Urban,Goa,Crime Against Men,Murder,Male,13-17,6576,3572,3004,4981,1595
2003,Rural,Maharashtra,Other Crimes,Corruption,Male,31-45,2243,690,1553,1023,1220
2006,Urban,Jharkhand,Crime Against Women,Domestic Violence,Male,18-30,1511,887,624,1004,507
2001,Rural,Odisha,Crime Against Men,Assault,Female,18-30,7477,5719,1758,6519,958
2008,Urban,Manipur,Other Crimes,Cyber Crime,Female,13-17,4840,4291,549,4677,163
2007,Rural,Jammu & Kashmir,Crime Against Men,Murder,Male,0-12,8097,6825,1272,7648,449
2008,Rural,Kerala,Property Crime,Vandalism,Female,13-17,4592,161,4431,2015,2577
2008,Urban,Nagaland,Property Crime,Burglary,Male,13-17,1198,274,924,508,690
2001,Rural,Meghalaya,Other Crimes,Corruption,Female,13-17,9771,6195,3576,6746,3025
2003,Urban,Goa,Other Crimes,Cyber Crime,Male,46-60,5629,632,4997,3685,1944
2007,Urban,Jharkhand,Property Crime,Vandalism,Male,13-17,1110,951,159,1009,101
2005,Urban,Himachal Pradesh,Property Crime,Burglary,Male,46-60,7995,438,7557,7880,115
2002,Urban,Tamil Nadu,Other Crimes,Drug Offense,Female,18-30,9193,4915,4278,7570,1623
2008,Rural,Andhra Pradesh,Crime Against Children,Child Abuse,Male,46-60,6819,6653,166,6777,42
2010,Rural,Himachal Pradesh,Crime Against Children,Kidnapping,Male,46-60,758,23,735,117,641
2004,Urban,Andhra Pradesh,Crime Against Men,Extortion,Male,46-60,4202,3526,676,4041,161
2005,Urban,Rajasthan,Crime Against Women,Domestic Violence,Female,0-12,562,238,324,548,14
2006,Rural,Punjab,Crime Against Men,Murder,Male,60+,8361,2448,5913,4021,4340
2009,Urban,Kerala,Crime Against Men,Murder,Female,18-30,6757,5063,1694,6418,339
2009,Urban,Himachal Pradesh,Crime Against Men,Assault,Female,18-30,3249,1622,1627,2204,1045
2004,Urban,Nagaland,Crime Against Men,Murder,Female,13-17,412,412,0,412,0
2001,Rural,Tamil Nadu,Crime Against Men,Extortion,Male,60+,6858,3908,2950,5157,1701
2004,Rural,Chhattisgarh,Crime Against Women,Dowry Deaths,Female,18-30,2114,1864,250,2054,60
2009,Urban,Karnataka,Other Crimes,Drug Offense,Male,18-30,7123,6732,391,6799,324
2008,Urban,Goa,Crime Against Men,Robbery,Male,0-12,2635,453,2182,956,1679
2001,Rural,Haryana,Property Crime,Vandalism,Male,31-45,8656,1370,7286,7987,669
2004,Rural,Nagaland,Crime Against Men,Robbery,Female,31-45,1245,1069,176,1214,31
2009,Urban,Telangana,Crime Against Men,Extortion,Male,31-45,363,97,266,352,11
2003,Urban,Tripura,Other Crimes,Corruption,Male,60+,3010,1018,1992,1302,1708
2005,Rural,Mizoram,Crime Against Children,Child Labor,Male,18-30,1937,1728,209,1737,200
2007,Urban,Tripura,Other Crimes,Corruption,Female,0-12,3478,1623,1855,2304,1174
2007,Rural,Goa,Crime Against Children,Child Abuse,Male,31-45,1988,597,1391,1825,163
2006,Rural,Andhra Pradesh,Crime Against Women,Rape,Male,60+,3230,2559,671,2828,402
2003,Rural,Maharashtra,Property Crime,Theft,Female,0-12,2360,1947,413,1986,374
2010,Rural,Meghalaya,Property Crime,Burglary,Male,46-60,9293,41,9252,1433,7860
2006,Urban,Manipur,Crime Against Women,Molestation,Male,31-45,5703,444,5259,3630,2073
2001,Urban,Goa,Other Crimes,Cyber Crime,Female,13-17,1094,1011,83,1041,53
2003,Rural,Goa,Crime Against Children,Trafficking,Female,13-17,5440,4453,987,5430,10
2003,Rural,Uttarakhand,Other Crimes,Corruption,Female,18-30,364,170,194,259,105
2004,Rural,Haryana,Crime Against Women,Dowry Deaths,Male,18-30,4019,653,3366,3652,367
2001,Rural,Nagaland,Crime Against Women,Dowry Deaths,Female,60+,1874,1162,712,1413,461
2006,Urban,Arunachal Pradesh,Other Crimes,Fraud,Male,31-45,7324,1003,6321,4907,2417
2002,Urban,Uttar Pradesh,Other Crimes,Fraud,Male,13-17,8656,2223,6433,3990,4666
2006,Urban,Arunachal Pradesh,Crime Against Men,Assault,Male,46-60,3206,3135,71,3157,49
2004,Urban,Bihar,Crime Against Women,Dowry Deaths,Male,60+,6130,4929,1201,5659,471
2001,Rural,West Bengal,Other Crimes,Drug Offense,Male,13-17,3452,2370,1082,2527,925
2007,Rural,Uttarakhand,Crime Against Men,Murder,Female,0-12,3712,589,3123,2075,1637
2006,Rural,Jharkhand,Crime Against Children,Child Labor,Male,46-60,7651,1052,6599,6939,712
2005,Urban,Assam,Other Crimes,Drug Offense,Male,0-12,7257,6746,511,6837,420
2004,Rural,Meghalaya,Crime Against Women,Domestic Violence,Female,13-17,6738,4958,1780,5287,1451
2002,Urban,Tripura,Crime Against Women,Molestation,Male,60+,1002,895,107,979,23
2003,Rural,Tamil Nadu,Other Crimes,Fraud,Female,13-17,7624,6823,801,7405,219
2010,Urban,Manipur,Crime Against Women,Rape,Female,13-17,8058,5087,2971,6178,1880
2010,Urban,Haryana,Crime Against Children,Trafficking,Male,60+,7406,6561,845,6894,512
2001,Rural,Madhya Pradesh,Crime Against Men,Assault,Female,46-60,1393,17,1376,1246,147
2007,Rural,Maharashtra,Crime Against Men,Murder,Female,13-17,9446,313,9133,2078,7368
2010,Urban,Himachal Pradesh,Crime Against Men,Assault,Male,46-60,7887,7594,293,7744,143
2010,Urban,Goa,Crime Against Women,Domestic Violence,Female,60+,9349,8538,811,8814,535
2002,Rural,Goa,Other Crimes,Fraud,Female,46-60,2903,2803,100,2866,37
2009,Urban,Sikkim,Crime Against Men,Murder,Male,31-45,9579,5203,4376,9484,95
2009,Rural,Delhi,Crime Against Men,Assault,Female,18-30,2556,1661,895,1775,781
2003,Urban,Goa,Other Crimes,Fraud,Male,13-17,2899,2671,228,2755,144
2006,Urban,Nagaland,Crime Against Men,Extortion,Female,13-17,9577,8337,1240,9576,1
2009,Urban,Uttarakhand,Crime Against Women,Dowry Deaths,Male,60+,3777,581,3196,3081,696
2001,Urban,Sikkim,Crime Against Women,Domestic Violence,Female,60+,9081,8764,317,9002,79
2010,Rural,Himachal Pradesh,Other Crimes,Drug Offense,Male,60+,278,157,121,254,24
2008,Rural,Delhi,Other Crimes,Cyber Crime,Female,0-12,3993,638,3355,1083,2910
2002,Urban,Bihar,Crime Against Children,Kidnapping,Female,0-12,4449,2159,2290,3654,795
2002,Urban,Maharashtra,Property Crime,Vandalism,Female,60+,7327,1867,5460,2229,5098
2003,Urban,Assam,Crime Against Children,Trafficking,Male,18-30,1284,789,495,1058,226
2005,Rural,Mizoram,Crime Against Children,Kidnapping,Male,0-12,9927,1681,8246,6921,3006
2004,Urban,Telangana,Other Crimes,Cyber Crime,Male,31-45,2753,1808,945,2524,229
2002,Rural,Rajasthan,Crime Against Men,Murder,Male,60+,9377,3272,6105,8632,745
2005,Rural,Maharashtra,Other Crimes,Drug Offense,Male,0-12,3071,1902,1169,2904,167
2003,Urban,Odisha,Property Crime,Burglary,Male,60+,1078,295,783,557,521
2004,Urban,Rajasthan,Crime Against Men,Murder,Female,0-12,8876,3581,5295,3615,5261
2002,Rural,Himachal Pradesh,Other Crimes,Fraud,Female,18-30,1949,907,1042,1861,88
2005,Rural,Assam,Crime Against Women,Molestation,Male,46-60,2589,2073,516,2332,257
2007,Urban,Maharashtra,Crime Against Children,Child Labor,Female,0-12,423,82,341,420,3
2006,Urban,Sikkim,Crime Against Children,Trafficking,Male,31-45,2441,1458,983,1614,827
2009,Rural,Jharkhand,Crime Against Children,Trafficking,Female,0-12,198,138,60,181,17
2006,Urban,Telangana,Crime Against Women,Domestic Violence,Male,0-12,862,408,454,805,57
2002,Rural,Tripura,Crime Against Children,Kidnapping,Female,31-45,813,531,282,811,2
2009,Urban,Uttar Pradesh,Crime Against Men,Extortion,Female,13-17,5598,2264,3334,3605,1993
2002,Rural,Karnataka,Other Crimes,Cyber Crime,Female,60+,3483,1097,2386,1335,2148
2002,Rural,Maharashtra,Other Crimes,Corruption,Male,60+,3468,921,2547,2772,696
2010,Urban,Telangana,Crime Against Men,Robbery,Female,31-45,5262,1010,4252,4915,347
2002,Rural,Uttarakhand,Crime Against Children,Kidnapping,Male,0-12,472,179,293,331,141
2009,Rural,Gujarat,Property Crime,Vandalism,Female,46-60,4364,210,4154,3601,763
2010,Rural,Telangana,Property Crime,Theft,Male,13-17,6696,2325,4371,3840,2856
2010,Urban,Odisha,Crime Against Women,Molestation,Female,18-30,9616,7979,1637,9110,506
2009,Urban,Sikkim,Other Crimes,Corruption,Male,13-17,8089,2183,5906,7199,890
2010,Urban,Jharkhand,Other Crimes,Corruption,Male,60+,9083,2151,6932,7766,1317
2008,Urban,Assam,Other Crimes,Fraud,Female,0-12,425,129,296,246,179
2005,Rural,Arunachal Pradesh,Crime Against Men,Assault,Female,13-17,5539,3782,1757,4297,1242
2007,Urban,Jammu & Kashmir,Crime Against Men,Extortion,Female,31-45,132,86,46,128,4
2007,Urban,Telangana,Other Crimes,Drug Offense,Male,31-45,7777,5004,2773,7035,742
2006,Urban,Punjab,Crime Against Men,Assault,Male,46-60,180,97,83,173,7
2003,Rural,Karnataka,Other Crimes,Drug Offense,Female,0-12,2152,1120,1032,1389,763
2002,Rural,Tamil Nadu,Crime Against Children,Kidnapping,Male,13-17,5671,5231,440,5445,226
2006,Rural,Sikkim,Crime Against Women,Molestation,Female,13-17,3165,1859,1306,2587,578
2006,Urban,Uttar Pradesh,Crime Against Children,Child Labor,Female,31-45,5750,2581,3169,3680,2070
2002,Rural,Rajasthan,Other Crimes,Fraud,Female,18-30,8455,4663,3792,5492,2963
2003,Urban,Mizoram,Crime Against Men,Robbery,Male,18-30,3174,1967,1207,2202,972
2003,Urban,Himachal Pradesh,Crime Against Children,Kidnapping,Male,31-45,337,235,102,291,46
2010,Urban,Chhattisgarh,Other Crimes,Corruption,Female,13-17,3206,2549,657,3033,173
2006,Urban,Karnataka,Property Crime,Theft,Female,0-12,5793,648,5145,3611,2182
2009,Urban,Sikkim,Property Crime,Theft,Male,13-17,5228,4344,884,4701,527
2004,Rural,Rajasthan,Crime Against Children,Trafficking,Male,46-60,2123,1290,833,1379,744
2009,Rural,Assam,Other Crimes,Corruption,Male,60+,65,0,65,27,38
2005,Rural,Manipur,Other Crimes,Drug Offense,Female,31-45,1744,1095,649,1511,233
2003,Urban,Himachal Pradesh,Crime Against Women,Domestic Violence,Female,18-30,9918,8727,1191,9469,449
2008,Urban,Himachal Pradesh,Property Crime,Burglary,Female,18-30,9643,975,8668,6204,3439
2004,Rural,Gujarat,Crime Against Women,Dowry Deaths,Male,60+,2552,1267,1285,2098,454
2007,Rural,Telangana,Other Crimes,Fraud,Female,31-45,2946,1534,1412,2731,215
2009,Urban,Uttarakhand,Crime Against Women,Dowry Deaths,Male,46-60,7745,6638,1107,6783,962
2005,Rural,Mizoram,Crime Against Children,Child Labor,Male,60+,5714,3326,2388,3441,2273
2007,Rural,Uttarakhand,Crime Against Men,Robbery,Male,46-60,4252,3194,1058,3259,993
2006,Urban,West Bengal,Crime Against Women,Domestic Violence,Female,13-17,734,413,321,513,221
2009,Urban,Madhya Pradesh,Crime Against Women,Rape,Male,60+,8198,6971,1227,7199,999
2009,Rural,Jammu & Kashmir,Crime Against Women,Molestation,Male,60+,1939,174,1765,1051,888
2006,Rural,Himachal Pradesh,Crime Against Men,Murder,Female,46-60,7921,2356,5565,6821,1100
2003,Rural,Telangana,Other Crimes,Fraud,Male,0-12,1868,1450,418,1619,249
2008,Urban,Uttar Pradesh,Crime Against Men,Assault,Male,0-12,9799,480,9319,8475,1324
2003,Urban,Tripura,Crime Against Children,Child Abuse,Male,13-17,6028,2093,3935,5074,954
2005,Rural,Maharashtra,Crime Against Women,Domestic Violence,Female,31-45,3926,1398,2528,3075,851
2006,Urban,Arunachal Pradesh,Crime Against Women,Rape,Male,31-45,2061,2004,57,2045,16
2010,Urban,West Bengal,Crime Against Children,Kidnapping,Female,46-60,8990,8454,536,8585,405
2003,Urban,Assam,Crime Against Men,Murder,Male,13-17,3610,36,3574,1824,1786
2003,Urban,Nagaland,Property Crime,Arson,Female,13-17,3421,165,3256,3323,98
2006,Urban,Jammu & Kashmir,Crime Against Children,Kidnapping,Female,13-17,1688,490,1198,631,1057
2008,Urban,Telangana,Crime Against Children,Trafficking,Male,13-17,4144,1065,3079,3752,392
2001,Urban,Chhattisgarh,Property Crime,Burglary,Male,46-60,7208,621,6587,6726,482
2008,Urban,Haryana,Property Crime,Arson,Female,60+,2064,1415,649,1802,262
2006,Rural,Jharkhand,Crime Against Children,Child Abuse,Female,18-30,7306,4363,2943,6402,904
2007,Rural,Chhattisgarh,Crime Against Women,Domestic Violence,Male,13-17,9103,3860,5243,6397,2706
2002,Urban,Mizoram,Crime Against Children,Child Abuse,Female,0-12,1245,538,707,624,621
2006,Urban,Gujarat,Property Crime,Theft,Male,18-30,2824,661,2163,2331,493
2008,Urban,Uttarakhand,Crime Against Men,Murder,Male,31-45,3104,1186,1918,3093,11
2002,Urban,West Bengal,Crime Against Children,Trafficking,Female,46-60,2889,545,2344,1434,1455
2004,Rural,Telangana,Crime Against Women,Rape,Female,18-30,4979,2548,2431,2605,2374
2002,Rural,Uttar Pradesh,Crime Against Women,Rape,Female,60+,9507,1545,7962,8833,674
2007,Rural,Sikkim,Property Crime,Burglary,Female,46-60,3361,1075,2286,1351,2010
2007,Urban,Goa,Crime Against Children,Child Labor,Male,0-12,1490,995,495,1318,172
2006,Urban,Punjab,Crime Against Children,Child Labor,Female,31-45,5364,97,5267,1633,3731
2007,Urban,Tamil Nadu,Crime Against Women,Rape,Male,13-17,3249,1231,2018,1259,1990
2005,Rural,Jharkhand,Crime Against Children,Child Labor,Female,18-30,1504,1336,168,1479,25
2008,Rural,Chhattisgarh,Crime Against Children,Kidnapping,Male,60+,2364,2110,254,2260,104
2004,Rural,West Bengal,Crime Against Children,Child Abuse,Female,60+,7995,2511,5484,3427,4568
2004,Rural,Himachal Pradesh,Crime Against Children,Child Labor,Female,18-30,4729,2870,1859,4274,455
2007,Rural,Uttarakhand,Crime Against Men,Extortion,Female,46-60,5264,3275,1989,3658,1606
2003,Urban,Assam,Crime Against Children,Kidnapping,Female,46-60,2681,1998,683,2642,39
2001,Urban,Madhya Pradesh,Other Crimes,Fraud,Male,18-30,4239,3420,819,3899,340
2004,Rural,Maharashtra,Crime Against Men,Murder,Female,0-12,4350,2637,1713,3183,1167
2004,Rural,Maharashtra,Property Crime,Burglary,Male,13-17,2511,485,2026,2035,476
2002,Urban,Odisha,Other Crimes,Cyber Crime,Female,31-45,62,61,1,62,0
2001,Urban,Jammu & Kashmir,Other Crimes,Corruption,Male,0-12,9496,1222,8274,8997,499
2001,Rural,Jharkhand,Property Crime,Arson,Male,60+,801,367,434,507,294
2003,Rural,Madhya Pradesh,Crime Against Children,Child Abuse,Female,13-17,7503,5215,2288,6795,708
2009,Rural,Assam,Crime Against Men,Extortion,Female,13-17,7951,1038,6913,3157,4794
2010,Rural,Chhattisgarh,Property Crime,Theft,Female,0-12,5957,1545,4412,5117,840
2009,Urban,Himachal Pradesh,Crime Against Children,Child Labor,Female,46-60,6731,6070,661,6145,586
2010,Rural,Madhya Pradesh,Crime Against Men,Robbery,Male,31-45,7410,2115,5295,5408,2002
2010,Urban,Tamil Nadu,Property Crime,Burglary,Male,13-17,291,4,287,71,220
2003,Urban,West Bengal,Crime Against Men,Murder,Male,60+,8922,6056,2866,6527,2395
2006,Urban,Telangana,Other Crimes,Drug Offense,Male,46-60,1973,1613,360,1655,318
2004,Urban,Maharashtra,Crime Against Men,Extortion,Male,0-12,4138,3173,965,3766,372
2009,Urban,Maharashtra,Property Crime,Vandalism,Female,60+,4200,1249,2951,2178,2022
2005,Rural,Jammu & Kashmir,Crime Against Children,Child Abuse,Male,60+,371,2,369,333,38
2005,Urban,Sikkim,Crime Against Children,Child Abuse,Male,46-60,3478,3205,273,3375,103
2010,Rural,Uttarakhand,Crime Against Children,Child Abuse,Male,31-45,4655,2202,2453,4640,15
2003,Urban,Sikkim,Crime Against Men,Murder,Female,0-12,7026,2059,4967,3430,3596
2004,Urban,Gujarat,Other Crimes,Corruption,Female,13-17,3414,2898,516,2915,499
2008,Rural,Arunachal Pradesh,Crime Against Men,Extortion,Male,18-30,1311,111,1200,572,739
2003,Rural,Mizoram,Crime Against Men,Robbery,Female,60+,6224,1730,4494,3289,2935
2002,Urban,Goa,Other Crimes,Drug Offense,Female,0-12,5510,877,4633,4813,697
2009,Rural,Tripura,Crime Against Men,Extortion,Female,0-12,1717,1063,654,1214,503
2008,Urban,Odisha,Property Crime,Theft,Male,0-12,7289,4094,3195,6781,508
2006,Urban,Uttarakhand,Property Crime,Burglary,Female,60+,6415,3603,2812,5815,600
2009,Rural,Andhra Pradesh,Crime Against Men,Murder,Female,18-30,8676,5636,3040,6983,1693
2005,Urban,Haryana,Property Crime,Theft,Male,46-60,629,131,498,620,9
2010,Urban,Andhra Pradesh,Crime Against Men,Extortion,Female,60+,3347,2866,481,2938,409
2010,Urban,Madhya Pradesh,Crime Against Men,Extortion,Female,46-60,331,203,128,321,10
2008,Urban,West Bengal,Crime Against Men,Assault,Male,31-45,258,258,0,258,0
2005,Urban,Punjab,Property Crime,Arson,Male,18-30,2105,1688,417,1982,123
2007,Urban,Jharkhand,Crime Against Women,Rape,Male,13-17,1087,631,456,887,200
2005,Urban,Himachal Pradesh,Crime Against Children,Child Labor,Female,31-45,9991,1883,8108,5353,4638
2009,Urban,Delhi,Property Crime,Vandalism,Male,60+,5191,2487,2704,2887,2304
2007,Urban,Sikkim,Crime Against Children,Kidnapping,Male,31-45,712,260,452,580,132
2010,Urban,Meghalaya,Other Crimes,Fraud,Female,0-12,3212,2007,1205,2275,937
2002,Rural,Arunachal Pradesh,Crime Against Women,Dowry Deaths,Male,46-60,6195,1446,4749,1623,4572
2003,Urban,Goa,Crime Against Women,Dowry Deaths,Male,18-30,3476,849,2627,2237,1239
2004,Urban,Karnataka,Other Crimes,Fraud,Female,18-30,5350,4522,828,4939,411
2005,Rural,Uttarakhand,Crime Against Women,Molestation,Male,0-12,2880,1426,1454,2131,749
2001,Rural,Haryana,Other Crimes,Fraud,Female,60+,6062,1306,4756,5165,897
2006,Urban,Haryana,Property Crime,Theft,Male,31-45,6420,961,5459,3337,3083
2006,Urban,Madhya Pradesh,Crime Against Men,Murder,Male,0-12,9494,2100,7394,6586,2908
2004,Urban,Chhattisgarh,Other Crimes,Corruption,Female,0-12,6602,1531,5071,4745,1857
2008,Rural,Uttarakhand,Crime Against Children,Kidnapping,Female,0-12,1873,1081,792,1249,624
2006,Rural,Telangana,Crime Against Children,Child Labor,Female,13-17,7783,5343,2440,5737,2046
2001,Rural,Uttarakhand,Crime Against Women,Domestic Violence,Male,60+,1734,1477,257,1521,213
2009,Urban,Meghalaya,Crime Against Men,Extortion,Female,18-30,5269,5058,211,5180,89
2005,Urban,Tamil Nadu,Property Crime,Arson,Male,31-45,2467,141,2326,2124,343
2008,Rural,Mizoram,Other Crimes,Drug Offense,Female,31-45,7050,5330,1720,6985,65
2007,Rural,Tamil Nadu,Crime Against Women,Domestic Violence,Female,31-45,5771,4279,1492,4882,889
2002,Urban,Manipur,Property Crime,Burglary,Female,31-45,7240,3396,3844,5927,1313
2009,Rural,Odisha,Property Crime,Arson,Female,46-60,7773,5400,2373,6150,1623
2010,Rural,Nagaland,Crime Against Women,Domestic Violence,Female,46-60,7768,5390,2378,6694,1074
2009,Urban,Punjab,Other Crimes,Corruption,Male,31-45,2684,740,1944,2579,105
2002,Urban,Bihar,Crime Against Men,Extortion,Female,46-60,3375,2791,584,3187,188
2003,Rural,Haryana,Property Crime,Theft,Female,60+,6024,5587,437,5864,160
2005,Urban,Punjab,Crime Against Men,Extortion,Male,46-60,5937,809,5128,5857,80
2004,Rural,Arunachal Pradesh,Crime Against Women,Molestation,Male,31-45,7864,5934,1930,7368,496
2006,Urban,Delhi,Crime Against Men,Extortion,Female,60+,6229,4164,2065,5685,544
2008,Urban,Kerala,Crime Against Women,Rape,Female,0-12,2259,1621,638,1676,583
2006,Rural,Karnataka,Crime Against Children,Trafficking,Female,0-12,4783,3568,1215,4003,780
2009,Urban,Telangana,Crime Against Children,Kidnapping,Male,46-60,6057,2088,3969,5471,586
2004,Urban,Bihar,Other Crimes,Fraud,Female,13-17,3598,2390,1208,3598,0
2008,Rural,Assam,Crime Against Men,Robbery,Female,31-45,2095,874,1221,1504,591
2008,Urban,Arunachal Pradesh,Other Crimes,Corruption,Female,18-30,426,86,340,262,164
2010,Urban,Nagaland,Crime Against Women,Molestation,Male,0-12,3812,145,3667,2474,1338
2001,Urban,Sikkim,Other Crimes,Drug Offense,Female,46-60,4620,3542,1078,3900,720
2007,Rural,Madhya Pradesh,Crime Against Men,Extortion,Female,18-30,5160,3923,1237,5108,52
2001,Rural,Sikkim,Crime Against Men,Robbery,Male,31-45,7028,508,6520,5554,1474
2005,Rural,Delhi,Property Crime,Burglary,Male,0-12,878,841,37,847,31
2009,Urban,Gujarat,Property Crime,Arson,Female,18-30,9646,1730,7916,5928,3718
2010,Rural,Chhattisgarh,Crime Against Men,Extortion,Female,60+,9966,7922,2044,9448,518
2003,Urban,Goa,Property Crime,Theft,Male,60+,56,6,50,29,27
2008,Urban,Assam,Other Crimes,Cyber Crime,Male,60+,2934,2775,159,2899,35
2007,Rural,Delhi,Property Crime,Vandalism,Female,0-12,4688,3077,1611,3811,877
2003,Rural,Delhi,Crime Against Women,Dowry Deaths,Female,13-17,159,84,75,153,6
2010,Urban,Uttarakhand,Property Crime,Arson,Male,46-60,689,450,239,655,34
2006,Urban,Haryana,Crime Against Men,Assault,Female,18-30,9402,3021,6381,4700,4702
2001,Urban,Delhi,Crime Against Women,Rape,Female,13-17,4949,4336,613,4410,539
2007,Rural,Nagaland,Other Crimes,Fraud,Male,46-60,8891,2678,6213,5218,3673
2007,Rural,Chhattisgarh,Crime Against Men,Murder,Male,46-60,8249,1164,7085,2903,5346
2003,Rural,Jammu & Kashmir,Crime Against Men,Extortion,Male,13-17,6849,5869,980,6743,106
2003,Urban,Chhattisgarh,Crime Against Men,Murder,Female,18-30,9033,8274,759,8681,352
2003,Rural,Rajasthan,Crime Against Men,Extortion,Female,18-30,1897,691,1206,746,1151
2004,Rural,Himachal Pradesh,Crime Against Children,Kidnapping,Female,18-30,4360,2147,2213,2255,2105
2010,Urban,Nagaland,Other Crimes,Cyber Crime,Male,18-30,8884,1900,6984,5570,3314
2001,Rural,Madhya Pradesh,Property Crime,Theft,Female,31-45,6610,6044,566,6068,542
2007,Urban,Uttarakhand,Crime Against Women,Rape,Male,18-30,4091,1645,2446,2882,1209
2005,Urban,Goa,Crime Against Men,Robbery,Female,0-12,1236,313,923,599,637
2009,Urban,Tripura,Crime Against Men,Extortion,Female,60+,7508,5025,2483,5694,1814
2007,Rural,Himachal Pradesh,Crime Against Women,Rape,Male,46-60,9109,14,9095,8160,949
2008,Rural,Chhattisgarh,Crime Against Men,Robbery,Female,46-60,6640,2723,3917,3388,3252
2005,Urban,Uttarakhand,Crime Against Men,Murder,Male,13-17,610,443,167,601,9
2004,Urban,Andhra Pradesh,Crime Against Women,Rape,Female,60+,3002,1099,1903,2576,426
2002,Urban,Meghalaya,Crime Against Women,Dowry Deaths,Female,60+,880,809,71,834,46
2005,Rural,Kerala,Crime Against Children,Child Abuse,Male,13-17,8026,5208,2818,7792,234
2004,Urban,Himachal Pradesh,Crime Against Children,Trafficking,Male,31-45,2705,2448,257,2669,36
2008,Rural,Gujarat,Crime Against Men,Assault,Female,31-45,5980,4558,1422,4887,1093
2008,Rural,Karnataka,Crime Against Women,Molestation,Female,0-12,4286,4187,99,4215,71
2004,Urban,Himachal Pradesh,Property Crime,Vandalism,Male,13-17,8559,7241,1318,8077,482
2002,Urban,Uttarakhand,Other Crimes,Fraud,Male,0-12,3306,640,2666,2617,689
2001,Rural,Assam,Crime Against Women,Rape,Male,31-45,7646,801,6845,1893,5753
2004,Rural,Uttar Pradesh,Property Crime,Vandalism,Female,46-60,7310,1684,5626,6985,325
2005,Urban,Nagaland,Crime Against Children,Child Abuse,Male,46-60,174,110,64,172,2
2003,Rural,Karnataka,Crime Against Men,Assault,Male,60+,2536,1750,786,2362,174
2005,Rural,Arunachal Pradesh,Crime Against Women,Rape,Female,60+,2188,1355,833,1516,672
2008,Urban,Punjab,Crime Against Women,Domestic Violence,Female,0-12,5170,695,4475,1494,3676
2003,Rural,Goa,Crime Against Children,Child Labor,Female,31-45,4242,184,4058,1613,2629
2008,Rural,Rajasthan,Crime Against Men,Robbery,Male,31-45,3089,1610,1479,2925,164
2008,Rural,Telangana,Property Crime,Burglary,Female,60+,100,23,77,26,74
2004,Urban,Haryana,Crime Against Women,Domestic Violence,Female,31-45,1396,1373,23,1374,22
2007,Rural,Delhi,Property Crime,Arson,Male,46-60,6591,3341,3250,3522,3069
2008,Urban,Meghalaya,Crime Against Women,Dowry Deaths,Female,31-45,6254,3471,2783,5427,827
2006,Rural,Rajasthan,Property Crime,Arson,Female,18-30,3315,1977,1338,2761,554
2005,Urban,Meghalaya,Property Crime,Vandalism,Female,13-17,9858,9621,237,9836,22
2009,Urban,Delhi,Crime Against Men,Extortion,Female,60+,8842,8148,694,8757,85
2004,Rural,Karnataka,Other Crimes,Cyber Crime,Female,46-60,6243,1191,5052,3756,2487
2002,Urban,Manipur,Crime Against Men,Murder,Male,60+,6929,4966,1963,6126,803
2010,Urban,Odisha,Other Crimes,Drug Offense,Female,13-17,3883,442,3441,1434,2449
2001,Urban,Sikkim,Crime Against Men,Extortion,Female,0-12,6531,4745,1786,6189,342
2007,Rural,Uttar Pradesh,Other Crimes,Fraud,Male,0-12,8205,6454,1751,6945,1260
2005,Urban,Jharkhand,Crime Against Children,Trafficking,Female,0-12,2337,2234,103,2259,78
2003,Urban,Haryana,Crime Against Women,Domestic Violence,Female,13-17,1684,1304,380,1480,204
2003,Urban,Jammu & Kashmir,Property Crime,Theft,Male,46-60,9920,6782,3138,8850,1070
2008,Rural,Tamil Nadu,Crime Against Women,Rape,Female,60+,3630,2890,740,3278,352
2002,Rural,Uttarakhand,Crime Against Men,Assault,Female,13-17,8472,5880,2592,7756,716
2002,Urban,Mizoram,Other Crimes,Fraud,Male,13-17,6565,6261,304,6529,36
2010,Urban,Uttar Pradesh,Property Crime,Vandalism,Male,60+,8339,8232,107,8286,53
2002,Rural,Assam,Crime Against Children,Trafficking,Male,60+,6715,5592,1123,6155,560
2007,Urban,Himachal Pradesh,Property Crime,Theft,Female,60+,5869,1313,4556,2310,3559
2010,Rural,Arunachal Pradesh,Crime Against Men,Murder,Female,0-12,6997,4936,2061,6142,855
2009,Rural,Manipur,Crime Against Children,Kidnapping,Male,18-30,6786,5340,1446,5556,1230
2002,Urban,Delhi,Crime Against Men,Robbery,Male,13-17,347,59,288,95,252
2008,Rural,Uttarakhand,Crime Against Children,Child Labor,Female,46-60,9141,215,8926,4438,4703
2010,Urban,Tripura,Other Crimes,Fraud,Female,13-17,3940,3822,118,3857,83
2005,Urban,Punjab,Crime Against Women,Molestation,Female,46-60,7377,1510,5867,3576,3801
2001,Rural,Rajasthan,Crime Against Men,Extortion,Male,0-12,9747,5026,4721,6520,3227
2007,Rural,Meghalaya,Crime Against Men,Assault,Male,60+,9511,2689,6822,6382,3129
2010,Rural,Arunachal Pradesh,Crime Against Men,Murder,Female,0-12,7597,6963,634,6967,630
2008,Urban,Maharashtra,Property Crime,Theft,Female,46-60,1384,73,1311,880,504
2010,Urban,Uttar Pradesh,Crime Against Men,Robbery,Male,0-12,2010,1831,179,1950,60
2004,Urban,Gujarat,Other Crimes,Corruption,Male,60+,1876,311,1565,1732,144
2004,Urban,Rajasthan,Property Crime,Vandalism,Male,60+,4214,3320,894,3866,348
2008,Rural,Rajasthan,Crime Against Children,Kidnapping,Female,18-30,4236,3123,1113,3488,748
2004,Urban,Tripura,Crime Against Men,Assault,Female,31-45,9351,4292,5059,7992,1359
2007,Urban,Odisha,Crime Against Men,Assault,Female,60+,9289,3935,5354,7517,1772
2005,Urban,Delhi,Crime Against Men,Assault,Female,18-30,4921,4814,107,4837,84
2004,Rural,Arunachal Pradesh,Other Crimes,Cyber Crime,Female,18-30,7647,6919,728,7247,400
2007,Urban,Goa,Crime Against Children,Trafficking,Male,18-30,9369,4932,4437,7347,2022
2004,Urban,Assam,Other Crimes,Cyber Crime,Male,31-45,2765,1131,1634,2653,112
2010,Urban,Telangana,Other Crimes,Cyber Crime,Male,13-17,6378,4076,2302,4723,1655
2005,Rural,Haryana,Property Crime,Burglary,Female,13-17,5877,3110,2767,3286,2591
2002,Rural,Assam,Crime Against Women,Domestic Violence,Female,46-60,1078,509,569,798,280
2010,Urban,Jammu & Kashmir,Property Crime,Arson,Male,0-12,3966,1921,2045,3479,487
2008,Rural,Andhra Pradesh,Crime Against Men,Robbery,Female,31-45,993,269,724,557,436
2010,Urban,Odisha,Crime Against Women,Molestation,Male,31-45,364,251,113,260,104
2007,Urban,Bihar,Crime Against Women,Molestation,Male,0-12,4725,3456,1269,3559,1166
2009,Rural,Tamil Nadu,Crime Against Women,Molestation,Male,0-12,8858,125,8733,146,8712
2008,Rural,Kerala,Crime Against Women,Domestic Violence,Male,46-60,212,27,185,134,78
2002,Urban,Meghalaya,Crime Against Men,Murder,Female,13-17,1262,311,951,1091,171
2002,Rural,Mizoram,Crime Against Men,Assault,Female,60+,3358,469,2889,2972,386
2003,Urban,Kerala,Crime Against Children,Child Abuse,Male,0-12,4601,1700,2901,3489,1112
2010,Rural,Jammu & Kashmir,Property Crime,Theft,Female,31-45,412,316,96,357,55
2008,Rural,Karnataka,Other Crimes,Corruption,Male,0-12,3148,3132,16,3141,7
2010,Urban,Haryana,Other Crimes,Fraud,Female,31-45,7569,7278,291,7324,245
2009,Urban,Delhi,Other Crimes,Fraud,Female,0-12,2411,130,2281,2278,133
2009,Rural,Jammu & Kashmir,Other Crimes,Fraud,Male,31-45,3766,2444,1322,3198,568
2010,Rural,Karnataka,Property Crime,Burglary,Male,13-17,6137,678,5459,2091,4046
2010,Urban,Karnataka,Crime Against Children,Trafficking,Male,46-60,896,388,508,806,90
2002,Rural,Jammu & Kashmir,Crime Against Men,Robbery,Male,46-60,5471,1021,4450,3732,1739
2008,Rural,Uttarakhand,Other Crimes,Fraud,Female,60+,1772,475,1297,1375,397
2008,Rural,Jammu & Kashmir,Crime Against Children,Child Labor,Male,18-30,9666,2385,7281,4886,4780
2001,Rural,Chhattisgarh,Crime Against Women,Domestic Violence,Male,13-17,8759,3903,4856,4862,3897
2006,Urban,Himachal Pradesh,Crime Against Men,Robbery,Male,60+,7572,7221,351,7278,294
2004,Urban,Himachal Pradesh,Crime Against Children,Kidnapping,Female,31-45,8834,3655,5179,7901,933
2002,Urban,Haryana,Crime Against Women,Dowry Deaths,Female,60+,6554,2052,4502,4367,2187
2001,Urban,Nagaland,Property Crime,Theft,Female,60+,9116,6345,2771,7327,1789
2008,Rural,Sikkim,Crime Against Children,Trafficking,Female,31-45,1974,438,1536,652,1322
2006,Rural,Uttar Pradesh,Property Crime,Burglary,Male,0-12,5288,514,4774,1243,4045
2002,Urban,Chhattisgarh,Crime Against Children,Kidnapping,Female,13-17,5826,437,5389,4580,1246
2010,Rural,Meghalaya,Property Crime,Theft,Female,60+,7153,1785,5368,5354,1799
2001,Rural,Madhya Pradesh,Property Crime,Vandalism,Female,13-17,7744,1965,5779,3086,4658
2003,Rural,Bihar,Crime Against Men,Robbery,Female,0-12,7654,2282,5372,3666,3988
2002,Urban,Delhi,Crime Against Children,Child Labor,Male,13-17,6667,6313,354,6612,55
2004,Urban,Rajasthan,Crime Against Men,Extortion,Female,13-17,968,719,249,885,83
2007,Rural,Chhattisgarh,Other Crimes,Fraud,Female,60+,7980,367,7613,2956,5024
2009,Rural,Jammu & Kashmir,Other Crimes,Cyber Crime,Female,31-45,7375,2212,5163,7149,226
2006,Rural,Sikkim,Crime Against Men,Robbery,Male,60+,7581,5449,2132,6993,588
2001,Urban,Bihar,Crime Against Men,Extortion,Male,31-45,4189,620,3569,2486,1703
2001,Urban,Andhra Pradesh,Property Crime,Arson,Female,13-17,1593,1330,263,1583,10
2007,Rural,Rajasthan,Crime Against Men,Assault,Male,60+,2155,198,1957,535,1620
2008,Urban,Chhattisgarh,Crime Against Children,Child Abuse,Male,18-30,7061,5807,1254,6252,809
2002,Urban,Himachal Pradesh,Crime Against Men,Extortion,Female,31-45,3037,495,2542,1541,1496
2005,Urban,Himachal Pradesh,Crime Against Children,Child Labor,Female,18-30,545,143,402,315,230
2008,Urban,Haryana,Crime Against Children,Trafficking,Female,60+,5320,3654,1666,4656,664
2001,Rural,Mizoram,Crime Against Children,Child Abuse,Female,18-30,482,323,159,470,12
2005,Rural,Mizoram,Other Crimes,Drug Offense,Female,60+,6648,245,6403,3909,2739
2002,Rural,West Bengal,Property Crime,Arson,Male,18-30,8861,5670,3191,8384,477
2001,Urban,Bihar,Crime Against Children,Kidnapping,Male,0-12,8721,1142,7579,1172,7549
2005,Rural,Telangana,Other Crimes,Drug Offense,Female,60+,504,479,25,500,4
2003,Urban,Tamil Nadu,Crime Against Men,Murder,Female,31-45,2693,131,2562,2014,679
2002,Urban,Jharkhand,Property Crime,Arson,Male,31-45,6541,1067,5474,4538,2003
2006,Rural,Jharkhand,Crime Against Children,Trafficking,Male,0-12,9096,3104,5992,6083,3013
2002,Urban,Rajasthan,Other Crimes,Fraud,Female,18-30,4993,3490,1503,3490,1503
2002,Rural,Rajasthan,Property Crime,Arson,Female,0-12,2751,2477,274,2746,5
2008,Rural,Mizoram,Crime Against Men,Assault,Male,18-30,4408,2422,1986,3875,533
2009,Rural,Telangana,Crime Against Men,Murder,Male,0-12,611,497,114,604,7
2001,Urban,West Bengal,Crime Against Men,Murder,Female,60+,7759,5853,1906,5918,1841
2001,Rural,Madhya Pradesh,Crime Against Men,Extortion,Female,60+,8912,12,8900,1901,7011
2001,Rural,Nagaland,Crime Against Men,Murder,Female,18-30,9990,1589,8401,2417,7573
2007,Rural,Rajasthan,Property Crime,Arson,Male,18-30,7776,1403,6373,4803,2973
2003,Rural,Chhattisgarh,Crime Against Children,Child Abuse,Male,13-17,8031,2050,5981,4196,3835
2004,Rural,Sikkim,Other Crimes,Drug Offense,Male,13-17,9011,1925,7086,5029,3982
2002,Urban,Odisha,Crime Against Women,Rape,Male,46-60,4506,3880,626,4409,97
2008,Urban,Mizoram,Crime Against Children,Trafficking,Female,0-12,6353,3705,2648,5802,551
2006,Rural,Tamil Nadu,Property Crime,Arson,Female,46-60,1078,185,893,404,674
2010,Urban,Chhattisgarh,Other Crimes,Drug Offense,Female,60+,9528,8581,947,9459,69
2001,Urban,Chhattisgarh,Crime Against Men,Robbery,Female,0-12,8960,5,8955,6334,2626
2008,Urban,Andhra Pradesh,Crime Against Women,Dowry Deaths,Female,31-45,8900,8214,686,8818,82
2004,Urban,West Bengal,Property Crime,Burglary,Male,31-45,6633,3342,3291,3793,2840
2010,Rural,Arunachal Pradesh,Crime Against Men,Murder,Male,0-12,3454,727,2727,1301,2153
2001,Rural,Uttarakhand,Crime Against Men,Murder,Male,60+,4944,4136,808,4194,750
2002,Urban,Haryana,Other Crimes,Drug Offense,Male,13-17,5042,1273,3769,1576,3466
2005,Rural,Gujarat,Crime Against Children,Kidnapping,Female,13-17,8343,7630,713,8066,277
2005,Rural,West Bengal,Crime Against Women,Domestic Violence,Female,13-17,8412,7863,549,8040,372
2002,Rural,West Bengal,Other Crimes,Corruption,Female,60+,6634,5944,690,6309,325
2009,Rural,Tripura,Other Crimes,Cyber Crime,Male,31-45,8666,62,8604,6241,2425
2005,Urban,Haryana,Crime Against Women,Dowry Deaths,Male,60+,6152,1548,4604,2406,3746
2001,Urban,Goa,Other Crimes,Corruption,Female,31-45,352,101,251,338,14
2004,Urban,Kerala,Crime Against Women,Rape,Male,18-30,3078,812,2266,1345,1733
2005,Rural,Bihar,Property Crime,Burglary,Female,60+,4761,2414,2347,3496,1265
2003,Urban,Nagaland,Crime Against Children,Kidnapping,Female,0-12,7879,1268,6611,4804,3075
2002,Urban,Uttarakhand,Property Crime,Vandalism,Male,46-60,9993,3138,6855,4112,5881
2010,Urban,Haryana,Crime Against Women,Domestic Violence,Female,0-12,7484,3495,3989,6665,819
2008,Urban,Mizoram,Property Crime,Vandalism,Male,46-60,3634,967,2667,976,2658
2006,Urban,Tamil Nadu,Property Crime,Theft,Female,60+,4474,2002,2472,2958,1516
2010,Rural,Arunachal Pradesh,Other Crimes,Drug Offense,Female,13-17,4069,327,3742,3780,289
2008,Urban,Rajasthan,Crime Against Children,Trafficking,Female,46-60,9992,573,9419,624,9368
2004,Rural,Rajasthan,Other Crimes,Drug Offense,Female,31-45,966,846,120,924,42
2005,Urban,Haryana,Crime Against Women,Dowry Deaths,Male,18-30,4106,55,4051,2963,1143
2009,Rural,Andhra Pradesh,Crime Against Men,Murder,Male,0-12,9237,7218,2019,7851,1386
2002,Rural,Sikkim,Property Crime,Theft,Female,18-30,5744,44,5700,320,5424
2008,Urban,Tamil Nadu,Crime Against Children,Kidnapping,Male,60+,4294,1657,2637,3918,376
2001,Urban,Haryana,Crime Against Men,Assault,Female,18-30,1976,1131,845,1153,823
2003,Rural,Tamil Nadu,Property Crime,Theft,Male,18-30,9500,4212,5288,4854,4646
2010,Urban,Mizoram,Other Crimes,Cyber Crime,Female,0-12,9500,4287,5213,6557,2943
2009,Urban,Madhya Pradesh,Crime Against Men,Assault,Female,60+,4879,2832,2047,4258,621
2003,Urban,Meghalaya,Crime Against Children,Child Labor,Male,31-45,2804,1275,1529,2668,136
2008,Rural,Himachal Pradesh,Crime Against Women,Rape,Male,60+,7945,3571,4374,7109,836
2007,Urban,Gujarat,Crime Against Women,Domestic Violence,Female,18-30,5093,1796,3297,3751,1342
2009,Urban,Meghalaya,Property Crime,Arson,Male,18-30,3558,3411,147,3539,19
2006,Urban,Arunachal Pradesh,Crime Against Women,Molestation,Male,13-17,1425,975,450,1084,341
2006,Urban,Goa,Property Crime,Burglary,Male,60+,4078,1826,2252,2931,1147
2003,Rural,Meghalaya,Crime Against Children,Child Abuse,Female,31-45,4680,3183,1497,3335,1345
2005,Urban,Maharashtra,Other Crimes,Fraud,Female,18-30,9825,2335,7490,3978,5847
2007,Rural,Gujarat,Other Crimes,Fraud,Male,46-60,8544,5022,3522,6739,1805
2007,Rural,Tamil Nadu,Other Crimes,Fraud,Male,13-17,2951,1341,1610,1552,1399
2005,Rural,Uttar Pradesh,Other Crimes,Cyber Crime,Female,13-17,1371,822,549,1224,147
2009,Urban,Andhra Pradesh,Crime Against Women,Molestation,Female,60+,2837,2658,179,2682,155
2009,Rural,Haryana,Property Crime,Theft,Female,13-17,7056,6843,213,6850,206
2005,Rural,Kerala,Crime Against Men,Assault,Male,18-30,6094,5385,709,5572,522
2009,Urban,Tamil Nadu,Property Crime,Vandalism,Female,46-60,1333,548,785,800,533
2008,Urban,Chhattisgarh,Property Crime,Theft,Female,13-17,7533,7465,68,7512,21
2006,Rural,Mizoram,Other Crimes,Drug Offense,Female,18-30,3906,2770,1136,3072,834
2010,Urban,Nagaland,Property Crime,Arson,Female,60+,2942,1487,1455,2920,22
2004,Urban,Manipur,Property Crime,Burglary,Female,60+,5237,4043,1194,4205,1032
2008,Rural,Goa,Property Crime,Burglary,Female,13-17,7910,5229,2681,7362,548
2006,Urban,Punjab,Property Crime,Burglary,Male,0-12,9134,7840,1294,8744,390
2009,Rural,Bihar,Crime Against Women,Domestic Violence,Female,31-45,4051,654,3397,2837,1214
2006,Urban,Tripura,Property Crime,Arson,Male,31-45,6843,3150,3693,3286,3557
2008,Rural,Karnataka,Other Crimes,Fraud,Male,46-60,2170,567,1603,1382,788
2010,Urban,West Bengal,Crime Against Men,Extortion,Female,60+,101,9,92,38,63
2003,Urban,Bihar,Other Crimes,Drug Offense,Female,46-60,4080,3999,81,4054,26
2004,Urban,Mizoram,Other Crimes,Drug Offense,Female,46-60,2710,1906,804,2479,231
2010,Rural,Meghalaya,Crime Against Children,Trafficking,Female,0-12,879,774,105,859,20
2003,Rural,Punjab,Crime Against Children,Kidnapping,Female,13-17,413,251,162,320,93
2003,Rural,Tamil Nadu,Crime Against Children,Child Labor,Female,18-30,4499,2196,2303,4282,217
2001,Urban,Nagaland,Crime Against Children,Child Abuse,Male,0-12,8482,5759,2723,8084,398
2009,Urban,Assam,Other Crimes,Drug Offense,Male,0-12,2593,2168,425,2280,313
2009,Urban,Tripura,Property Crime,Theft,Male,13-17,7610,5107,2503,7098,512
2005,Urban,West Bengal,Crime Against Women,Rape,Male,0-12,1538,1402,136,1415,123
2008,Urban,Uttar Pradesh,Other Crimes,Cyber Crime,Male,18-30,3370,2657,713,3148,222
2006,Urban,Telangana,Crime Against Women,Molestation,Female,13-17,6269,4027,2242,4313,1956
2009,Urban,Himachal Pradesh,Crime Against Men,Extortion,Male,46-60,1782,317,1465,1572,210
2008,Urban,Manipur,Other Crimes,Cyber Crime,Male,46-60,790,346,444,584,206
2010,Urban,Mizoram,Crime Against Men,Robbery,Female,18-30,6224,5007,1217,6185,39
2010,Urban,Uttarakhand,Other Crimes,Corruption,Female,18-30,401,271,130,275,126
2002,Rural,Odisha,Property Crime,Theft,Female,18-30,6804,1714,5090,6244,560
2004,Urban,Haryana,Crime Against Women,Rape,Female,13-17,4342,2224,2118,3934,408
2007,Rural,Maharashtra,Crime Against Women,Rape,Male,0-12,683,537,146,539,144
2004,Urban,Andhra Pradesh,Crime Against Women,Rape,Female,18-30,9312,8216,1096,9052,260
2010,Urban,Sikkim,Crime Against Men,Robbery,Male,31-45,9902,3400,6502,4885,5017
2009,Urban,Meghalaya,Crime Against Men,Assault,Female,46-60,4262,1890,2372,2554,1708
2002,Urban,West Bengal,Crime Against Men,Assault,Female,18-30,7775,6055,1720,6901,874
2008,Rural,Maharashtra,Crime Against Men,Murder,Male,0-12,3501,2243,1258,2412,1089
2002,Rural,Nagaland,Crime Against Men,Assault,Male,0-12,9290,6629,2661,7674,1616
2009,Rural,Mizoram,Other Crimes,Corruption,Male,60+,7533,6238,1295,7018,515
2005,Rural,Bihar,Crime Against Children,Trafficking,Male,46-60,6554,2568,3986,6520,34
2004,Urban,Assam,Other Crimes,Drug Offense,Male,60+,156,54,102,86,70
2008,Rural,Telangana,Property Crime,Theft,Male,31-45,4191,3541,650,3756,435
2004,Rural,Himachal Pradesh,Other Crimes,Drug Offense,Female,60+,5618,1495,4123,3910,1708
2005,Rural,Tamil Nadu,Crime Against Children,Trafficking,Male,13-17,7136,3443,3693,5635,1501
2001,Urban,Andhra Pradesh,Crime Against Men,Murder,Male,31-45,3312,1914,1398,2073,1239
2003,Urban,Maharashtra,Crime Against Men,Extortion,Male,18-30,6964,1891,5073,3761,3203
2002,Rural,Uttarakhand,Other Crimes,Cyber Crime,Male,0-12,8997,8534,463,8663,334
2003,Rural,Delhi,Crime Against Children,Trafficking,Male,60+,8725,5939,2786,7121,1604
2001,Rural,Meghalaya,Crime Against Men,Robbery,Male,46-60,6632,2839,3793,6438,194
2007,Urban,Meghalaya,Property Crime,Theft,Female,18-30,9175,922,8253,6223,2952
2009,Urban,Haryana,Property Crime,Arson,Female,0-12,4152,2722,1430,2997,1155
2008,Urban,Jammu & Kashmir,Crime Against Children,Kidnapping,Male,13-17,4030,795,3235,3704,326
2007,Urban,Nagaland,Crime Against Men,Robbery,Male,0-12,9621,72,9549,4761,4860
2005,Rural,Maharashtra,Crime Against Women,Molestation,Male,60+,9973,1018,8955,3677,6296
2010,Urban,West Bengal,Other Crimes,Cyber Crime,Male,0-12,5899,2805,3094,3490,2409
2008,Rural,Punjab,Crime Against Women,Molestation,Male,31-45,407,80,327,268,139
2009,Urban,Jharkhand,Other Crimes,Fraud,Male,46-60,7460,2571,4889,6133,1327
2003,Urban,Maharashtra,Property Crime,Theft,Female,46-60,6175,1400,4775,1755,4420
2001,Urban,Tripura,Crime Against Children,Trafficking,Female,13-17,2851,2675,176,2749,102
2001,Urban,Chhattisgarh,Crime Against Women,Domestic Violence,Female,0-12,7130,6675,455,6801,329
2007,Urban,Goa,Crime Against Women,Molestation,Male,46-60,2804,604,2200,2055,749
2002,Urban,Uttarakhand,Crime Against Children,Child Labor,Female,13-17,9772,9094,678,9645,127
2003,Urban,Tamil Nadu,Crime Against Women,Rape,Female,31-45,6865,1459,5406,5323,1542
2007,Urban,Mizoram,Property Crime,Vandalism,Male,31-45,1022,925,97,956,66
2007,Urban,Karnataka,Crime Against Children,Kidnapping,Male,18-30,9594,6053,3541,6510,3084
2005,Rural,Andhra Pradesh,Crime Against Children,Kidnapping,Female,46-60,2270,1389,881,2128,142
2003,Rural,Sikkim,Crime Against Women,Dowry Deaths,Male,31-45,1983,1322,661,1648,335
2002,Urban,Haryana,Crime Against Women,Molestation,Female,18-30,1981,237,1744,1778,203
2008,Rural,Odisha,Crime Against Men,Robbery,Male,60+,491,201,290,405,86
2009,Rural,Uttar Pradesh,Crime Against Children,Trafficking,Female,0-12,627,303,324,532,95
2010,Urban,Maharashtra,Property Crime,Burglary,Male,46-60,8111,7480,631,7986,125
2006,Rural,Uttarakhand,Crime Against Men,Assault,Female,13-17,2079,1090,989,1118,961
2002,Rural,Odisha,Property Crime,Burglary,Female,31-45,2029,1391,638,1662,367
2005,Urban,Goa,Property Crime,Burglary,Male,60+,5063,1601,3462,4513,550
2008,Rural,Mizoram,Property Crime,Burglary,Male,46-60,5215,4748,467,4885,330
2010,Urban,Assam,Crime Against Men,Assault,Male,31-45,9154,5372,3782,8813,341
2001,Urban,Manipur,Crime Against Children,Child Labor,Female,31-45,9197,642,8555,8879,318
2002,Urban,Punjab,Property Crime,Theft,Male,60+,1864,1195,669,1418,446
2008,Rural,Mizoram,Crime Against Men,Robbery,Male,13-17,9148,5924,3224,6564,2584
2001,Urban,Nagaland,Crime Against Women,Domestic Violence,Male,31-45,1886,1830,56,1880,6
2006,Rural,Jammu & Kashmir,Other Crimes,Fraud,Male,60+,5698,2907,2791,3792,1906
2008,Rural,Delhi,Crime Against Men,Extortion,Female,13-17,4367,3278,1089,3592,775
2005,Urban,Arunachal Pradesh,Crime Against Men,Assault,Male,0-12,124,52,72,115,9
2007,Urban,Odisha,Crime Against Men,Robbery,Male,31-45,9102,4557,4545,5889,3213
2004,Urban,Jharkhand,Crime Against Men,Assault,Female,13-17,7430,1280,6150,4293,3137
2003,Rural,West Bengal,Other Crimes,Corruption,Female,13-17,7782,2549,5233,4139,3643
2007,Urban,Jammu & Kashmir,Other Crimes,Corruption,Male,0-12,8561,2795,5766,7023,1538
2010,Urban,Chhattisgarh,Property Crime,Theft,Female,18-30,3785,1685,2100,1709,2076
2002,Rural,Sikkim,Property Crime,Theft,Female,60+,6849,961,5888,3721,3128
2009,Urban,Goa,Crime Against Men,Extortion,Female,13-17,1263,1240,23,1259,4
2009,Rural,Assam,Crime Against Children,Trafficking,Male,0-12,7795,4427,3368,7142,653
2009,Urban,Jammu & Kashmir,Other Crimes,Corruption,Male,13-17,5334,1707,3627,2442,2892
2001,Urban,Chhattisgarh,Crime Against Children,Child Abuse,Female,60+,687,349,338,628,59
2001,Urban,Andhra Pradesh,Crime Against Men,Assault,Female,60+,7734,77,7657,573,7161
2003,Urban,Maharashtra,Crime Against Children,Trafficking,Male,13-17,1814,699,1115,1664,150
2001,Urban,Uttar Pradesh,Crime Against Men,Extortion,Male,46-60,498,258,240,401,97
2002,Rural,Arunachal Pradesh,Crime Against Men,Assault,Male,13-17,4813,4755,58,4793,20
2009,Rural,Odisha,Crime Against Children,Trafficking,Female,60+,8665,7912,753,8515,150
2007,Rural,Gujarat,Crime Against Women,Molestation,Female,31-45,6296,1986,4310,5910,386
2004,Urban,Karnataka,Property Crime,Burglary,Male,46-60,3364,340,3024,1990,1374
2003,Urban,Manipur,Crime Against Women,Rape,Male,31-45,9114,2610,6504,8823,291
2006,Rural,Odisha,Property Crime,Arson,Male,0-12,2555,2339,216,2534,21
2004,Rural,Odisha,Crime Against Men,Extortion,Male,31-45,400,233,167,395,5
2008,Urban,Uttarakhand,Other Crimes,Cyber Crime,Female,31-45,1257,92,1165,1196,61
2005,Rural,Haryana,Other Crimes,Drug Offense,Male,31-45,8293,582,7711,2264,6029
2001,Rural,Uttar Pradesh,Crime Against Children,Trafficking,Female,46-60,3608,822,2786,2249,1359
2006,Rural,Kerala,Property Crime,Arson,Male,60+,2050,1863,187,1996,54
2008,Urban,West Bengal,Crime Against Men,Robbery,Female,31-45,7155,2862,4293,6354,801
2008,Rural,Madhya Pradesh,Property Crime,Arson,Male,18-30,5342,5211,131,5273,69
2005,Rural,Gujarat,Other Crimes,Drug Offense,Female,46-60,2103,1462,641,1499,604
2005,Urban,Haryana,Other Crimes,Fraud,Male,46-60,7086,827,6259,3736,3350
2005,Rural,Arunachal Pradesh,Other Crimes,Drug Offense,Female,46-60,2183,853,1330,1192,991
2004,Rural,Sikkim,Crime Against Women,Domestic Violence,Female,0-12,3539,1654,1885,1900,1639
2008,Rural,Telangana,Crime Against Children,Child Labor,Female,60+,3059,2939,120,2986,73
2009,Urban,Telangana,Crime Against Children,Child Labor,Female,46-60,7166,4986,2180,5935,1231
2003,Urban,Punjab,Crime Against Children,Child Labor,Male,46-60,6527,3989,2538,4487,2040
2003,Urban,Tripura,Crime Against Women,Rape,Male,13-17,7050,3665,3385,4380,2670
2004,Urban,Jharkhand,Property Crime,Arson,Female,31-45,4234,2879,1355,3267,967
2006,Urban,Manipur,Property Crime,Vandalism,Male,46-60,6326,2572,3754,3843,2483
2002,Rural,Kerala,Crime Against Children,Trafficking,Female,31-45,4846,2692,2154,4825,21
2006,Urban,Odisha,Crime Against Men,Robbery,Female,60+,181,103,78,111,70
2004,Urban,Kerala,Crime Against Men,Assault,Male,60+,5240,1867,3373,2008,3232
2002,Urban,Andhra Pradesh,Other Crimes,Drug Offense,Female,0-12,7557,1702,5855,2095,5462
2009,Rural,Gujarat,Crime Against Women,Domestic Violence,Male,60+,8438,4539,3899,7016,1422
2005,Rural,Manipur,Other Crimes,Cyber Crime,Female,60+,7517,5446,2071,7284,233
2003,Urban,Maharashtra,Crime Against Men,Murder,Male,18-30,3997,847,3150,1254,2743
2007,Rural,Karnataka,Other Crimes,Cyber Crime,Female,13-17,9843,2022,7821,3525,6318
2005,Rural,Uttarakhand,Crime Against Men,Murder,Female,46-60,5081,3307,1774,4745,336
2009,Urban,Tripura,Other Crimes,Fraud,Male,46-60,2253,1130,1123,1207,1046
2006,Urban,Tripura,Crime Against Children,Child Labor,Female,60+,5254,619,4635,2285,2969
2002,Rural,Gujarat,Crime Against Children,Trafficking,Male,13-17,9317,5591,3726,8769,548
2004,Rural,Jharkhand,Property Crime,Burglary,Female,18-30,2532,1330,1202,2406,126
2002,Rural,Manipur,Other Crimes,Cyber Crime,Male,60+,8390,4002,4388,6555,1835
2006,Rural,Bihar,Crime Against Children,Kidnapping,Female,0-12,7732,5333,2399,5778,1954
2003,Urban,Uttarakhand,Crime Against Men,Assault,Female,60+,5562,1977,3585,2509,3053
2001,Rural,Jharkhand,Crime Against Children,Child Labor,Male,0-12,4584,2617,1967,3093,1491
2002,Urban,Tripura,Crime Against Men,Extortion,Male,13-17,825,500,325,812,13
2009,Urban,Mizoram,Crime Against Children,Child Labor,Male,60+,3145,1683,1462,1695,1450
2008,Urban,Punjab,Crime Against Women,Dowry Deaths,Female,60+,392,138,254,159,233
2010,Urban,Bihar,Crime Against Children,Child Abuse,Male,18-30,3121,838,2283,1666,1455
2010,Urban,Manipur,Other Crimes,Corruption,Female,13-17,1881,314,1567,1299,582
2001,Rural,Telangana,Crime Against Children,Trafficking,Male,46-60,8703,5362,3341,8543,160
2002,Rural,Telangana,Crime Against Children,Child Labor,Female,0-12,9418,2377,7041,3623,5795
2004,Rural,Uttar Pradesh,Other Crimes,Corruption,Male,18-30,2697,2197,500,2455,242
2004,Rural,Manipur,Other Crimes,Drug Offense,Male,46-60,2211,1258,953,1286,925
2007,Rural,Rajasthan,Crime Against Men,Robbery,Male,60+,6719,3146,3573,6484,235
2001,Urban,Tripura,Crime Against Men,Robbery,Male,18-30,7207,6429,778,6944,263
2010,Rural,Madhya Pradesh,Property Crime,Arson,Male,0-12,2845,105,2740,1521,1324
2005,Rural,Rajasthan,Other Crimes,Corruption,Male,46-60,2745,1502,1243,1536,1209
2005,Rural,Gujarat,Crime Against Children,Kidnapping,Female,18-30,8477,5431,3046,7500,977
2008,Urban,Jammu & Kashmir,Crime Against Men,Robbery,Female,0-12,4329,1866,2463,1911,2418
2001,Urban,Odisha,Other Crimes,Drug Offense,Male,60+,3046,534,2512,2206,840
2003,Rural,Nagaland,Property Crime,Vandalism,Male,13-17,5434,2082,3352,3348,2086
2003,Rural,Chhattisgarh,Crime Against Children,Trafficking,Male,0-12,7457,1337,6120,4700,2757
2009,Rural,Chhattisgarh,Other Crimes,Drug Offense,Male,18-30,4547,2703,1844,4386,161
2003,Urban,Arunachal Pradesh,Crime Against Children,Child Abuse,Female,13-17,5655,4249,1406,5185,470
2004,Urban,Uttarakhand,Property Crime,Burglary,Male,31-45,453,388,65,447,6
2009,Urban,Andhra Pradesh,Property Crime,Arson,Female,13-17,912,0,912,785,127
2009,Rural,Chhattisgarh,Other Crimes,Corruption,Female,31-45,6161,5736,425,6146,15
2004,Rural,Jharkhand,Crime Against Children,Kidnapping,Male,60+,3247,3244,3,3244,3
2004,Rural,Uttar Pradesh,Property Crime,Burglary,Female,60+,6840,6030,810,6099,741
2010,Rural,Delhi,Crime Against Women,Domestic Violence,Male,31-45,8527,1294,7233,4138,4389
2002,Rural,Tripura,Property Crime,Theft,Female,31-45,8029,5583,2446,7950,79
2004,Rural,Mizoram,Crime Against Women,Domestic Violence,Male,0-12,2782,645,2137,1719,1063
2008,Urban,Rajasthan,Other Crimes,Corruption,Male,60+,1077,1025,52,1028,49
2009,Rural,Meghalaya,Property Crime,Burglary,Male,60+,3857,2440,1417,2559,1298
2010,Urban,Madhya Pradesh,Crime Against Men,Assault,Male,46-60,2125,401,1724,1381,744
2007,Rural,Madhya Pradesh,Property Crime,Theft,Female,46-60,3909,1903,2006,3172,737
2005,Urban,Rajasthan,Property Crime,Burglary,Male,60+,7283,5476,1807,6635,648
2002,Urban,Tamil Nadu,Crime Against Women,Dowry Deaths,Male,18-30,991,571,420,873,118
2008,Urban,Goa,Crime Against Children,Child Labor,Male,31-45,7416,3679,3737,4596,2820
2007,Urban,Andhra Pradesh,Property Crime,Theft,Female,46-60,321,302,19,317,4
2006,Urban,Gujarat,Crime Against Children,Child Abuse,Female,18-30,6528,6416,112,6448,80
2002,Urban,Odisha,Property Crime,Arson,Female,60+,2116,1735,381,2044,72
2005,Urban,Manipur,Crime Against Men,Murder,Male,13-17,587,317,270,534,53
2001,Urban,Tripura,Crime Against Women,Molestation,Male,13-17,3410,439,2971,3398,12
2004,Urban,Arunachal Pradesh,Other Crimes,Drug Offense,Female,18-30,3211,1643,1568,2350,861
2002,Rural,Rajasthan,Crime Against Children,Trafficking,Female,31-45,5371,4279,1092,4512,859
2006,Urban,Meghalaya,Crime Against Men,Extortion,Male,31-45,9259,1923,7336,3996,5263
2003,Rural,Assam,Crime Against Children,Child Labor,Female,18-30,1087,569,518,838,249
2002,Urban,Haryana,Crime Against Women,Domestic Violence,Female,18-30,3798,3101,697,3562,236
2008,Urban,Nagaland,Crime Against Children,Kidnapping,Female,46-60,800,0,800,189,611
2006,Urban,Manipur,Crime Against Men,Extortion,Female,60+,3594,3339,255,3480,114
2004,Rural,Gujarat,Property Crime,Theft,Female,60+,2479,83,2396,510,1969
2010,Urban,Meghalaya,Crime Against Women,Dowry Deaths,Male,60+,806,115,691,438,368
2003,Rural,West Bengal,Crime Against Men,Robbery,Male,60+,1755,678,1077,1114,641
2002,Urban,Tamil Nadu,Crime Against Women,Domestic Violence,Female,18-30,2485,1553,932,1974,511
2004,Rural,Kerala,Crime Against Children,Child Labor,Male,31-45,3544,765,2779,2091,1453
2002,Rural,Meghalaya,Crime Against Women,Dowry Deaths,Female,0-12,9876,2905,6971,3811,6065
2001,Rural,Mizoram,Crime Against Men,Assault,Male,18-30,1241,1062,179,1182,59
2006,Rural,Kerala,Other Crimes,Drug Offense,Male,18-30,2771,2433,338,2477,294
2007,Urban,Tamil Nadu,Crime Against Men,Extortion,Male,46-60,1483,1064,419,1329,154
2008,Urban,Karnataka,Crime Against Men,Extortion,Male,13-17,3842,2951,891,3191,651
2006,Rural,Bihar,Crime Against Women,Domestic Violence,Female,13-17,3319,1277,2042,1756,1563
2010,Urban,Jharkhand,Other Crimes,Drug Offense,Female,13-17,3649,2071,1578,3241,408
2002,Urban,Assam,Crime Against Women,Dowry Deaths,Male,31-45,7766,5269,2497,6333,1433
2001,Rural,Punjab,Property Crime,Vandalism,Male,0-12,8417,1032,7385,3685,4732
2005,Rural,Tripura,Property Crime,Vandalism,Female,18-30,9073,6100,2973,7033,2040
2009,Rural,Meghalaya,Crime Against Children,Kidnapping,Male,0-12,9908,3086,6822,9868,40
2002,Urban,Bihar,Crime Against Men,Murder,Male,0-12,2919,643,2276,2233,686
2001,Urban,Himachal Pradesh,Crime Against Children,Kidnapping,Female,18-30,9806,1260,8546,7835,1971
2010,Rural,Karnataka,Crime Against Men,Robbery,Male,46-60,970,65,905,426,544
2003,Rural,Bihar,Other Crimes,Cyber Crime,Male,18-30,6720,5034,1686,6610,110
2007,Urban,Goa,Other Crimes,Drug Offense,Male,60+,3218,2672,546,2999,219
2006,Rural,Karnataka,Property Crime,Theft,Male,0-12,5419,2570,2849,4131,1288
2009,Urban,Goa,Other Crimes,Drug Offense,Male,18-30,8513,6101,2412,6151,2362
2008,Rural,Odisha,Crime Against Men,Extortion,Male,0-12,419,148,271,408,11
2008,Urban,Andhra Pradesh,Crime Against Men,Robbery,Male,0-12,5101,4694,407,4790,311
2007,Rural,Sikkim,Property Crime,Arson,Female,60+,3480,2925,555,3317,163
2007,Rural,Jharkhand,Property Crime,Burglary,Female,13-17,7786,4779,3007,7187,599
2010,Urban,Punjab,Other Crimes,Drug Offense,Female,18-30,8193,6969,1224,7870,323
2002,Rural,Uttarakhand,Crime Against Children,Trafficking,Female,46-60,7713,5062,2651,6354,1359
2003,Rural,Delhi,Crime Against Children,Kidnapping,Male,0-12,5938,2852,3086,3565,2373
2010,Urban,Manipur,Other Crimes,Cyber Crime,Male,0-12,2166,1048,1118,1645,521
2004,Rural,Meghalaya,Crime Against Children,Trafficking,Male,13-17,9713,2348,7365,4116,5597
2006,Rural,Jammu & Kashmir,Crime Against Children,Trafficking,Male,0-12,8101,345,7756,7145,956
2005,Rural,Manipur,Crime Against Men,Murder,Male,0-12,4888,3284,1604,4830,58
2008,Urban,Haryana,Crime Against Men,Robbery,Male,31-45,8498,3635,4863,7042,1456
2009,Rural,Sikkim,Crime Against Children,Child Labor,Female,18-30,1864,720,1144,1426,438
2007,Urban,Kerala,Crime Against Women,Domestic Violence,Male,18-30,1531,1504,27,1526,5
2004,Urban,Mizoram,Other Crimes,Fraud,Female,0-12,4778,3526,1252,4444,334
2007,Rural,Rajasthan,Other Crimes,Drug Offense,Female,31-45,9726,5902,3824,8754,972
2001,Urban,Gujarat,Crime Against Women,Dowry Deaths,Male,31-45,2573,807,1766,2209,364
2002,Rural,Uttarakhand,Crime Against Women,Domestic Violence,Female,13-17,3924,3330,594,3821,103
2008,Rural,Uttar Pradesh,Crime Against Children,Kidnapping,Male,31-45,2725,799,1926,2329,396
2010,Urban,Tripura,Crime Against Children,Child Abuse,Male,18-30,5345,2351,2994,4556,789
2001,Urban,Manipur,Crime Against Women,Molestation,Female,18-30,1915,1882,33,1883,32
2004,Urban,Arunachal Pradesh,Other Crimes,Drug Offense,Male,60+,5429,3616,1813,5355,74
2010,Rural,Mizoram,Crime Against Men,Extortion,Male,0-12,6746,2674,4072,4707,2039
2005,Rural,Bihar,Crime Against Children,Child Labor,Female,18-30,1891,1439,452,1547,344
2008,Rural,Jammu & Kashmir,Property Crime,Burglary,Male,31-45,1624,1036,588,1490,134
2005,Urban,Nagaland,Crime Against Children,Child Labor,Female,46-60,3647,796,2851,2674,973
2004,Rural,Uttar Pradesh,Property Crime,Burglary,Male,13-17,5833,930,4903,4803,1030
2009,Urban,Maharashtra,Crime Against Children,Child Labor,Male,0-12,7188,6642,546,6923,265
2005,Rural,Telangana,Crime Against Children,Child Labor,Female,31-45,4045,2945,1100,3652,393
2010,Rural,Tamil Nadu,Crime Against Children,Child Labor,Female,18-30,5579,5389,190,5494,85
2002,Urban,Uttarakhand,Crime Against Men,Robbery,Female,31-45,7639,3018,4621,4483,3156
2006,Urban,Madhya Pradesh,Property Crime,Burglary,Female,31-45,1072,995,77,1046,26
2009,Urban,Manipur,Crime Against Men,Murder,Female,46-60,6769,6717,52,6736,33
2009,Rural,Uttarakhand,Property Crime,Vandalism,Male,46-60,9755,732,9023,4264,5491
2005,Rural,Punjab,Crime Against Men,Murder,Male,60+,9981,2178,7803,6044,3937
2010,Urban,Nagaland,Property Crime,Arson,Female,0-12,1036,416,620,651,385
2005,Urban,Rajasthan,Other Crimes,Corruption,Male,60+,4559,2348,2211,2647,1912
2007,Rural,Andhra Pradesh,Crime Against Men,Extortion,Female,31-45,6335,4511,1824,5279,1056
2006,Rural,Rajasthan,Crime Against Children,Kidnapping,Female,46-60,207,20,187,89,118
2008,Urban,Tripura,Crime Against Children,Child Labor,Female,60+,6684,2986,3698,4550,2134
2007,Urban,Uttar Pradesh,Other Crimes,Drug Offense,Female,60+,5079,3058,2021,4853,226
2002,Rural,Andhra Pradesh,Crime Against Children,Child Labor,Female,0-12,6717,1488,5229,3026,3691
2005,Urban,Chhattisgarh,Crime Against Children,Child Abuse,Female,18-30,857,466,391,838,19
2006,Rural,Tamil Nadu,Property Crime,Vandalism,Male,46-60,6128,5389,739,5855,273
2001,Rural,Delhi,Property Crime,Theft,Female,46-60,9367,8287,1080,9303,64
2003,Rural,West Bengal,Crime Against Women,Molestation,Male,60+,5758,3328,2430,5691,67
2006,Rural,Uttarakhand,Property Crime,Arson,Female,60+,1602,447,1155,1073,529
2002,Rural,Bihar,Crime Against Women,Domestic Violence,Male,31-45,6540,4702,1838,6069,471
2004,Urban,Rajasthan,Crime Against Men,Extortion,Male,60+,9254,5953,3301,7404,1850
2006,Urban,Tripura,Crime Against Women,Dowry Deaths,Male,46-60,1784,122,1662,1446,338
2007,Urban,Mizoram,Crime Against Men,Robbery,Female,13-17,4500,2714,1786,3479,1021
2004,Rural,Odisha,Crime Against Women,Molestation,Male,31-45,1545,883,662,1135,410
2005,Urban,Assam,Crime Against Women,Dowry Deaths,Male,0-12,1350,643,707,1000,350
2004,Rural,Uttarakhand,Crime Against Women,Molestation,Male,13-17,4368,3824,544,4236,132
2010,Rural,Telangana,Crime Against Women,Rape,Male,0-12,4393,3632,761,3777,616
2001,Rural,Haryana,Crime Against Women,Molestation,Female,60+,1508,1276,232,1501,7
2005,Urban,Karnataka,Property Crime,Arson,Female,0-12,7946,6134,1812,6728,1218
2004,Urban,Uttar Pradesh,Crime Against Women,Domestic Violence,Female,13-17,9104,2084,7020,5151,3953
2003,Urban,Meghalaya,Property Crime,Burglary,Female,60+,6565,3489,3076,4484,2081
2006,Urban,Kerala,Property Crime,Theft,Male,31-45,521,58,463,469,52
2001,Urban,Manipur,Property Crime,Vandalism,Male,0-12,2408,2080,328,2155,253
2008,Rural,Chhattisgarh,Crime Against Children,Kidnapping,Male,13-17,5052,3526,1526,3930,1122
2009,Urban,Haryana,Crime Against Women,Rape,Female,13-17,6970,2989,3981,4635,2335
2006,Rural,Meghalaya,Property Crime,Arson,Male,0-12,1751,426,1325,1282,469
2003,Urban,Bihar,Property Crime,Arson,Female,13-17,3497,2229,1268,2968,529
2010,Urban,Delhi,Other Crimes,Fraud,Male,60+,5086,569,4517,4894,192
2002,Urban,Delhi,Crime Against Women,Domestic Violence,Male,46-60,7767,1643,6124,4915,2852
2004,Urban,Arunachal Pradesh,Crime Against Women,Dowry Deaths,Male,31-45,4704,1039,3665,4624,80
2009,Urban,Mizoram,Crime Against Children,Child Labor,Male,60+,9116,4461,4655,7258,1858
2004,Urban,Andhra Pradesh,Other Crimes,Corruption,Female,46-60,695,617,78,663,32
2010,Rural,Manipur,Property Crime,Vandalism,Female,46-60,7789,291,7498,4175,3614
2008,Rural,Himachal Pradesh,Property Crime,Theft,Male,60+,4778,3919,859,4742,36
2009,Rural,Telangana,Other Crimes,Corruption,Female,31-45,1086,793,293,808,278
2002,Rural,Arunachal Pradesh,Crime Against Children,Child Abuse,Male,13-17,8170,6615,1555,7789,381
2002,Rural,Goa,Crime Against Women,Dowry Deaths,Female,0-12,6656,3121,3535,5748,908
2008,Rural,Uttarakhand,Property Crime,Arson,Male,60+,1756,809,947,910,846
2006,Urban,West Bengal,Crime Against Men,Murder,Female,13-17,3112,140,2972,1689,1423
2001,Rural,Odisha,Crime Against Men,Murder,Female,18-30,1410,1212,198,1301,109
2007,Urban,Haryana,Crime Against Women,Domestic Violence,Male,0-12,2080,1374,706,1428,652
2007,Urban,Assam,Other Crimes,Corruption,Male,13-17,8046,1205,6841,6486,1560
2006,Urban,Odisha,Other Crimes,Cyber Crime,Female,13-17,2003,1656,347,1776,227
2009,Urban,Mizoram,Crime Against Women,Rape,Female,0-12,821,588,233,616,205
2008,Rural,Jharkhand,Crime Against Women,Dowry Deaths,Female,60+,8870,2735,6135,4796,4074
2005,Rural,Manipur,Crime Against Children,Kidnapping,Female,60+,320,200,120,222,98
2002,Rural,Tamil Nadu,Property Crime,Vandalism,Female,18-30,4352,1881,2471,2473,1879
2004,Urban,Goa,Crime Against Men,Extortion,Male,18-30,8454,7900,554,8433,21
2007,Rural,Jammu & Kashmir,Property Crime,Arson,Female,18-30,7068,5881,1187,6660,408
2002,Urban,Gujarat,Crime Against Children,Child Labor,Male,60+,4282,1522,2760,3844,438
2004,Urban,Haryana,Other Crimes,Corruption,Female,0-12,4330,4033,297,4250,80
2007,Urban,Madhya Pradesh,Crime Against Women,Dowry Deaths,Female,0-12,8494,3624,4870,7655,839
2003,Rural,Uttar Pradesh,Crime Against Women,Domestic Violence,Male,18-30,2305,432,1873,674,1631
2003,Urban,Himachal Pradesh,Crime Against Children,Trafficking,Male,31-45,3828,258,3570,1372,2456
2010,Rural,Madhya Pradesh,Property Crime,Vandalism,Female,18-30,3758,3687,71,3697,61
2005,Urban,Maharashtra,Crime Against Children,Kidnapping,Male,18-30,4409,1709,2700,3105,1304
2003,Urban,Nagaland,Property Crime,Vandalism,Female,46-60,3466,1628,1838,1698,1768
2001,Urban,Goa,Property Crime,Theft,Male,13-17,8140,2770,5370,6717,1423
2007,Urban,Goa,Crime Against Children,Child Labor,Male,18-30,8671,7508,1163,8188,483
2008,Rural,Uttar Pradesh,Property Crime,Theft,Male,13-17,6312,1449,4863,3622,2690
2007,Rural,Jharkhand,Crime Against Children,Child Labor,Female,60+,7751,935,6816,6528,1223
2009,Rural,Manipur,Crime Against Men,Assault,Female,0-12,3179,1108,2071,1788,1391
2010,Rural,Bihar,Crime Against Men,Assault,Female,60+,5663,5278,385,5350,313
2003,Urban,Assam,Crime Against Children,Trafficking,Female,60+,3493,362,3131,2096,1397
2006,Urban,Kerala,Crime Against Children,Child Abuse,Female,0-12,7462,5326,2136,5364,2098
2008,Rural,Goa,Crime Against Women,Domestic Violence,Female,13-17,2687,1051,1636,1916,771
2008,Urban,West Bengal,Crime Against Women,Domestic Violence,Male,0-12,5322,1262,4060,3429,1893
2003,Urban,Kerala,Crime Against Men,Robbery,Female,0-12,8535,1588,6947,4736,3799
2005,Rural,Jharkhand,Property Crime,Vandalism,Male,60+,4452,2455,1997,3569,883
2003,Urban,West Bengal,Other Crimes,Cyber Crime,Female,13-17,9375,3840,5535,7111,2264
2010,Rural,Tamil Nadu,Crime Against Women,Molestation,Male,60+,6377,1205,5172,2816,3561
2004,Urban,Bihar,Property Crime,Vandalism,Male,13-17,1256,915,341,1193,63
2002,Rural,Sikkim,Crime Against Women,Molestation,Male,46-60,2756,22,2734,1774,982
2003,Rural,West Bengal,Crime Against Children,Child Labor,Female,18-30,2234,297,1937,1356,878
2005,Urban,Haryana,Property Crime,Vandalism,Male,60+,841,365,476,606,235
2001,Urban,Odisha,Property Crime,Theft,Male,18-30,920,817,103,835,85
2008,Rural,Madhya Pradesh,Crime Against Men,Robbery,Female,0-12,8795,3348,5447,6670,2125
2008,Urban,Assam,Crime Against Women,Rape,Female,60+,1798,1038,760,1299,499
2009,Urban,Goa,Crime Against Men,Extortion,Female,31-45,2306,1149,1157,1643,663
2008,Urban,Uttar Pradesh,Crime Against Women,Molestation,Male,13-17,2252,1387,865,2126,126
2004,Rural,Andhra Pradesh,Crime Against Children,Child Abuse,Female,18-30,1468,1454,14,1467,1
2003,Rural,Tripura,Property Crime,Vandalism,Male,0-12,4881,2537,2344,2716,2165
2006,Rural,Tamil Nadu,Property Crime,Vandalism,Female,18-30,6149,622,5527,1723,4426
2008,Urban,Odisha,Crime Against Women,Dowry Deaths,Male,13-17,6659,3130,3529,4916,1743
2005,Urban,Madhya Pradesh,Crime Against Men,Robbery,Male,0-12,7411,1421,5990,3465,3946
2006,Rural,Telangana,Crime Against Women,Rape,Female,60+,2548,2415,133,2429,119
2009,Urban,Delhi,Crime Against Women,Rape,Female,46-60,5440,2584,2856,4311,1129
2002,Rural,Telangana,Crime Against Children,Child Abuse,Female,0-12,1926,930,996,1297,629
2010,Urban,Madhya Pradesh,Other Crimes,Corruption,Male,46-60,6538,5210,1328,5306,1232
2005,Urban,Arunachal Pradesh,Other Crimes,Fraud,Female,18-30,6937,6537,400,6539,398
2005,Urban,Uttar Pradesh,Other Crimes,Cyber Crime,Female,46-60,4832,4417,415,4457,375
2009,Urban,West Bengal,Property Crime,Arson,Male,0-12,5388,4230,1158,4873,515
2002,Rural,Odisha,Crime Against Men,Robbery,Male,31-45,7492,1768,5724,6837,655
2003,Rural,Kerala,Other Crimes,Fraud,Female,18-30,5286,3218,2068,5173,113
2009,Urban,Nagaland,Crime Against Men,Murder,Male,13-17,7338,828,6510,6928,410
2001,Rural,Uttar Pradesh,Property Crime,Burglary,Female,31-45,7138,5505,1633,6345,793
2005,Urban,Karnataka,Crime Against Women,Rape,Male,46-60,4001,74,3927,694,3307
2004,Rural,Meghalaya,Crime Against Men,Extortion,Male,31-45,669,322,347,564,105
2005,Rural,Himachal Pradesh,Other Crimes,Corruption,Male,46-60,5931,3722,2209,4180,1751
2008,Urban,Nagaland,Crime Against Men,Murder,Male,13-17,278,31,247,75,203
2009,Rural,Kerala,Crime Against Children,Kidnapping,Female,18-30,6179,1638,4541,3087,3092
2003,Rural,Jharkhand,Property Crime,Burglary,Male,13-17,4596,145,4451,407,4189
2007,Urban,Meghalaya,Property Crime,Arson,Female,13-17,8277,2671,5606,3736,4541
2005,Urban,Goa,Crime Against Men,Robbery,Female,31-45,3774,2760,1014,3456,318
2007,Urban,Sikkim,Crime Against Men,Assault,Male,60+,9270,6050,3220,6992,2278
2004,Urban,Haryana,Other Crimes,Fraud,Male,18-30,9597,3566,6031,5914,3683
2006,Urban,Rajasthan,Crime Against Men,Robbery,Female,46-60,85,74,11,82,3
2010,Rural,Arunachal Pradesh,Crime Against Children,Kidnapping,Female,18-30,5204,119,5085,4585,619
2008,Rural,Odisha,Property Crime,Vandalism,Female,46-60,3413,2980,433,3027,386
2008,Urban,Chhattisgarh,Crime Against Children,Trafficking,Male,13-17,9202,3852,5350,7833,1369
2006,Rural,Gujarat,Other Crimes,Corruption,Male,46-60,9643,8039,1604,8609,1034
2006,Rural,Maharashtra,Other Crimes,Cyber Crime,Female,31-45,7715,3195,4520,5069,2646
2002,Urban,Mizoram,Other Crimes,Corruption,Male,60+,7067,3627,3440,7055,12
2003,Rural,Madhya Pradesh,Crime Against Children,Trafficking,Male,31-45,2639,1771,868,2254,385
2002,Urban,Uttar Pradesh,Crime Against Children,Kidnapping,Male,31-45,3957,2837,1120,3948,9
2004,Rural,Manipur,Crime Against Men,Murder,Female,60+,5145,2802,2343,5136,9
2001,Rural,Tripura,Crime Against Women,Rape,Male,60+,6100,3429,2671,3795,2305
2006,Urban,Chhattisgarh,Other Crimes,Cyber Crime,Male,31-45,8494,5829,2665,7259,1235
2007,Rural,Sikkim,Other Crimes,Cyber Crime,Male,18-30,8569,4676,3893,7711,858
2008,Urban,Chhattisgarh,Property Crime,Vandalism,Male,60+,1823,1587,236,1692,131
2007,Rural,Tripura,Crime Against Men,Murder,Male,18-30,6265,5210,1055,5729,536
2003,Urban,Uttarakhand,Crime Against Men,Assault,Male,13-17,3078,2237,841,2850,228
2004,Rural,West Bengal,Crime Against Men,Assault,Male,31-45,6726,1500,5226,4131,2595
2003,Urban,Madhya Pradesh,Other Crimes,Fraud,Male,13-17,5206,4090,1116,4911,295
2005,Rural,Nagaland,Crime Against Women,Dowry Deaths,Female,0-12,1745,1404,341,1410,335
2006,Urban,Maharashtra,Property Crime,Burglary,Male,60+,9509,6344,3165,7985,1524
2004,Rural,Maharashtra,Crime Against Children,Child Abuse,Male,0-12,5847,5379,468,5595,252
2001,Urban,Bihar,Other Crimes,Drug Offense,Male,46-60,9262,833,8429,5296,3966
2009,Rural,Tamil Nadu,Other Crimes,Fraud,Female,31-45,5155,2796,2359,3041,2114
2006,Rural,Meghalaya,Other Crimes,Fraud,Male,18-30,8483,3686,4797,5742,2741
2004,Urban,Bihar,Crime Against Children,Kidnapping,Male,0-12,5050,492,4558,4275,775
2001,Urban,Assam,Property Crime,Theft,Female,31-45,3143,560,2583,1687,1456
2007,Urban,Sikkim,Property Crime,Vandalism,Female,31-45,5808,3841,1967,4123,1685
2009,Rural,Andhra Pradesh,Crime Against Women,Domestic Violence,Male,46-60,1888,1596,292,1752,136
2003,Rural,Goa,Crime Against Women,Dowry Deaths,Male,46-60,8393,4415,3978,5030,3363
2009,Rural,Tamil Nadu,Property Crime,Arson,Male,0-12,2364,2042,322,2344,20
2007,Rural,Assam,Crime Against Men,Robbery,Male,31-45,1285,944,341,1109,176
2009,Rural,Madhya Pradesh,Crime Against Children,Child Abuse,Male,18-30,2003,298,1705,1519,484
2001,Rural,Meghalaya,Other Crimes,Drug Offense,Female,46-60,5966,2915,3051,5305,661
2009,Urban,Jharkhand,Crime Against Children,Kidnapping,Male,46-60,3745,540,3205,1172,2573
2008,Urban,Himachal Pradesh,Property Crime,Arson,Male,13-17,5664,1053,4611,3990,1674
2006,Rural,Karnataka,Crime Against Men,Assault,Male,18-30,7923,4131,3792,6114,1809
2005,Rural,Andhra Pradesh,Crime Against Men,Extortion,Male,46-60,8496,6940,1556,7323,1173
2002,Rural,Punjab,Crime Against Men,Murder,Female,46-60,3903,1522,2381,1933,1970
2003,Rural,Haryana,Crime Against Women,Molestation,Male,31-45,587,345,242,445,142
2006,Rural,Telangana,Crime Against Children,Trafficking,Male,18-30,9174,1103,8071,2486,6688
2007,Rural,Meghalaya,Crime Against Men,Murder,Female,31-45,8801,5335,3466,6890,1911
2007,Urban,Tamil Nadu,Crime Against Women,Molestation,Male,60+,6422,2651,3771,2779,3643
2005,Urban,Maharashtra,Crime Against Women,Rape,Female,46-60,1621,1206,415,1363,258
2007,Urban,Nagaland,Property Crime,Theft,Female,60+,7727,5615,2112,5760,1967
2002,Rural,Karnataka,Other Crimes,Cyber Crime,Female,18-30,1838,970,868,1504,334
2002,Urban,Karnataka,Property Crime,Arson,Male,18-30,1583,934,649,1320,263
2006,Rural,Karnataka,Crime Against Children,Trafficking,Female,18-30,1301,684,617,799,502
2003,Urban,Delhi,Property Crime,Burglary,Male,13-17,5890,1426,4464,5457,433
2005,Rural,Manipur,Crime Against Men,Extortion,Male,13-17,4096,3488,608,3868,228
2002,Urban,Goa,Property Crime,Arson,Male,60+,3282,2323,959,3000,282
2003,Rural,Sikkim,Crime Against Men,Robbery,Female,31-45,7743,7156,587,7610,133
2009,Urban,Maharashtra,Crime Against Children,Child Abuse,Male,18-30,8849,4469,4380,5286,3563
2009,Rural,Madhya Pradesh,Crime Against Men,Assault,Male,46-60,5329,4512,817,4781,548
2008,Rural,Delhi,Crime Against Children,Child Abuse,Male,31-45,3180,3103,77,3152,28
2010,Urban,Kerala,Other Crimes,Drug Offense,Male,46-60,314,53,261,275,39
2010,Urban,Jharkhand,Other Crimes,Corruption,Female,18-30,9184,4261,4923,4773,4411
2003,Rural,Odisha,Crime Against Men,Assault,Male,46-60,3520,2225,1295,2425,1095
2005,Rural,West Bengal,Other Crimes,Corruption,Female,0-12,5696,4907,789,5603,93
2001,Urban,Kerala,Other Crimes,Fraud,Male,60+,3612,2118,1494,3445,167
2002,Urban,Jharkhand,Other Crimes,Fraud,Female,60+,7622,1305,6317,2122,5500
2009,Rural,Assam,Property Crime,Arson,Male,60+,6007,3831,2176,5441,566
2003,Urban,Odisha,Crime Against Children,Trafficking,Male,13-17,6831,1990,4841,4735,2096
2007,Rural,Kerala,Property Crime,Arson,Male,60+,4348,1026,3322,3970,378
2008,Urban,Bihar,Crime Against Children,Child Labor,Male,13-17,2416,795,1621,2384,32
2001,Rural,Arunachal Pradesh,Crime Against Men,Murder,Female,13-17,5263,4804,459,5247,16
2004,Rural,Manipur,Crime Against Children,Trafficking,Male,60+,7860,1701,6159,4120,3740
2003,Rural,Himachal Pradesh,Other Crimes,Fraud,Male,13-17,4866,2284,2582,4306,560
2002,Rural,Sikkim,Crime Against Women,Domestic Violence,Female,18-30,4330,1986,2344,3508,822
2002,Rural,Jharkhand,Crime Against Women,Domestic Violence,Female,46-60,747,250,497,592,155
2003,Rural,Mizoram,Other Crimes,Fraud,Male,13-17,9362,6483,2879,7519,1843
2009,Urban,Goa,Crime Against Women,Rape,Male,0-12,3351,2312,1039,2645,706
2006,Rural,Sikkim,Crime Against Women,Rape,Female,60+,8185,1712,6473,2384,5801
2006,Rural,Meghalaya,Crime Against Children,Kidnapping,Female,31-45,5845,4540,1305,4910,935
2007,Rural,Delhi,Property Crime,Theft,Female,60+,4292,4226,66,4283,9
2002,Rural,Himachal Pradesh,Crime Against Women,Domestic Violence,Female,60+,4068,3862,206,3885,183
2004,Rural,Telangana,Other Crimes,Corruption,Female,46-60,1862,84,1778,1725,137
2004,Rural,Himachal Pradesh,Other Crimes,Drug Offense,Male,0-12,6167,18,6149,2710,3457
2009,Rural,Jharkhand,Other Crimes,Fraud,Female,18-30,90,30,60,81,9
2001,Rural,Madhya Pradesh,Crime Against Women,Dowry Deaths,Male,18-30,5854,2508,3346,3905,1949
2010,Rural,Meghalaya,Other Crimes,Drug Offense,Male,18-30,3547,2308,1239,3507,40
2009,Rural,Himachal Pradesh,Crime Against Children,Child Labor,Male,18-30,2299,2199,100,2206,93
2005,Urban,Tamil Nadu,Other Crimes,Drug Offense,Female,46-60,5161,4792,369,4920,241
2002,Rural,Uttar Pradesh,Crime Against Men,Assault,Female,60+,8709,4827,3882,8626,83
2002,Urban,Bihar,Crime Against Women,Rape,Male,46-60,1966,795,1171,1061,905
2007,Urban,Nagaland,Crime Against Women,Molestation,Male,18-30,8536,5960,2576,6347,2189
2005,Urban,Nagaland,Crime Against Women,Domestic Violence,Female,31-45,5053,4930,123,5018,35
2007,Urban,Jammu & Kashmir,Crime Against Children,Kidnapping,Female,18-30,6876,6777,99,6840,36
2003,Urban,Madhya Pradesh,Other Crimes,Corruption,Male,31-45,5208,5014,194,5062,146
2010,Rural,Kerala,Crime Against Women,Domestic Violence,Male,0-12,8858,524,8334,8380,478
2005,Urban,Jharkhand,Crime Against Men,Murder,Female,46-60,6183,4543,1640,5080,1103
2003,Urban,Arunachal Pradesh,Property Crime,Vandalism,Male,13-17,7691,209,7482,1458,6233
2007,Rural,Gujarat,Crime Against Men,Assault,Male,13-17,5011,2076,2935,3702,1309
2010,Rural,Assam,Other Crimes,Cyber Crime,Female,31-45,9915,8120,1795,9282,633
2005,Rural,Assam,Crime Against Women,Rape,Female,31-45,5763,5052,711,5162,601
2009,Rural,Maharashtra,Crime Against Women,Dowry Deaths,Male,60+,2909,923,1986,1350,1559
2002,Rural,Sikkim,Other Crimes,Corruption,Female,60+,554,265,289,514,40
2004,Urban,Uttarakhand,Property Crime,Theft,Male,60+,6036,1675,4361,3722,2314
2002,Urban,Nagaland,Crime Against Women,Domestic Violence,Female,60+,556,171,385,515,41
2008,Rural,Nagaland,Crime Against Children,Child Labor,Female,46-60,1709,1330,379,1707,2
2009,Urban,Bihar,Property Crime,Vandalism,Female,18-30,9306,4177,5129,4859,4447
2006,Rural,Madhya Pradesh,Crime Against Women,Domestic Violence,Male,60+,7753,3828,3925,7586,167
2002,Rural,West Bengal,Crime Against Women,Domestic Violence,Female,60+,5560,2160,3400,5023,537
2009,Urban,Rajasthan,Crime Against Children,Kidnapping,Female,0-12,3751,1531,2220,2107,1644
2008,Urban,Madhya Pradesh,Crime Against Children,Kidnapping,Male,0-12,5619,4130,1489,5353,266
2009,Urban,Manipur,Crime Against Men,Robbery,Female,60+,9919,1923,7996,7124,2795
2006,Urban,Jammu & Kashmir,Crime Against Children,Trafficking,Male,18-30,5991,3053,2938,5585,406
2007,Rural,Uttarakhand,Crime Against Children,Trafficking,Female,18-30,831,734,97,785,46
2001,Urban,Uttarakhand,Crime Against Children,Child Abuse,Male,31-45,1009,870,139,877,132
2007,Rural,Punjab,Other Crimes,Corruption,Male,31-45,175,37,138,109,66
2001,Urban,West Bengal,Crime Against Men,Murder,Female,46-60,7165,5872,1293,6647,518
2006,Urban,Rajasthan,Property Crime,Vandalism,Female,0-12,6819,1969,4850,4055,2764
2009,Urban,Chhattisgarh,Property Crime,Vandalism,Female,0-12,676,124,552,578,98
2006,Urban,Madhya Pradesh,Crime Against Men,Extortion,Male,13-17,4267,650,3617,3249,1018
2003,Urban,Rajasthan,Crime Against Men,Robbery,Male,18-30,8829,736,8093,1673,7156
2001,Rural,Bihar,Crime Against Children,Child Abuse,Female,18-30,266,221,45,224,42
2002,Rural,Mizoram,Other Crimes,Drug Offense,Female,0-12,2101,1049,1052,1551,550
2008,Urban,Madhya Pradesh,Crime Against Children,Kidnapping,Female,13-17,9244,7871,1373,9139,105
2003,Urban,Chhattisgarh,Property Crime,Vandalism,Male,60+,7895,7680,215,7813,82
2005,Rural,Tamil Nadu,Property Crime,Vandalism,Female,60+,8410,2583,5827,3023,5387
2008,Urban,Telangana,Other Crimes,Corruption,Male,31-45,7728,2706,5022,5683,2045
2010,Rural,Bihar,Other Crimes,Cyber Crime,Female,31-45,9826,8341,1485,9554,272
2010,Urban,Bihar,Crime Against Men,Extortion,Male,31-45,4309,1178,3131,1499,2810
2007,Rural,Sikkim,Crime Against Women,Molestation,Female,60+,6348,2780,3568,6111,237
2005,Urban,Andhra Pradesh,Crime Against Men,Murder,Male,13-17,7784,3910,3874,5490,2294
2009,Urban,Maharashtra,Property Crime,Vandalism,Male,18-30,136,94,42,104,32
2006,Urban,Bihar,Crime Against Children,Child Labor,Female,60+,7858,1891,5967,6362,1496
2003,Rural,Odisha,Crime Against Children,Child Abuse,Male,31-45,3890,982,2908,2070,1820
2006,Rural,Madhya Pradesh,Other Crimes,Drug Offense,Male,0-12,7336,4747,2589,5960,1376
2004,Rural,Nagaland,Crime Against Women,Rape,Female,13-17,8625,6515,2110,7108,1517
2009,Rural,Jammu & Kashmir,Crime Against Children,Kidnapping,Female,18-30,3769,2510,1259,3363,406
2002,Rural,Nagaland,Property Crime,Vandalism,Female,0-12,6093,3106,2987,3365,2728
2001,Rural,Uttarakhand,Crime Against Men,Extortion,Female,46-60,6920,683,6237,5319,1601
2006,Rural,Andhra Pradesh,Other Crimes,Cyber Crime,Male,60+,2720,2567,153,2656,64
2008,Urban,Andhra Pradesh,Other Crimes,Fraud,Female,31-45,5160,1573,3587,1856,3304
2002,Rural,West Bengal,Crime Against Children,Trafficking,Male,31-45,9537,2279,7258,3029,6508
2002,Urban,Uttarakhand,Other Crimes,Corruption,Female,13-17,6626,2553,4073,4004,2622
2003,Rural,Tripura,Crime Against Women,Domestic Violence,Female,46-60,3190,1864,1326,2652,538
2007,Rural,Bihar,Crime Against Children,Child Labor,Female,13-17,1221,468,753,1208,13
2006,Rural,Meghalaya,Property Crime,Vandalism,Male,13-17,546,308,238,411,135
2010,Urban,Goa,Property Crime,Theft,Male,31-45,3132,1797,1335,2775,357
2010,Rural,Tamil Nadu,Property Crime,Vandalism,Male,31-45,1964,50,1914,1666,298
2006,Urban,Odisha,Other Crimes,Cyber Crime,Female,31-45,6799,3180,3619,3355,3444
2010,Urban,Mizoram,Property Crime,Burglary,Female,13-17,1567,1147,420,1469,98
2007,Rural,Haryana,Crime Against Children,Child Labor,Male,46-60,5045,1894,3151,2321,2724
2008,Urban,Assam,Crime Against Children,Child Labor,Female,31-45,1928,1257,671,1816,112
2006,Urban,Punjab,Crime Against Women,Molestation,Female,18-30,3980,1447,2533,3585,395
2002,Urban,Chhattisgarh,Property Crime,Arson,Female,18-30,6108,377,5731,5211,897
2010,Rural,Mizoram,Crime Against Children,Child Abuse,Male,13-17,3574,2832,742,2972,602
2001,Rural,Madhya Pradesh,Property Crime,Vandalism,Female,18-30,1111,170,941,734,377
2010,Urban,Uttarakhand,Property Crime,Theft,Male,13-17,1160,421,739,535,625
2009,Urban,Mizoram,Crime Against Men,Robbery,Female,31-45,8551,5761,2790,7832,719
2007,Urban,Tripura,Crime Against Men,Extortion,Female,18-30,8366,1368,6998,6953,1413
2002,Rural,Nagaland,Crime Against Men,Robbery,Male,46-60,8530,3213,5317,7786,744
2010,Rural,Chhattisgarh,Property Crime,Arson,Female,60+,2097,1844,253,1899,198
2004,Rural,Mizoram,Crime Against Men,Robbery,Male,13-17,4556,2145,2411,3746,810
2007,Rural,Madhya Pradesh,Crime Against Women,Rape,Female,18-30,8241,283,7958,2639,5602
2007,Urban,Assam,Crime Against Women,Domestic Violence,Female,13-17,2110,248,1862,679,1431
2004,Urban,Himachal Pradesh,Crime Against Women,Molestation,Female,60+,2048,59,1989,749,1299
2009,Urban,Jammu & Kashmir,Crime Against Men,Extortion,Female,18-30,2790,2633,157,2669,121
2001,Rural,Goa,Crime Against Children,Child Labor,Male,46-60,3402,1851,1551,3346,56
2007,Rural,Tamil Nadu,Crime Against Children,Child Abuse,Male,0-12,3120,19,3101,478,2642
2008,Urban,Odisha,Crime Against Children,Child Labor,Male,0-12,9221,5422,3799,8662,559
2006,Urban,Chhattisgarh,Property Crime,Burglary,Female,46-60,8923,540,8383,4170,4753
2006,Urban,Karnataka,Other Crimes,Corruption,Male,18-30,6489,1399,5090,3740,2749
2006,Rural,Kerala,Crime Against Women,Rape,Male,0-12,7259,2823,4436,4756,2503
2003,Rural,Tamil Nadu,Property Crime,Arson,Male,18-30,648,255,393,412,236
2009,Urban,Kerala,Crime Against Women,Molestation,Male,0-12,3505,926,2579,1076,2429
2010,Rural,Uttarakhand,Crime Against Children,Kidnapping,Female,31-45,8414,8191,223,8320,94
2004,Urban,Manipur,Crime Against Children,Child Abuse,Male,46-60,4573,4572,1,4573,0
2008,Urban,Arunachal Pradesh,Other Crimes,Drug Offense,Male,46-60,4922,3889,1033,4669,253
2006,Urban,Mizoram,Property Crime,Arson,Male,0-12,9558,4883,4675,8385,1173
2004,Rural,Sikkim,Crime Against Men,Extortion,Female,31-45,5640,4574,1066,5283,357
2006,Rural,Andhra Pradesh,Crime Against Men,Robbery,Female,60+,1098,1022,76,1061,37
2002,Rural,Arunachal Pradesh,Other Crimes,Fraud,Female,31-45,2978,1339,1639,2698,280
2009,Rural,West Bengal,Crime Against Children,Kidnapping,Male,13-17,3026,51,2975,2023,1003
2004,Rural,Haryana,Crime Against Men,Assault,Female,18-30,6865,1114,5751,5685,1180
2003,Urban,Uttarakhand,Property Crime,Arson,Female,46-60,2947,2292,655,2753,194
2007,Rural,Tamil Nadu,Crime Against Women,Molestation,Male,60+,8502,72,8430,1504,6998
2003,Urban,West Bengal,Crime Against Men,Robbery,Female,18-30,7463,3543,3920,6657,806
2010,Urban,Delhi,Crime Against Children,Kidnapping,Male,0-12,9283,4248,5035,7332,1951
2009,Rural,Sikkim,Crime Against Children,Kidnapping,Female,46-60,6950,3079,3871,3586,3364
2003,Rural,Maharashtra,Crime Against Women,Domestic Violence,Male,18-30,5053,2515,2538,4416,637
2009,Rural,Tripura,Crime Against Women,Rape,Female,46-60,3257,1807,1450,2380,877
2009,Urban,Mizoram,Crime Against Men,Murder,Female,31-45,6797,2897,3900,5849,948
2002,Rural,Mizoram,Other Crimes,Corruption,Male,31-45,7659,1792,5867,4295,3364
2005,Rural,Jharkhand,Property Crime,Burglary,Female,60+,6997,5033,1964,5193,1804
2008,Rural,Mizoram,Crime Against Women,Dowry Deaths,Male,60+,5641,4491,1150,5133,508
2003,Rural,Andhra Pradesh,Crime Against Children,Child Abuse,Male,18-30,7628,7299,329,7391,237
2007,Urban,Rajasthan,Crime Against Men,Assault,Female,18-30,9807,4871,4936,8096,1711
2008,Urban,Maharashtra,Crime Against Men,Extortion,Male,46-60,5166,153,5013,1503,3663
2002,Urban,Meghalaya,Crime Against Men,Extortion,Male,31-45,9631,8545,1086,9307,324
2007,Rural,Uttarakhand,Property Crime,Arson,Female,18-30,1057,825,232,881,176
2001,Urban,Tamil Nadu,Crime Against Men,Assault,Male,60+,2569,534,2035,2099,470
2009,Urban,Karnataka,Other Crimes,Fraud,Female,46-60,2932,2412,520,2867,65
2006,Urban,Delhi,Crime Against Women,Domestic Violence,Female,0-12,846,838,8,839,7
2003,Urban,Assam,Crime Against Children,Child Abuse,Female,46-60,2350,1363,987,2343,7
2002,Rural,Sikkim,Crime Against Children,Child Abuse,Male,31-45,3081,2178,903,2417,664
2003,Rural,Mizoram,Other Crimes,Cyber Crime,Female,31-45,2097,1317,780,1743,354
2002,Rural,Odisha,Crime Against Women,Domestic Violence,Male,0-12,6343,4798,1545,5177,1166
2007,Rural,Karnataka,Other Crimes,Fraud,Female,60+,5652,644,5008,4010,1642
2007,Urban,Rajasthan,Property Crime,Vandalism,Female,60+,122,101,21,118,4
2001,Urban,Bihar,Crime Against Men,Murder,Female,31-45,6683,5076,1607,5430,1253
2003,Urban,Rajasthan,Crime Against Men,Assault,Male,13-17,5799,31,5768,5578,221
2009,Rural,West Bengal,Property Crime,Vandalism,Female,31-45,2747,910,1837,1944,803
2004,Urban,Bihar,Other Crimes,Fraud,Male,18-30,6419,3549,2870,3975,2444
2001,Rural,Arunachal Pradesh,Crime Against Men,Assault,Female,13-17,6430,4675,1755,6371,59
2005,Urban,Assam,Crime Against Men,Murder,Female,31-45,6515,2218,4297,4567,1948
2004,Rural,Gujarat,Crime Against Children,Trafficking,Female,60+,7367,4952,2415,6160,1207
2003,Urban,Telangana,Other Crimes,Drug Offense,Male,31-45,1823,992,831,1532,291
2010,Urban,Tripura,Crime Against Children,Kidnapping,Female,46-60,9352,3646,5706,7489,1863
2008,Urban,Goa,Crime Against Women,Molestation,Female,0-12,9301,6233,3068,7239,2062
2004,Urban,Meghalaya,Crime Against Men,Murder,Female,18-30,9803,8573,1230,9705,98
2009,Rural,Mizoram,Other Crimes,Drug Offense,Male,18-30,4707,2678,2029,3234,1473
2003,Urban,Assam,Crime Against Men,Assault,Female,31-45,3309,2215,1094,2699,610
2003,Urban,Nagaland,Other Crimes,Cyber Crime,Male,46-60,1004,846,158,966,38
2002,Urban,Punjab,Crime Against Women,Domestic Violence,Female,0-12,3297,275,3022,1226,2071
2001,Rural,Mizoram,Crime Against Women,Molestation,Male,13-17,7671,2107,5564,5402,2269
2010,Rural,Himachal Pradesh,Property Crime,Vandalism,Female,60+,1198,142,1056,1002,196
2007,Rural,Uttarakhand,Crime Against Women,Domestic Violence,Male,18-30,7695,3936,3759,4067,3628
2003,Rural,Arunachal Pradesh,Property Crime,Burglary,Male,46-60,4303,3253,1050,4007,296
2006,Urban,Jharkhand,Crime Against Women,Domestic Violence,Female,60+,116,38,78,44,72
2007,Urban,Uttar Pradesh,Crime Against Children,Kidnapping,Male,0-12,3146,1777,1369,3110,36
2010,Rural,Himachal Pradesh,Property Crime,Theft,Female,18-30,5622,4578,1044,5501,121
2009,Rural,Kerala,Crime Against Children,Trafficking,Male,13-17,9648,7260,2388,7841,1807
2002,Urban,Haryana,Property Crime,Burglary,Male,46-60,3269,2079,1190,2493,776
2008,Urban,Uttarakhand,Crime Against Men,Murder,Male,46-60,5365,1300,4065,5054,311
2003,Urban,Mizoram,Crime Against Children,Kidnapping,Male,13-17,6646,3067,3579,4818,1828
2002,Rural,Bihar,Crime Against Men,Murder,Male,18-30,2401,845,1556,1170,1231
2006,Urban,Sikkim,Crime Against Women,Dowry Deaths,Male,18-30,3800,3683,117,3691,109
2007,Rural,Maharashtra,Property Crime,Vandalism,Female,31-45,2218,1178,1040,2046,172
2002,Rural,Uttar Pradesh,Property Crime,Theft,Male,60+,4528,3794,734,3827,701
2006,Urban,Jammu & Kashmir,Other Crimes,Fraud,Female,60+,4953,932,4021,4115,838
2002,Urban,Andhra Pradesh,Crime Against Children,Child Abuse,Female,0-12,3995,2004,1991,2284,1711
2008,Rural,Odisha,Crime Against Children,Child Labor,Male,46-60,1128,944,184,1039,89
2004,Urban,Uttar Pradesh,Crime Against Men,Assault,Female,13-17,8293,1726,6567,3847,4446
2002,Urban,Arunachal Pradesh,Other Crimes,Drug Offense,Male,18-30,9513,6185,3328,6212,3301
2008,Urban,Manipur,Other Crimes,Cyber Crime,Female,31-45,5877,3084,2793,3476,2401
2010,Urban,Nagaland,Property Crime,Theft,Female,18-30,2825,558,2267,1959,866
2010,Urban,Mizoram,Crime Against Children,Trafficking,Female,18-30,8897,5989,2908,7924,973
2007,Urban,Rajasthan,Crime Against Men,Murder,Male,0-12,2623,742,1881,1416,1207
2003,Urban,Andhra Pradesh,Crime Against Children,Child Labor,Female,46-60,1461,1385,76,1412,49
2004,Urban,Himachal Pradesh,Crime Against Women,Dowry Deaths,Female,18-30,7934,6758,1176,7850,84
2007,Urban,Bihar,Crime Against Women,Domestic Violence,Male,46-60,386,142,244,228,158
2007,Rural,Rajasthan,Property Crime,Vandalism,Male,0-12,2626,1968,658,2533,93
2001,Urban,Meghalaya,Other Crimes,Cyber Crime,Female,31-45,9748,8675,1073,9630,118
2008,Rural,Delhi,Property Crime,Vandalism,Female,0-12,3265,1320,1945,2272,993
2005,Rural,Jharkhand,Crime Against Women,Rape,Female,13-17,2314,126,2188,1135,1179
2003,Rural,Meghalaya,Other Crimes,Drug Offense,Male,0-12,5932,5594,338,5795,137
2005,Rural,Nagaland,Crime Against Children,Child Abuse,Female,46-60,765,529,236,683,82
2003,Rural,Uttarakhand,Crime Against Men,Assault,Male,46-60,1281,931,350,1171,110
2002,Rural,Arunachal Pradesh,Other Crimes,Corruption,Male,46-60,4059,3117,942,3339,720
2003,Urban,Jharkhand,Property Crime,Theft,Male,60+,2390,227,2163,1670,720
2007,Urban,Delhi,Property Crime,Vandalism,Female,60+,2712,2033,679,2295,417
2001,Urban,Punjab,Property Crime,Theft,Female,46-60,7262,1980,5282,5758,1504
2005,Urban,Sikkim,Crime Against Men,Murder,Male,31-45,3594,682,2912,1422,2172
2001,Rural,Himachal Pradesh,Crime Against Children,Child Abuse,Male,18-30,1849,943,906,1590,259
2001,Urban,Rajasthan,Crime Against Women,Dowry Deaths,Male,18-30,9488,1111,8377,3525,5963
2005,Urban,Andhra Pradesh,Crime Against Women,Rape,Female,18-30,4831,3819,1012,4083,748
2004,Rural,Andhra Pradesh,Crime Against Women,Domestic Violence,Female,13-17,6177,1162,5015,4698,1479
2006,Rural,Himachal Pradesh,Other Crimes,Corruption,Female,13-17,725,118,607,340,385
2010,Rural,Rajasthan,Crime Against Children,Child Labor,Male,46-60,3458,1605,1853,1620,1838
2005,Rural,Uttar Pradesh,Crime Against Men,Robbery,Female,31-45,306,156,150,190,116
2003,Urban,Jammu & Kashmir,Other Crimes,Corruption,Female,0-12,6358,1177,5181,6239,119
2002,Rural,Himachal Pradesh,Crime Against Women,Domestic Violence,Male,60+,1980,986,994,1157,823
2008,Rural,Telangana,Other Crimes,Cyber Crime,Female,18-30,1831,223,1608,1593,238
2010,Rural,Uttar Pradesh,Crime Against Women,Dowry Deaths,Male,46-60,5312,1942,3370,2997,2315
2007,Rural,Odisha,Crime Against Women,Rape,Female,46-60,3106,2792,314,2905,201
2002,Rural,Tamil Nadu,Other Crimes,Cyber Crime,Male,13-17,6936,2419,4517,3167,3769
2007,Rural,Manipur,Crime Against Women,Dowry Deaths,Female,31-45,3504,1377,2127,1832,1672
2007,Urban,Gujarat,Other Crimes,Fraud,Male,13-17,8530,2773,5757,3960,4570
2010,Rural,Rajasthan,Crime Against Men,Assault,Male,31-45,936,406,530,498,438
2006,Urban,Meghalaya,Crime Against Men,Robbery,Female,18-30,9021,4109,4912,7446,1575
2004,Rural,Uttar Pradesh,Crime Against Women,Molestation,Male,46-60,3781,1934,1847,3077,704
2006,Urban,Jharkhand,Crime Against Children,Child Abuse,Male,31-45,3501,1978,1523,3151,350
2002,Urban,Maharashtra,Crime Against Men,Extortion,Male,13-17,584,536,48,551,33
2004,Urban,Uttar Pradesh,Crime Against Women,Dowry Deaths,Male,0-12,1810,1351,459,1375,435
2002,Rural,Nagaland,Crime Against Children,Child Labor,Female,31-45,161,142,19,159,2
2007,Rural,Bihar,Crime Against Women,Dowry Deaths,Female,13-17,6506,6156,350,6471,35
2007,Urban,Delhi,Crime Against Children,Kidnapping,Male,60+,3558,2076,1482,3213,345
2006,Rural,Kerala,Other Crimes,Cyber Crime,Female,18-30,8268,4310,3958,5696,2572
2009,Urban,Uttar Pradesh,Other Crimes,Drug Offense,Female,31-45,7940,1596,6344,5344,2596
2002,Urban,Maharashtra,Other Crimes,Fraud,Male,60+,4243,148,4095,3049,1194
2004,Urban,Jammu & Kashmir,Crime Against Men,Robbery,Female,0-12,7910,415,7495,1347,6563
2010,Rural,Mizoram,Crime Against Men,Robbery,Female,0-12,9649,289,9360,6640,3009
2004,Urban,Tripura,Crime Against Women,Domestic Violence,Male,46-60,9760,5780,3980,8957,803
2009,Rural,Tripura,Other Crimes,Cyber Crime,Female,13-17,260,163,97,248,12
2002,Urban,Telangana,Crime Against Men,Robbery,Male,60+,5647,3910,1737,4852,795
2001,Rural,Telangana,Property Crime,Vandalism,Female,13-17,1063,349,714,722,341
2009,Urban,Karnataka,Crime Against Women,Dowry Deaths,Female,13-17,9637,9143,494,9493,144
2008,Urban,Kerala,Property Crime,Burglary,Male,13-17,290,115,175,200,90
2007,Urban,Rajasthan,Crime Against Men,Robbery,Female,46-60,7161,4214,2947,4327,2834
2006,Urban,Gujarat,Property Crime,Theft,Female,46-60,7618,5803,1815,6493,1125
2006,Rural,Tamil Nadu,Crime Against Men,Extortion,Female,31-45,373,311,62,341,32
2006,Rural,Assam,Crime Against Children,Child Abuse,Male,13-17,3403,1051,2352,1589,1814
2008,Rural,Delhi,Property Crime,Theft,Male,46-60,3983,1230,2753,1806,2177
2002,Urban,Tamil Nadu,Crime Against Men,Extortion,Male,31-45,833,585,248,814,19
2004,Rural,Bihar,Other Crimes,Cyber Crime,Female,18-30,8626,6992,1634,7543,1083
2003,Rural,Jammu & Kashmir,Crime Against Men,Extortion,Male,13-17,8085,3618,4467,6121,1964
2004,Rural,Uttar Pradesh,Crime Against Children,Trafficking,Male,46-60,8132,4007,4125,6698,1434
2006,Rural,Madhya Pradesh,Crime Against Men,Extortion,Male,18-30,5221,4853,368,5172,49
2009,Urban,Manipur,Other Crimes,Fraud,Male,18-30,1283,109,1174,1112,171
2006,Urban,Tripura,Crime Against Men,Robbery,Male,46-60,8939,4427,4512,5688,3251
2007,Rural,Delhi,Crime Against Women,Domestic Violence,Female,0-12,8703,2462,6241,7340,1363
2003,Rural,West Bengal,Crime Against Women,Molestation,Female,13-17,1768,487,1281,1503,265
2008,Urban,Jharkhand,Other Crimes,Cyber Crime,Male,13-17,5182,2490,2692,3061,2121
2001,Urban,Madhya Pradesh,Crime Against Children,Kidnapping,Male,60+,5543,5465,78,5512,31
2002,Rural,Nagaland,Other Crimes,Fraud,Male,18-30,711,359,352,578,133
2005,Urban,Rajasthan,Other Crimes,Fraud,Male,46-60,7785,6559,1226,6969,816
2009,Rural,Tamil Nadu,Crime Against Children,Child Abuse,Female,31-45,4263,77,4186,1561,2702
2007,Rural,Madhya Pradesh,Crime Against Children,Kidnapping,Male,13-17,6160,2256,3904,3784,2376
2004,Rural,Sikkim,Crime Against Men,Extortion,Male,18-30,2665,1346,1319,1530,1135
2002,Rural,Uttar Pradesh,Crime Against Women,Domestic Violence,Female,18-30,4106,2185,1921,2771,1335
2005,Rural,Madhya Pradesh,Property Crime,Burglary,Female,31-45,2441,187,2254,2214,227
2010,Urban,Kerala,Crime Against Women,Domestic Violence,Male,18-30,6784,5102,1682,6310,474
2001,Urban,Mizoram,Property Crime,Theft,Female,46-60,989,538,451,820,169
2005,Rural,Rajasthan,Crime Against Women,Dowry Deaths,Female,60+,6183,3302,2881,5552,631
2004,Urban,Chhattisgarh,Crime Against Women,Domestic Violence,Female,18-30,9701,8358,1343,9400,301
2009,Urban,Telangana,Crime Against Women,Rape,Male,13-17,2211,627,1584,2163,48
2003,Rural,Uttarakhand,Other Crimes,Corruption,Female,46-60,6698,245,6453,4505,2193
2006,Urban,Himachal Pradesh,Crime Against Women,Molestation,Female,18-30,8292,1517,6775,5908,2384
2002,Urban,Uttar Pradesh,Crime Against Women,Rape,Female,60+,4074,533,3541,1536,2538
2010,Rural,Meghalaya,Other Crimes,Fraud,Male,0-12,9359,7421,1938,8410,949
2008,Rural,Haryana,Property Crime,Vandalism,Male,13-17,8823,1458,7365,7753,1070
2008,Urban,Uttarakhand,Crime Against Children,Trafficking,Female,60+,7167,1664,5503,2949,4218
2002,Rural,Gujarat,Crime Against Children,Child Abuse,Female,18-30,2759,576,2183,728,2031
2004,Rural,Gujarat,Other Crimes,Fraud,Male,46-60,9856,9168,688,9280,576
2004,Urban,Kerala,Crime Against Children,Child Labor,Male,18-30,9003,2612,6391,8124,879
2004,Urban,Gujarat,Crime Against Men,Assault,Male,60+,4189,3731,458,4189,0
2008,Rural,Uttar Pradesh,Crime Against Women,Rape,Female,31-45,9345,6959,2386,9042,303
2010,Urban,Mizoram,Crime Against Men,Assault,Male,31-45,5327,3924,1403,5235,92
2009,Rural,Chhattisgarh,Crime Against Children,Child Labor,Male,18-30,6793,4416,2377,5859,934
2004,Rural,Nagaland,Property Crime,Burglary,Male,31-45,4549,208,4341,3478,1071
2002,Rural,Telangana,Other Crimes,Corruption,Male,31-45,8120,2860,5260,8013,107
2003,Urban,Delhi,Crime Against Men,Extortion,Female,13-17,8958,3330,5628,3558,5400
2003,Urban,Jharkhand,Other Crimes,Cyber Crime,Male,0-12,6326,3333,2993,6185,141
2005,Rural,Uttarakhand,Crime Against Men,Assault,Male,60+,7748,4959,2789,5304,2444
2003,Rural,Karnataka,Crime Against Men,Extortion,Female,0-12,2829,1303,1526,1447,1382
2007,Rural,Madhya Pradesh,Other Crimes,Fraud,Male,18-30,9899,1954,7945,6034,3865
2006,Rural,Goa,Property Crime,Arson,Female,31-45,7330,5006,2324,6230,1100
2007,Rural,Jharkhand,Crime Against Women,Dowry Deaths,Male,46-60,4842,2904,1938,3464,1378
2001,Urban,Maharashtra,Crime Against Men,Murder,Female,18-30,5417,4961,456,5124,293
2010,Urban,Assam,Crime Against Women,Dowry Deaths,Female,60+,7858,6561,1297,6859,999
2009,Rural,Kerala,Property Crime,Burglary,Female,60+,4341,2455,1886,3229,1112
2003,Urban,Nagaland,Property Crime,Burglary,Male,13-17,3904,3774,130,3863,41
2001,Urban,Jammu & Kashmir,Crime Against Men,Extortion,Male,0-12,1899,552,1347,1019,880
2002,Urban,Odisha,Crime Against Children,Child Abuse,Male,31-45,7460,1007,6453,2443,5017
2005,Urban,Goa,Crime Against Women,Rape,Male,0-12,2167,1330,837,2136,31
2004,Urban,Uttar Pradesh,Property Crime,Burglary,Male,60+,158,45,113,75,83
2010,Urban,Manipur,Other Crimes,Fraud,Female,0-12,7665,6022,1643,6923,742
2006,Rural,Jammu & Kashmir,Property Crime,Arson,Female,0-12,9944,8782,1162,9133,811
2010,Rural,Andhra Pradesh,Crime Against Men,Extortion,Female,13-17,8914,2883,6031,8762,152
2007,Rural,Odisha,Crime Against Women,Molestation,Female,31-45,7417,3960,3457,6452,965
2006,Rural,Meghalaya,Property Crime,Arson,Female,13-17,7644,271,7373,7214,430
2005,Rural,Manipur,Crime Against Children,Child Labor,Male,46-60,4857,4523,334,4587,270
2006,Urban,Tripura,Crime Against Children,Kidnapping,Male,13-17,9929,5623,4306,7024,2905
2003,Urban,Tripura,Crime Against Women,Domestic Violence,Male,46-60,5549,3548,2001,4263,1286
2009,Urban,Telangana,Property Crime,Arson,Male,60+,3485,1859,1626,3447,38
2004,Urban,Goa,Crime Against Children,Child Labor,Male,13-17,8141,3302,4839,3327,4814
2009,Urban,Meghalaya,Crime Against Women,Domestic Violence,Female,60+,8794,84,8710,2039,6755
2002,Rural,Madhya Pradesh,Crime Against Women,Molestation,Male,60+,3390,2770,620,3135,255
2009,Rural,Jammu & Kashmir,Crime Against Children,Child Abuse,Male,18-30,9704,1116,8588,1249,8455
2004,Rural,Odisha,Crime Against Men,Murder,Female,13-17,6540,5767,773,6161,379
2006,Urban,Jammu & Kashmir,Other Crimes,Fraud,Female,31-45,9723,5353,4370,8360,1363
2001,Urban,Arunachal Pradesh,Other Crimes,Corruption,Female,60+,3376,28,3348,3227,149
2003,Urban,Punjab,Property Crime,Vandalism,Male,13-17,7754,3619,4135,4040,3714
2008,Rural,Tamil Nadu,Property Crime,Theft,Female,31-45,5834,4180,1654,4802,1032
2010,Urban,Tripura,Other Crimes,Fraud,Female,0-12,8973,8323,650,8746,227
2004,Rural,Nagaland,Crime Against Women,Molestation,Male,0-12,8242,4063,4179,7979,263
2004,Rural,Haryana,Crime Against Women,Rape,Male,46-60,1046,295,751,1029,17
2002,Rural,Tamil Nadu,Crime Against Men,Robbery,Male,46-60,1856,1542,314,1626,230
2005,Rural,Chhattisgarh,Crime Against Children,Child Labor,Female,31-45,8731,386,8345,4346,4385
2008,Rural,Rajasthan,Other Crimes,Drug Offense,Female,13-17,9440,1136,8304,2854,6586
2003,Rural,Jharkhand,Crime Against Women,Rape,Male,13-17,3597,1629,1968,3451,146
2008,Rural,Chhattisgarh,Crime Against Men,Extortion,Male,18-30,4224,3010,1214,3793,431
2007,Rural,Uttar Pradesh,Crime Against Women,Rape,Male,46-60,4321,1302,3019,2192,2129
2004,Urban,Haryana,Crime Against Women,Dowry Deaths,Male,31-45,1590,447,1143,750,840
2008,Rural,Jharkhand,Other Crimes,Corruption,Female,31-45,5638,3048,2590,4811,827
2008,Rural,Manipur,Property Crime,Burglary,Male,31-45,6913,6288,625,6292,621
2002,Rural,Nagaland,Crime Against Men,Murder,Male,31-45,6189,4808,1381,6041,148
2002,Rural,Gujarat,Crime Against Children,Child Abuse,Male,31-45,2435,1826,609,1984,451
2005,Urban,Gujarat,Crime Against Children,Child Labor,Male,0-12,2051,875,1176,1783,268
2007,Urban,Uttar Pradesh,Crime Against Women,Domestic Violence,Female,13-17,3644,2011,1633,3233,411
2008,Urban,West Bengal,Crime Against Children,Kidnapping,Female,18-30,2381,44,2337,1985,396
2004,Urban,Gujarat,Crime Against Children,Child Labor,Male,0-12,8199,966,7233,3139,5060
2002,Urban,Delhi,Crime Against Women,Domestic Violence,Male,46-60,7419,5741,1678,7374,45
2005,Urban,Andhra Pradesh,Crime Against Women,Domestic Violence,Male,31-45,1596,870,726,940,656
2009,Urban,Nagaland,Crime Against Women,Domestic Violence,Female,18-30,9211,3201,6010,5066,4145
2002,Urban,Haryana,Other Crimes,Drug Offense,Female,0-12,5907,4393,1514,4937,970
2009,Urban,Goa,Crime Against Men,Murder,Male,31-45,5251,3552,1699,3959,1292
2001,Urban,Maharashtra,Crime Against Men,Assault,Female,46-60,1646,1389,257,1452,194
2006,Rural,Bihar,Crime Against Women,Rape,Female,60+,767,630,137,652,115
2004,Rural,Meghalaya,Property Crime,Vandalism,Female,13-17,893,129,764,768,125
2001,Rural,Manipur,Property Crime,Theft,Female,18-30,3897,3758,139,3787,110
2008,Rural,Karnataka,Property Crime,Arson,Male,18-30,4481,1708,2773,2939,1542
2006,Urban,Uttar Pradesh,Crime Against Women,Rape,Male,13-17,3698,2917,781,3137,561
2008,Urban,Andhra Pradesh,Property Crime,Theft,Male,18-30,5883,4687,1196,4879,1004
2005,Urban,Mizoram,Property Crime,Theft,Male,60+,1392,715,677,914,478
2010,Urban,Maharashtra,Crime Against Men,Assault,Female,13-17,9319,4081,5238,7555,1764
2009,Rural,Madhya Pradesh,Other Crimes,Fraud,Female,18-30,6106,2222,3884,5104,1002
2008,Rural,Jammu & Kashmir,Crime Against Women,Rape,Female,46-60,9031,7702,1329,7972,1059
2010,Urban,Uttarakhand,Crime Against Men,Murder,Female,0-12,8932,3025,5907,5048,3884
2006,Urban,West Bengal,Property Crime,Burglary,Male,31-45,2907,317,2590,380,2527
2001,Rural,Goa,Crime Against Men,Murder,Male,46-60,6614,5067,1547,6186,428
2010,Urban,Punjab,Property Crime,Arson,Male,13-17,2261,1229,1032,1630,631
2001,Urban,Madhya Pradesh,Property Crime,Arson,Female,0-12,5262,1425,3837,1629,3633
2008,Urban,Andhra Pradesh,Property Crime,Burglary,Male,46-60,1670,749,921,1512,158
2001,Rural,Madhya Pradesh,Property Crime,Burglary,Male,18-30,6565,463,6102,4927,1638
2007,Urban,Tripura,Property Crime,Arson,Male,0-12,9711,3099,6612,7821,1890
2001,Urban,Sikkim,Crime Against Men,Extortion,Male,60+,2207,1502,705,1598,609
2007,Urban,Chhattisgarh,Crime Against Men,Extortion,Female,31-45,6795,4928,1867,5164,1631
2006,Rural,Jharkhand,Property Crime,Arson,Female,13-17,4270,1556,2714,2300,1970
2002,Rural,Nagaland,Other Crimes,Cyber Crime,Male,31-45,9437,5908,3529,9247,190
2009,Urban,Andhra Pradesh,Crime Against Women,Domestic Violence,Female,31-45,2754,368,2386,1524,1230
2004,Urban,Assam,Crime Against Men,Extortion,Female,18-30,1127,955,172,1033,94
2010,Urban,Uttar Pradesh,Property Crime,Vandalism,Female,18-30,139,16,123,20,119
2010,Rural,Uttar Pradesh,Property Crime,Vandalism,Female,60+,1263,1125,138,1153,110
2003,Urban,Nagaland,Crime Against Men,Extortion,Male,13-17,5996,678,5318,2207,3789
2003,Rural,Andhra Pradesh,Crime Against Men,Robbery,Male,13-17,3798,1729,2069,2418,1380
2003,Rural,Telangana,Crime Against Men,Extortion,Female,31-45,1341,805,536,1232,109
2006,Urban,Jammu & Kashmir,Property Crime,Theft,Male,31-45,1768,1724,44,1724,44
2006,Rural,Himachal Pradesh,Crime Against Women,Rape,Male,13-17,6334,5877,457,6078,256
2005,Urban,Himachal Pradesh,Property Crime,Theft,Female,13-17,8074,5740,2334,6336,1738
2003,Rural,Tripura,Other Crimes,Cyber Crime,Female,18-30,8591,378,8213,6472,2119
2007,Rural,Manipur,Other Crimes,Drug Offense,Female,60+,8401,6888,1513,7550,851
2010,Rural,Jharkhand,Property Crime,Vandalism,Female,46-60,632,444,188,447,185
2009,Urban,Madhya Pradesh,Property Crime,Arson,Female,60+,988,853,135,931,57
2009,Rural,Madhya Pradesh,Property Crime,Theft,Female,18-30,1633,1195,438,1243,390
2003,Urban,Telangana,Crime Against Men,Extortion,Male,31-45,4998,3105,1893,3844,1154
2002,Urban,Chhattisgarh,Crime Against Men,Assault,Female,13-17,7919,466,7453,5814,2105
2010,Rural,Uttarakhand,Crime Against Men,Assault,Male,46-60,4928,2383,2545,4452,476
2006,Rural,Gujarat,Crime Against Women,Molestation,Male,18-30,5696,2693,3003,5154,542
2002,Urban,Arunachal Pradesh,Crime Against Women,Dowry Deaths,Female,46-60,2991,2049,942,2367,624
2004,Rural,Madhya Pradesh,Other Crimes,Corruption,Female,60+,531,67,464,359,172
2002,Rural,Haryana,Crime Against Women,Domestic Violence,Female,0-12,345,113,232,215,130
2005,Rural,Jammu & Kashmir,Other Crimes,Cyber Crime,Male,18-30,5523,4898,625,4944,579
2005,Rural,Haryana,Crime Against Men,Assault,Female,60+,9952,5315,4637,5615,4337
2010,Rural,Haryana,Crime Against Women,Molestation,Male,13-17,2415,2065,350,2107,308
2005,Urban,Sikkim,Crime Against Men,Robbery,Female,0-12,8278,4541,3737,5043,3235
2006,Rural,Arunachal Pradesh,Other Crimes,Drug Offense,Female,0-12,8631,4065,4566,4779,3852
2002,Urban,Bihar,Crime Against Men,Robbery,Male,13-17,5658,2975,2683,4515,1143
2002,Rural,Karnataka,Other Crimes,Cyber Crime,Male,18-30,9084,3636,5448,4465,4619
2010,Urban,Arunachal Pradesh,Crime Against Men,Extortion,Male,46-60,1972,1844,128,1851,121
2008,Urban,Odisha,Property Crime,Theft,Male,13-17,4489,3893,596,4137,352
2007,Rural,Goa,Property Crime,Arson,Female,31-45,5453,2725,2728,4925,528
2008,Rural,Maharashtra,Crime Against Children,Trafficking,Female,60+,9973,6812,3161,7274,2699
2004,Urban,Bihar,Crime Against Men,Murder,Male,18-30,2505,79,2426,163,2342
2009,Rural,Bihar,Property Crime,Burglary,Female,18-30,7416,2013,5403,2714,4702
2004,Rural,Telangana,Crime Against Men,Extortion,Female,60+,6070,397,5673,4910,1160
2007,Urban,Assam,Crime Against Men,Assault,Female,18-30,5343,4663,680,5134,209
2010,Rural,Haryana,Property Crime,Arson,Male,31-45,4009,1942,2067,3047,962
2007,Urban,West Bengal,Crime Against Men,Assault,Male,18-30,4848,156,4692,3613,1235
2006,Urban,Odisha,Crime Against Women,Rape,Male,18-30,6733,4707,2026,5371,1362
2009,Urban,Uttar Pradesh,Crime Against Men,Extortion,Female,0-12,418,181,237,185,233
2002,Urban,Punjab,Crime Against Women,Dowry Deaths,Male,31-45,7772,699,7073,1333,6439
2007,Urban,Odisha,Crime Against Children,Kidnapping,Male,31-45,1798,1012,786,1764,34
2010,Urban,Gujarat,Other Crimes,Fraud,Female,13-17,7652,5391,2261,7626,26
2003,Urban,Tripura,Other Crimes,Cyber Crime,Female,31-45,1656,665,991,1001,655
2004,Urban,Chhattisgarh,Crime Against Women,Dowry Deaths,Female,46-60,6597,511,6086,965,5632
2010,Urban,Haryana,Crime Against Children,Child Labor,Female,31-45,5682,993,4689,3105,2577
2003,Urban,Jharkhand,Crime Against Men,Murder,Male,18-30,1774,379,1395,1065,709
2010,Urban,Telangana,Other Crimes,Cyber Crime,Male,60+,2541,578,1963,2231,310
2009,Rural,Punjab,Other Crimes,Cyber Crime,Female,18-30,6449,2951,3498,4523,1926
2002,Rural,Tripura,Crime Against Women,Dowry Deaths,Female,18-30,6190,4480,1710,5359,831
2005,Rural,Chhattisgarh,Crime Against Men,Extortion,Male,0-12,9245,7797,1448,8189,1056
2004,Urban,Gujarat,Other Crimes,Cyber Crime,Male,13-17,9788,2093,7695,6299,3489
2004,Urban,Uttar Pradesh,Crime Against Women,Rape,Male,18-30,7353,220,7133,1345,6008
2006,Rural,Nagaland,Crime Against Children,Trafficking,Female,60+,4436,570,3866,1183,3253
2007,Rural,Assam,Crime Against Children,Trafficking,Male,18-30,8801,2225,6576,5689,3112
2002,Urban,Goa,Crime Against Children,Kidnapping,Male,31-45,2255,561,1694,1250,1005
2008,Urban,Sikkim,Property Crime,Vandalism,Female,13-17,4181,77,4104,633,3548
2008,Urban,Madhya Pradesh,Crime Against Women,Rape,Male,60+,3551,1091,2460,1242,2309
2009,Rural,Chhattisgarh,Crime Against Women,Molestation,Female,18-30,4294,4233,61,4286,8
2001,Rural,West Bengal,Crime Against Men,Robbery,Male,18-30,1054,182,872,1022,32
2001,Rural,Manipur,Crime Against Men,Murder,Female,46-60,3678,2417,1261,3323,355
2007,Rural,Gujarat,Property Crime,Theft,Female,0-12,6477,2669,3808,5139,1338
2009,Urban,Mizoram,Other Crimes,Cyber Crime,Male,13-17,5958,1354,4604,3216,2742
2008,Urban,Arunachal Pradesh,Property Crime,Burglary,Female,13-17,5432,5302,130,5344,88
2008,Rural,Tamil Nadu,Other Crimes,Cyber Crime,Male,13-17,5138,3486,1652,4032,1106
2001,Rural,Jammu & Kashmir,Crime Against Children,Kidnapping,Female,13-17,8812,5221,3591,7133,1679
2002,Urban,Goa,Crime Against Men,Murder,Female,31-45,5511,478,5033,5328,183
2008,Rural,Uttar Pradesh,Crime Against Children,Child Abuse,Female,13-17,5536,4940,596,5353,183
2001,Urban,Maharashtra,Other Crimes,Fraud,Male,46-60,2812,2321,491,2487,325
2003,Rural,Odisha,Crime Against Men,Robbery,Male,18-30,2592,509,2083,606,1986
2009,Rural,Madhya Pradesh,Property Crime,Arson,Male,13-17,6411,2375,4036,4159,2252
2002,Rural,Bihar,Crime Against Children,Child Labor,Male,60+,5478,1344,4134,1673,3805
2003,Urban,Karnataka,Crime Against Women,Rape,Male,18-30,4754,3446,1308,4020,734
2007,Urban,Rajasthan,Crime Against Children,Child Abuse,Female,0-12,1856,359,1497,1402,454
2006,Urban,Delhi,Crime Against Children,Child Abuse,Female,31-45,3441,3342,99,3428,13
2003,Urban,Nagaland,Crime Against Children,Child Abuse,Male,18-30,6953,1019,5934,1109,5844
2005,Urban,West Bengal,Crime Against Children,Child Abuse,Male,13-17,1461,831,630,864,597
2010,Rural,Tripura,Crime Against Children,Child Labor,Female,13-17,6329,4270,2059,4580,1749
2009,Rural,Andhra Pradesh,Other Crimes,Cyber Crime,Male,31-45,9580,7596,1984,9415,165
2007,Rural,Jharkhand,Other Crimes,Corruption,Female,18-30,3355,330,3025,3005,350
2001,Urban,Maharashtra,Crime Against Women,Molestation,Male,60+,3132,1983,1149,2985,147
2006,Urban,Gujarat,Property Crime,Vandalism,Female,13-17,1191,733,458,807,384
2004,Urban,Telangana,Crime Against Women,Rape,Male,46-60,3606,2747,859,3113,493
2007,Rural,Delhi,Other Crimes,Corruption,Male,18-30,9540,1538,8002,3404,6136
2010,Urban,Gujarat,Crime Against Men,Assault,Male,60+,7595,5953,1642,6346,1249
2006,Urban,Madhya Pradesh,Property Crime,Vandalism,Female,13-17,6410,2696,3714,4966,1444
2008,Rural,Assam,Crime Against Men,Murder,Female,60+,7651,261,7390,269,7382
2004,Urban,Madhya Pradesh,Property Crime,Arson,Female,46-60,5171,4196,975,4735,436
2010,Rural,Goa,Property Crime,Vandalism,Male,18-30,126,67,59,111,15
2003,Rural,Chhattisgarh,Crime Against Men,Assault,Female,18-30,2728,1812,916,1961,767
2002,Rural,Telangana,Property Crime,Burglary,Male,13-17,5322,1810,3512,4357,965
2001,Urban,Bihar,Crime Against Children,Kidnapping,Male,13-17,2853,2269,584,2812,41
2007,Urban,Haryana,Crime Against Women,Molestation,Male,46-60,4685,4627,58,4680,5
2001,Urban,Jharkhand,Crime Against Men,Murder,Male,46-60,5270,3671,1599,4458,812
2001,Urban,Arunachal Pradesh,Crime Against Children,Trafficking,Female,13-17,1732,436,1296,1693,39
2001,Urban,Kerala,Property Crime,Arson,Female,13-17,6393,5802,591,5802,591
2007,Urban,Haryana,Other Crimes,Cyber Crime,Female,18-30,2684,399,2285,1182,1502
2005,Rural,Haryana,Crime Against Children,Child Abuse,Female,46-60,6240,5368,872,5566,674
2006,Urban,Haryana,Crime Against Women,Molestation,Female,46-60,2477,404,2073,2391,86
2005,Rural,Haryana,Crime Against Women,Molestation,Male,46-60,2557,2169,388,2182,375
2005,Urban,Odisha,Crime Against Children,Trafficking,Female,18-30,3658,1989,1669,2863,795
2001,Rural,Nagaland,Crime Against Women,Rape,Female,18-30,9769,6329,3440,7721,2048
2006,Rural,Kerala,Other Crimes,Corruption,Male,18-30,256,44,212,178,78
2004,Urban,Karnataka,Other Crimes,Fraud,Male,0-12,8562,1918,6644,2585,5977
2001,Urban,Uttar Pradesh,Crime Against Men,Assault,Male,0-12,5483,2100,3383,5222,261
2004,Rural,Tamil Nadu,Crime Against Men,Robbery,Male,18-30,6408,2426,3982,4346,2062
2005,Rural,Chhattisgarh,Crime Against Children,Kidnapping,Male,60+,1490,996,494,1467,23
2008,Urban,Karnataka,Crime Against Women,Dowry Deaths,Male,31-45,9747,4986,4761,6399,3348
2005,Rural,Goa,Property Crime,Vandalism,Female,0-12,119,37,82,59,60
2006,Rural,Himachal Pradesh,Other Crimes,Drug Offense,Male,13-17,2843,1836,1007,2583,260
2010,Urban,Manipur,Crime Against Men,Assault,Male,46-60,9346,2464,6882,3531,5815
2006,Urban,Rajasthan,Crime Against Women,Rape,Male,0-12,2366,2132,234,2352,14
2002,Rural,West Bengal,Property Crime,Burglary,Male,60+,9314,5123,4191,6942,2372
2004,Rural,Assam,Crime Against Women,Dowry Deaths,Female,60+,2481,2045,436,2048,433
2010,Rural,Goa,Other Crimes,Drug Offense,Male,18-30,7575,345,7230,2611,4964
2006,Rural,Haryana,Crime Against Children,Trafficking,Male,13-17,9953,5573,4380,5976,3977
2010,Urban,Rajasthan,Property Crime,Arson,Male,46-60,2081,591,1490,1879,202
2002,Urban,West Bengal,Crime Against Children,Child Labor,Male,13-17,2735,2078,657,2644,91
2003,Urban,Sikkim,Other Crimes,Fraud,Male,31-45,7995,5534,2461,7294,701
2002,Rural,West Bengal,Crime Against Men,Murder,Male,31-45,7647,1073,6574,4624,3023
2003,Urban,Andhra Pradesh,Crime Against Children,Kidnapping,Male,13-17,4019,2982,1037,3733,286
2007,Rural,Jammu & Kashmir,Crime Against Men,Murder,Male,31-45,3730,836,2894,1814,1916
2003,Rural,Karnataka,Crime Against Children,Trafficking,Female,13-17,7214,2171,5043,4642,2572
2002,Urban,Himachal Pradesh,Crime Against Children,Child Labor,Female,18-30,6384,4303,2081,4646,1738
2008,Urban,Andhra Pradesh,Crime Against Children,Child Abuse,Female,46-60,9021,8310,711,8716,305
2006,Rural,Nagaland,Crime Against Women,Rape,Male,31-45,688,425,263,564,124
2008,Rural,Bihar,Crime Against Men,Extortion,Male,13-17,6235,414,5821,720,5515
2004,Urban,Tamil Nadu,Property Crime,Theft,Female,0-12,8179,4698,3481,5814,2365
2006,Rural,Punjab,Crime Against Women,Dowry Deaths,Male,13-17,4301,3548,753,3675,626
2001,Urban,Maharashtra,Crime Against Men,Extortion,Female,60+,8817,8716,101,8772,45
2009,Urban,West Bengal,Other Crimes,Corruption,Male,13-17,855,251,604,429,426
2005,Rural,Delhi,Other Crimes,Corruption,Male,60+,7214,4152,3062,4808,2406
2006,Rural,Jharkhand,Crime Against Children,Child Labor,Male,60+,1241,650,591,954,287
2009,Urban,Manipur,Crime Against Men,Extortion,Male,46-60,9626,3840,5786,9513,113
2005,Rural,Mizoram,Crime Against Men,Robbery,Male,18-30,2776,411,2365,1577,1199
2010,Urban,Arunachal Pradesh,Crime Against Men,Murder,Male,60+,4203,1801,2402,3767,436
2010,Rural,Tripura,Other Crimes,Corruption,Male,0-12,3042,2436,606,2823,219
2002,Urban,Andhra Pradesh,Property Crime,Burglary,Male,60+,8271,603,7668,6798,1473
2003,Urban,Mizoram,Property Crime,Theft,Male,18-30,3765,3271,494,3761,4
2009,Rural,Punjab,Property Crime,Theft,Male,0-12,8114,5556,2558,5994,2120
2006,Rural,Gujarat,Crime Against Women,Rape,Male,0-12,5391,549,4842,1470,3921
2008,Urban,Himachal Pradesh,Crime Against Men,Extortion,Male,13-17,214,2,212,173,41
2003,Urban,Delhi,Crime Against Children,Child Abuse,Female,13-17,9277,8754,523,9231,46
2003,Rural,Maharashtra,Property Crime,Vandalism,Female,18-30,6053,1567,4486,3740,2313
2004,Rural,Goa,Crime Against Children,Trafficking,Male,60+,2615,107,2508,529,2086
2004,Rural,Rajasthan,Crime Against Children,Child Labor,Male,46-60,3827,1804,2023,3742,85
2008,Rural,Jammu & Kashmir,Crime Against Women,Dowry Deaths,Female,46-60,9987,3557,6430,4402,5585
2009,Rural,Goa,Crime Against Children,Child Abuse,Female,13-17,286,219,67,219,67
2002,Rural,Kerala,Crime Against Women,Molestation,Female,46-60,6700,796,5904,1349,5351
2002,Rural,Meghalaya,Crime Against Women,Rape,Female,13-17,3816,2416,1400,3559,257
2010,Urban,Telangana,Crime Against Men,Robbery,Female,46-60,4166,1925,2241,2665,1501
2009,Rural,Rajasthan,Property Crime,Arson,Female,31-45,6596,3633,2963,6231,365
2003,Urban,Uttar Pradesh,Crime Against Men,Assault,Male,0-12,2052,1084,968,1961,91
2003,Urban,Gujarat,Crime Against Men,Extortion,Male,13-17,3846,1002,2844,1421,2425
2007,Urban,Himachal Pradesh,Crime Against Children,Kidnapping,Male,60+,575,534,41,551,24
2009,Urban,Karnataka,Crime Against Children,Trafficking,Female,46-60,5609,3269,2340,3512,2097
2009,Rural,Uttarakhand,Property Crime,Theft,Male,13-17,179,98,81,169,10
2008,Urban,West Bengal,Property Crime,Vandalism,Female,60+,269,88,181,133,136
2010,Urban,Madhya Pradesh,Other Crimes,Cyber Crime,Male,60+,8660,1430,7230,3202,5458
2003,Urban,Andhra Pradesh,Other Crimes,Corruption,Male,46-60,2984,1217,1767,2304,680
2005,Rural,Maharashtra,Crime Against Children,Child Labor,Female,46-60,3943,713,3230,3070,873
2008,Rural,Tamil Nadu,Crime Against Men,Extortion,Female,31-45,2750,1059,1691,1486,1264
2008,Urban,Uttar Pradesh,Other Crimes,Fraud,Female,46-60,4618,655,3963,1247,3371
2001,Rural,West Bengal,Property Crime,Vandalism,Female,31-45,2029,103,1926,1287,742
2009,Rural,Tamil Nadu,Other Crimes,Drug Offense,Male,60+,814,507,307,644,170
2003,Rural,Gujarat,Crime Against Men,Robbery,Male,18-30,6438,3091,3347,3157,3281
2009,Urban,Odisha,Crime Against Women,Dowry Deaths,Female,0-12,9385,2794,6591,3202,6183
2002,Urban,Jammu & Kashmir,Other Crimes,Drug Offense,Female,31-45,479,174,305,368,111
2006,Rural,Goa,Property Crime,Arson,Male,31-45,9996,8429,1567,9128,868
2010,Rural,Gujarat,Crime Against Men,Extortion,Female,31-45,7452,2843,4609,6363,1089
2008,Urban,Manipur,Crime Against Children,Trafficking,Male,46-60,2027,1303,724,1856,171
2001,Rural,Himachal Pradesh,Crime Against Women,Molestation,Female,18-30,7311,6228,1083,6230,1081
2007,Urban,Jammu & Kashmir,Other Crimes,Fraud,Male,60+,7313,670,6643,4684,2629
2001,Rural,Meghalaya,Other Crimes,Corruption,Male,18-30,5376,2548,2828,5158,218
2001,Urban,Tamil Nadu,Crime Against Children,Trafficking,Male,0-12,4979,2288,2691,3011,1968
2002,Urban,Tripura,Crime Against Women,Dowry Deaths,Female,31-45,6610,4694,1916,4694,1916
2005,Rural,Telangana,Property Crime,Vandalism,Female,13-17,9689,7060,2629,8252,1437
2006,Urban,West Bengal,Crime Against Men,Extortion,Female,13-17,5058,832,4226,2125,2933
2009,Urban,Uttarakhand,Property Crime,Theft,Female,13-17,7527,998,6529,5622,1905
2002,Rural,Uttarakhand,Crime Against Women,Rape,Female,46-60,1046,737,309,956,90
2001,Rural,Jammu & Kashmir,Crime Against Women,Dowry Deaths,Male,46-60,1873,1572,301,1699,174
2006,Urban,Uttarakhand,Crime Against Children,Kidnapping,Male,0-12,9029,2105,6924,7749,1280
2007,Urban,Assam,Property Crime,Vandalism,Male,60+,4165,2791,1374,3555,610
2004,Urban,Bihar,Crime Against Women,Rape,Male,60+,7928,1523,6405,2546,5382
2010,Urban,Karnataka,Crime Against Men,Robbery,Male,60+,9031,4586,4445,4795,4236
2003,Urban,Telangana,Crime Against Children,Child Labor,Male,13-17,346,46,300,87,259
2001,Rural,Andhra Pradesh,Crime Against Children,Kidnapping,Female,31-45,8173,3087,5086,7357,816
2004,Rural,Punjab,Crime Against Women,Rape,Female,0-12,5161,4745,416,4848,313
2001,Rural,Maharashtra,Property Crime,Theft,Female,13-17,6639,5963,676,6066,573
2001,Rural,Telangana,Crime Against Children,Kidnapping,Female,60+,2421,2144,277,2326,95
2004,Rural,Andhra Pradesh,Other Crimes,Corruption,Female,31-45,2198,27,2171,147,2051
2006,Urban,Maharashtra,Crime Against Men,Robbery,Female,46-60,4405,1863,2542,2788,1617
2004,Urban,Chhattisgarh,Crime Against Men,Murder,Female,60+,2994,642,2352,732,2262
2002,Urban,Haryana,Crime Against Children,Child Labor,Male,46-60,2319,2017,302,2027,292
2002,Urban,Mizoram,Other Crimes,Fraud,Female,0-12,6430,1111,5319,3597,2833
2001,Rural,Punjab,Property Crime,Arson,Female,31-45,4478,3239,1239,3780,698
2005,Rural,Gujarat,Property Crime,Burglary,Male,18-30,4325,1883,2442,4036,289
2007,Rural,Arunachal Pradesh,Other Crimes,Drug Offense,Male,31-45,7728,6753,975,7452,276
2005,Urban,Sikkim,Crime Against Children,Child Labor,Female,31-45,7468,7361,107,7416,52
2003,Urban,Tamil Nadu,Crime Against Men,Assault,Female,0-12,3622,2067,1555,3352,270
2010,Urban,Punjab,Crime Against Women,Domestic Violence,Male,60+,5183,1113,4070,2684,2499
2004,Rural,Jharkhand,Crime Against Women,Domestic Violence,Male,60+,9752,6383,3369,7117,2635
2005,Urban,Delhi,Crime Against Women,Domestic Violence,Male,46-60,3738,1651,2087,2232,1506
2005,Urban,Jharkhand,Crime Against Children,Child Abuse,Female,0-12,9019,2064,6955,2618,6401
2007,Urban,Mizoram,Crime Against Children,Trafficking,Male,18-30,8723,3935,4788,4983,3740
2004,Rural,Rajasthan,Other Crimes,Drug Offense,Male,46-60,3695,3291,404,3435,260
2008,Rural,Tripura,Crime Against Children,Kidnapping,Female,18-30,4870,3721,1149,4767,103
2006,Urban,Manipur,Crime Against Children,Kidnapping,Female,31-45,9008,7588,1420,8760,248
2009,Rural,Himachal Pradesh,Crime Against Women,Rape,Male,18-30,9975,4928,5047,6936,3039
2009,Urban,Kerala,Crime Against Women,Domestic Violence,Female,60+,8113,1145,6968,3967,4146
2006,Urban,Tripura,Crime Against Women,Molestation,Female,13-17,8586,8024,562,8583,3
2002,Rural,Chhattisgarh,Crime Against Women,Molestation,Male,13-17,9944,4401,5543,9137,807
2002,Urban,Assam,Crime Against Men,Extortion,Female,0-12,5667,2128,3539,4849,818
2005,Urban,Madhya Pradesh,Crime Against Men,Murder,Female,18-30,7456,4069,3387,5695,1761
2002,Urban,Mizoram,Property Crime,Arson,Female,13-17,4050,2694,1356,3738,312
2002,Rural,Uttarakhand,Crime Against Children,Trafficking,Female,31-45,3247,1593,1654,2184,1063
2004,Urban,Karnataka,Crime Against Children,Trafficking,Female,46-60,9208,974,8234,7224,1984
2010,Rural,Uttarakhand,Crime Against Men,Assault,Male,46-60,3488,1133,2355,1167,2321
2006,Rural,Andhra Pradesh,Property Crime,Burglary,Female,46-60,3866,1479,2387,1798,2068
2005,Rural,Tamil Nadu,Other Crimes,Cyber Crime,Male,0-12,2539,959,1580,1831,708
2007,Rural,Rajasthan,Property Crime,Burglary,Male,0-12,3847,3132,715,3267,580
2007,Urban,Nagaland,Property Crime,Vandalism,Female,18-30,7526,1565,5961,1611,5915
2009,Urban,Tripura,Other Crimes,Corruption,Female,46-60,4329,3133,1196,4321,8
2005,Urban,Telangana,Crime Against Children,Trafficking,Male,46-60,5755,2682,3073,4429,1326
2010,Rural,Sikkim,Crime Against Men,Extortion,Male,18-30,1085,1080,5,1085,0
2002,Urban,Mizoram,Crime Against Children,Child Abuse,Female,31-45,9831,5011,4820,7619,2212
2001,Urban,Kerala,Crime Against Women,Molestation,Male,46-60,587,19,568,476,111
2006,Urban,Nagaland,Crime Against Children,Child Labor,Female,13-17,2771,542,2229,1600,1171
2002,Urban,Jharkhand,Crime Against Men,Assault,Female,46-60,8275,1646,6629,4684,3591
2002,Urban,Karnataka,Crime Against Men,Extortion,Female,31-45,5616,4096,1520,5324,292
2010,Rural,Haryana,Crime Against Women,Rape,Female,31-45,9431,5470,3961,5810,3621
2009,Urban,Tamil Nadu,Other Crimes,Drug Offense,Male,18-30,9615,8304,1311,8402,1213
2002,Rural,Maharashtra,Crime Against Women,Molestation,Male,46-60,5085,3929,1156,4059,1026
2003,Rural,Bihar,Crime Against Children,Trafficking,Female,46-60,2477,1263,1214,1861,616
2009,Urban,Sikkim,Crime Against Men,Extortion,Male,0-12,1894,1808,86,1844,50
2001,Rural,Himachal Pradesh,Crime Against Women,Domestic Violence,Male,18-30,4938,3635,1303,3723,1215
2003,Urban,Rajasthan,Crime Against Women,Molestation,Male,46-60,7311,4669,2642,6600,711
2005,Rural,Tripura,Crime Against Children,Child Labor,Female,46-60,6156,4258,1898,5951,205
2002,Rural,Nagaland,Property Crime,Arson,Female,13-17,1774,480,1294,1231,543
2004,Rural,West Bengal,Crime Against Women,Domestic Violence,Male,46-60,1009,698,311,784,225
2004,Rural,Manipur,Property Crime,Arson,Female,0-12,3493,1666,1827,3169,324
2003,Urban,Bihar,Crime Against Men,Assault,Female,0-12,1626,1511,115,1570,56
2006,Rural,Goa,Crime Against Men,Assault,Male,0-12,5214,3501,1713,4293,921
2010,Urban,Mizoram,Other Crimes,Fraud,Female,18-30,7475,2523,4952,4864,2611
2003,Rural,Uttar Pradesh,Crime Against Men,Extortion,Male,60+,5231,3133,2098,3987,1244
2010,Urban,West Bengal,Property Crime,Vandalism,Male,0-12,2479,2433,46,2437,42
2002,Rural,Tamil Nadu,Crime Against Women,Domestic Violence,Female,31-45,4421,2021,2400,4196,225
2004,Urban,Jharkhand,Crime Against Children,Child Abuse,Female,60+,5651,1813,3838,3446,2205
2009,Urban,Gujarat,Crime Against Women,Domestic Violence,Male,60+,1139,921,218,962,177
2003,Urban,Rajasthan,Crime Against Women,Molestation,Male,46-60,2503,1966,537,2195,308
2007,Rural,Madhya Pradesh,Crime Against Women,Molestation,Female,46-60,598,405,193,559,39
2004,Urban,Delhi,Crime Against Children,Kidnapping,Male,46-60,6739,2068,4671,4927,1812
2007,Urban,West Bengal,Crime Against Men,Extortion,Female,18-30,3592,608,2984,1553,2039
2010,Rural,Kerala,Crime Against Men,Murder,Male,0-12,5932,2790,3142,4703,1229
2006,Urban,Andhra Pradesh,Crime Against Men,Robbery,Female,60+,6431,1993,4438,2391,4040
2010,Urban,Meghalaya,Other Crimes,Fraud,Female,31-45,9876,4416,5460,9486,390
2002,Rural,Punjab,Other Crimes,Cyber Crime,Male,13-17,4124,1632,2492,3832,292
2010,Urban,Maharashtra,Property Crime,Vandalism,Female,31-45,7669,3558,4111,6261,1408
2008,Urban,Jharkhand,Crime Against Women,Domestic Violence,Female,60+,7480,3712,3768,5535,1945
2002,Urban,Chhattisgarh,Other Crimes,Fraud,Male,18-30,2354,2333,21,2345,9
2008,Rural,Madhya Pradesh,Crime Against Children,Trafficking,Male,13-17,1851,439,1412,1154,697
2005,Urban,Haryana,Crime Against Children,Kidnapping,Male,31-45,9605,205,9400,4187,5418
2008,Urban,Meghalaya,Crime Against Women,Dowry Deaths,Male,13-17,6714,749,5965,5811,903
2001,Rural,Manipur,Crime Against Men,Murder,Female,31-45,4165,204,3961,4123,42
2009,Rural,Punjab,Crime Against Men,Robbery,Female,31-45,4816,4686,130,4716,100
2009,Urban,Madhya Pradesh,Crime Against Children,Child Abuse,Female,13-17,8311,200,8111,4826,3485
2010,Urban,Sikkim,Other Crimes,Cyber Crime,Female,46-60,2867,80,2787,663,2204
2004,Urban,Tamil Nadu,Crime Against Women,Molestation,Female,18-30,7634,2471,5163,5266,2368
2004,Urban,Karnataka,Crime Against Children,Child Abuse,Male,0-12,3609,1461,2148,2912,697
2004,Urban,Bihar,Crime Against Men,Extortion,Male,60+,5886,2978,2908,4871,1015
2003,Urban,Himachal Pradesh,Crime Against Women,Dowry Deaths,Male,0-12,8765,8604,161,8641,124
2007,Rural,Haryana,Crime Against Children,Child Abuse,Male,13-17,8005,536,7469,7653,352
2008,Rural,Punjab,Crime Against Men,Assault,Male,13-17,857,153,704,617,240
2006,Rural,Jammu & Kashmir,Property Crime,Vandalism,Female,13-17,3952,2594,1358,3325,627
2010,Urban,Jharkhand,Crime Against Children,Kidnapping,Male,13-17,6663,4781,1882,4907,1756
2002,Rural,Nagaland,Crime Against Women,Rape,Male,60+,5642,1458,4184,5634,8
2005,Urban,Chhattisgarh,Crime Against Men,Murder,Male,0-12,5026,687,4339,1285,3741
2010,Rural,Jharkhand,Other Crimes,Corruption,Female,31-45,9239,6826,2413,9187,52
2002,Rural,Kerala,Property Crime,Burglary,Male,0-12,8296,4309,3987,4861,3435
2006,Rural,Chhattisgarh,Other Crimes,Drug Offense,Male,18-30,9042,8825,217,8858,184
2004,Rural,Sikkim,Property Crime,Theft,Female,13-17,8231,7155,1076,7654,577
2004,Rural,Uttar Pradesh,Crime Against Women,Domestic Violence,Male,31-45,6996,2349,4647,3771,3225
2007,Rural,Maharashtra,Other Crimes,Drug Offense,Male,13-17,7192,3396,3796,3596,3596
2002,Rural,Himachal Pradesh,Crime Against Children,Trafficking,Male,60+,2123,23,2100,321,1802
2003,Urban,Nagaland,Crime Against Men,Extortion,Male,18-30,6451,6376,75,6448,3
2007,Urban,Jharkhand,Crime Against Men,Assault,Female,0-12,8285,5567,2718,5716,2569
2001,Rural,Andhra Pradesh,Crime Against Children,Trafficking,Male,46-60,5129,20,5109,773,4356
2003,Urban,Kerala,Crime Against Men,Extortion,Male,18-30,5284,2524,2760,3679,1605
2001,Rural,Rajasthan,Crime Against Children,Child Abuse,Female,0-12,2394,2342,52,2387,7
2001,Rural,Manipur,Crime Against Children,Kidnapping,Male,60+,6325,4533,1792,5611,714
2004,Urban,Rajasthan,Other Crimes,Fraud,Male,46-60,9901,4734,5167,5208,4693
2007,Rural,Sikkim,Crime Against Men,Extortion,Male,13-17,5268,4073,1195,4109,1159
2005,Urban,Karnataka,Crime Against Children,Kidnapping,Male,60+,661,582,79,616,45
2006,Rural,Haryana,Crime Against Children,Child Abuse,Female,0-12,9431,8259,1172,8662,769
2006,Rural,Jammu & Kashmir,Other Crimes,Drug Offense,Female,60+,8135,5285,2850,6590,1545
2010,Urban,Tripura,Property Crime,Theft,Male,46-60,3721,3359,362,3387,334
2003,Rural,Karnataka,Other Crimes,Fraud,Female,31-45,917,636,281,730,187
2004,Urban,Kerala,Crime Against Men,Murder,Male,31-45,4310,3437,873,4172,138
2010,Rural,Tamil Nadu,Crime Against Men,Extortion,Female,60+,8631,682,7949,6392,2239
2008,Rural,Tamil Nadu,Other Crimes,Cyber Crime,Female,18-30,7698,4255,3443,6334,1364
2009,Urban,Jammu & Kashmir,Crime Against Women,Molestation,Female,60+,2466,2359,107,2447,19
2009,Urban,Haryana,Other Crimes,Fraud,Male,0-12,9800,6501,3299,9032,768
2008,Urban,Telangana,Crime Against Children,Kidnapping,Male,31-45,6574,1355,5219,1407,5167
2005,Rural,West Bengal,Crime Against Children,Trafficking,Male,60+,5751,3198,2553,3631,2120
2008,Rural,Goa,Crime Against Women,Dowry Deaths,Male,31-45,4664,3354,1310,3519,1145
2007,Urban,Arunachal Pradesh,Crime Against Men,Robbery,Male,31-45,8616,8153,463,8600,16
2001,Rural,West Bengal,Property Crime,Burglary,Female,31-45,7137,5592,1545,6596,541
2007,Rural,Meghalaya,Crime Against Children,Kidnapping,Female,13-17,163,142,21,158,5
2003,Urban,Gujarat,Crime Against Men,Assault,Male,46-60,3900,133,3767,1805,2095
2003,Urban,Uttarakhand,Crime Against Men,Murder,Male,60+,4688,2472,2216,3093,1595
2006,Rural,Sikkim,Crime Against Women,Rape,Male,31-45,2327,782,1545,1998,329
2004,Rural,Andhra Pradesh,Crime Against Women,Molestation,Male,31-45,4369,453,3916,2411,1958
2009,Rural,Madhya Pradesh,Other Crimes,Cyber Crime,Female,31-45,5602,5391,211,5429,173
2008,Urban,Sikkim,Crime Against Children,Child Labor,Male,60+,1712,1576,136,1626,86
2005,Rural,Haryana,Crime Against Women,Molestation,Female,13-17,5507,2609,2898,5453,54
2005,Urban,Tamil Nadu,Crime Against Children,Kidnapping,Male,13-17,8911,4122,4789,8347,564
2003,Rural,Himachal Pradesh,Crime Against Men,Assault,Female,0-12,6410,3925,2485,5612,798
2004,Urban,Haryana,Crime Against Women,Dowry Deaths,Male,31-45,6281,1558,4723,5386,895
2005,Urban,Mizoram,Crime Against Men,Extortion,Male,60+,6992,4449,2543,5837,1155
2007,Rural,Himachal Pradesh,Crime Against Men,Robbery,Female,31-45,8242,1242,7000,7423,819
2004,Rural,Delhi,Crime Against Men,Extortion,Female,0-12,4888,4321,567,4692,196
2004,Rural,Bihar,Other Crimes,Cyber Crime,Male,46-60,7203,6064,1139,7197,6
2010,Rural,Chhattisgarh,Crime Against Women,Molestation,Female,0-12,9300,7008,2292,7767,1533
2001,Rural,Goa,Crime Against Children,Kidnapping,Female,18-30,1267,45,1222,1151,116
2010,Urban,Bihar,Crime Against Women,Rape,Female,46-60,4454,1864,2590,3479,975
2001,Rural,Rajasthan,Crime Against Women,Domestic Violence,Male,46-60,500,173,327,367,133
2009,Urban,Mizoram,Crime Against Women,Dowry Deaths,Male,0-12,2069,731,1338,834,1235
2009,Rural,Chhattisgarh,Other Crimes,Fraud,Male,46-60,5025,3684,1341,4918,107
2003,Rural,Jharkhand,Crime Against Women,Rape,Female,18-30,848,57,791,183,665
2010,Urban,Uttar Pradesh,Crime Against Men,Assault,Female,60+,2897,2807,90,2840,57
2008,Urban,Nagaland,Other Crimes,Cyber Crime,Male,0-12,8650,413,8237,8305,345
2001,Urban,Uttarakhand,Crime Against Children,Trafficking,Male,13-17,9380,1436,7944,7124,2256
2005,Rural,Telangana,Property Crime,Arson,Female,18-30,9033,5125,3908,7350,1683
2006,Rural,Rajasthan,Crime Against Men,Assault,Female,13-17,3421,279,3142,777,2644
2001,Urban,Manipur,Other Crimes,Fraud,Female,18-30,6402,1463,4939,3390,3012
2009,Rural,Rajasthan,Crime Against Women,Rape,Male,46-60,6571,1430,5141,2991,3580
2005,Rural,Tamil Nadu,Other Crimes,Cyber Crime,Male,31-45,1893,1288,605,1402,491
2005,Rural,Manipur,Crime Against Men,Extortion,Female,31-45,7042,1346,5696,5394,1648
2003,Urban,Chhattisgarh,Crime Against Children,Child Labor,Female,46-60,7285,3905,3380,6204,1081
2010,Urban,Chhattisgarh,Other Crimes,Cyber Crime,Female,31-45,9553,6519,3034,7349,2204
2004,Rural,Punjab,Crime Against Children,Kidnapping,Male,13-17,1130,888,242,1084,46
2006,Urban,Maharashtra,Crime Against Women,Molestation,Female,31-45,7097,3471,3626,6820,277
2009,Urban,Punjab,Crime Against Women,Molestation,Female,46-60,6367,1713,4654,2996,3371
2001,Urban,Tripura,Property Crime,Burglary,Female,13-17,9086,1949,7137,2896,6190
2003,Urban,Jharkhand,Crime Against Children,Kidnapping,Female,46-60,9014,6399,2615,6657,2357
2004,Rural,Assam,Other Crimes,Cyber Crime,Male,0-12,8141,7442,699,7866,275
2004,Rural,Goa,Crime Against Women,Dowry Deaths,Female,60+,152,17,135,138,14
2006,Rural,Kerala,Crime Against Women,Rape,Female,13-17,9646,3134,6512,8430,1216
2009,Rural,Goa,Property Crime,Arson,Male,18-30,7990,4234,3756,6280,1710
2010,Rural,Punjab,Crime Against Men,Extortion,Male,0-12,5846,1709,4137,4486,1360
2010,Rural,Mizoram,Other Crimes,Fraud,Male,13-17,5856,5550,306,5779,77
2001,Urban,Andhra Pradesh,Crime Against Women,Molestation,Female,46-60,7466,1138,6328,2966,4500
2006,Rural,Assam,Crime Against Children,Child Abuse,Male,0-12,7289,6854,435,6932,357
2010,Urban,Bihar,Property Crime,Theft,Male,18-30,6132,2333,3799,4262,1870
2004,Rural,Madhya Pradesh,Crime Against Men,Extortion,Female,18-30,2973,1078,1895,2046,927
2010,Urban,Bihar,Crime Against Men,Extortion,Male,31-45,4105,663,3442,3625,480
2010,Urban,Meghalaya,Crime Against Men,Murder,Female,31-45,3116,1404,1712,2929,187
2009,Rural,Tripura,Property Crime,Theft,Female,18-30,1813,1102,711,1361,452
2008,Rural,Bihar,Other Crimes,Fraud,Female,31-45,1642,1549,93,1637,5
2001,Urban,Chhattisgarh,Crime Against Men,Robbery,Male,18-30,4705,391,4314,4535,170
2002,Urban,Jammu & Kashmir,Crime Against Children,Child Abuse,Male,18-30,5783,4045,1738,4572,1211
2003,Rural,Delhi,Crime Against Women,Dowry Deaths,Female,31-45,5639,3975,1664,5351,288
2009,Urban,Telangana,Crime Against Women,Rape,Female,13-17,6131,3833,2298,5597,534
2003,Rural,Haryana,Crime Against Women,Dowry Deaths,Female,31-45,9452,9343,109,9355,97
2007,Urban,Uttarakhand,Crime Against Children,Trafficking,Female,31-45,4543,1319,3224,2862,1681
2003,Rural,Arunachal Pradesh,Property Crime,Burglary,Female,18-30,4883,3872,1011,4577,306
2004,Urban,Nagaland,Crime Against Women,Molestation,Female,46-60,7812,2063,5749,6742,1070
2002,Rural,Rajasthan,Crime Against Men,Murder,Male,0-12,9737,4010,5727,9720,17
2003,Urban,Himachal Pradesh,Crime Against Women,Domestic Violence,Female,31-45,349,305,44,347,2
2001,Rural,Tamil Nadu,Crime Against Children,Child Abuse,Female,46-60,9720,365,9355,7994,1726
2007,Urban,Gujarat,Property Crime,Arson,Male,31-45,5402,3363,2039,3957,1445
2009,Urban,Kerala,Crime Against Men,Robbery,Male,13-17,3042,1815,1227,2426,616
2006,Urban,Maharashtra,Other Crimes,Cyber Crime,Female,0-12,1695,1665,30,1681,14
2007,Urban,Uttar Pradesh,Crime Against Children,Child Labor,Male,18-30,676,594,82,619,57
2001,Rural,Goa,Crime Against Children,Child Labor,Male,13-17,7261,4584,2677,5730,1531
2001,Rural,West Bengal,Other Crimes,Drug Offense,Female,60+,6792,4250,2542,4822,1970
2006,Rural,Uttarakhand,Crime Against Women,Molestation,Female,60+,6583,3818,2765,6452,131
2008,Rural,Arunachal Pradesh,Crime Against Children,Trafficking,Male,0-12,6216,4407,1809,6058,158
2006,Rural,Kerala,Other Crimes,Drug Offense,Male,46-60,7282,2613,4669,5659,1623
2009,Rural,Rajasthan,Crime Against Women,Molestation,Male,0-12,6468,710,5758,4158,2310
2004,Rural,West Bengal,Property Crime,Theft,Male,0-12,796,259,537,448,348
2007,Urban,Punjab,Other Crimes,Corruption,Female,60+,6997,2960,4037,4855,2142
2009,Rural,Manipur,Crime Against Women,Molestation,Female,31-45,6686,1143,5543,2988,3698
2008,Rural,Maharashtra,Property Crime,Theft,Male,31-45,5555,3738,1817,5298,257
2009,Urban,Gujarat,Property Crime,Burglary,Female,13-17,5944,3397,2547,4963,981
2007,Urban,Uttarakhand,Crime Against Children,Kidnapping,Female,0-12,1946,1152,794,1318,628
2009,Rural,Mizoram,Other Crimes,Cyber Crime,Female,0-12,3696,306,3390,3016,680
2009,Urban,West Bengal,Other Crimes,Corruption,Male,18-30,8798,2542,6256,8256,542
2007,Rural,Bihar,Crime Against Men,Extortion,Male,31-45,3873,3045,828,3396,477
2010,Urban,Nagaland,Other Crimes,Corruption,Male,13-17,1144,121,1023,1109,35
2003,Urban,Maharashtra,Crime Against Women,Rape,Male,13-17,2285,1101,1184,2052,233
2003,Rural,Karnataka,Crime Against Children,Trafficking,Male,60+,1882,1276,606,1591,291
2004,Rural,Meghalaya,Crime Against Women,Rape,Male,31-45,6068,4463,1605,5418,650
2010,Urban,Goa,Crime Against Women,Molestation,Male,60+,8248,4190,4058,6877,1371
2004,Rural,Chhattisgarh,Crime Against Men,Robbery,Female,0-12,6582,5994,588,6284,298
2004,Urban,Uttarakhand,Other Crimes,Cyber Crime,Male,46-60,4412,2716,1696,3054,1358
2010,Rural,Andhra Pradesh,Crime Against Children,Kidnapping,Male,60+,2095,1707,388,1803,292
2002,Rural,Telangana,Property Crime,Theft,Female,60+,8622,1755,6867,4836,3786
2003,Urban,Telangana,Property Crime,Burglary,Female,18-30,6496,5049,1447,5839,657
2010,Rural,Jharkhand,Crime Against Men,Murder,Female,0-12,4839,4375,464,4594,245
2006,Rural,Chhattisgarh,Crime Against Men,Robbery,Female,0-12,2453,1561,892,2336,117
2006,Rural,Haryana,Crime Against Men,Assault,Female,18-30,3290,1688,1602,1887,1403
2009,Urban,Kerala,Property Crime,Burglary,Male,13-17,4979,3260,1719,4714,265
2006,Rural,Telangana,Crime Against Men,Extortion,Female,31-45,2552,1346,1206,2241,311
2008,Urban,Punjab,Crime Against Children,Kidnapping,Female,46-60,8254,3840,4414,6096,2158
2010,Rural,Tamil Nadu,Crime Against Children,Child Abuse,Male,18-30,5660,3465,2195,4635,1025
2007,Rural,Chhattisgarh,Crime Against Women,Molestation,Male,60+,2601,2387,214,2421,180
2002,Urban,Bihar,Other Crimes,Corruption,Female,31-45,3990,2092,1898,2184,1806
2009,Urban,Goa,Crime Against Men,Robbery,Male,60+,2840,1533,1307,2838,2
2003,Rural,Goa,Crime Against Children,Child Labor,Female,18-30,9705,4499,5206,8869,836
2004,Urban,Arunachal Pradesh,Other Crimes,Corruption,Female,31-45,6664,699,5965,4782,1882
2006,Rural,Assam,Crime Against Children,Child Labor,Male,46-60,2380,2039,341,2209,171
2001,Urban,Arunachal Pradesh,Crime Against Women,Molestation,Female,31-45,606,538,68,555,51
2008,Urban,West Bengal,Crime Against Children,Child Labor,Male,31-45,7679,1750,5929,3851,3828
2005,Urban,Madhya Pradesh,Property Crime,Vandalism,Male,18-30,3772,1571,2201,3665,107
2001,Urban,Telangana,Crime Against Women,Dowry Deaths,Male,60+,6041,5072,969,5574,467
2004,Urban,Punjab,Crime Against Women,Domestic Violence,Female,60+,2505,1762,743,2135,370
2010,Urban,Tamil Nadu,Property Crime,Arson,Female,31-45,5399,2304,3095,5001,398
2003,Urban,Bihar,Crime Against Children,Kidnapping,Male,13-17,2770,1396,1374,2573,197
2008,Urban,Telangana,Property Crime,Vandalism,Female,31-45,3078,169,2909,825,2253
2009,Urban,Bihar,Property Crime,Vandalism,Female,13-17,6306,4372,1934,4736,1570
2001,Urban,Goa,Crime Against Women,Domestic Violence,Male,46-60,3795,861,2934,1760,2035
2006,Urban,Himachal Pradesh,Other Crimes,Cyber Crime,Male,46-60,5787,754,5033,3239,2548
2005,Urban,Maharashtra,Crime Against Men,Assault,Male,60+,3731,2544,1187,3510,221
2008,Urban,Chhattisgarh,Crime Against Women,Rape,Male,60+,3306,1643,1663,2364,942
2003,Urban,Kerala,Crime Against Children,Child Abuse,Female,0-12,3851,2836,1015,2965,886
2003,Rural,Madhya Pradesh,Property Crime,Vandalism,Male,31-45,5967,2373,3594,2493,3474
2010,Urban,Bihar,Crime Against Women,Domestic Violence,Male,31-45,5612,5427,185,5467,145
2006,Rural,Tripura,Other Crimes,Corruption,Male,13-17,5439,2746,2693,3872,1567
2002,Rural,Maharashtra,Crime Against Children,Child Abuse,Female,46-60,6451,2691,3760,4956,1495
2001,Urban,Odisha,Crime Against Children,Child Abuse,Male,60+,5817,5218,599,5796,21
2001,Urban,Madhya Pradesh,Crime Against Men,Murder,Male,31-45,8849,8822,27,8830,19
2008,Rural,Assam,Property Crime,Arson,Male,60+,2425,1277,1148,2353,72
2006,Rural,Assam,Crime Against Women,Molestation,Female,18-30,1451,1345,106,1447,4
2003,Rural,Himachal Pradesh,Crime Against Men,Extortion,Female,13-17,6411,6044,367,6054,357
2001,Rural,Delhi,Crime Against Children,Child Abuse,Male,60+,3892,1313,2579,3462,430
2009,Rural,Mizoram,Crime Against Children,Child Labor,Male,0-12,2155,642,1513,1694,461
2004,Rural,Assam,Property Crime,Arson,Male,13-17,54,25,29,25,29
2008,Urban,Madhya Pradesh,Crime Against Women,Domestic Violence,Male,46-60,6630,725,5905,3087,3543
2008,Urban,Odisha,Other Crimes,Corruption,Male,46-60,156,152,4,154,2
2003,Rural,Jharkhand,Crime Against Children,Trafficking,Male,31-45,4308,1793,2515,2695,1613
2010,Urban,Mizoram,Crime Against Women,Molestation,Male,13-17,3570,20,3550,1074,2496
2008,Rural,Maharashtra,Crime Against Children,Child Abuse,Female,13-17,3350,2759,591,3072,278
2002,Urban,Sikkim,Other Crimes,Cyber Crime,Female,13-17,1245,1004,241,1177,68
2004,Rural,Haryana,Property Crime,Burglary,Male,46-60,572,230,342,471,101
2008,Rural,Bihar,Crime Against Children,Child Abuse,Female,18-30,6776,2228,4548,2385,4391
2004,Urban,Uttar Pradesh,Crime Against Children,Child Labor,Female,31-45,5629,5433,196,5569,60
2002,Rural,Telangana,Property Crime,Burglary,Female,60+,7407,1050,6357,5222,2185
2006,Urban,Punjab,Crime Against Children,Child Abuse,Male,46-60,9133,309,8824,6200,2933
2006,Rural,Madhya Pradesh,Crime Against Men,Assault,Female,46-60,6273,1672,4601,2533,3740
2005,Rural,Bihar,Property Crime,Arson,Male,13-17,3566,685,2881,3014,552
2001,Urban,Tripura,Property Crime,Arson,Male,46-60,2018,1021,997,1209,809
2002,Urban,Maharashtra,Crime Against Men,Murder,Male,60+,1200,1063,137,1191,9
2003,Rural,Nagaland,Crime Against Men,Robbery,Female,31-45,6002,4061,1941,4256,1746
2001,Urban,Maharashtra,Crime Against Women,Rape,Male,18-30,5571,1844,3727,3235,2336
2009,Rural,Jharkhand,Property Crime,Theft,Male,31-45,348,138,210,324,24
2007,Rural,Mizoram,Crime Against Women,Domestic Violence,Female,60+,6546,6485,61,6520,26
2003,Urban,Odisha,Crime Against Children,Child Abuse,Female,31-45,3626,1516,2110,2238,1388
2009,Urban,Chhattisgarh,Crime Against Men,Robbery,Female,0-12,3896,3457,439,3702,194
2005,Urban,Andhra Pradesh,Other Crimes,Cyber Crime,Female,60+,1744,473,1271,799,945
2008,Urban,Punjab,Property Crime,Vandalism,Male,31-45,710,593,117,705,5
2005,Rural,Tamil Nadu,Property Crime,Theft,Female,31-45,2956,2930,26,2956,0
2001,Urban,Meghalaya,Crime Against Women,Dowry Deaths,Male,60+,1746,565,1181,1623,123
2001,Rural,Jharkhand,Crime Against Men,Murder,Male,31-45,7266,6138,1128,6692,574
2007,Rural,Maharashtra,Property Crime,Vandalism,Female,18-30,2872,138,2734,1668,1204
2008,Urban,Rajasthan,Crime Against Children,Child Abuse,Male,60+,5881,2310,3571,2698,3183
2001,Rural,Arunachal Pradesh,Property Crime,Burglary,Female,60+,9589,1539,8050,1564,8025
2010,Rural,Assam,Other Crimes,Drug Offense,Female,13-17,8756,8242,514,8717,39
2006,Urban,Delhi,Crime Against Children,Child Abuse,Male,13-17,8721,2561,6160,7974,747
2003,Urban,Tamil Nadu,Crime Against Children,Child Labor,Male,31-45,4526,1966,2560,4322,204
2010,Urban,Tripura,Other Crimes,Fraud,Female,46-60,3205,3048,157,3048,157
2003,Urban,Uttar Pradesh,Crime Against Women,Dowry Deaths,Female,0-12,9719,5752,3967,7285,2434
2005,Urban,Tripura,Crime Against Children,Child Labor,Female,13-17,886,153,733,330,556
2005,Urban,Sikkim,Crime Against Children,Child Labor,Female,46-60,2837,90,2747,2072,765
2001,Urban,Goa,Crime Against Men,Murder,Male,31-45,3131,964,2167,1296,1835
2003,Rural,Mizoram,Crime Against Children,Trafficking,Male,0-12,4707,3847,860,4410,297
2004,Rural,Andhra Pradesh,Other Crimes,Corruption,Female,13-17,1155,968,187,1065,90
2001,Urban,Gujarat,Crime Against Children,Child Labor,Male,46-60,1518,416,1102,1009,509
2010,Urban,Sikkim,Crime Against Men,Robbery,Female,0-12,7987,1320,6667,4995,2992
2002,Rural,Odisha,Other Crimes,Corruption,Female,31-45,4909,1281,3628,3554,1355
2003,Urban,Uttarakhand,Property Crime,Theft,Female,60+,1588,731,857,1291,297
2001,Rural,West Bengal,Crime Against Women,Domestic Violence,Female,60+,6990,1393,5597,3010,3980
2001,Rural,Tamil Nadu,Other Crimes,Fraud,Male,0-12,3093,2616,477,2834,259
2009,Urban,Bihar,Crime Against Men,Assault,Female,13-17,1182,977,205,1057,125
2009,Urban,Himachal Pradesh,Crime Against Women,Rape,Male,31-45,4272,2423,1849,3124,1148
2007,Urban,Manipur,Crime Against Women,Rape,Female,46-60,9388,8813,575,9200,188
2005,Urban,Karnataka,Crime Against Men,Assault,Female,13-17,8234,6764,1470,7431,803
2007,Rural,Arunachal Pradesh,Other Crimes,Fraud,Male,60+,3648,705,2943,2301,1347
2010,Rural,Arunachal Pradesh,Property Crime,Arson,Female,13-17,6063,4451,1612,5175,888
2001,Urban,West Bengal,Crime Against Men,Murder,Female,0-12,1480,324,1156,556,924
2007,Urban,Rajasthan,Crime Against Children,Child Abuse,Male,18-30,101,16,85,45,56
2003,Rural,Punjab,Crime Against Women,Dowry Deaths,Female,18-30,7758,2748,5010,5475,2283
2009,Urban,Nagaland,Property Crime,Vandalism,Female,60+,5049,3294,1755,4806,243
2003,Rural,Bihar,Crime Against Women,Molestation,Male,46-60,4924,1355,3569,4063,861
2008,Urban,Tamil Nadu,Property Crime,Vandalism,Male,0-12,352,130,222,204,148
2008,Rural,Assam,Crime Against Children,Child Abuse,Male,60+,7579,1788,5791,4861,2718
2008,Rural,Nagaland,Crime Against Children,Child Abuse,Female,13-17,6268,4279,1989,6259,9
2003,Urban,Karnataka,Crime Against Women,Rape,Female,31-45,3138,2620,518,2849,289
2008,Urban,Mizoram,Crime Against Women,Rape,Male,13-17,4348,187,4161,1316,3032
2007,Rural,Manipur,Other Crimes,Corruption,Female,60+,8336,392,7944,6332,2004
2008,Rural,Mizoram,Other Crimes,Fraud,Male,46-60,9185,2971,6214,9180,5
2007,Rural,West Bengal,Other Crimes,Cyber Crime,Female,13-17,3417,332,3085,1801,1616
2007,Rural,Nagaland,Other Crimes,Corruption,Male,31-45,3332,2173,1159,2536,796
2004,Rural,Sikkim,Property Crime,Burglary,Female,60+,8238,532,7706,5345,2893
2001,Urban,West Bengal,Other Crimes,Drug Offense,Female,18-30,8758,4415,4343,6468,2290
2001,Rural,Telangana,Crime Against Children,Kidnapping,Female,60+,5902,3246,2656,5582,320
2009,Urban,Gujarat,Crime Against Children,Child Labor,Female,31-45,73,50,23,60,13
2005,Rural,West Bengal,Crime Against Men,Robbery,Female,13-17,8747,3880,4867,7472,1275
2009,Rural,West Bengal,Crime Against Children,Kidnapping,Female,13-17,4398,4150,248,4231,167
2007,Rural,Tripura,Crime Against Women,Molestation,Female,13-17,9623,8288,1335,8738,885
2007,Urban,Manipur,Other Crimes,Drug Offense,Male,46-60,1424,803,621,991,433
2009,Urban,Himachal Pradesh,Crime Against Men,Assault,Female,31-45,3116,715,2401,1794,1322
2006,Urban,Manipur,Crime Against Men,Extortion,Male,0-12,7636,1973,5663,3427,4209
2005,Rural,Mizoram,Crime Against Men,Assault,Male,60+,4505,197,4308,4360,145
2001,Urban,Odisha,Crime Against Women,Rape,Male,31-45,6738,5006,1732,6686,52
2001,Urban,Telangana,Crime Against Children,Kidnapping,Male,0-12,7262,2786,4476,5467,1795
2001,Urban,Chhattisgarh,Property Crime,Burglary,Male,18-30,8734,2330,6404,5295,3439
2010,Urban,Gujarat,Crime Against Women,Molestation,Male,13-17,1326,577,749,915,411
2008,Rural,Karnataka,Property Crime,Theft,Female,60+,1180,712,468,828,352
2003,Rural,Meghalaya,Property Crime,Theft,Female,13-17,4695,1781,2914,3000,1695
2006,Rural,Jammu & Kashmir,Crime Against Men,Robbery,Male,13-17,6227,4781,1446,5591,636
2006,Urban,Madhya Pradesh,Crime Against Women,Rape,Female,60+,5536,5085,451,5429,107
2004,Rural,Madhya Pradesh,Crime Against Women,Molestation,Male,18-30,3966,274,3692,1388,2578
2002,Urban,Punjab,Crime Against Women,Dowry Deaths,Female,13-17,882,310,572,469,413
2005,Urban,Nagaland,Other Crimes,Drug Offense,Female,60+,7020,1792,5228,5970,1050
2007,Urban,Meghalaya,Crime Against Children,Trafficking,Male,18-30,3545,769,2776,1024,2521
2010,Rural,Kerala,Crime Against Men,Extortion,Female,60+,671,345,326,605,66
2008,Rural,Rajasthan,Property Crime,Arson,Female,13-17,4159,1162,2997,3171,988
2007,Urban,Sikkim,Crime Against Women,Rape,Female,60+,6151,1227,4924,3433,2718
2006,Urban,Uttar Pradesh,Crime Against Women,Domestic Violence,Male,46-60,5500,1370,4130,2844,2656
2002,Urban,Mizoram,Crime Against Men,Assault,Female,46-60,2550,814,1736,2439,111
2003,Rural,Uttar Pradesh,Property Crime,Burglary,Male,31-45,6257,2624,3633,4325,1932
2010,Rural,Haryana,Crime Against Men,Extortion,Male,31-45,8227,7022,1205,8091,136
2007,Rural,Mizoram,Other Crimes,Corruption,Female,13-17,8173,2306,5867,2807,5366
2001,Rural,Sikkim,Other Crimes,Drug Offense,Male,0-12,5295,3363,1932,3531,1764
2008,Urban,Assam,Property Crime,Burglary,Male,0-12,8011,6662,1349,7717,294
2001,Rural,Maharashtra,Crime Against Men,Extortion,Male,0-12,5414,325,5089,4938,476
2002,Rural,Assam,Crime Against Men,Murder,Female,46-60,1248,676,572,997,251
2002,Urban,Arunachal Pradesh,Crime Against Women,Rape,Female,0-12,6634,3760,2874,6245,389
2001,Urban,Arunachal Pradesh,Property Crime,Arson,Male,0-12,1179,584,595,976,203
2004,Urban,Assam,Crime Against Children,Trafficking,Male,0-12,7917,6086,1831,6638,1279
2007,Rural,Maharashtra,Property Crime,Theft,Female,31-45,2562,243,2319,2524,38
2001,Rural,Uttarakhand,Crime Against Men,Assault,Male,31-45,4614,3343,1271,3427,1187
2009,Rural,Rajasthan,Crime Against Women,Dowry Deaths,Female,18-30,1907,1424,483,1901,6
2004,Rural,Uttarakhand,Other Crimes,Fraud,Male,60+,9183,8016,1167,8856,327
2008,Rural,Mizoram,Property Crime,Vandalism,Female,46-60,4908,4286,622,4528,380
2006,Rural,Kerala,Other Crimes,Fraud,Female,31-45,877,507,370,834,43
2006,Rural,Arunachal Pradesh,Property Crime,Vandalism,Female,60+,9086,4351,4735,8521,565
2005,Rural,Assam,Property Crime,Theft,Male,31-45,4998,2770,2228,3874,1124
2002,Urban,Punjab,Other Crimes,Corruption,Female,60+,7126,4485,2641,5183,1943
2008,Urban,Odisha,Crime Against Children,Child Labor,Female,31-45,3415,2229,1186,2440,975
2004,Urban,Gujarat,Crime Against Men,Robbery,Male,13-17,3383,1526,1857,1900,1483
2007,Rural,Arunachal Pradesh,Crime Against Men,Extortion,Female,13-17,9395,8062,1333,9090,305
2004,Urban,Tripura,Crime Against Children,Kidnapping,Male,46-60,8665,7160,1505,7725,940
2001,Rural,Andhra Pradesh,Crime Against Children,Child Abuse,Male,31-45,9715,5845,3870,9417,298
2009,Rural,Sikkim,Crime Against Children,Trafficking,Female,0-12,8297,7936,361,8085,212
2002,Rural,Odisha,Crime Against Children,Kidnapping,Female,60+,537,384,153,527,10
2008,Rural,Andhra Pradesh,Crime Against Children,Trafficking,Female,13-17,2642,2181,461,2186,456
2001,Urban,Nagaland,Crime Against Women,Rape,Female,46-60,7551,5212,2339,7390,161
2008,Rural,Bihar,Other Crimes,Fraud,Male,31-45,5676,983,4693,2226,3450
2005,Rural,Rajasthan,Crime Against Women,Molestation,Male,46-60,9224,5464,3760,7289,1935
2010,Urban,Himachal Pradesh,Crime Against Women,Rape,Female,13-17,474,225,249,461,13
2009,Rural,Tamil Nadu,Property Crime,Arson,Male,46-60,573,245,328,389,184
2008,Urban,Jharkhand,Property Crime,Theft,Male,13-17,7551,5343,2208,7224,327
2003,Urban,Bihar,Crime Against Children,Child Abuse,Male,0-12,244,198,46,206,38
2007,Urban,Karnataka,Property Crime,Theft,Male,60+,1188,722,466,954,234
2003,Rural,Tripura,Crime Against Children,Kidnapping,Female,18-30,6631,6439,192,6568,63
2007,Rural,Madhya Pradesh,Property Crime,Burglary,Male,18-30,1378,608,770,719,659
2002,Urban,Goa,Property Crime,Theft,Female,31-45,4139,830,3309,3148,991
2004,Rural,Jammu & Kashmir,Crime Against Children,Child Labor,Female,0-12,1260,348,912,657,603
2008,Rural,Gujarat,Crime Against Children,Child Abuse,Male,60+,2248,116,2132,1867,381
2006,Rural,Nagaland,Crime Against Men,Assault,Female,60+,577,26,551,260,317
2008,Rural,Rajasthan,Crime Against Women,Rape,Female,18-30,9706,1485,8221,7339,2367
2007,Urban,Odisha,Crime Against Children,Child Abuse,Female,18-30,7170,1616,5554,6972,198
2005,Rural,Andhra Pradesh,Property Crime,Vandalism,Male,46-60,8081,6633,1448,7479,602
2008,Urban,Arunachal Pradesh,Crime Against Children,Kidnapping,Female,31-45,1001,621,380,819,182
2006,Urban,Karnataka,Crime Against Children,Child Abuse,Male,18-30,8853,6182,2671,8798,55
2001,Rural,Jharkhand,Other Crimes,Cyber Crime,Male,0-12,840,542,298,643,197
2001,Rural,Goa,Property Crime,Vandalism,Male,18-30,6389,1939,4450,2538,3851
2004,Rural,Madhya Pradesh,Property Crime,Burglary,Male,46-60,4604,3964,640,4034,570
2008,Rural,Karnataka,Property Crime,Theft,Female,13-17,5294,3758,1536,5154,140
2010,Rural,Karnataka,Other Crimes,Corruption,Male,0-12,1018,135,883,551,467
2006,Rural,Tripura,Crime Against Women,Molestation,Female,18-30,8784,7083,1701,7273,1511
2002,Rural,Jammu & Kashmir,Crime Against Women,Molestation,Male,18-30,7868,6715,1153,7620,248
2010,Rural,Tamil Nadu,Crime Against Women,Dowry Deaths,Male,13-17,7386,2735,4651,6921,465
2010,Rural,Himachal Pradesh,Property Crime,Burglary,Female,60+,4711,2037,2674,2967,1744
2005,Rural,Karnataka,Property Crime,Vandalism,Male,31-45,9369,3990,5379,5933,3436
2005,Urban,Delhi,Crime Against Children,Kidnapping,Male,31-45,1069,590,479,755,314
2006,Rural,Punjab,Other Crimes,Cyber Crime,Male,18-30,3395,318,3077,901,2494
2001,Urban,Sikkim,Crime Against Women,Dowry Deaths,Female,13-17,1754,681,1073,1332,422
2003,Urban,West Bengal,Crime Against Children,Child Abuse,Male,13-17,8496,2725,5771,5550,2946
2007,Rural,Arunachal Pradesh,Other Crimes,Cyber Crime,Female,0-12,6766,628,6138,890,5876
2008,Rural,Chhattisgarh,Crime Against Men,Robbery,Male,31-45,2873,956,1917,1703,1170
2007,Urban,Nagaland,Property Crime,Vandalism,Male,46-60,4806,736,4070,3533,1273
2010,Urban,Jharkhand,Crime Against Men,Extortion,Male,18-30,6125,1217,4908,3862,2263
2001,Rural,Madhya Pradesh,Crime Against Women,Molestation,Female,0-12,3670,3127,543,3546,124
2009,Rural,Jammu & Kashmir,Crime Against Women,Dowry Deaths,Male,46-60,6561,3119,3442,3597,2964
2005,Urban,Meghalaya,Other Crimes,Drug Offense,Male,60+,4853,4083,770,4772,81
2007,Rural,Odisha,Property Crime,Theft,Female,0-12,91,46,45,84,7
2010,Urban,Mizoram,Crime Against Children,Child Labor,Female,31-45,4059,147,3912,1340,2719
2004,Rural,Jammu & Kashmir,Other Crimes,Corruption,Male,46-60,6646,5832,814,5995,651
2002,Urban,Odisha,Crime Against Men,Murder,Female,46-60,2421,2172,249,2380,41
2002,Urban,Himachal Pradesh,Crime Against Children,Trafficking,Female,31-45,1586,908,678,955,631
2001,Rural,Mizoram,Other Crimes,Drug Offense,Female,31-45,3567,879,2688,1212,2355
2003,Urban,Himachal Pradesh,Other Crimes,Cyber Crime,Female,46-60,3211,662,2549,2362,849
2005,Rural,Mizoram,Crime Against Men,Robbery,Male,13-17,2140,205,1935,1578,562
2005,Rural,Andhra Pradesh,Crime Against Women,Dowry Deaths,Female,18-30,2053,771,1282,1927,126
2002,Rural,Telangana,Other Crimes,Corruption,Male,13-17,7537,981,6556,4315,3222
2010,Rural,Tripura,Crime Against Men,Murder,Male,60+,4306,2,4304,3357,949
2008,Rural,Andhra Pradesh,Other Crimes,Cyber Crime,Female,31-45,3311,548,2763,1456,1855
2003,Rural,Nagaland,Other Crimes,Corruption,Female,46-60,9927,8103,1824,8764,1163
2008,Urban,Haryana,Crime Against Children,Child Labor,Male,46-60,8257,7453,804,7468,789
2005,Rural,West Bengal,Crime Against Women,Rape,Male,18-30,7497,1308,6189,6926,571
2009,Rural,Delhi,Crime Against Men,Robbery,Female,31-45,5786,2637,3149,5059,727
2005,Urban,Uttar Pradesh,Property Crime,Burglary,Female,13-17,8590,7835,755,8195,395
2004,Rural,Delhi,Property Crime,Theft,Male,18-30,900,777,123,828,72
2004,Rural,Jharkhand,Crime Against Children,Child Abuse,Female,31-45,2144,181,1963,1653,491
2005,Urban,Gujarat,Crime Against Children,Child Abuse,Female,0-12,4424,85,4339,1769,2655
2006,Urban,Bihar,Crime Against Women,Rape,Male,46-60,6454,1572,4882,3328,3126
2005,Urban,Uttar Pradesh,Crime Against Children,Child Labor,Male,18-30,5216,2320,2896,2793,2423
2005,Rural,Rajasthan,Other Crimes,Fraud,Female,31-45,3729,2007,1722,2887,842
2008,Rural,Punjab,Property Crime,Burglary,Female,0-12,2330,198,2132,900,1430
2008,Rural,Karnataka,Crime Against Children,Child Abuse,Female,60+,8645,5101,3544,5429,3216
2002,Rural,Tripura,Other Crimes,Fraud,Male,60+,500,89,411,455,45
2004,Urban,Maharashtra,Crime Against Men,Extortion,Male,0-12,2487,171,2316,1134,1353
2003,Rural,Gujarat,Crime Against Men,Murder,Male,46-60,3497,1876,1621,2204,1293
2010,Urban,Goa,Crime Against Men,Robbery,Male,13-17,792,666,126,753,39
2010,Rural,Assam,Other Crimes,Corruption,Male,13-17,7721,1065,6656,4679,3042
2001,Urban,Meghalaya,Property Crime,Burglary,Female,31-45,9345,7726,1619,7800,1545
2006,Urban,Andhra Pradesh,Other Crimes,Drug Offense,Female,18-30,551,377,174,458,93
2004,Urban,West Bengal,Crime Against Children,Child Labor,Female,0-12,7609,4842,2767,6670,939
2010,Rural,Manipur,Crime Against Women,Domestic Violence,Male,13-17,6402,3396,3006,5685,717
2005,Urban,Odisha,Crime Against Men,Extortion,Male,18-30,1761,489,1272,551,1210
2003,Urban,Chhattisgarh,Crime Against Men,Assault,Male,46-60,9503,2678,6825,9484,19
2003,Urban,Punjab,Crime Against Children,Child Labor,Male,13-17,3013,282,2731,2290,723
2001,Rural,Uttar Pradesh,Other Crimes,Cyber Crime,Male,60+,4691,1741,2950,4461,230
2010,Urban,Haryana,Property Crime,Vandalism,Female,31-45,7369,2445,4924,6490,879
2002,Rural,Haryana,Crime Against Men,Murder,Female,46-60,5667,2634,3033,4755,912
2001,Rural,Gujarat,Crime Against Children,Kidnapping,Male,0-12,2996,718,2278,1873,1123
2010,Urban,Jammu & Kashmir,Crime Against Men,Assault,Male,31-45,9780,3476,6304,6059,3721
2005,Urban,Bihar,Crime Against Women,Molestation,Female,13-17,4119,105,4014,2726,1393
2002,Urban,Karnataka,Property Crime,Arson,Female,31-45,2130,271,1859,819,1311
2004,Rural,Chhattisgarh,Crime Against Women,Molestation,Male,0-12,8984,8761,223,8824,160
2008,Urban,Delhi,Crime Against Women,Molestation,Male,31-45,5255,1928,3327,4448,807
2008,Rural,West Bengal,Crime Against Women,Dowry Deaths,Female,0-12,854,555,299,566,288
2006,Rural,Jammu & Kashmir,Crime Against Children,Trafficking,Male,13-17,8675,2191,6484,8653,22
2008,Urban,Tamil Nadu,Crime Against Men,Murder,Male,60+,3948,1341,2607,2277,1671
2001,Rural,West Bengal,Crime Against Women,Rape,Female,46-60,1305,1138,167,1216,89
2010,Urban,Kerala,Crime Against Children,Kidnapping,Female,31-45,9750,4571,5179,4865,4885
2004,Urban,Tripura,Crime Against Women,Domestic Violence,Male,31-45,7352,5560,1792,6642,710
2001,Rural,Meghalaya,Crime Against Women,Dowry Deaths,Male,31-45,8191,6947,1244,7118,1073
2005,Urban,Jharkhand,Crime Against Men,Robbery,Male,0-12,7611,5787,1824,6143,1468
2010,Urban,Andhra Pradesh,Crime Against Men,Extortion,Male,0-12,1883,1286,597,1858,25
2003,Urban,Delhi,Crime Against Men,Robbery,Male,13-17,8274,1812,6462,6470,1804
2003,Rural,Chhattisgarh,Crime Against Children,Kidnapping,Female,60+,8387,7896,491,7924,463
2010,Rural,Gujarat,Crime Against Women,Molestation,Male,60+,1035,349,686,397,638
2004,Rural,Punjab,Crime Against Men,Extortion,Female,13-17,9712,9353,359,9579,133
2009,Rural,Telangana,Crime Against Women,Rape,Female,46-60,5592,4274,1318,4898,694
2001,Urban,Assam,Crime Against Men,Assault,Female,60+,6037,2440,3597,3999,2038
2005,Urban,Jharkhand,Property Crime,Theft,Female,31-45,1640,1369,271,1389,251
2010,Rural,West Bengal,Crime Against Women,Domestic Violence,Male,60+,6288,1624,4664,2943,3345
2007,Rural,Chhattisgarh,Property Crime,Theft,Female,18-30,9478,9189,289,9266,212
2002,Urban,Kerala,Other Crimes,Corruption,Male,13-17,8338,5688,2650,6259,2079
2008,Urban,Arunachal Pradesh,Crime Against Children,Trafficking,Male,46-60,4869,1889,2980,2254,2615
2002,Rural,Maharashtra,Crime Against Children,Kidnapping,Female,60+,5803,1789,4014,5421,382
2009,Rural,Manipur,Crime Against Children,Child Labor,Female,60+,1190,762,428,843,347
2004,Urban,Chhattisgarh,Other Crimes,Cyber Crime,Female,46-60,7164,5481,1683,6818,346
2009,Urban,Madhya Pradesh,Other Crimes,Cyber Crime,Female,31-45,8235,3920,4315,5334,2901
2002,Rural,Andhra Pradesh,Crime Against Children,Child Abuse,Male,60+,177,175,2,177,0
2002,Rural,Jharkhand,Property Crime,Vandalism,Female,60+,8889,1843,7046,5737,3152
2008,Urban,Bihar,Property Crime,Theft,Male,46-60,8870,5186,3684,8560,310
2010,Rural,Tamil Nadu,Other Crimes,Corruption,Female,46-60,8508,3912,4596,4143,4365
2010,Rural,Mizoram,Crime Against Women,Dowry Deaths,Male,60+,5581,3310,2271,3934,1647
2001,Urban,Himachal Pradesh,Other Crimes,Corruption,Male,46-60,7454,3787,3667,4163,3291
2007,Urban,Tripura,Property Crime,Theft,Male,31-45,9390,7165,2225,8873,517
2003,Urban,Mizoram,Crime Against Men,Assault,Male,18-30,8690,8154,536,8231,459
2010,Rural,Madhya Pradesh,Other Crimes,Cyber Crime,Female,18-30,1658,1059,599,1195,463
2007,Rural,Jharkhand,Crime Against Men,Murder,Female,60+,6583,6004,579,6004,579
2002,Urban,Himachal Pradesh,Property Crime,Theft,Male,0-12,4002,1644,2358,3009,993
2007,Urban,Assam,Property Crime,Vandalism,Male,0-12,8280,4014,4266,5861,2419
2002,Urban,Goa,Crime Against Children,Kidnapping,Female,0-12,5522,1694,3828,4477,1045
2010,Rural,Manipur,Property Crime,Arson,Male,60+,626,149,477,607,19
2008,Rural,Uttarakhand,Crime Against Women,Molestation,Male,13-17,9007,372,8635,7338,1669
2001,Rural,West Bengal,Property Crime,Vandalism,Male,60+,2477,122,2355,445,2032
2001,Urban,Andhra Pradesh,Property Crime,Arson,Male,13-17,1735,1036,699,1257,478
2001,Rural,Kerala,Crime Against Children,Trafficking,Male,0-12,1791,635,1156,1495,296
2001,Urban,Nagaland,Crime Against Women,Domestic Violence,Male,60+,8800,2229,6571,4393,4407
2001,Urban,Himachal Pradesh,Crime Against Children,Child Labor,Male,18-30,2892,2133,759,2191,701
2003,Urban,Kerala,Crime Against Women,Rape,Male,46-60,9850,4230,5620,6225,3625
2005,Urban,Jharkhand,Crime Against Children,Child Labor,Female,0-12,900,276,624,712,188
2004,Urban,Nagaland,Property Crime,Burglary,Female,46-60,1103,1039,64,1043,60
2009,Rural,Bihar,Crime Against Women,Molestation,Female,46-60,3427,3324,103,3357,70
2003,Urban,Jammu & Kashmir,Crime Against Women,Molestation,Male,18-30,7633,4013,3620,5047,2586
2008,Urban,Chhattisgarh,Crime Against Children,Child Abuse,Female,13-17,3352,1328,2024,3122,230
2010,Rural,Madhya Pradesh,Crime Against Children,Trafficking,Female,13-17,2947,1908,1039,2538,409
2005,Urban,West Bengal,Crime Against Women,Rape,Male,13-17,9387,5326,4061,6234,3153
2009,Urban,Punjab,Property Crime,Vandalism,Female,31-45,4147,3720,427,4123,24
2005,Urban,Telangana,Property Crime,Burglary,Female,18-30,4423,2668,1755,3593,830
2006,Rural,Arunachal Pradesh,Crime Against Men,Robbery,Male,46-60,3438,1357,2081,2749,689
2004,Urban,Chhattisgarh,Property Crime,Burglary,Female,31-45,677,559,118,651,26
2004,Urban,Sikkim,Crime Against Men,Murder,Female,0-12,4367,2450,1917,3183,1184
2006,Rural,Jammu & Kashmir,Property Crime,Theft,Male,46-60,9481,2011,7470,8985,496
2004,Rural,Nagaland,Other Crimes,Fraud,Male,46-60,7506,4630,2876,6208,1298
2006,Urban,Manipur,Crime Against Women,Rape,Male,60+,3506,757,2749,2060,1446
2002,Urban,Goa,Crime Against Men,Robbery,Male,60+,4594,1120,3474,1502,3092
2009,Urban,Haryana,Other Crimes,Cyber Crime,Male,18-30,2122,1035,1087,1731,391
2004,Urban,Meghalaya,Crime Against Children,Child Abuse,Male,60+,6768,6456,312,6751,17
2006,Urban,Jammu & Kashmir,Property Crime,Burglary,Female,60+,5688,3001,2687,3942,1746
2003,Rural,Jharkhand,Crime Against Men,Extortion,Male,13-17,5104,1381,3723,3369,1735
2008,Rural,Punjab,Other Crimes,Drug Offense,Male,0-12,6738,5736,1002,6636,102
2010,Urban,Kerala,Crime Against Children,Kidnapping,Male,46-60,6494,2883,3611,4856,1638
2009,Rural,Himachal Pradesh,Crime Against Men,Assault,Male,60+,9776,5976,3800,8752,1024
2009,Urban,Tamil Nadu,Property Crime,Vandalism,Female,18-30,6063,442,5621,1106,4957
2009,Rural,Uttar Pradesh,Other Crimes,Cyber Crime,Male,0-12,9624,1029,8595,8485,1139
2005,Urban,Arunachal Pradesh,Crime Against Women,Domestic Violence,Male,31-45,7871,1705,6166,5539,2332
2009,Urban,Tripura,Other Crimes,Fraud,Male,60+,7809,3498,4311,5036,2773
2003,Rural,Manipur,Other Crimes,Cyber Crime,Male,13-17,9016,3148,5868,8065,951
2003,Rural,Madhya Pradesh,Crime Against Men,Assault,Male,31-45,5213,3848,1365,4258,955
2006,Rural,Haryana,Crime Against Men,Extortion,Female,60+,9741,8753,988,9710,31
2001,Rural,Punjab,Crime Against Men,Extortion,Male,18-30,9210,4770,4440,8909,301
2002,Rural,Telangana,Property Crime,Theft,Male,18-30,7164,6935,229,6991,173
2003,Urban,Tripura,Crime Against Women,Domestic Violence,Male,60+,4739,2771,1968,2785,1954
2005,Urban,Mizoram,Crime Against Children,Child Labor,Female,0-12,3471,2545,926,2824,647
2004,Urban,Delhi,Property Crime,Vandalism,Male,31-45,7589,4097,3492,7173,416
2003,Rural,Punjab,Crime Against Children,Trafficking,Female,18-30,8455,2415,6040,5146,3309
2007,Urban,Madhya Pradesh,Other Crimes,Drug Offense,Female,13-17,8223,7997,226,8174,49
2001,Rural,Telangana,Crime Against Men,Extortion,Male,46-60,7446,3631,3815,4801,2645
2009,Rural,Meghalaya,Other Crimes,Drug Offense,Male,31-45,7239,1211,6028,3842,3397
2001,Urban,Gujarat,Property Crime,Vandalism,Female,60+,6059,4802,1257,5929,130
2008,Urban,Uttarakhand,Crime Against Children,Kidnapping,Female,31-45,6765,2259,4506,2287,4478
2008,Urban,Tripura,Crime Against Men,Extortion,Female,31-45,3552,1884,1668,3473,79
2003,Urban,Tripura,Property Crime,Theft,Female,13-17,241,189,52,214,27
2006,Rural,Chhattisgarh,Other Crimes,Fraud,Male,31-45,523,305,218,486,37
2005,Rural,Jharkhand,Crime Against Women,Dowry Deaths,Male,60+,6503,2188,4315,4793,1710
2001,Urban,Himachal Pradesh,Crime Against Men,Extortion,Female,13-17,3702,3347,355,3492,210
2003,Urban,Kerala,Property Crime,Theft,Male,0-12,8628,2039,6589,4480,4148
2002,Rural,Tamil Nadu,Crime Against Men,Murder,Male,46-60,7080,4790,2290,5792,1288
2004,Rural,Mizoram,Other Crimes,Corruption,Male,0-12,6810,2740,4070,3765,3045
2002,Rural,Tamil Nadu,Crime Against Men,Assault,Female,46-60,6193,5464,729,5521,672
2010,Urban,Jammu & Kashmir,Crime Against Men,Robbery,Male,13-17,2886,2885,1,2885,1
2008,Urban,Uttarakhand,Crime Against Men,Robbery,Female,18-30,9760,2486,7274,8038,1722
2009,Rural,Telangana,Other Crimes,Fraud,Male,31-45,2273,1162,1111,1897,376
2006,Rural,Manipur,Crime Against Women,Rape,Female,31-45,5151,2800,2351,4285,866
2008,Rural,Jammu & Kashmir,Property Crime,Vandalism,Male,31-45,8460,3179,5281,3411,5049
2006,Rural,Karnataka,Crime Against Women,Dowry Deaths,Male,31-45,8554,6090,2464,6180,2374
2001,Rural,Odisha,Crime Against Men,Extortion,Male,13-17,1164,609,555,1076,88
2003,Rural,Manipur,Property Crime,Theft,Female,18-30,734,192,542,464,270
2004,Urban,Delhi,Other Crimes,Drug Offense,Female,0-12,2273,1669,604,2223,50
2007,Rural,Chhattisgarh,Crime Against Men,Murder,Male,31-45,7981,5394,2587,7500,481
2005,Rural,Himachal Pradesh,Crime Against Children,Kidnapping,Female,31-45,535,450,85,471,64
2004,Urban,Sikkim,Crime Against Men,Extortion,Female,46-60,120,43,77,68,52
2002,Urban,Karnataka,Crime Against Women,Dowry Deaths,Female,0-12,3550,2013,1537,2169,1381
2004,Urban,Himachal Pradesh,Crime Against Children,Trafficking,Male,0-12,3718,377,3341,3402,316
2003,Rural,Uttarakhand,Property Crime,Arson,Female,18-30,3005,1217,1788,2424,581
2002,Urban,Jharkhand,Other Crimes,Fraud,Male,31-45,2383,1163,1220,1425,958
2005,Rural,Odisha,Crime Against Men,Robbery,Female,0-12,4377,1896,2481,3148,1229
2003,Urban,Tripura,Crime Against Women,Dowry Deaths,Female,31-45,2466,40,2426,450,2016
2001,Rural,Jharkhand,Property Crime,Burglary,Male,0-12,7679,4353,3326,4389,3290
2008,Urban,Bihar,Other Crimes,Drug Offense,Female,13-17,7255,2447,4808,2969,4286
2005,Rural,Gujarat,Crime Against Women,Molestation,Female,31-45,4723,2702,2021,3252,1471
2001,Urban,Jammu & Kashmir,Property Crime,Arson,Female,31-45,910,119,791,275,635
2006,Rural,Jammu & Kashmir,Property Crime,Vandalism,Male,60+,4148,2647,1501,3454,694
2008,Rural,Mizoram,Crime Against Children,Child Abuse,Female,46-60,5616,3785,1831,5503,113
2006,Rural,Andhra Pradesh,Crime Against Men,Murder,Male,46-60,2439,1891,548,2241,198
2005,Rural,Karnataka,Crime Against Children,Child Abuse,Male,18-30,5881,2937,2944,4771,1110
2008,Rural,Odisha,Crime Against Children,Kidnapping,Male,18-30,9857,5743,4114,6799,3058
2001,Rural,Bihar,Crime Against Men,Extortion,Female,18-30,2946,1288,1658,2379,567
2005,Urban,Arunachal Pradesh,Crime Against Women,Domestic Violence,Female,60+,2500,254,2246,1810,690
2010,Rural,Kerala,Other Crimes,Cyber Crime,Female,0-12,8495,2053,6442,4366,4129
2009,Urban,Bihar,Property Crime,Arson,Female,46-60,2198,1566,632,1854,344
2007,Urban,Mizoram,Property Crime,Arson,Male,60+,6758,3429,3329,5135,1623
2008,Urban,Manipur,Crime Against Men,Assault,Male,46-60,2008,1932,76,1939,69
2010,Urban,Mizoram,Property Crime,Burglary,Female,46-60,2531,876,1655,1725,806
2007,Rural,Punjab,Property Crime,Theft,Male,13-17,7486,1628,5858,4061,3425
2010,Urban,Gujarat,Other Crimes,Cyber Crime,Female,0-12,2827,672,2155,1478,1349
2003,Urban,Madhya Pradesh,Other Crimes,Fraud,Female,31-45,9348,717,8631,6851,2497
2007,Urban,Madhya Pradesh,Crime Against Men,Assault,Male,0-12,2584,335,2249,2346,238
2003,Rural,Goa,Other Crimes,Cyber Crime,Male,46-60,9816,7217,2599,7962,1854
2009,Urban,Maharashtra,Crime Against Children,Child Labor,Female,13-17,2550,1250,1300,1267,1283
2005,Urban,Maharashtra,Crime Against Men,Extortion,Male,46-60,2035,121,1914,619,1416
2009,Urban,Kerala,Crime Against Men,Assault,Male,18-30,1241,811,430,877,364
2004,Rural,Chhattisgarh,Crime Against Men,Extortion,Male,46-60,1335,504,831,1185,150
2010,Rural,Odisha,Crime Against Men,Murder,Male,46-60,8333,7100,1233,8082,251
2001,Rural,Andhra Pradesh,Crime Against Women,Rape,Male,60+,7471,1895,5576,3514,3957
2002,Rural,Uttarakhand,Crime Against Men,Robbery,Female,31-45,6133,1225,4908,3317,2816
2007,Rural,Uttarakhand,Other Crimes,Drug Offense,Male,18-30,8532,1939,6593,6739,1793
2004,Rural,Madhya Pradesh,Property Crime,Vandalism,Male,46-60,2483,1349,1134,1794,689
2007,Rural,Madhya Pradesh,Crime Against Children,Child Labor,Male,13-17,2452,1262,1190,1679,773
2006,Urban,Telangana,Other Crimes,Corruption,Female,46-60,1635,726,909,869,766
2005,Urban,Maharashtra,Property Crime,Arson,Male,31-45,6562,2316,4246,2638,3924
2002,Urban,Jharkhand,Crime Against Children,Child Labor,Male,13-17,5748,3488,2260,5218,530
2010,Urban,Uttarakhand,Crime Against Children,Child Labor,Male,18-30,4777,3488,1289,4770,7
2005,Urban,Chhattisgarh,Property Crime,Arson,Male,18-30,4576,1529,3047,1568,3008
2009,Rural,Tripura,Crime Against Women,Domestic Violence,Female,13-17,7979,6240,1739,6984,995
2001,Rural,Uttarakhand,Other Crimes,Fraud,Male,13-17,8788,3217,5571,5664,3124
2006,Urban,Assam,Crime Against Children,Child Abuse,Male,13-17,4711,4569,142,4686,25
2009,Rural,Jharkhand,Crime Against Children,Child Labor,Female,46-60,408,253,155,324,84
2001,Urban,Karnataka,Other Crimes,Drug Offense,Female,60+,5739,947,4792,1815,3924
2004,Rural,Uttarakhand,Other Crimes,Drug Offense,Female,0-12,6552,5202,1350,6083,469
2005,Urban,Uttarakhand,Other Crimes,Cyber Crime,Female,46-60,3305,2851,454,3024,281
2007,Rural,Maharashtra,Crime Against Women,Rape,Male,0-12,5018,1181,3837,2704,2314
2006,Urban,Maharashtra,Property Crime,Theft,Female,60+,1578,977,601,1060,518
2004,Rural,Goa,Crime Against Children,Trafficking,Male,31-45,9209,8848,361,9038,171
2005,Rural,Andhra Pradesh,Crime Against Children,Child Labor,Male,13-17,1813,1655,158,1710,103
2004,Urban,Haryana,Crime Against Women,Molestation,Male,46-60,3444,2388,1056,3008,436
2009,Urban,Uttarakhand,Crime Against Men,Extortion,Male,0-12,1936,1202,734,1832,104
2004,Rural,Maharashtra,Crime Against Women,Dowry Deaths,Male,31-45,6163,2615,3548,4689,1474
2003,Rural,Kerala,Crime Against Children,Kidnapping,Male,13-17,8410,985,7425,4388,4022
2002,Urban,Odisha,Crime Against Men,Extortion,Male,31-45,2594,1438,1156,2381,213
2007,Rural,Karnataka,Crime Against Women,Molestation,Female,46-60,438,208,230,292,146
2003,Urban,Chhattisgarh,Property Crime,Arson,Male,31-45,4949,1469,3480,1883,3066
2008,Urban,Kerala,Property Crime,Theft,Male,13-17,6193,5043,1150,5973,220
2008,Urban,Sikkim,Other Crimes,Cyber Crime,Male,0-12,464,146,318,345,119
2009,Rural,Assam,Other Crimes,Cyber Crime,Male,13-17,388,150,238,346,42
2006,Rural,Delhi,Property Crime,Arson,Male,13-17,6269,4467,1802,5944,325
2004,Urban,Kerala,Crime Against Children,Kidnapping,Female,13-17,9890,7862,2028,9065,825
2005,Urban,Arunachal Pradesh,Crime Against Children,Kidnapping,Male,31-45,2652,1665,987,1919,733
2002,Urban,Assam,Other Crimes,Fraud,Male,60+,736,135,601,301,435
2010,Rural,Uttar Pradesh,Crime Against Women,Domestic Violence,Male,60+,1288,492,796,698,590
2005,Rural,Bihar,Property Crime,Vandalism,Female,60+,551,227,324,278,273
2006,Urban,Tripura,Crime Against Men,Robbery,Male,46-60,794,437,357,769,25
2008,Urban,Nagaland,Crime Against Women,Rape,Female,31-45,4883,2943,1940,3603,1280
2001,Rural,Karnataka,Other Crimes,Corruption,Male,0-12,7889,7647,242,7883,6
2009,Urban,Meghalaya,Crime Against Men,Murder,Male,18-30,1545,489,1056,941,604
2004,Rural,Manipur,Crime Against Men,Assault,Male,0-12,228,142,86,199,29
2010,Rural,Arunachal Pradesh,Property Crime,Burglary,Female,31-45,6274,5088,1186,5809,465
2005,Rural,Meghalaya,Crime Against Children,Child Abuse,Female,18-30,5636,2640,2996,3876,1760
2010,Urban,Nagaland,Property Crime,Burglary,Female,60+,2543,2414,129,2504,39
2008,Rural,Bihar,Other Crimes,Corruption,Female,46-60,6728,5168,1560,6517,211
2007,Urban,Uttar Pradesh,Other Crimes,Drug Offense,Male,13-17,5034,4066,968,4721,313
2009,Urban,West Bengal,Property Crime,Vandalism,Female,0-12,3488,1762,1726,2590,898
2003,Rural,Arunachal Pradesh,Crime Against Women,Dowry Deaths,Female,60+,821,254,567,688,133
2010,Urban,Meghalaya,Property Crime,Theft,Male,31-45,7403,1082,6321,6554,849
2010,Rural,Goa,Crime Against Men,Robbery,Male,31-45,4551,3723,828,4550,1
2006,Rural,Uttar Pradesh,Crime Against Men,Assault,Male,0-12,6872,3487,3385,3583,3289
2006,Rural,Sikkim,Crime Against Women,Dowry Deaths,Male,31-45,2877,2113,764,2524,353
2008,Rural,Jharkhand,Other Crimes,Drug Offense,Male,18-30,8331,13,8318,479,7852
2008,Rural,Delhi,Other Crimes,Corruption,Female,18-30,9921,2924,6997,5378,4543
2010,Urban,Maharashtra,Crime Against Men,Assault,Female,31-45,5512,2120,3392,5329,183
2007,Urban,Manipur,Crime Against Women,Rape,Female,31-45,80,73,7,78,2
2007,Urban,Punjab,Crime Against Women,Molestation,Female,46-60,6367,4118,2249,5103,1264
2002,Rural,Rajasthan,Crime Against Men,Robbery,Male,0-12,3670,159,3511,1279,2391
2003,Rural,Uttarakhand,Other Crimes,Corruption,Male,0-12,7306,4543,2763,4865,2441
2009,Rural,Jharkhand,Crime Against Children,Child Abuse,Female,0-12,3224,2810,414,2816,408
2006,Rural,Karnataka,Crime Against Men,Assault,Male,31-45,6591,6246,345,6568,23
2004,Rural,Uttarakhand,Crime Against Men,Extortion,Female,0-12,2310,2205,105,2249,61
2009,Rural,Chhattisgarh,Property Crime,Vandalism,Female,0-12,5601,5358,243,5592,9
2001,Urban,Jammu & Kashmir,Property Crime,Burglary,Female,31-45,5521,5267,254,5442,79
2002,Urban,Assam,Crime Against Men,Extortion,Male,18-30,1669,1470,199,1502,167
2009,Rural,Maharashtra,Crime Against Children,Child Labor,Male,31-45,8014,5244,2770,6115,1899
2005,Rural,Jammu & Kashmir,Crime Against Men,Extortion,Female,0-12,8755,4638,4117,7803,952
2010,Rural,Karnataka,Crime Against Children,Child Abuse,Female,60+,493,243,250,473,20
2002,Urban,Arunachal Pradesh,Crime Against Children,Child Abuse,Male,31-45,6177,480,5697,5478,699
2009,Rural,Madhya Pradesh,Other Crimes,Fraud,Female,31-45,6479,3803,2676,4405,2074
2010,Rural,Madhya Pradesh,Property Crime,Vandalism,Male,18-30,3787,514,3273,3571,216
2004,Rural,Uttar Pradesh,Crime Against Children,Trafficking,Female,31-45,4662,3489,1173,4275,387
2010,Urban,Manipur,Property Crime,Theft,Male,13-17,4029,3768,261,3854,175
2004,Urban,Tamil Nadu,Property Crime,Arson,Male,13-17,1349,451,898,537,812
2009,Urban,Sikkim,Other Crimes,Drug Offense,Male,0-12,1393,1120,273,1197,196
2005,Urban,Odisha,Other Crimes,Fraud,Female,13-17,540,517,23,534,6
2005,Urban,Uttar Pradesh,Crime Against Children,Kidnapping,Female,18-30,5351,3663,1688,4249,1102
2007,Rural,Nagaland,Crime Against Men,Assault,Female,13-17,4412,1820,2592,2260,2152
2001,Rural,Himachal Pradesh,Crime Against Children,Child Labor,Male,0-12,4731,3360,1371,4288,443
2005,Urban,Uttar Pradesh,Other Crimes,Corruption,Male,13-17,4244,374,3870,2289,1955
2007,Rural,Jharkhand,Property Crime,Vandalism,Male,46-60,2761,729,2032,1338,1423
2004,Urban,Telangana,Crime Against Women,Domestic Violence,Female,0-12,1363,869,494,1020,343
2001,Urban,Haryana,Crime Against Children,Child Abuse,Male,46-60,2893,309,2584,2516,377
2002,Urban,Tripura,Other Crimes,Corruption,Male,31-45,6685,2659,4026,6092,593
2008,Urban,Telangana,Property Crime,Vandalism,Male,18-30,882,307,575,697,185
2006,Urban,West Bengal,Crime Against Women,Dowry Deaths,Male,31-45,5284,4750,534,4857,427
2003,Urban,Odisha,Crime Against Children,Trafficking,Male,31-45,5243,1327,3916,2071,3172
2010,Rural,Uttarakhand,Property Crime,Arson,Female,60+,6892,6304,588,6472,420
2009,Rural,Chhattisgarh,Property Crime,Arson,Female,46-60,4266,3346,920,3646,620
2004,Urban,Punjab,Other Crimes,Drug Offense,Female,46-60,7360,156,7204,3335,4025
2003,Urban,Chhattisgarh,Crime Against Children,Child Labor,Male,46-60,6902,5292,1610,6855,47
2005,Rural,Bihar,Crime Against Children,Child Abuse,Male,46-60,3610,3094,516,3148,462
2006,Urban,Uttarakhand,Crime Against Children,Child Abuse,Female,13-17,3703,910,2793,1655,2048
2006,Urban,Haryana,Crime Against Children,Kidnapping,Female,46-60,6032,393,5639,1849,4183
2003,Urban,Nagaland,Crime Against Women,Rape,Male,0-12,279,65,214,271,8
2006,Urban,Andhra Pradesh,Property Crime,Arson,Female,46-60,9224,32,9192,2617,6607
2004,Rural,Assam,Crime Against Men,Robbery,Male,31-45,9091,4060,5031,6497,2594
2009,Urban,Haryana,Other Crimes,Fraud,Male,31-45,1430,1379,51,1381,49
2002,Rural,Gujarat,Crime Against Men,Extortion,Male,31-45,3603,1403,2200,1697,1906
2007,Urban,Nagaland,Property Crime,Arson,Female,46-60,4805,2825,1980,4346,459
2006,Rural,Jammu & Kashmir,Crime Against Women,Rape,Female,0-12,5470,536,4934,4126,1344
2003,Urban,Goa,Property Crime,Burglary,Male,0-12,5088,24,5064,531,4557
2003,Urban,Assam,Property Crime,Vandalism,Female,0-12,3879,1410,2469,3715,164
2004,Urban,Uttarakhand,Property Crime,Theft,Female,31-45,3477,536,2941,1068,2409
2009,Urban,Tamil Nadu,Crime Against Men,Assault,Female,46-60,7488,4655,2833,5296,2192
2004,Urban,Uttarakhand,Crime Against Men,Extortion,Female,46-60,5125,2350,2775,3492,1633
2005,Rural,Tripura,Crime Against Women,Molestation,Male,60+,5655,3914,1741,4014,1641
2007,Urban,Gujarat,Other Crimes,Drug Offense,Male,0-12,4185,517,3668,3986,199
2005,Urban,Assam,Crime Against Children,Child Abuse,Female,60+,9247,5728,3519,6864,2383
2004,Urban,Arunachal Pradesh,Crime Against Men,Murder,Female,46-60,1360,1089,271,1259,101
2002,Rural,Himachal Pradesh,Crime Against Men,Murder,Female,31-45,670,204,466,221,449
2001,Urban,Bihar,Property Crime,Theft,Male,46-60,2455,1897,558,1908,547
2009,Urban,Mizoram,Other Crimes,Corruption,Male,13-17,9469,4755,4714,5773,3696
2007,Rural,Telangana,Crime Against Children,Child Labor,Male,13-17,9072,3344,5728,5189,3883
2006,Rural,Karnataka,Property Crime,Vandalism,Male,18-30,5178,5096,82,5116,62
2001,Rural,Meghalaya,Property Crime,Theft,Male,13-17,2421,2413,8,2420,1
2005,Urban,West Bengal,Property Crime,Vandalism,Female,31-45,8997,8824,173,8969,28
2003,Rural,Rajasthan,Other Crimes,Cyber Crime,Male,46-60,8213,6989,1224,8091,122
2009,Urban,West Bengal,Other Crimes,Drug Offense,Female,31-45,3349,1575,1774,1579,1770
2008,Urban,Kerala,Crime Against Men,Assault,Female,0-12,2794,2506,288,2537,257
2003,Urban,Delhi,Crime Against Women,Domestic Violence,Female,31-45,9278,7308,1970,7513,1765
2007,Urban,Karnataka,Crime Against Men,Assault,Male,18-30,352,89,263,304,48
2010,Urban,West Bengal,Crime Against Women,Rape,Female,60+,3476,591,2885,1172,2304
2010,Rural,Meghalaya,Crime Against Men,Assault,Male,46-60,8347,4657,3690,5170,3177
2003,Urban,Assam,Other Crimes,Fraud,Female,31-45,3568,386,3182,2902,666
2007,Urban,Uttar Pradesh,Other Crimes,Fraud,Male,0-12,6453,2066,4387,3395,3058
2006,Rural,Mizoram,Property Crime,Arson,Male,60+,741,156,585,477,264
2005,Urban,Goa,Crime Against Women,Molestation,Male,60+,3994,3938,56,3941,53
2001,Urban,Sikkim,Crime Against Women,Molestation,Female,13-17,7863,4295,3568,6248,1615
2003,Rural,Nagaland,Crime Against Women,Molestation,Male,31-45,8678,2272,6406,7211,1467
2007,Urban,Uttarakhand,Crime Against Women,Domestic Violence,Female,46-60,6526,1696,4830,5381,1145
2006,Rural,Andhra Pradesh,Crime Against Men,Murder,Female,18-30,6174,3525,2649,5938,236
2001,Urban,Uttarakhand,Crime Against Women,Dowry Deaths,Female,0-12,3314,946,2368,1441,1873
2009,Urban,Mizoram,Other Crimes,Cyber Crime,Female,18-30,2531,495,2036,1701,830
2007,Urban,Arunachal Pradesh,Crime Against Women,Rape,Male,0-12,2379,1915,464,2203,176
2007,Urban,Uttar Pradesh,Crime Against Children,Child Abuse,Female,0-12,4216,2181,2035,3670,546
2001,Rural,Mizoram,Crime Against Women,Dowry Deaths,Female,18-30,5282,1863,3419,4058,1224
2007,Urban,Jharkhand,Property Crime,Theft,Male,46-60,6976,1404,5572,4026,2950
2003,Rural,Karnataka,Other Crimes,Drug Offense,Male,31-45,5254,5233,21,5235,19
2001,Rural,Gujarat,Other Crimes,Fraud,Female,18-30,4139,1586,2553,2828,1311
2002,Urban,Punjab,Crime Against Women,Domestic Violence,Female,31-45,4307,1644,2663,2487,1820
2006,Rural,Haryana,Crime Against Children,Child Abuse,Female,18-30,8429,5538,2891,6383,2046
2004,Urban,Haryana,Crime Against Men,Robbery,Female,18-30,1248,698,550,1236,12
2006,Urban,Rajasthan,Crime Against Women,Domestic Violence,Female,0-12,5259,1077,4182,2575,2684
2005,Urban,Madhya Pradesh,Crime Against Men,Assault,Female,0-12,9818,7880,1938,8408,1410
2005,Rural,West Bengal,Property Crime,Arson,Male,18-30,3335,2442,893,2649,686
2001,Urban,Rajasthan,Other Crimes,Fraud,Female,31-45,228,204,24,219,9
2006,Rural,Tamil Nadu,Other Crimes,Corruption,Male,46-60,4906,4156,750,4291,615
2010,Rural,Maharashtra,Crime Against Children,Trafficking,Male,18-30,4293,2207,2086,3386,907
2007,Rural,Uttarakhand,Crime Against Men,Assault,Male,18-30,5225,1747,3478,3580,1645
2005,Rural,Uttarakhand,Crime Against Women,Dowry Deaths,Male,60+,5937,3548,2389,4717,1220
2006,Rural,Delhi,Other Crimes,Corruption,Male,46-60,3814,1118,2696,2079,1735
2007,Urban,Chhattisgarh,Property Crime,Theft,Female,31-45,1193,604,589,1096,97
2006,Urban,Tripura,Other Crimes,Cyber Crime,Female,0-12,222,90,132,207,15
2004,Rural,Jammu & Kashmir,Crime Against Children,Trafficking,Female,31-45,3714,2809,905,3193,521
2002,Rural,Punjab,Property Crime,Vandalism,Male,31-45,9575,787,8788,882,8693
2008,Urban,Rajasthan,Property Crime,Burglary,Female,60+,5390,573,4817,3917,1473
2004,Rural,Tamil Nadu,Other Crimes,Drug Offense,Female,0-12,6272,5259,1013,5549,723
2001,Urban,Nagaland,Other Crimes,Corruption,Male,60+,9000,3582,5418,4926,4074
2004,Rural,Nagaland,Property Crime,Arson,Male,0-12,1709,516,1193,1010,699
2002,Urban,Punjab,Property Crime,Burglary,Female,46-60,2640,1837,803,2167,473
2008,Urban,Jammu & Kashmir,Crime Against Children,Child Labor,Male,31-45,5828,3471,2357,4535,1293
2009,Rural,Telangana,Crime Against Children,Child Abuse,Female,60+,7846,2110,5736,6533,1313
2009,Rural,Arunachal Pradesh,Other Crimes,Corruption,Male,60+,9087,9026,61,9043,44
2009,Rural,Sikkim,Crime Against Children,Child Abuse,Male,18-30,5799,4359,1440,5506,293
2008,Rural,Meghalaya,Crime Against Children,Child Labor,Female,18-30,8799,4031,4768,8513,286
2003,Urban,Maharashtra,Crime Against Children,Kidnapping,Female,18-30,3323,2333,990,3299,24
2002,Rural,Telangana,Crime Against Women,Dowry Deaths,Male,60+,861,192,669,362,499
2010,Urban,Goa,Property Crime,Vandalism,Female,13-17,4663,1566,3097,1785,2878
2004,Urban,Uttarakhand,Property Crime,Theft,Male,60+,9049,8792,257,8884,165
2002,Rural,Delhi,Property Crime,Arson,Female,46-60,3520,2381,1139,2625,895
2002,Urban,West Bengal,Crime Against Women,Domestic Violence,Male,46-60,4072,3698,374,4031,41
2001,Rural,Jammu & Kashmir,Crime Against Men,Assault,Female,60+,7017,3364,3653,5105,1912
2009,Urban,Meghalaya,Crime Against Men,Assault,Female,18-30,9911,3393,6518,6816,3095
2004,Rural,Uttarakhand,Property Crime,Theft,Female,13-17,4063,1012,3051,1476,2587
2008,Rural,Kerala,Crime Against Men,Robbery,Female,18-30,1127,65,1062,867,260
2006,Urban,Assam,Crime Against Women,Dowry Deaths,Female,13-17,1605,750,855,992,613
2004,Rural,Jammu & Kashmir,Property Crime,Arson,Male,46-60,4378,3300,1078,3815,563
2008,Urban,Nagaland,Crime Against Children,Trafficking,Female,60+,3449,215,3234,575,2874
2009,Urban,Mizoram,Crime Against Women,Rape,Female,60+,1938,1269,669,1309,629
2001,Urban,Delhi,Crime Against Children,Child Abuse,Male,31-45,8919,1319,7600,1488,7431
2005,Rural,Chhattisgarh,Crime Against Women,Domestic Violence,Male,0-12,9401,3468,5933,9177,224
2001,Rural,Maharashtra,Crime Against Men,Robbery,Female,18-30,5983,5275,708,5644,339
2001,Rural,Maharashtra,Property Crime,Theft,Male,46-60,3391,432,2959,1973,1418
2002,Urban,Meghalaya,Other Crimes,Drug Offense,Female,31-45,901,362,539,654,247
2009,Rural,Jammu & Kashmir,Property Crime,Arson,Male,46-60,432,413,19,429,3
2006,Urban,Chhattisgarh,Other Crimes,Drug Offense,Male,0-12,730,182,548,628,102
2003,Urban,Chhattisgarh,Crime Against Men,Robbery,Female,46-60,1652,166,1486,1275,377
2004,Rural,Gujarat,Other Crimes,Corruption,Female,0-12,6399,3408,2991,5265,1134
2008,Urban,West Bengal,Crime Against Children,Child Abuse,Female,18-30,4089,1398,2691,3118,971
2005,Urban,Delhi,Crime Against Women,Rape,Female,46-60,5344,5039,305,5158,186
2004,Urban,Jammu & Kashmir,Crime Against Men,Extortion,Female,46-60,8843,6131,2712,7679,1164
2001,Rural,Maharashtra,Property Crime,Vandalism,Male,18-30,1311,266,1045,935,376
2004,Rural,Arunachal Pradesh,Crime Against Women,Domestic Violence,Female,60+,5371,2926,2445,3551,1820
2008,Rural,Uttarakhand,Other Crimes,Corruption,Male,60+,502,14,488,322,180
2002,Rural,Telangana,Other Crimes,Cyber Crime,Male,0-12,832,386,446,688,144
2007,Urban,Himachal Pradesh,Other Crimes,Drug Offense,Male,60+,1925,1745,180,1867,58
2009,Rural,Tamil Nadu,Property Crime,Vandalism,Male,46-60,5218,2373,2845,4946,272
2008,Rural,Maharashtra,Crime Against Men,Assault,Female,18-30,400,4,396,73,327
2010,Urban,Andhra Pradesh,Crime Against Children,Trafficking,Male,60+,1642,1502,140,1560,82
2010,Rural,Arunachal Pradesh,Crime Against Women,Domestic Violence,Male,31-45,3865,509,3356,2722,1143
2010,Urban,Rajasthan,Crime Against Men,Extortion,Male,60+,8246,5508,2738,5890,2356
2003,Urban,Arunachal Pradesh,Property Crime,Arson,Female,60+,9980,8778,1202,9917,63
2005,Urban,Assam,Crime Against Women,Molestation,Male,46-60,7908,3498,4410,7767,141
2003,Urban,Himachal Pradesh,Crime Against Children,Child Abuse,Female,0-12,7255,3900,3355,6054,1201
2009,Rural,Punjab,Other Crimes,Corruption,Female,46-60,3747,39,3708,1688,2059
2010,Urban,Punjab,Crime Against Men,Murder,Male,60+,9982,2244,7738,8646,1336
2005,Urban,Himachal Pradesh,Crime Against Men,Assault,Male,46-60,7522,6857,665,7018,504
2008,Rural,Tamil Nadu,Crime Against Children,Trafficking,Female,0-12,7536,1795,5741,6411,1125
2004,Rural,Sikkim,Crime Against Women,Rape,Female,31-45,3246,1342,1904,1856,1390
2006,Urban,Tamil Nadu,Crime Against Women,Rape,Male,18-30,3824,3136,688,3500,324
2004,Rural,Nagaland,Crime Against Men,Extortion,Female,13-17,6426,1791,4635,3225,3201
2003,Urban,Chhattisgarh,Crime Against Men,Assault,Male,46-60,5128,4431,697,4960,168
2008,Urban,Goa,Other Crimes,Drug Offense,Female,31-45,8401,7734,667,8154,247
2009,Rural,Uttarakhand,Other Crimes,Corruption,Female,60+,1133,450,683,1100,33
2001,Rural,Mizoram,Crime Against Women,Molestation,Female,46-60,6893,4481,2412,5919,974
2005,Rural,Haryana,Crime Against Children,Trafficking,Male,31-45,5601,805,4796,4341,1260
2007,Rural,Manipur,Crime Against Children,Child Labor,Female,18-30,6763,4667,2096,4964,1799
2010,Rural,Kerala,Crime Against Children,Kidnapping,Male,0-12,991,838,153,968,23
2007,Rural,Odisha,Crime Against Children,Trafficking,Female,60+,7773,101,7672,3022,4751
2008,Urban,Odisha,Crime Against Men,Assault,Male,31-45,7155,5135,2020,5151,2004
2002,Rural,Chhattisgarh,Other Crimes,Fraud,Female,46-60,9497,8085,1412,9085,412
2006,Rural,Delhi,Crime Against Men,Assault,Male,0-12,3488,2691,797,3040,448
2004,Urban,Telangana,Crime Against Women,Rape,Female,60+,2661,1419,1242,2585,76
2002,Rural,Bihar,Crime Against Men,Extortion,Female,31-45,3494,1230,2264,1880,1614
2004,Rural,Odisha,Other Crimes,Corruption,Male,0-12,4523,3978,545,4062,461
2006,Urban,Sikkim,Property Crime,Arson,Female,46-60,2080,769,1311,1568,512
2004,Urban,Jharkhand,Crime Against Men,Murder,Male,46-60,5665,3492,2173,5590,75
2003,Urban,Assam,Crime Against Children,Child Abuse,Female,0-12,2822,1506,1316,1819,1003
2009,Rural,Jammu & Kashmir,Crime Against Children,Child Abuse,Male,13-17,1795,1053,742,1287,508
2001,Urban,Telangana,Property Crime,Vandalism,Female,13-17,793,280,513,347,446
2008,Urban,Gujarat,Crime Against Women,Rape,Female,46-60,3795,3240,555,3636,159
2002,Urban,Karnataka,Other Crimes,Cyber Crime,Female,60+,3132,2288,844,2775,357
2010,Urban,Tripura,Crime Against Women,Dowry Deaths,Female,13-17,4465,543,3922,3076,1389
2006,Urban,Nagaland,Crime Against Children,Child Labor,Male,18-30,6826,5239,1587,6076,750
2007,Urban,Bihar,Crime Against Children,Child Abuse,Female,13-17,1786,1146,640,1779,7
2009,Urban,Odisha,Property Crime,Theft,Female,60+,2255,1611,644,1616,639
2008,Rural,Telangana,Other Crimes,Drug Offense,Female,60+,6008,5927,81,5946,62
2002,Rural,Uttarakhand,Crime Against Men,Robbery,Male,31-45,4984,3155,1829,4268,716
2009,Rural,Telangana,Crime Against Children,Kidnapping,Female,46-60,2936,2182,754,2666,270
2002,Rural,Punjab,Crime Against Men,Robbery,Female,31-45,6168,2377,3791,2870,3298
2010,Rural,Jharkhand,Property Crime,Vandalism,Female,31-45,4904,2739,2165,4124,780
2010,Urban,Maharashtra,Property Crime,Burglary,Male,46-60,6014,4899,1115,5789,225
2004,Rural,Bihar,Crime Against Children,Child Abuse,Male,31-45,5915,4717,1198,5574,341
2008,Urban,Tripura,Crime Against Women,Rape,Female,13-17,9896,7442,2454,7518,2378
2007,Rural,Kerala,Other Crimes,Cyber Crime,Female,13-17,893,106,787,349,544
2006,Urban,Uttarakhand,Crime Against Children,Kidnapping,Female,60+,5220,2193,3027,5073,147
2002,Urban,Karnataka,Property Crime,Arson,Female,18-30,4278,1116,3162,1834,2444
2009,Rural,Meghalaya,Crime Against Women,Dowry Deaths,Male,46-60,2122,1334,788,1974,148
2008,Urban,Maharashtra,Crime Against Men,Assault,Female,46-60,9480,9350,130,9441,39
2003,Rural,Madhya Pradesh,Crime Against Children,Child Abuse,Female,13-17,5849,853,4996,2868,2981
2010,Rural,Karnataka,Crime Against Women,Molestation,Male,0-12,1830,1373,457,1444,386
2007,Urban,Chhattisgarh,Crime Against Women,Rape,Female,18-30,5668,559,5109,4167,1501
2005,Urban,Rajasthan,Crime Against Women,Dowry Deaths,Male,31-45,1782,1221,561,1271,511
2006,Rural,Jharkhand,Crime Against Children,Trafficking,Male,60+,8787,6073,2714,6107,2680
2001,Urban,Punjab,Property Crime,Vandalism,Male,46-60,2350,536,1814,564,1786
2008,Rural,Kerala,Property Crime,Theft,Male,13-17,2491,1110,1381,2383,108
2007,Urban,Gujarat,Crime Against Men,Murder,Female,0-12,3811,291,3520,3045,766
2006,Urban,Telangana,Crime Against Children,Child Abuse,Male,0-12,9375,6672,2703,9078,297
2005,Rural,Goa,Crime Against Men,Murder,Female,18-30,6010,3992,2018,4293,1717
2006,Rural,Maharashtra,Other Crimes,Corruption,Female,31-45,3362,1785,1577,3175,187
2008,Urban,Bihar,Other Crimes,Cyber Crime,Male,60+,5619,2942,2677,3681,1938
2005,Rural,Madhya Pradesh,Crime Against Children,Trafficking,Female,0-12,9810,8280,1530,9576,234
2002,Urban,Gujarat,Other Crimes,Drug Offense,Male,0-12,4138,2602,1536,3068,1070
2007,Rural,Punjab,Other Crimes,Cyber Crime,Female,18-30,1419,1316,103,1403,16
2002,Urban,Arunachal Pradesh,Property Crime,Theft,Male,18-30,6808,4086,2722,6198,610
2001,Urban,Uttar Pradesh,Crime Against Women,Molestation,Male,18-30,3525,125,3400,2003,1522
2002,Urban,Haryana,Crime Against Men,Assault,Male,13-17,5723,2802,2921,4550,1173
2004,Urban,Gujarat,Property Crime,Burglary,Female,60+,8801,4633,4168,4788,4013
2005,Urban,Assam,Crime Against Men,Assault,Male,60+,421,67,354,235,186
2007,Rural,Nagaland,Crime Against Children,Trafficking,Male,0-12,6083,3543,2540,5142,941
2002,Rural,Haryana,Other Crimes,Fraud,Male,18-30,1086,406,680,518,568
2002,Urban,Sikkim,Crime Against Men,Extortion,Male,13-17,5869,2898,2971,3655,2214
2004,Rural,Rajasthan,Property Crime,Vandalism,Male,60+,3324,1735,1589,3056,268
2001,Urban,Andhra Pradesh,Crime Against Women,Molestation,Male,60+,7039,6518,521,6522,517
2001,Urban,Kerala,Crime Against Men,Extortion,Female,46-60,2771,1404,1367,2081,690
2010,Rural,Mizoram,Crime Against Women,Molestation,Male,18-30,5940,19,5921,3700,2240
2008,Urban,Karnataka,Property Crime,Arson,Female,13-17,4993,359,4634,4947,46
2005,Urban,Gujarat,Crime Against Children,Child Labor,Male,18-30,9842,3312,6530,9831,11
2003,Rural,Karnataka,Property Crime,Vandalism,Female,60+,2859,958,1901,1012,1847
2003,Rural,Uttar Pradesh,Crime Against Children,Child Abuse,Male,46-60,9716,598,9118,603,9113
2009,Rural,Manipur,Property Crime,Burglary,Female,0-12,4970,524,4446,1892,3078
2004,Rural,Goa,Property Crime,Vandalism,Male,31-45,694,70,624,511,183
2004,Urban,Bihar,Other Crimes,Corruption,Male,0-12,6077,4323,1754,4385,1692
2010,Rural,Assam,Crime Against Men,Extortion,Female,0-12,4798,4356,442,4710,88
2006,Urban,Kerala,Crime Against Children,Child Abuse,Female,31-45,6692,2734,3958,4132,2560
2007,Urban,Telangana,Crime Against Women,Dowry Deaths,Male,31-45,4611,4376,235,4583,28
2009,Urban,Haryana,Property Crime,Burglary,Female,18-30,871,655,216,814,57
2008,Rural,Maharashtra,Property Crime,Arson,Male,60+,8525,4545,3980,7600,925
2003,Urban,Rajasthan,Other Crimes,Fraud,Male,18-30,3950,754,3196,2282,1668
2006,Urban,Karnataka,Property Crime,Theft,Male,46-60,8563,2166,6397,5233,3330
2010,Urban,Rajasthan,Property Crime,Burglary,Male,46-60,3192,1531,1661,2307,885
2001,Urban,Karnataka,Crime Against Women,Rape,Male,60+,3208,2949,259,3206,2
2001,Urban,Goa,Crime Against Women,Domestic Violence,Male,60+,9092,5703,3389,7608,1484
2001,Urban,Goa,Crime Against Men,Robbery,Male,31-45,8754,3189,5565,8157,597
2005,Rural,Jharkhand,Crime Against Children,Child Labor,Male,13-17,6518,5086,1432,5901,617
2010,Urban,Goa,Crime Against Women,Rape,Female,60+,3866,2253,1613,2372,1494
2010,Urban,Madhya Pradesh,Crime Against Women,Molestation,Male,60+,4822,4343,479,4553,269
2002,Urban,Uttar Pradesh,Property Crime,Arson,Female,18-30,4336,2333,2003,3831,505
2008,Rural,Goa,Crime Against Women,Molestation,Female,13-17,7328,1074,6254,7068,260
2005,Rural,Karnataka,Other Crimes,Cyber Crime,Female,13-17,5239,4839,400,5031,208
2009,Urban,Meghalaya,Crime Against Men,Murder,Male,0-12,9074,4316,4758,6338,2736
2005,Urban,Tamil Nadu,Crime Against Women,Molestation,Female,18-30,8481,7117,1364,7125,1356
2010,Rural,Maharashtra,Property Crime,Arson,Female,60+,5620,1971,3649,3278,2342
2002,Rural,West Bengal,Crime Against Women,Molestation,Female,60+,3569,1597,1972,3270,299
2010,Rural,Delhi,Crime Against Men,Murder,Male,0-12,9557,2389,7168,2459,7098
2008,Urban,Tripura,Crime Against Men,Assault,Male,13-17,1709,898,811,1512,197
2001,Rural,Rajasthan,Crime Against Women,Molestation,Female,0-12,7620,2435,5185,6859,761
2001,Rural,Andhra Pradesh,Property Crime,Theft,Male,46-60,9453,2108,7345,4276,5177
2009,Rural,Uttarakhand,Crime Against Children,Child Abuse,Female,60+,7429,230,7199,2202,5227
2010,Rural,Delhi,Crime Against Children,Child Abuse,Female,18-30,5675,4053,1622,5652,23
2007,Urban,Goa,Property Crime,Arson,Male,18-30,778,46,732,196,582
2002,Urban,Tripura,Other Crimes,Drug Offense,Female,60+,5475,3830,1645,4315,1160
2008,Urban,Tripura,Crime Against Women,Molestation,Male,0-12,8358,7185,1173,7865,493
2003,Urban,Tamil Nadu,Property Crime,Arson,Female,46-60,2918,2856,62,2869,49
2009,Urban,Bihar,Other Crimes,Corruption,Male,13-17,4211,1385,2826,3351,860
2003,Rural,Punjab,Crime Against Women,Molestation,Female,13-17,5497,1902,3595,4819,678
2004,Rural,Gujarat,Crime Against Women,Dowry Deaths,Male,60+,4893,1888,3005,3573,1320
2006,Urban,Andhra Pradesh,Other Crimes,Drug Offense,Female,31-45,9952,6153,3799,7480,2472
2001,Rural,Kerala,Crime Against Women,Molestation,Female,13-17,1593,1251,342,1484,109
2003,Rural,Jharkhand,Crime Against Women,Rape,Male,31-45,7560,2792,4768,3422,4138
2002,Urban,Odisha,Property Crime,Burglary,Female,13-17,5188,2862,2326,4676,512
2003,Rural,Tripura,Crime Against Children,Child Abuse,Male,60+,3168,83,3085,1341,1827
2002,Urban,Punjab,Crime Against Children,Trafficking,Male,60+,8846,2467,6379,5027,3819
2006,Urban,Telangana,Property Crime,Theft,Female,18-30,797,747,50,787,10
2001,Rural,Haryana,Crime Against Women,Dowry Deaths,Female,13-17,2897,2228,669,2787,110
2004,Rural,Bihar,Crime Against Women,Rape,Female,31-45,8354,7502,852,8019,335
2008,Rural,Mizoram,Property Crime,Burglary,Female,46-60,8021,4948,3073,6719,1302
2009,Urban,Assam,Other Crimes,Corruption,Female,46-60,7625,6552,1073,7105,520
2004,Urban,Punjab,Crime Against Children,Trafficking,Male,18-30,5864,3039,2825,3920,1944
2005,Rural,Jharkhand,Crime Against Children,Trafficking,Male,60+,3460,472,2988,2626,834
2004,Rural,Nagaland,Crime Against Children,Kidnapping,Male,46-60,4868,130,4738,3839,1029
2009,Urban,Kerala,Other Crimes,Cyber Crime,Male,31-45,5749,3640,2109,5173,576
2008,Rural,Jharkhand,Crime Against Women,Dowry Deaths,Female,46-60,5340,4572,768,5062,278
2007,Rural,Sikkim,Crime Against Children,Trafficking,Male,18-30,1454,1331,123,1395,59
2002,Urban,Himachal Pradesh,Crime Against Children,Trafficking,Female,60+,7060,4545,2515,5334,1726
2008,Rural,Karnataka,Crime Against Children,Kidnapping,Male,46-60,3300,727,2573,1952,1348
2004,Urban,Chhattisgarh,Property Crime,Arson,Female,0-12,1697,1319,378,1346,351
2006,Urban,Mizoram,Crime Against Children,Kidnapping,Female,60+,5187,1844,3343,4044,1143
2009,Urban,Nagaland,Property Crime,Vandalism,Male,0-12,1217,229,988,1161,56
2004,Urban,Tripura,Crime Against Women,Domestic Violence,Female,46-60,4457,3460,997,3857,600
2004,Rural,Haryana,Crime Against Children,Child Abuse,Male,13-17,4276,3200,1076,3393,883
2006,Rural,Punjab,Property Crime,Vandalism,Female,13-17,1618,595,1023,960,658
2008,Urban,Jharkhand,Other Crimes,Drug Offense,Female,60+,1175,463,712,660,515
2009,Rural,Bihar,Crime Against Women,Dowry Deaths,Male,18-30,5578,3850,1728,3855,1723
2010,Urban,Maharashtra,Crime Against Women,Dowry Deaths,Male,60+,9934,4753,5181,5226,4708
2004,Rural,Kerala,Crime Against Women,Molestation,Male,13-17,4573,4476,97,4573,0
2009,Urban,Madhya Pradesh,Crime Against Men,Assault,Male,0-12,707,23,684,469,238
2005,Rural,Gujarat,Crime Against Men,Murder,Male,31-45,6684,1866,4818,2124,4560
2003,Rural,Himachal Pradesh,Crime Against Men,Robbery,Male,60+,778,246,532,649,129
2009,Urban,Tripura,Crime Against Men,Robbery,Female,0-12,3950,3858,92,3939,11
2006,Urban,Telangana,Crime Against Men,Extortion,Male,18-30,1784,1675,109,1708,76
2010,Urban,Karnataka,Crime Against Children,Kidnapping,Female,46-60,9199,3040,6159,6360,2839
2003,Urban,Tamil Nadu,Crime Against Men,Robbery,Female,18-30,4388,1397,2991,3842,546
2009,Urban,Uttarakhand,Crime Against Children,Kidnapping,Male,46-60,4815,3406,1409,3640,1175
2003,Rural,Assam,Crime Against Children,Trafficking,Female,60+,2048,261,1787,1012,1036
2001,Urban,Maharashtra,Crime Against Children,Kidnapping,Male,46-60,9355,2560,6795,5960,3395
2009,Rural,Goa,Crime Against Women,Molestation,Female,31-45,866,595,271,731,135
2003,Urban,Uttar Pradesh,Property Crime,Theft,Female,0-12,9425,7587,1838,8916,509
2008,Urban,Madhya Pradesh,Other Crimes,Corruption,Male,18-30,1955,1306,649,1763,192
2003,Rural,Tamil Nadu,Crime Against Women,Rape,Female,18-30,5922,126,5796,3066,2856
2003,Rural,Arunachal Pradesh,Crime Against Women,Rape,Female,18-30,3144,2882,262,2973,171
2002,Rural,West Bengal,Crime Against Men,Robbery,Female,60+,7304,2998,4306,5385,1919
2004,Urban,Telangana,Crime Against Women,Rape,Male,31-45,9198,3161,6037,4075,5123
2005,Urban,Telangana,Crime Against Women,Molestation,Female,0-12,7986,6683,1303,7859,127
2003,Rural,Odisha,Crime Against Women,Molestation,Male,0-12,9828,442,9386,4948,4880
2001,Rural,Madhya Pradesh,Crime Against Women,Rape,Male,13-17,7669,580,7089,3263,4406
2001,Urban,Gujarat,Other Crimes,Corruption,Male,31-45,431,113,318,284,147
2009,Urban,Tamil Nadu,Crime Against Men,Murder,Male,13-17,465,427,38,434,31
2009,Rural,Madhya Pradesh,Other Crimes,Cyber Crime,Female,0-12,6979,1632,5347,2430,4549
2002,Urban,Maharashtra,Crime Against Children,Child Labor,Female,31-45,6089,2886,3203,4049,2040
2009,Rural,Bihar,Crime Against Children,Child Abuse,Female,13-17,6007,4006,2001,5653,354
2005,Rural,West Bengal,Property Crime,Theft,Female,13-17,4827,1280,3547,4405,422
2002,Urban,Jharkhand,Other Crimes,Cyber Crime,Male,46-60,592,344,248,426,166
2001,Rural,Chhattisgarh,Property Crime,Burglary,Female,0-12,2347,1794,553,1858,489
2006,Rural,Andhra Pradesh,Other Crimes,Corruption,Female,13-17,2243,788,1455,928,1315
2006,Rural,Nagaland,Crime Against Women,Molestation,Male,18-30,5842,5292,550,5795,47
2010,Rural,Tripura,Other Crimes,Cyber Crime,Male,0-12,3929,3170,759,3895,34
2010,Rural,Punjab,Other Crimes,Drug Offense,Male,60+,6355,3854,2501,5474,881
2010,Urban,Rajasthan,Other Crimes,Cyber Crime,Male,31-45,8947,902,8045,1740,7207
2006,Urban,Mizoram,Crime Against Men,Extortion,Female,31-45,8849,6585,2264,7055,1794
2010,Rural,Haryana,Crime Against Men,Murder,Male,18-30,7760,3499,4261,6969,791
2006,Rural,Uttar Pradesh,Crime Against Women,Domestic Violence,Male,60+,9999,8776,1223,9936,63
2008,Urban,Haryana,Other Crimes,Drug Offense,Female,60+,3582,2470,1112,3263,319
2002,Rural,Mizoram,Crime Against Children,Child Labor,Male,31-45,820,411,409,603,217
2010,Urban,Uttar Pradesh,Other Crimes,Cyber Crime,Female,46-60,2489,1079,1410,1822,667
2004,Rural,Mizoram,Crime Against Women,Rape,Female,46-60,790,279,511,300,490
2006,Rural,Gujarat,Other Crimes,Fraud,Male,0-12,4394,1489,2905,1908,2486
2004,Urban,Assam,Crime Against Children,Child Abuse,Female,18-30,6677,4879,1798,5047,1630
2003,Rural,Jammu & Kashmir,Crime Against Men,Robbery,Male,18-30,890,540,350,637,253
2003,Urban,Sikkim,Other Crimes,Drug Offense,Male,13-17,7343,1174,6169,5891,1452
2004,Urban,Meghalaya,Other Crimes,Drug Offense,Male,0-12,3445,1905,1540,1969,1476
2005,Urban,Punjab,Property Crime,Burglary,Female,18-30,8202,2625,5577,6158,2044
2005,Rural,Jammu & Kashmir,Crime Against Children,Child Labor,Male,13-17,6930,4987,1943,6871,59
2003,Urban,Tamil Nadu,Crime Against Children,Child Labor,Male,13-17,5388,3843,1545,4384,1004
2001,Rural,Jharkhand,Crime Against Women,Domestic Violence,Male,18-30,8607,8206,401,8400,207
2010,Rural,Mizoram,Crime Against Men,Assault,Female,13-17,7235,6150,1085,7034,201
2003,Urban,Rajasthan,Crime Against Men,Extortion,Male,60+,7550,4962,2588,5201,2349
2002,Rural,Bihar,Crime Against Men,Assault,Female,0-12,8069,2374,5695,6692,1377
2006,Rural,Arunachal Pradesh,Other Crimes,Fraud,Male,31-45,2980,570,2410,2159,821
2003,Rural,Himachal Pradesh,Crime Against Women,Domestic Violence,Female,13-17,8361,2751,5610,7660,701
2006,Rural,Kerala,Crime Against Women,Molestation,Male,18-30,4045,3491,554,3669,376
2008,Rural,Rajasthan,Crime Against Women,Molestation,Male,31-45,2071,1899,172,1977,94
2002,Rural,Delhi,Crime Against Women,Molestation,Male,60+,5861,5048,813,5058,803
2005,Urban,Arunachal Pradesh,Other Crimes,Fraud,Female,31-45,7482,2597,4885,4308,3174
2006,Rural,Uttarakhand,Other Crimes,Corruption,Female,0-12,3856,147,3709,2998,858
2004,Urban,Jammu & Kashmir,Other Crimes,Corruption,Male,46-60,4033,3894,139,4028,5
2009,Rural,Manipur,Crime Against Children,Trafficking,Female,60+,1680,157,1523,1098,582
2009,Rural,Uttar Pradesh,Other Crimes,Drug Offense,Male,46-60,5228,4368,860,4713,515
2007,Rural,Tamil Nadu,Crime Against Children,Kidnapping,Male,13-17,9921,6702,3219,7973,1948
2009,Rural,Rajasthan,Other Crimes,Fraud,Female,0-12,7475,3277,4198,6043,1432
2004,Rural,Sikkim,Property Crime,Vandalism,Female,46-60,2033,1043,990,1412,621
2004,Rural,Chhattisgarh,Property Crime,Arson,Female,18-30,986,154,832,217,769
2008,Urban,Nagaland,Crime Against Men,Murder,Male,31-45,7698,4496,3202,6149,1549
2003,Urban,Gujarat,Other Crimes,Corruption,Female,18-30,2062,1498,564,2051,11
2009,Rural,Tripura,Crime Against Women,Molestation,Male,18-30,2110,341,1769,2025,85
2002,Urban,Andhra Pradesh,Crime Against Children,Child Labor,Male,13-17,5287,509,4778,1768,3519
2002,Urban,Jharkhand,Crime Against Men,Robbery,Female,31-45,9034,1960,7074,2169,6865
2001,Urban,Manipur,Other Crimes,Cyber Crime,Male,60+,2774,2519,255,2615,159
2010,Urban,Odisha,Property Crime,Burglary,Male,31-45,9751,9034,717,9720,31
2001,Urban,Uttar Pradesh,Crime Against Men,Murder,Male,18-30,6724,212,6512,4990,1734
2001,Rural,Delhi,Crime Against Children,Child Labor,Female,18-30,4876,902,3974,2261,2615
2005,Rural,Tamil Nadu,Property Crime,Theft,Male,18-30,9011,7791,1220,8258,753
2006,Urban,Chhattisgarh,Crime Against Women,Domestic Violence,Female,46-60,9677,6732,2945,7019,2658
2006,Urban,Chhattisgarh,Property Crime,Burglary,Male,31-45,1464,1443,21,1453,11
2007,Urban,Jammu & Kashmir,Crime Against Children,Kidnapping,Male,0-12,2530,102,2428,677,1853
2002,Rural,Uttar Pradesh,Property Crime,Burglary,Female,46-60,2578,2322,256,2508,70
2002,Urban,Odisha,Crime Against Women,Dowry Deaths,Female,0-12,639,282,357,622,17
2002,Urban,West Bengal,Crime Against Men,Robbery,Female,31-45,4437,1904,2533,3812,625
2001,Urban,Tamil Nadu,Crime Against Women,Molestation,Female,13-17,6213,1319,4894,2390,3823
2001,Rural,Assam,Crime Against Men,Murder,Male,46-60,6544,1794,4750,3236,3308
2001,Urban,Haryana,Crime Against Children,Child Abuse,Female,0-12,2984,599,2385,2391,593
2003,Rural,Sikkim,Crime Against Children,Child Labor,Female,60+,2492,2382,110,2406,86
2002,Urban,Karnataka,Crime Against Women,Rape,Female,13-17,730,437,293,623,107
2001,Rural,Maharashtra,Property Crime,Vandalism,Female,0-12,9206,3938,5268,5043,4163
2003,Rural,Assam,Crime Against Children,Child Abuse,Female,46-60,3601,2848,753,3504,97
2010,Urban,Maharashtra,Crime Against Men,Extortion,Male,0-12,8359,2495,5864,4767,3592
2002,Urban,Chhattisgarh,Crime Against Children,Trafficking,Male,60+,4605,4264,341,4439,166
2004,Rural,Chhattisgarh,Other Crimes,Fraud,Female,18-30,4010,2973,1037,3998,12
2003,Rural,Karnataka,Crime Against Children,Kidnapping,Male,31-45,2200,2029,171,2171,29
2010,Rural,Madhya Pradesh,Crime Against Children,Child Abuse,Male,13-17,7263,1935,5328,6901,362
2006,Urban,Kerala,Other Crimes,Drug Offense,Male,46-60,3188,2024,1164,2928,260
2001,Urban,West Bengal,Other Crimes,Drug Offense,Male,60+,3693,1930,1763,2094,1599
2005,Rural,Kerala,Crime Against Women,Molestation,Male,60+,1327,934,393,1043,284
2010,Rural,Chhattisgarh,Property Crime,Arson,Female,46-60,7033,3183,3850,4101,2932
2009,Urban,Uttarakhand,Crime Against Men,Assault,Female,18-30,9976,9601,375,9661,315
2001,Urban,Haryana,Crime Against Women,Dowry Deaths,Female,13-17,1851,1282,569,1392,459
2006,Rural,Himachal Pradesh,Property Crime,Burglary,Male,60+,7755,3078,4677,4084,3671
2009,Urban,Uttarakhand,Crime Against Men,Extortion,Female,18-30,8437,4288,4149,5704,2733
2001,Rural,Chhattisgarh,Crime Against Men,Extortion,Male,31-45,5468,3697,1771,4387,1081
2006,Urban,West Bengal,Crime Against Women,Molestation,Female,31-45,9927,2822,7105,3795,6132
2007,Rural,Jammu & Kashmir,Other Crimes,Corruption,Male,46-60,6197,2329,3868,6062,135
2003,Rural,Odisha,Crime Against Women,Dowry Deaths,Female,31-45,1527,1097,430,1438,89
2003,Rural,Uttar Pradesh,Crime Against Children,Kidnapping,Female,0-12,3316,3065,251,3225,91
2006,Rural,Tamil Nadu,Other Crimes,Cyber Crime,Male,18-30,5241,1989,3252,5056,185
2010,Rural,Rajasthan,Crime Against Women,Dowry Deaths,Female,31-45,4249,3815,434,3963,286
2001,Rural,Mizoram,Crime Against Children,Child Labor,Female,31-45,5295,736,4559,4616,679
2005,Urban,Tamil Nadu,Property Crime,Burglary,Male,18-30,8336,730,7606,781,7555
2008,Rural,Uttar Pradesh,Property Crime,Theft,Male,46-60,490,163,327,356,134
2001,Rural,Uttarakhand,Crime Against Women,Molestation,Female,31-45,8468,4512,3956,5334,3134
2001,Urban,Jammu & Kashmir,Property Crime,Burglary,Female,0-12,4145,3567,578,3907,238
2006,Urban,Mizoram,Crime Against Men,Assault,Male,13-17,6409,3508,2901,6307,102
2004,Urban,Mizoram,Crime Against Children,Kidnapping,Female,13-17,9137,7971,1166,8212,925
2008,Rural,Jammu & Kashmir,Crime Against Women,Molestation,Female,60+,6589,2011,4578,2398,4191
2008,Urban,Jharkhand,Crime Against Women,Dowry Deaths,Male,13-17,9395,6506,2889,6785,2610
2009,Rural,Himachal Pradesh,Crime Against Children,Child Labor,Male,18-30,3557,2258,1299,3304,253
2008,Rural,Telangana,Other Crimes,Drug Offense,Female,0-12,4268,2116,2152,4217,51
2010,Urban,Assam,Property Crime,Theft,Female,18-30,556,345,211,355,201
2003,Urban,Haryana,Crime Against Women,Molestation,Male,18-30,4179,1275,2904,3367,812
2004,Urban,Sikkim,Crime Against Children,Kidnapping,Female,46-60,1772,536,1236,1304,468
2006,Urban,Himachal Pradesh,Crime Against Women,Rape,Female,60+,2196,984,1212,1673,523
2004,Rural,Rajasthan,Crime Against Women,Rape,Male,0-12,7245,775,6470,2707,4538
2004,Urban,Himachal Pradesh,Other Crimes,Corruption,Female,18-30,8804,6015,2789,8122,682
2003,Urban,Meghalaya,Crime Against Women,Domestic Violence,Male,0-12,8133,1626,6507,1963,6170
2006,Rural,Mizoram,Crime Against Children,Kidnapping,Female,13-17,7580,5879,1701,6388,1192
2008,Rural,Tamil Nadu,Crime Against Women,Domestic Violence,Male,18-30,5967,73,5894,2360,3607
2003,Rural,Sikkim,Other Crimes,Drug Offense,Male,46-60,2677,2435,242,2481,196
2001,Rural,Manipur,Crime Against Men,Robbery,Male,13-17,8946,8923,23,8933,13
2009,Rural,Uttar Pradesh,Crime Against Men,Robbery,Male,31-45,8080,2496,5584,4373,3707
2003,Rural,Sikkim,Crime Against Children,Child Abuse,Female,31-45,7628,3944,3684,6913,715
2004,Rural,Tripura,Other Crimes,Corruption,Female,0-12,4096,1236,2860,3779,317
2002,Urban,Assam,Crime Against Women,Molestation,Female,13-17,4591,1116,3475,2375,2216
2004,Rural,Haryana,Other Crimes,Cyber Crime,Female,60+,5416,3963,1453,4727,689
2007,Rural,Uttarakhand,Other Crimes,Corruption,Female,60+,2857,87,2770,2689,168
2009,Rural,Jharkhand,Crime Against Women,Rape,Male,46-60,1408,976,432,999,409
2003,Urban,Uttarakhand,Crime Against Men,Extortion,Female,0-12,7066,816,6250,4185,2881
2005,Rural,Tripura,Crime Against Women,Domestic Violence,Female,13-17,5511,3384,2127,4304,1207
2009,Rural,Jammu & Kashmir,Other Crimes,Cyber Crime,Male,46-60,2037,488,1549,1683,354
2003,Urban,Nagaland,Other Crimes,Cyber Crime,Male,60+,4471,1433,3038,3297,1174
2009,Rural,Telangana,Property Crime,Burglary,Female,13-17,9928,17,9911,616,9312
2010,Rural,West Bengal,Crime Against Women,Domestic Violence,Female,18-30,2561,362,2199,740,1821
2004,Rural,Arunachal Pradesh,Crime Against Men,Extortion,Male,46-60,2714,1331,1383,2500,214
2009,Rural,Tripura,Crime Against Women,Rape,Male,60+,6992,1977,5015,5641,1351
2005,Rural,Rajasthan,Property Crime,Arson,Female,0-12,2650,1932,718,2472,178
2002,Rural,Uttarakhand,Crime Against Children,Child Labor,Female,60+,6064,4879,1185,5441,623
2002,Urban,West Bengal,Crime Against Children,Trafficking,Male,18-30,4168,692,3476,1404,2764
2006,Urban,Madhya Pradesh,Crime Against Women,Domestic Violence,Female,0-12,1042,973,69,1011,31
2001,Rural,Manipur,Other Crimes,Cyber Crime,Female,46-60,3141,1184,1957,2296,845
2001,Rural,Mizoram,Other Crimes,Fraud,Male,18-30,818,167,651,186,632
2007,Urban,Uttar Pradesh,Crime Against Women,Domestic Violence,Female,60+,2558,1053,1505,1352,1206
2001,Urban,Jammu & Kashmir,Crime Against Children,Child Labor,Female,60+,2425,691,1734,2042,383
2004,Urban,Odisha,Crime Against Women,Rape,Male,13-17,9742,288,9454,2422,7320
2004,Rural,Himachal Pradesh,Other Crimes,Corruption,Female,18-30,9039,7634,1405,7647,1392
2008,Rural,Tamil Nadu,Crime Against Children,Child Abuse,Female,46-60,2982,2939,43,2953,29
2009,Urban,Maharashtra,Crime Against Women,Dowry Deaths,Male,60+,7969,5283,2686,7472,497
2008,Rural,Tripura,Crime Against Men,Extortion,Male,13-17,2384,1206,1178,2276,108
2007,Urban,Tripura,Other Crimes,Corruption,Male,18-30,1941,1499,442,1627,314
2006,Urban,Maharashtra,Other Crimes,Cyber Crime,Male,60+,7774,339,7435,2227,5547
2010,Urban,Maharashtra,Crime Against Women,Domestic Violence,Female,13-17,2288,1066,1222,1098,1190
2010,Urban,Madhya Pradesh,Crime Against Children,Trafficking,Female,46-60,2080,1768,312,1829,251
2006,Urban,Madhya Pradesh,Crime Against Women,Domestic Violence,Male,0-12,1514,250,1264,1170,344
2007,Urban,Jammu & Kashmir,Crime Against Men,Robbery,Female,60+,7672,3092,4580,7217,455
2006,Rural,Himachal Pradesh,Crime Against Children,Child Labor,Male,0-12,7653,627,7026,7123,530
2006,Urban,Punjab,Crime Against Women,Domestic Violence,Female,31-45,6396,1506,4890,3085,3311
2010,Rural,Tripura,Property Crime,Vandalism,Female,0-12,6980,3417,3563,4175,2805
2002,Rural,Uttarakhand,Crime Against Men,Assault,Male,60+,2817,2313,504,2441,376
2009,Urban,Rajasthan,Property Crime,Theft,Male,13-17,8423,3355,5068,7153,1270
2002,Rural,Gujarat,Crime Against Children,Child Labor,Female,31-45,696,543,153,573,123
2009,Urban,Telangana,Property Crime,Arson,Female,31-45,7578,4823,2755,5775,1803
2007,Rural,Tamil Nadu,Property Crime,Arson,Female,46-60,4366,3239,1127,3903,463
2010,Rural,Madhya Pradesh,Crime Against Women,Molestation,Female,46-60,8589,2398,6191,3284,5305
2007,Rural,Uttarakhand,Crime Against Women,Dowry Deaths,Male,0-12,9246,959,8287,6156,3090
2004,Rural,Chhattisgarh,Other Crimes,Drug Offense,Female,0-12,8218,7518,700,7734,484
2002,Urban,Tripura,Crime Against Children,Child Abuse,Female,60+,988,21,967,718,270
2003,Rural,Odisha,Crime Against Women,Dowry Deaths,Male,18-30,6864,1301,5563,5337,1527
2005,Rural,Punjab,Property Crime,Theft,Female,18-30,656,12,644,50,606
2008,Rural,Uttarakhand,Other Crimes,Fraud,Female,46-60,8496,4883,3613,8244,252
2007,Urban,Gujarat,Crime Against Children,Child Abuse,Female,46-60,2065,1397,668,1584,481
2005,Rural,Sikkim,Crime Against Men,Robbery,Female,31-45,3341,2547,794,3245,96
2007,Rural,Tripura,Crime Against Men,Extortion,Male,0-12,2381,1391,990,1998,383
2001,Urban,Goa,Crime Against Men,Robbery,Male,13-17,3643,1730,1913,1802,1841
2009,Rural,Sikkim,Crime Against Women,Rape,Male,18-30,1569,901,668,1478,91
2009,Urban,Rajasthan,Crime Against Men,Murder,Female,13-17,807,193,614,713,94
2003,Rural,Odisha,Crime Against Children,Child Labor,Male,31-45,8271,4872,3399,8049,222
2007,Rural,Nagaland,Property Crime,Arson,Male,46-60,921,595,326,800,121
2006,Rural,Uttarakhand,Property Crime,Theft,Female,31-45,857,211,646,646,211
2003,Urban,Jharkhand,Crime Against Women,Domestic Violence,Female,31-45,7346,320,7026,3432,3914
2009,Rural,Karnataka,Crime Against Women,Domestic Violence,Male,13-17,7050,4906,2144,5881,1169
2009,Urban,Madhya Pradesh,Crime Against Women,Molestation,Female,18-30,8522,5579,2943,7060,1462
2004,Urban,Bihar,Crime Against Children,Child Abuse,Male,18-30,7066,2327,4739,2836,4230
2005,Urban,Jammu & Kashmir,Crime Against Women,Dowry Deaths,Male,13-17,1749,1136,613,1698,51
2008,Rural,Jharkhand,Other Crimes,Drug Offense,Female,13-17,5715,4333,1382,5375,340
2008,Rural,Assam,Other Crimes,Drug Offense,Male,31-45,7353,2992,4361,7066,287
2006,Urban,Goa,Crime Against Women,Rape,Female,46-60,9172,2959,6213,7547,1625
2006,Rural,Andhra Pradesh,Crime Against Men,Robbery,Female,60+,7829,5781,2048,6079,1750
2010,Rural,Assam,Crime Against Men,Extortion,Male,46-60,3314,2298,1016,2608,706
2006,Urban,Telangana,Property Crime,Arson,Female,31-45,573,155,418,256,317
2002,Rural,Meghalaya,Crime Against Children,Child Labor,Female,13-17,8408,1924,6484,3347,5061
2002,Urban,Madhya Pradesh,Property Crime,Theft,Male,31-45,4862,1367,3495,3121,1741
2002,Urban,Meghalaya,Crime Against Women,Molestation,Male,60+,9518,5461,4057,7537,1981
2009,Rural,Bihar,Property Crime,Arson,Female,31-45,614,558,56,604,10
2007,Urban,Tripura,Property Crime,Arson,Male,31-45,2978,2449,529,2920,58
2001,Urban,Jharkhand,Crime Against Men,Extortion,Female,13-17,2127,1325,802,1394,733
2006,Urban,Jammu & Kashmir,Property Crime,Vandalism,Male,46-60,8322,2554,5768,4883,3439
2007,Rural,Kerala,Crime Against Children,Trafficking,Female,60+,7493,5538,1955,7285,208
2004,Urban,Telangana,Crime Against Women,Rape,Male,0-12,6072,3126,2946,3316,2756
2010,Rural,Madhya Pradesh,Crime Against Women,Dowry Deaths,Male,60+,7561,1053,6508,3447,4114
2009,Rural,Uttar Pradesh,Property Crime,Theft,Female,46-60,8569,3940,4629,6851,1718
2008,Rural,Haryana,Property Crime,Theft,Male,18-30,5990,4230,1760,4397,1593
2001,Rural,Telangana,Property Crime,Arson,Female,0-12,8314,7582,732,7702,612
2004,Urban,Jammu & Kashmir,Property Crime,Theft,Female,18-30,445,388,57,433,12
2002,Rural,Tripura,Crime Against Women,Molestation,Male,18-30,248,126,122,150,98
2007,Urban,Madhya Pradesh,Crime Against Men,Murder,Male,18-30,8815,91,8724,7966,849
2005,Urban,Jharkhand,Crime Against Children,Child Abuse,Male,46-60,6159,680,5479,4887,1272
2006,Urban,Jammu & Kashmir,Crime Against Women,Molestation,Male,31-45,8767,1784,6983,3097,5670
2009,Urban,Tripura,Crime Against Women,Rape,Female,60+,9511,6246,3265,8605,906
2004,Rural,Haryana,Crime Against Children,Child Labor,Female,13-17,3137,1996,1141,3076,61
2008,Rural,West Bengal,Crime Against Children,Trafficking,Male,31-45,6812,661,6151,4344,2468
2004,Urban,Tripura,Crime Against Women,Rape,Female,46-60,6374,645,5729,819,5555
2002,Urban,Arunachal Pradesh,Crime Against Children,Child Labor,Male,0-12,4611,4050,561,4342,269
2008,Rural,Andhra Pradesh,Crime Against Children,Child Labor,Male,0-12,3475,2721,754,2830,645
2009,Rural,Meghalaya,Other Crimes,Fraud,Male,13-17,4747,1060,3687,1157,3590
2006,Urban,Uttarakhand,Crime Against Women,Molestation,Female,60+,8442,3173,5269,4822,3620
2004,Urban,Andhra Pradesh,Crime Against Women,Domestic Violence,Male,46-60,6661,5425,1236,5664,997
2004,Rural,Mizoram,Crime Against Women,Domestic Violence,Female,13-17,7213,1177,6036,4305,2908
2008,Rural,Madhya Pradesh,Property Crime,Burglary,Female,31-45,8835,7083,1752,8244,591
2007,Urban,Punjab,Property Crime,Burglary,Male,60+,9659,816,8843,7603,2056
2003,Rural,Uttar Pradesh,Crime Against Men,Robbery,Female,18-30,8286,814,7472,7684,602
2004,Urban,Gujarat,Crime Against Women,Molestation,Female,0-12,8339,928,7411,3094,5245
2010,Urban,Chhattisgarh,Other Crimes,Cyber Crime,Male,46-60,4510,960,3550,3863,647
2010,Urban,Arunachal Pradesh,Property Crime,Theft,Male,13-17,5127,13,5114,4129,998
2003,Urban,Assam,Other Crimes,Drug Offense,Male,60+,541,416,125,516,25
2007,Rural,Kerala,Crime Against Women,Domestic Violence,Male,13-17,6179,34,6145,4623,1556
2008,Rural,Manipur,Property Crime,Burglary,Male,46-60,4753,1931,2822,3486,1267
2009,Rural,Tamil Nadu,Property Crime,Burglary,Male,13-17,7590,4540,3050,5100,2490
2003,Urban,Bihar,Crime Against Men,Extortion,Female,0-12,5634,1878,3756,3624,2010
2005,Rural,Tamil Nadu,Crime Against Men,Robbery,Male,60+,991,30,961,924,67
2010,Urban,Madhya Pradesh,Crime Against Children,Kidnapping,Female,13-17,1182,800,382,985,197
2004,Rural,Kerala,Crime Against Men,Extortion,Female,13-17,4363,1968,2395,3481,882
2003,Urban,Himachal Pradesh,Crime Against Children,Trafficking,Female,31-45,4564,4402,162,4523,41
2001,Rural,Bihar,Crime Against Children,Child Labor,Male,0-12,8352,2293,6059,6816,1536
2003,Rural,Odisha,Crime Against Children,Child Abuse,Male,13-17,8629,6965,1664,8409,220
2004,Urban,Telangana,Crime Against Men,Assault,Male,46-60,9014,2328,6686,2615,6399
2008,Rural,Tripura,Crime Against Men,Assault,Male,0-12,8353,3318,5035,7580,773
2003,Urban,Haryana,Property Crime,Theft,Male,46-60,323,221,102,266,57
2007,Urban,Maharashtra,Other Crimes,Corruption,Female,46-60,6007,748,5259,3025,2982
2002,Rural,Tamil Nadu,Crime Against Children,Child Labor,Female,46-60,2293,1421,872,1725,568
2003,Urban,Jammu & Kashmir,Other Crimes,Cyber Crime,Female,46-60,139,47,92,53,86
2008,Urban,Madhya Pradesh,Crime Against Children,Trafficking,Male,0-12,7496,5082,2414,5357,2139
2001,Urban,Tripura,Crime Against Children,Child Abuse,Male,46-60,4925,1536,3389,3896,1029
2007,Rural,Chhattisgarh,Crime Against Children,Kidnapping,Male,31-45,9904,6569,3335,9399,505
2001,Rural,Uttarakhand,Property Crime,Burglary,Male,0-12,9029,611,8418,2847,6182
2005,Rural,Nagaland,Crime Against Women,Domestic Violence,Male,60+,428,297,131,414,14
2004,Rural,Arunachal Pradesh,Other Crimes,Drug Offense,Male,60+,3325,1457,1868,3058,267
2003,Rural,West Bengal,Crime Against Children,Child Abuse,Female,60+,1135,1059,76,1064,71
2004,Rural,Andhra Pradesh,Crime Against Women,Rape,Male,0-12,8563,1161,7402,1186,7377
2008,Urban,Haryana,Crime Against Women,Domestic Violence,Male,46-60,5301,944,4357,3491,1810
2002,Rural,Meghalaya,Crime Against Men,Assault,Female,46-60,1492,1043,449,1135,357
2008,Rural,Chhattisgarh,Crime Against Men,Extortion,Male,0-12,9659,441,9218,8244,1415
2010,Urban,Sikkim,Crime Against Men,Murder,Male,18-30,2017,322,1695,1730,287
2004,Rural,Odisha,Other Crimes,Fraud,Female,60+,8867,5794,3073,6297,2570
2007,Urban,Jammu & Kashmir,Crime Against Women,Domestic Violence,Female,60+,3546,626,2920,1733,1813
2008,Urban,Karnataka,Other Crimes,Drug Offense,Male,13-17,6370,4246,2124,4657,1713
2002,Urban,Punjab,Crime Against Women,Domestic Violence,Female,18-30,1582,808,774,883,699
2002,Urban,Delhi,Property Crime,Theft,Female,60+,813,634,179,766,47
2006,Rural,Tripura,Other Crimes,Fraud,Male,31-45,9213,904,8309,3088,6125
2004,Urban,Nagaland,Crime Against Children,Child Labor,Female,31-45,612,211,401,281,331
2003,Rural,Punjab,Property Crime,Arson,Female,18-30,2710,2629,81,2662,48
2004,Rural,Gujarat,Property Crime,Vandalism,Female,31-45,3474,734,2740,1715,1759
2005,Rural,Uttar Pradesh,Property Crime,Vandalism,Male,31-45,3548,1733,1815,2628,920
2004,Urban,Kerala,Crime Against Children,Kidnapping,Male,18-30,7645,4808,2837,6288,1357
2008,Urban,Assam,Property Crime,Arson,Female,18-30,1851,1663,188,1690,161
2004,Urban,Rajasthan,Crime Against Men,Robbery,Male,13-17,3356,415,2941,1211,2145
2005,Urban,Maharashtra,Crime Against Men,Assault,Female,31-45,2044,832,1212,876,1168
2004,Urban,Assam,Property Crime,Vandalism,Female,13-17,2917,185,2732,2047,870
2003,Rural,Haryana,Crime Against Men,Robbery,Female,13-17,6953,578,6375,3308,3645
2006,Urban,Kerala,Crime Against Men,Robbery,Male,46-60,5622,4126,1496,4859,763
2009,Rural,Delhi,Crime Against Children,Trafficking,Female,0-12,1352,235,1117,242,1110
2003,Urban,Telangana,Crime Against Women,Molestation,Male,18-30,7398,2940,4458,6724,674
2004,Rural,Assam,Property Crime,Theft,Male,31-45,9687,3894,5793,7598,2089
2003,Urban,Punjab,Crime Against Children,Trafficking,Male,46-60,2988,1067,1921,2866,122
2007,Rural,Tripura,Crime Against Children,Trafficking,Male,13-17,5437,3098,2339,3363,2074
2003,Rural,Madhya Pradesh,Property Crime,Vandalism,Female,31-45,2537,2232,305,2369,168
2008,Rural,Bihar,Property Crime,Arson,Male,60+,2853,1471,1382,2217,636
2010,Rural,Jammu & Kashmir,Crime Against Men,Murder,Male,18-30,7901,250,7651,5454,2447
2001,Urban,Sikkim,Other Crimes,Corruption,Male,18-30,9258,6827,2431,7653,1605
2005,Urban,Kerala,Property Crime,Vandalism,Male,31-45,7804,7689,115,7785,19
2008,Rural,Mizoram,Crime Against Children,Child Abuse,Female,13-17,4105,501,3604,2966,1139
2002,Rural,Jammu & Kashmir,Other Crimes,Fraud,Female,60+,817,767,50,803,14
2005,Rural,Telangana,Crime Against Women,Molestation,Male,0-12,3810,879,2931,894,2916
2005,Rural,Manipur,Crime Against Children,Kidnapping,Male,31-45,7075,5419,1656,6328,747
2006,Rural,Tripura,Property Crime,Arson,Female,46-60,7824,4210,3614,6924,900
2005,Urban,Andhra Pradesh,Crime Against Children,Trafficking,Male,31-45,1025,469,556,555,470
2008,Rural,Andhra Pradesh,Other Crimes,Cyber Crime,Male,0-12,7895,927,6968,7275,620
2005,Rural,Tamil Nadu,Other Crimes,Cyber Crime,Female,18-30,6517,1526,4991,3303,3214
2003,Rural,Telangana,Crime Against Children,Child Labor,Male,60+,1993,1806,187,1812,181
2009,Rural,Meghalaya,Other Crimes,Cyber Crime,Female,60+,1521,167,1354,1422,99
2009,Rural,Arunachal Pradesh,Crime Against Men,Extortion,Female,60+,6166,1442,4724,1525,4641
2002,Rural,Himachal Pradesh,Crime Against Women,Molestation,Male,0-12,457,413,44,441,16
2009,Rural,Delhi,Crime Against Men,Extortion,Male,13-17,5391,5352,39,5354,37
2009,Rural,Kerala,Crime Against Women,Dowry Deaths,Female,13-17,6633,646,5987,6533,100
2007,Rural,Tripura,Property Crime,Vandalism,Female,13-17,7516,2777,4739,4029,3487
2006,Urban,Chhattisgarh,Property Crime,Vandalism,Female,18-30,6717,1257,5460,6447,270
2008,Urban,Telangana,Crime Against Women,Domestic Violence,Female,0-12,2583,2435,148,2519,64
2005,Rural,Telangana,Property Crime,Burglary,Female,31-45,6323,2501,3822,2675,3648
2001,Urban,Jharkhand,Other Crimes,Drug Offense,Female,0-12,4193,2493,1700,4092,101
2003,Rural,Odisha,Crime Against Men,Robbery,Male,18-30,6161,2023,4138,5391,770
2009,Rural,Goa,Crime Against Children,Trafficking,Female,31-45,1899,197,1702,1371,528
2001,Urban,Delhi,Crime Against Men,Assault,Female,46-60,709,590,119,707,2
2006,Rural,Maharashtra,Crime Against Children,Kidnapping,Female,31-45,529,372,157,419,110
2008,Rural,Goa,Crime Against Women,Dowry Deaths,Male,18-30,9495,6091,3404,6967,2528
2008,Rural,Jammu & Kashmir,Crime Against Children,Kidnapping,Male,18-30,4550,42,4508,2431,2119
2004,Urban,Goa,Crime Against Children,Child Labor,Female,31-45,8400,5391,3009,7373,1027
2004,Urban,Telangana,Crime Against Women,Rape,Male,60+,7854,3578,4276,5058,2796
2008,Urban,Rajasthan,Property Crime,Burglary,Female,0-12,6271,457,5814,719,5552
2003,Urban,West Bengal,Crime Against Women,Molestation,Male,60+,6122,2199,3923,4320,1802
2006,Rural,Goa,Property Crime,Arson,Female,13-17,9621,648,8973,7711,1910
2009,Urban,Jammu & Kashmir,Crime Against Children,Trafficking,Male,18-30,3279,1317,1962,3146,133
2001,Urban,Himachal Pradesh,Crime Against Children,Kidnapping,Male,18-30,3424,2390,1034,2426,998
2009,Urban,Jammu & Kashmir,Crime Against Men,Assault,Male,13-17,7303,768,6535,3703,3600
2005,Urban,Mizoram,Crime Against Children,Child Abuse,Male,46-60,1314,487,827,1185,129
2005,Urban,Meghalaya,Other Crimes,Corruption,Female,0-12,1043,792,251,1027,16
2006,Urban,Jammu & Kashmir,Crime Against Women,Dowry Deaths,Male,0-12,8028,1904,6124,6838,1190
2010,Rural,Meghalaya,Other Crimes,Corruption,Male,46-60,2168,325,1843,1669,499
2001,Rural,Madhya Pradesh,Other Crimes,Fraud,Male,18-30,3399,3000,399,3281,118
2008,Rural,Mizoram,Other Crimes,Drug Offense,Female,18-30,230,21,209,124,106
2005,Rural,Uttar Pradesh,Crime Against Children,Child Labor,Male,0-12,6603,6428,175,6568,35
2008,Urban,Kerala,Other Crimes,Cyber Crime,Female,31-45,7032,5271,1761,5872,1160
2009,Urban,Telangana,Property Crime,Burglary,Female,31-45,2192,1733,459,2059,133
2009,Urban,Sikkim,Crime Against Women,Domestic Violence,Male,18-30,8552,3177,5375,7931,621
2008,Rural,Manipur,Crime Against Women,Rape,Female,31-45,8502,7682,820,8458,44
2007,Rural,Telangana,Crime Against Men,Robbery,Male,60+,8910,4661,4249,5418,3492
2007,Urban,Madhya Pradesh,Property Crime,Theft,Female,13-17,4157,1594,2563,2132,2025
2008,Urban,Rajasthan,Other Crimes,Corruption,Male,18-30,6215,1467,4748,1864,4351
2008,Urban,Sikkim,Other Crimes,Cyber Crime,Male,13-17,3580,1718,1862,2029,1551
2001,Rural,Jammu & Kashmir,Crime Against Children,Trafficking,Female,46-60,6559,746,5813,3438,3121
2003,Urban,Bihar,Other Crimes,Cyber Crime,Male,60+,9056,3922,5134,7436,1620
2002,Urban,Arunachal Pradesh,Property Crime,Arson,Female,18-30,73,28,45,42,31
2009,Rural,Mizoram,Property Crime,Burglary,Female,0-12,1842,660,1182,746,1096
2008,Rural,Nagaland,Other Crimes,Cyber Crime,Male,60+,9415,1302,8113,3643,5772
2009,Urban,Meghalaya,Crime Against Women,Molestation,Male,60+,8352,8148,204,8200,152
2010,Urban,Tamil Nadu,Other Crimes,Fraud,Female,60+,2178,490,1688,769,1409
2009,Rural,Manipur,Crime Against Women,Molestation,Male,0-12,128,74,54,112,16
2004,Rural,Gujarat,Crime Against Men,Extortion,Male,13-17,1219,431,788,1141,78
2001,Rural,Uttar Pradesh,Crime Against Children,Child Abuse,Male,60+,823,132,691,327,496
2004,Urban,Himachal Pradesh,Crime Against Children,Child Labor,Female,31-45,8549,2806,5743,5191,3358
2006,Rural,Nagaland,Crime Against Women,Rape,Female,18-30,7034,3619,3415,5227,1807
2002,Rural,Jammu & Kashmir,Crime Against Women,Rape,Male,31-45,6650,833,5817,5413,1237
2007,Urban,Sikkim,Property Crime,Burglary,Male,31-45,7362,3514,3848,6129,1233
2002,Rural,Tripura,Crime Against Men,Assault,Male,60+,5889,3348,2541,4368,1521
2005,Urban,Himachal Pradesh,Property Crime,Arson,Male,46-60,1224,703,521,1057,167
2004,Urban,Gujarat,Other Crimes,Drug Offense,Female,46-60,4243,400,3843,2140,2103
2004,Rural,Gujarat,Crime Against Men,Murder,Female,31-45,254,103,151,180,74
2001,Rural,Delhi,Crime Against Children,Trafficking,Male,18-30,4621,3107,1514,3746,875
2001,Rural,Haryana,Property Crime,Vandalism,Female,31-45,4069,420,3649,1208,2861
2008,Urban,Sikkim,Crime Against Women,Molestation,Female,18-30,5183,898,4285,3928,1255
2009,Rural,Odisha,Crime Against Women,Molestation,Male,60+,4647,1658,2989,3767,880
2005,Rural,Delhi,Other Crimes,Fraud,Female,31-45,6868,4058,2810,5346,1522
2007,Urban,Karnataka,Crime Against Women,Rape,Male,18-30,6456,4065,2391,5007,1449
2005,Rural,Chhattisgarh,Crime Against Men,Murder,Male,0-12,951,128,823,731,220
2004,Rural,Maharashtra,Crime Against Women,Molestation,Female,46-60,8338,3368,4970,7856,482
2004,Urban,Gujarat,Crime Against Children,Child Labor,Male,0-12,4388,2749,1639,3432,956
2006,Urban,Uttarakhand,Crime Against Children,Child Abuse,Female,13-17,3704,453,3251,1474,2230
2001,Urban,Tamil Nadu,Crime Against Children,Kidnapping,Female,13-17,6751,5702,1049,6096,655
2006,Urban,Bihar,Crime Against Men,Extortion,Male,31-45,7066,99,6967,935,6131
2003,Urban,Gujarat,Property Crime,Burglary,Female,60+,1232,1167,65,1206,26
2006,Rural,Meghalaya,Crime Against Women,Rape,Female,13-17,8691,3002,5689,8107,584
2010,Urban,Madhya Pradesh,Crime Against Children,Kidnapping,Male,13-17,199,26,173,37,162
2006,Rural,Goa,Crime Against Women,Molestation,Female,46-60,4894,2436,2458,4407,487
2003,Rural,Maharashtra,Crime Against Women,Rape,Female,18-30,8815,4281,4534,5750,3065
2009,Urban,Goa,Crime Against Men,Assault,Male,13-17,4523,3875,648,4068,455
2004,Rural,Rajasthan,Crime Against Children,Trafficking,Female,60+,8093,7837,256,7881,212
2008,Urban,Delhi,Other Crimes,Corruption,Female,0-12,8974,3587,5387,8895,79
2007,Urban,West Bengal,Crime Against Men,Robbery,Female,31-45,7567,3318,4249,4321,3246
2006,Urban,Kerala,Property Crime,Theft,Female,13-17,1926,641,1285,810,1116
2006,Urban,Assam,Crime Against Women,Dowry Deaths,Male,0-12,610,285,325,433,177
2007,Urban,Assam,Property Crime,Arson,Female,13-17,6097,5778,319,6010,87
2002,Rural,Manipur,Other Crimes,Drug Offense,Male,13-17,8660,5014,3646,7761,899
2002,Urban,Maharashtra,Crime Against Women,Rape,Female,13-17,396,336,60,378,18
2010,Rural,Gujarat,Property Crime,Burglary,Male,18-30,9044,685,8359,6107,2937
2007,Rural,Sikkim,Crime Against Women,Dowry Deaths,Male,60+,4874,2561,2313,3413,1461
2008,Urban,Chhattisgarh,Other Crimes,Drug Offense,Female,18-30,6945,5426,1519,6757,188
2004,Rural,Rajasthan,Property Crime,Burglary,Female,0-12,5604,2977,2627,3393,2211
2008,Rural,Arunachal Pradesh,Property Crime,Burglary,Female,0-12,3599,2391,1208,3594,5
2003,Urban,Chhattisgarh,Crime Against Children,Trafficking,Female,18-30,6502,2070,4432,3846,2656
2003,Rural,Andhra Pradesh,Property Crime,Vandalism,Female,18-30,8837,3110,5727,7691,1146
2008,Urban,Uttar Pradesh,Crime Against Children,Child Abuse,Female,18-30,9907,2438,7469,8256,1651
2010,Rural,Assam,Crime Against Children,Child Labor,Female,46-60,5521,1722,3799,2946,2575
2003,Rural,Maharashtra,Crime Against Women,Molestation,Male,0-12,1823,726,1097,1494,329
2004,Urban,Tamil Nadu,Crime Against Children,Child Abuse,Female,46-60,8896,793,8103,5981,2915
2001,Rural,Tamil Nadu,Crime Against Men,Assault,Female,13-17,3194,151,3043,1886,1308
2003,Rural,Madhya Pradesh,Property Crime,Arson,Male,31-45,5031,3059,1972,4294,737
2004,Urban,Gujarat,Property Crime,Theft,Male,31-45,2055,1589,466,2048,7
2007,Urban,Uttar Pradesh,Other Crimes,Fraud,Male,18-30,1429,1197,232,1338,91
2008,Rural,Uttar Pradesh,Crime Against Men,Assault,Female,13-17,4177,1886,2291,2620,1557
2007,Urban,Punjab,Other Crimes,Fraud,Male,46-60,6879,6855,24,6868,11
2007,Urban,Himachal Pradesh,Crime Against Men,Extortion,Male,31-45,576,326,250,530,46
2002,Rural,West Bengal,Crime Against Men,Murder,Male,13-17,872,687,185,828,44
2010,Rural,Meghalaya,Crime Against Children,Child Labor,Female,13-17,7815,500,7315,1562,6253
2003,Urban,Rajasthan,Property Crime,Arson,Female,13-17,4479,827,3652,2277,2202
2004,Urban,West Bengal,Property Crime,Arson,Male,18-30,5808,1215,4593,4264,1544
2005,Urban,Goa,Crime Against Men,Assault,Male,46-60,3161,391,2770,1220,1941
2002,Urban,Jammu & Kashmir,Crime Against Children,Trafficking,Male,31-45,5998,3075,2923,5658,340
2002,Rural,Chhattisgarh,Crime Against Children,Trafficking,Female,18-30,5433,1335,4098,3115,2318
2005,Rural,West Bengal,Crime Against Children,Child Labor,Female,46-60,5963,5533,430,5607,356
2006,Urban,Assam,Crime Against Men,Extortion,Male,31-45,5617,4153,1464,5417,200
2009,Urban,Rajasthan,Crime Against Men,Extortion,Male,60+,6485,2352,4133,3349,3136
2009,Rural,Uttar Pradesh,Property Crime,Theft,Male,13-17,2778,552,2226,2107,671
2004,Urban,Uttar Pradesh,Crime Against Women,Molestation,Female,13-17,170,72,98,136,34
2009,Urban,Madhya Pradesh,Crime Against Children,Child Abuse,Female,13-17,7677,4068,3609,6734,943
2010,Urban,Rajasthan,Other Crimes,Drug Offense,Male,0-12,4250,2904,1346,3500,750
2002,Urban,Telangana,Crime Against Women,Rape,Male,13-17,6504,3030,3474,4045,2459
2010,Urban,Manipur,Crime Against Men,Extortion,Female,18-30,6517,5468,1049,6013,504
2006,Urban,Kerala,Crime Against Women,Rape,Female,46-60,5200,2518,2682,4152,1048
2004,Rural,Sikkim,Property Crime,Burglary,Male,46-60,7805,1343,6462,6761,1044
2001,Urban,Gujarat,Crime Against Men,Assault,Female,31-45,5324,4386,938,4625,699
2007,Urban,Maharashtra,Crime Against Children,Child Abuse,Female,31-45,6450,4713,1737,5670,780
2001,Rural,Jharkhand,Property Crime,Arson,Female,60+,8709,2385,6324,6690,2019
2002,Rural,Telangana,Other Crimes,Fraud,Female,31-45,1087,785,302,937,150
2002,Urban,Maharashtra,Crime Against Children,Trafficking,Female,31-45,3311,3165,146,3252,59
2004,Urban,Uttar Pradesh,Crime Against Men,Robbery,Male,0-12,7727,4366,3361,6883,844
2003,Rural,Gujarat,Crime Against Men,Extortion,Male,0-12,7948,2715,5233,3843,4105
2003,Urban,Uttarakhand,Crime Against Children,Trafficking,Female,0-12,9701,4274,5427,7556,2145
2002,Urban,Mizoram,Crime Against Children,Child Labor,Male,18-30,7363,2589,4774,3188,4175
2005,Urban,Kerala,Crime Against Women,Molestation,Female,0-12,7295,1818,5477,6944,351
2001,Urban,Rajasthan,Other Crimes,Drug Offense,Male,13-17,8696,4514,4182,5487,3209
2007,Rural,Uttarakhand,Crime Against Women,Dowry Deaths,Female,13-17,6403,3384,3019,4933,1470
2008,Rural,Telangana,Other Crimes,Corruption,Female,13-17,4714,23,4691,304,4410
2007,Rural,Goa,Crime Against Women,Molestation,Male,46-60,4429,4169,260,4233,196
2008,Urban,Meghalaya,Property Crime,Vandalism,Male,46-60,4135,2108,2027,2685,1450
2006,Urban,Manipur,Crime Against Children,Kidnapping,Male,60+,1494,1148,346,1434,60
2006,Urban,Tamil Nadu,Property Crime,Theft,Male,46-60,1576,100,1476,471,1105
2009,Urban,Manipur,Crime Against Women,Domestic Violence,Male,13-17,2053,888,1165,1293,760
2001,Urban,Arunachal Pradesh,Crime Against Men,Extortion,Female,60+,2396,2309,87,2309,87
2002,Urban,Uttarakhand,Property Crime,Arson,Female,0-12,2607,1712,895,2395,212
2002,Urban,Arunachal Pradesh,Crime Against Men,Assault,Female,13-17,7800,3332,4468,4773,3027
2005,Rural,Madhya Pradesh,Other Crimes,Fraud,Female,0-12,6155,1977,4178,4863,1292
2003,Rural,Rajasthan,Crime Against Women,Molestation,Female,18-30,2056,1837,219,2056,0
2001,Urban,Maharashtra,Property Crime,Vandalism,Male,18-30,2514,2185,329,2429,85
2001,Rural,Sikkim,Other Crimes,Cyber Crime,Male,31-45,3073,152,2921,749,2324
2002,Urban,Andhra Pradesh,Crime Against Women,Molestation,Male,0-12,1202,942,260,1039,163
2001,Urban,Kerala,Other Crimes,Drug Offense,Female,46-60,5839,3601,2238,3943,1896
2007,Urban,Kerala,Crime Against Children,Child Abuse,Female,0-12,5146,4977,169,5109,37
2003,Rural,West Bengal,Other Crimes,Drug Offense,Female,18-30,5443,3973,1470,5103,340
2001,Rural,Nagaland,Crime Against Women,Molestation,Female,18-30,326,154,172,206,120
2008,Rural,Odisha,Other Crimes,Fraud,Female,60+,8241,7560,681,8139,102
2003,Urban,Sikkim,Other Crimes,Cyber Crime,Female,13-17,1544,1066,478,1222,322
2007,Rural,Kerala,Crime Against Children,Child Labor,Male,13-17,7434,1013,6421,4342,3092
2008,Urban,Assam,Property Crime,Vandalism,Female,18-30,8847,5676,3171,7331,1516
2001,Urban,Karnataka,Property Crime,Vandalism,Male,60+,1949,1101,848,1351,598
2009,Rural,Nagaland,Crime Against Women,Dowry Deaths,Female,31-45,5180,1209,3971,3882,1298
2001,Rural,Delhi,Crime Against Women,Domestic Violence,Female,13-17,3477,336,3141,818,2659
2005,Urban,Telangana,Other Crimes,Corruption,Male,31-45,674,308,366,669,5
2010,Rural,Telangana,Other Crimes,Fraud,Female,0-12,1444,459,985,811,633
2004,Rural,Punjab,Crime Against Women,Domestic Violence,Female,13-17,7791,4459,3332,6728,1063
2004,Rural,Bihar,Other Crimes,Cyber Crime,Male,46-60,3249,2275,974,2563,686
2002,Urban,Punjab,Crime Against Children,Kidnapping,Male,60+,9848,4267,5581,6487,3361
2009,Urban,Arunachal Pradesh,Crime Against Women,Molestation,Male,46-60,366,91,275,173,193
2002,Rural,Tripura,Crime Against Children,Trafficking,Female,31-45,1287,73,1214,412,875
2007,Rural,Karnataka,Property Crime,Vandalism,Male,0-12,5271,1131,4140,1647,3624
2005,Rural,Kerala,Other Crimes,Corruption,Female,0-12,1571,774,797,780,791
2009,Rural,Uttar Pradesh,Other Crimes,Drug Offense,Female,0-12,7806,1494,6312,5277,2529
2003,Rural,Himachal Pradesh,Crime Against Children,Trafficking,Female,31-45,3559,1158,2401,1743,1816
2008,Urban,Sikkim,Crime Against Women,Molestation,Female,31-45,1790,344,1446,1160,630
2001,Urban,Arunachal Pradesh,Crime Against Men,Assault,Female,60+,124,122,2,124,0
2008,Urban,Delhi,Crime Against Children,Kidnapping,Female,13-17,7707,1738,5969,2113,5594
2003,Rural,Haryana,Crime Against Children,Trafficking,Female,46-60,6250,3342,2908,5668,582
2006,Urban,Mizoram,Property Crime,Arson,Male,60+,9392,261,9131,9279,113
2002,Rural,West Bengal,Crime Against Women,Molestation,Male,13-17,6589,1250,5339,1800,4789
2001,Rural,Goa,Property Crime,Arson,Female,60+,5489,4692,797,4825,664
2007,Rural,Nagaland,Property Crime,Vandalism,Male,13-17,4459,606,3853,2484,1975
2002,Rural,Meghalaya,Crime Against Men,Assault,Female,31-45,6620,1985,4635,4774,1846
2002,Rural,Himachal Pradesh,Crime Against Men,Murder,Male,13-17,3178,2135,1043,2466,712
2009,Rural,Nagaland,Crime Against Men,Extortion,Male,18-30,949,473,476,861,88
2009,Rural,Rajasthan,Crime Against Men,Robbery,Female,18-30,3692,1503,2189,1827,1865
2004,Rural,Delhi,Crime Against Children,Child Labor,Female,31-45,6382,4185,2197,5396,986
2005,Rural,Jammu & Kashmir,Other Crimes,Corruption,Male,0-12,8669,818,7851,7407,1262
2008,Rural,Andhra Pradesh,Crime Against Men,Extortion,Female,0-12,5537,3863,1674,5397,140
2007,Rural,Madhya Pradesh,Crime Against Men,Murder,Male,0-12,7446,3433,4013,6951,495
2002,Urban,Nagaland,Crime Against Women,Dowry Deaths,Male,0-12,237,53,184,142,95
2005,Rural,Goa,Crime Against Women,Dowry Deaths,Male,0-12,5329,5094,235,5329,0
2006,Urban,Maharashtra,Property Crime,Theft,Male,46-60,3288,2693,595,3212,76
2002,Rural,Arunachal Pradesh,Crime Against Women,Domestic Violence,Male,13-17,5913,3176,2737,5023,890
2010,Rural,Punjab,Crime Against Children,Child Labor,Female,18-30,8860,1149,7711,6807,2053
2002,Urban,Andhra Pradesh,Crime Against Children,Child Abuse,Male,60+,4359,2089,2270,3992,367
2003,Urban,Meghalaya,Crime Against Men,Assault,Male,60+,7501,5381,2120,6646,855
2003,Rural,Jammu & Kashmir,Property Crime,Burglary,Male,13-17,7920,3669,4251,5290,2630
2008,Urban,Mizoram,Crime Against Men,Extortion,Female,31-45,2847,1086,1761,2123,724
2003,Rural,Rajasthan,Other Crimes,Fraud,Female,13-17,1162,298,864,997,165
2007,Rural,Arunachal Pradesh,Crime Against Children,Child Abuse,Female,60+,4634,4242,392,4436,198
2004,Rural,Chhattisgarh,Property Crime,Arson,Female,46-60,2210,1556,654,1925,285
2008,Urban,Karnataka,Other Crimes,Cyber Crime,Female,0-12,9737,3981,5756,6579,3158
2004,Rural,Jammu & Kashmir,Other Crimes,Fraud,Female,0-12,6770,1136,5634,5834,936
2005,Rural,Gujarat,Crime Against Children,Child Abuse,Female,18-30,7060,6279,781,6662,398
2003,Rural,Punjab,Property Crime,Theft,Male,31-45,2361,230,2131,1770,591
2001,Rural,Nagaland,Crime Against Children,Trafficking,Female,18-30,7295,879,6416,4905,2390
2002,Urban,Tripura,Property Crime,Theft,Male,31-45,2613,273,2340,1975,638
2004,Urban,Assam,Crime Against Men,Assault,Female,18-30,1014,542,472,640,374
2008,Rural,Assam,Property Crime,Vandalism,Male,31-45,526,407,119,462,64
2010,Urban,Karnataka,Crime Against Children,Child Abuse,Female,0-12,9810,792,9018,8525,1285
2002,Rural,Tripura,Crime Against Women,Dowry Deaths,Female,18-30,8004,6189,1815,7727,277
2002,Urban,Punjab,Property Crime,Arson,Female,60+,9406,4286,5120,9271,135
2008,Urban,Haryana,Crime Against Children,Kidnapping,Female,13-17,3116,1333,1783,2672,444
2002,Rural,Meghalaya,Crime Against Women,Rape,Female,13-17,9612,5779,3833,9163,449
2005,Urban,Meghalaya,Crime Against Men,Extortion,Male,46-60,2914,1574,1340,1894,1020
2006,Urban,Himachal Pradesh,Crime Against Women,Domestic Violence,Male,13-17,9097,7183,1914,8258,839
2008,Rural,Arunachal Pradesh,Crime Against Children,Trafficking,Female,13-17,5701,4384,1317,5083,618
2008,Rural,Andhra Pradesh,Other Crimes,Cyber Crime,Male,46-60,3427,2987,440,3111,316
2007,Urban,Himachal Pradesh,Property Crime,Vandalism,Male,46-60,3949,398,3551,2063,1886
2002,Urban,Uttarakhand,Crime Against Children,Kidnapping,Male,31-45,3208,1007,2201,1650,1558
2002,Rural,Chhattisgarh,Other Crimes,Fraud,Male,31-45,9192,4425,4767,6431,2761
2006,Rural,Punjab,Crime Against Women,Molestation,Male,46-60,403,17,386,227,176
2001,Urban,Meghalaya,Crime Against Men,Murder,Male,46-60,7259,5504,1755,6794,465
2003,Rural,Jammu & Kashmir,Crime Against Men,Assault,Male,18-30,5278,1850,3428,3281,1997
2010,Rural,Assam,Other Crimes,Cyber Crime,Female,18-30,810,718,92,762,48
2004,Urban,Assam,Crime Against Children,Child Abuse,Male,60+,695,92,603,227,468
2006,Rural,Jharkhand,Crime Against Women,Rape,Female,0-12,9751,6935,2816,7908,1843
2010,Rural,Kerala,Crime Against Children,Kidnapping,Female,46-60,1620,1481,139,1484,136
2006,Urban,Bihar,Crime Against Children,Kidnapping,Female,0-12,647,77,570,539,108
2005,Urban,Telangana,Property Crime,Arson,Female,18-30,6500,4533,1967,5370,1130
2010,Rural,Manipur,Other Crimes,Fraud,Female,0-12,1875,545,1330,810,1065
2002,Rural,West Bengal,Property Crime,Arson,Male,60+,2917,970,1947,1893,1024
2003,Urban,Nagaland,Property Crime,Theft,Male,60+,578,385,193,467,111
2007,Urban,Assam,Crime Against Men,Assault,Female,13-17,2766,2318,448,2417,349
2008,Urban,Uttar Pradesh,Other Crimes,Corruption,Male,60+,2956,477,2479,2839,117
2009,Rural,Jammu & Kashmir,Property Crime,Theft,Male,46-60,6221,2045,4176,5623,598
2007,Rural,Gujarat,Crime Against Women,Molestation,Female,46-60,3336,1705,1631,1958,1378
2009,Rural,Jammu & Kashmir,Crime Against Children,Child Labor,Male,31-45,2076,522,1554,1772,304
2006,Rural,Karnataka,Crime Against Children,Kidnapping,Male,18-30,6305,634,5671,6084,221
2010,Urban,Delhi,Other Crimes,Drug Offense,Female,60+,7195,6145,1050,6311,884
2008,Rural,Jharkhand,Property Crime,Theft,Male,13-17,3766,167,3599,1354,2412
2003,Urban,Karnataka,Crime Against Children,Kidnapping,Female,46-60,6357,6051,306,6202,155
2010,Urban,Karnataka,Crime Against Men,Extortion,Female,31-45,9793,8453,1340,8630,1163
2006,Urban,Arunachal Pradesh,Crime Against Men,Robbery,Male,13-17,6648,1841,4807,5725,923
2006,Urban,Madhya Pradesh,Property Crime,Arson,Male,13-17,3160,1463,1697,2112,1048
2001,Urban,Kerala,Other Crimes,Drug Offense,Male,31-45,7547,6725,822,6742,805
2009,Urban,Rajasthan,Crime Against Women,Molestation,Male,18-30,5985,596,5389,5679,306
2008,Rural,Jammu & Kashmir,Other Crimes,Corruption,Female,18-30,1842,1567,275,1805,37
2005,Urban,Mizoram,Crime Against Children,Trafficking,Female,0-12,4955,4657,298,4688,267
2001,Rural,Gujarat,Crime Against Children,Trafficking,Male,60+,3085,1572,1513,2928,157
2007,Rural,Karnataka,Crime Against Men,Murder,Female,13-17,6734,3852,2882,4212,2522
2004,Rural,Manipur,Crime Against Women,Domestic Violence,Male,46-60,2042,157,1885,801,1241
2006,Rural,Mizoram,Crime Against Men,Murder,Male,18-30,7798,6359,1439,7432,366
2005,Urban,Jammu & Kashmir,Crime Against Women,Domestic Violence,Male,18-30,9696,8344,1352,9670,26
2007,Urban,Punjab,Other Crimes,Drug Offense,Female,60+,8344,704,7640,5076,3268
2010,Urban,Tamil Nadu,Crime Against Men,Robbery,Female,60+,3157,2432,725,3151,6
2001,Rural,Bihar,Property Crime,Theft,Male,13-17,2883,2845,38,2873,10
2003,Rural,Kerala,Crime Against Men,Murder,Female,18-30,9340,9102,238,9281,59
2010,Urban,Rajasthan,Crime Against Men,Assault,Female,31-45,679,342,337,453,226
2007,Rural,Nagaland,Crime Against Men,Extortion,Female,18-30,4290,1369,2921,3089,1201
2007,Rural,Sikkim,Crime Against Women,Rape,Male,60+,5139,156,4983,2357,2782
2003,Urban,Odisha,Property Crime,Theft,Male,31-45,301,63,238,140,161
2002,Rural,Tripura,Property Crime,Theft,Female,13-17,5338,1755,3583,3188,2150
2007,Rural,Meghalaya,Other Crimes,Corruption,Female,18-30,8746,5810,2936,6102,2644
2006,Urban,Rajasthan,Crime Against Women,Molestation,Male,46-60,2104,1326,778,1979,125
2007,Urban,Punjab,Crime Against Women,Dowry Deaths,Male,46-60,7904,7875,29,7893,11
2001,Urban,Odisha,Crime Against Children,Kidnapping,Female,60+,4737,734,4003,4702,35
2010,Urban,Gujarat,Property Crime,Arson,Female,31-45,1489,1192,297,1389,100
2001,Rural,Nagaland,Crime Against Women,Rape,Female,18-30,8636,5976,2660,7788,848
2003,Rural,Chhattisgarh,Crime Against Women,Rape,Female,31-45,7367,4298,3069,6627,740
2010,Urban,Nagaland,Other Crimes,Corruption,Male,60+,504,491,13,493,11
2010,Urban,Nagaland,Other Crimes,Corruption,Female,31-45,7385,2377,5008,4034,3351
2009,Rural,Odisha,Crime Against Men,Assault,Female,31-45,8319,1696,6623,6864,1455
2010,Rural,Mizoram,Crime Against Men,Robbery,Male,31-45,2513,778,1735,1067,1446
2010,Urban,Goa,Property Crime,Arson,Female,60+,4055,3091,964,3587,468
2003,Rural,Punjab,Other Crimes,Cyber Crime,Male,18-30,7889,1212,6677,5520,2369
2007,Rural,Delhi,Other Crimes,Cyber Crime,Female,31-45,2279,349,1930,1703,576
2003,Rural,Haryana,Crime Against Children,Child Abuse,Male,60+,2174,1159,1015,1181,993
2004,Rural,Goa,Crime Against Women,Rape,Female,60+,9606,892,8714,2413,7193
2005,Rural,Jharkhand,Crime Against Children,Trafficking,Male,31-45,2809,343,2466,1256,1553
2008,Urban,West Bengal,Crime Against Men,Robbery,Female,60+,1351,385,966,701,650
2007,Urban,Jharkhand,Crime Against Men,Robbery,Female,60+,7904,3253,4651,4121,3783
2010,Urban,Delhi,Crime Against Women,Dowry Deaths,Male,31-45,2246,1789,457,2045,201
2004,Rural,Uttarakhand,Crime Against Men,Assault,Male,46-60,9282,6544,2738,8005,1277
2005,Rural,Karnataka,Crime Against Men,Assault,Male,60+,6752,517,6235,5779,973
2007,Rural,Karnataka,Crime Against Children,Child Labor,Male,60+,7927,3774,4153,6598,1329
2009,Urban,Bihar,Other Crimes,Fraud,Male,13-17,7080,5976,1104,6270,810
2006,Urban,Kerala,Crime Against Women,Molestation,Male,18-30,650,570,80,634,16
2008,Rural,Kerala,Crime Against Children,Child Labor,Male,13-17,6467,4550,1917,5131,1336
2003,Rural,Andhra Pradesh,Crime Against Men,Assault,Male,31-45,8141,6705,1436,7316,825
2009,Urban,Andhra Pradesh,Property Crime,Arson,Female,0-12,7291,1395,5896,3291,4000
2009,Urban,Haryana,Property Crime,Theft,Female,60+,1589,1194,395,1444,145
2008,Urban,Assam,Property Crime,Vandalism,Male,0-12,6387,3187,3200,3657,2730
2007,Rural,Himachal Pradesh,Other Crimes,Corruption,Male,13-17,7198,6751,447,7033,165
2005,Urban,Goa,Property Crime,Theft,Female,46-60,7476,1511,5965,3204,4272
2005,Rural,Uttar Pradesh,Other Crimes,Drug Offense,Female,13-17,4160,1282,2878,2365,1795
2008,Rural,Goa,Other Crimes,Cyber Crime,Female,46-60,984,225,759,458,526
2009,Urban,Bihar,Property Crime,Burglary,Female,60+,4037,3449,588,3456,581
2002,Rural,Mizoram,Property Crime,Burglary,Male,31-45,7398,3616,3782,6345,1053
2005,Urban,Nagaland,Property Crime,Burglary,Male,0-12,747,568,179,580,167
2009,Rural,Odisha,Property Crime,Burglary,Male,60+,5198,2270,2928,3326,1872
2009,Urban,Odisha,Crime Against Children,Kidnapping,Female,46-60,5780,3397,2383,4864,916
2002,Urban,Haryana,Other Crimes,Cyber Crime,Male,0-12,8941,1617,7324,5502,3439
2004,Urban,Assam,Other Crimes,Fraud,Male,18-30,7949,2273,5676,2408,5541
2001,Rural,Chhattisgarh,Property Crime,Arson,Female,60+,3611,624,2987,1188,2423
2004,Urban,Gujarat,Other Crimes,Drug Offense,Male,0-12,6771,6561,210,6609,162
2007,Rural,Telangana,Crime Against Children,Child Abuse,Male,46-60,1713,173,1540,1689,24
2003,Urban,Telangana,Crime Against Children,Child Labor,Female,31-45,7074,3530,3544,5980,1094
2005,Urban,Himachal Pradesh,Crime Against Women,Dowry Deaths,Male,0-12,4613,125,4488,1116,3497
2006,Urban,Assam,Crime Against Women,Rape,Female,13-17,5838,2553,3285,3319,2519
2001,Urban,Uttar Pradesh,Other Crimes,Cyber Crime,Female,46-60,6170,4074,2096,5058,1112
2002,Rural,Chhattisgarh,Crime Against Children,Trafficking,Female,60+,8513,3596,4917,4114,4399
2001,Urban,Kerala,Crime Against Women,Molestation,Female,13-17,4003,2004,1999,3437,566
2008,Rural,Telangana,Other Crimes,Drug Offense,Female,60+,7133,6605,528,6771,362
2001,Rural,Maharashtra,Crime Against Women,Molestation,Male,31-45,1386,761,625,1140,246
2004,Rural,Nagaland,Crime Against Men,Extortion,Female,31-45,6409,1672,4737,4303,2106
2004,Rural,Himachal Pradesh,Crime Against Women,Dowry Deaths,Male,18-30,2083,1040,1043,1601,482
2005,Rural,Jammu & Kashmir,Crime Against Women,Molestation,Male,13-17,6264,413,5851,6118,146
2007,Urban,Madhya Pradesh,Other Crimes,Fraud,Female,60+,4580,4127,453,4371,209
2007,Urban,Kerala,Property Crime,Vandalism,Male,46-60,7548,7100,448,7380,168
2007,Urban,Telangana,Other Crimes,Fraud,Male,31-45,9333,1030,8303,5094,4239
2002,Urban,Telangana,Property Crime,Burglary,Female,0-12,1510,1504,6,1510,0
2008,Rural,Odisha,Crime Against Men,Robbery,Female,31-45,9544,7333,2211,8398,1146
2008,Rural,Delhi,Crime Against Women,Domestic Violence,Female,0-12,3674,162,3512,2030,1644
2005,Urban,Goa,Crime Against Women,Domestic Violence,Male,18-30,4503,3105,1398,3577,926
2001,Rural,Madhya Pradesh,Crime Against Women,Molestation,Female,31-45,9955,5203,4752,8891,1064
2010,Urban,Rajasthan,Crime Against Men,Assault,Male,46-60,2860,544,2316,857,2003
2004,Urban,Himachal Pradesh,Crime Against Men,Murder,Female,60+,9340,397,8943,7022,2318
2002,Urban,Haryana,Crime Against Men,Robbery,Male,0-12,7986,200,7786,3823,4163
2006,Rural,Karnataka,Crime Against Children,Trafficking,Female,46-60,981,868,113,915,66
2008,Rural,Punjab,Crime Against Women,Molestation,Female,0-12,531,205,326,499,32
2001,Rural,Meghalaya,Other Crimes,Corruption,Female,60+,3392,110,3282,548,2844
2009,Rural,Gujarat,Crime Against Women,Rape,Male,60+,6857,3692,3165,6498,359
2008,Urban,Jharkhand,Crime Against Children,Trafficking,Female,13-17,6890,4925,1965,5020,1870
2003,Rural,Mizoram,Other Crimes,Drug Offense,Male,0-12,5212,993,4219,4339,873
2009,Rural,Gujarat,Crime Against Children,Child Abuse,Female,31-45,4667,3989,678,4074,593
2005,Rural,Uttar Pradesh,Crime Against Men,Assault,Female,0-12,4105,2066,2039,4033,72
2005,Rural,Chhattisgarh,Crime Against Women,Dowry Deaths,Male,13-17,2990,872,2118,915,2075
2003,Rural,Nagaland,Crime Against Women,Domestic Violence,Male,13-17,7105,6157,948,6803,302
2008,Urban,Kerala,Other Crimes,Corruption,Female,60+,915,776,139,845,70
2005,Rural,Haryana,Crime Against Men,Robbery,Female,46-60,3891,263,3628,500,3391
2005,Urban,Andhra Pradesh,Crime Against Men,Robbery,Female,31-45,4263,1925,2338,2021,2242
2002,Rural,Punjab,Crime Against Children,Trafficking,Female,31-45,7515,5048,2467,7044,471
2007,Urban,Kerala,Crime Against Children,Kidnapping,Female,13-17,493,416,77,460,33
2004,Rural,Karnataka,Property Crime,Burglary,Male,31-45,6745,1442,5303,3738,3007
2007,Rural,Himachal Pradesh,Crime Against Women,Rape,Male,18-30,6718,3968,2750,6207,511
2002,Urban,Tripura,Property Crime,Vandalism,Male,18-30,6118,4572,1546,5063,1055
2009,Rural,Tamil Nadu,Property Crime,Vandalism,Male,13-17,9317,5624,3693,7832,1485
2008,Rural,Goa,Property Crime,Theft,Male,60+,9715,5194,4521,9612,103
2004,Rural,Bihar,Property Crime,Arson,Female,18-30,5189,3558,1631,4310,879
2004,Urban,Odisha,Property Crime,Vandalism,Female,18-30,9926,9765,161,9827,99
2009,Urban,Telangana,Crime Against Men,Murder,Female,46-60,5086,3099,1987,4111,975
2005,Rural,Bihar,Crime Against Children,Child Labor,Female,31-45,1582,171,1411,1263,319
2005,Urban,Chhattisgarh,Crime Against Men,Murder,Female,46-60,1292,651,641,736,556
2003,Rural,Mizoram,Property Crime,Vandalism,Male,31-45,5143,2847,2296,3969,1174
2008,Rural,Jammu & Kashmir,Crime Against Children,Trafficking,Male,18-30,700,196,504,266,434
2005,Urban,Haryana,Other Crimes,Drug Offense,Male,18-30,1328,712,616,1030,298
2008,Urban,Tripura,Crime Against Men,Extortion,Female,60+,1453,547,906,1200,253
2005,Urban,Uttarakhand,Property Crime,Theft,Male,13-17,4296,620,3676,4193,103
2007,Urban,Assam,Other Crimes,Drug Offense,Male,13-17,9656,4428,5228,8095,1561
2006,Urban,Jammu & Kashmir,Other Crimes,Drug Offense,Male,31-45,4349,2004,2345,2354,1995
2003,Rural,Gujarat,Property Crime,Theft,Female,46-60,6904,5965,939,6505,399
2008,Rural,Bihar,Crime Against Children,Kidnapping,Male,0-12,9519,8210,1309,9390,129
2003,Urban,Delhi,Crime Against Women,Domestic Violence,Male,46-60,219,22,197,189,30
2002,Rural,Nagaland,Other Crimes,Corruption,Male,18-30,1685,922,763,1608,77
2002,Rural,Andhra Pradesh,Property Crime,Arson,Female,0-12,2177,1302,875,1370,807
2007,Urban,Rajasthan,Crime Against Children,Trafficking,Male,0-12,6915,3759,3156,6909,6
2008,Urban,Maharashtra,Crime Against Children,Child Abuse,Male,46-60,3911,1425,2486,3429,482
2002,Urban,Rajasthan,Crime Against Men,Murder,Female,60+,6238,1481,4757,5831,407
2003,Urban,Telangana,Crime Against Women,Dowry Deaths,Female,31-45,7074,6618,456,6833,241
2002,Rural,Telangana,Property Crime,Theft,Female,18-30,5715,4578,1137,4609,1106
2010,Rural,Jammu & Kashmir,Other Crimes,Fraud,Male,0-12,4820,1618,3202,2253,2567
2003,Rural,Kerala,Other Crimes,Drug Offense,Male,13-17,8265,2582,5683,2584,5681
2010,Rural,Nagaland,Crime Against Women,Molestation,Male,13-17,3173,1042,2131,1705,1468
2006,Rural,Assam,Crime Against Men,Extortion,Female,18-30,7784,820,6964,3600,4184
2008,Urban,Odisha,Crime Against Children,Child Abuse,Female,31-45,5017,2764,2253,4818,199
2002,Urban,Telangana,Crime Against Children,Child Abuse,Female,18-30,5165,4520,645,4669,496
2007,Rural,Uttarakhand,Other Crimes,Drug Offense,Female,0-12,4766,3613,1153,4763,3
2003,Rural,Gujarat,Crime Against Women,Dowry Deaths,Male,18-30,9080,5998,3082,7868,1212
2004,Urban,Tamil Nadu,Property Crime,Burglary,Female,13-17,3425,2288,1137,3027,398
2005,Urban,Karnataka,Property Crime,Theft,Female,0-12,9165,2723,6442,8766,399
2004,Rural,Goa,Property Crime,Burglary,Male,31-45,3405,2750,655,3111,294
2002,Rural,West Bengal,Crime Against Children,Child Abuse,Male,13-17,8989,5851,3138,7242,1747
2006,Urban,Rajasthan,Property Crime,Vandalism,Male,0-12,8639,7708,931,7745,894
2010,Rural,Punjab,Crime Against Men,Robbery,Female,13-17,7829,7410,419,7703,126
2005,Rural,Mizoram,Crime Against Men,Murder,Female,60+,5123,592,4531,3820,1303
2004,Urban,Manipur,Other Crimes,Drug Offense,Female,18-30,3046,1279,1767,1890,1156
2004,Rural,West Bengal,Other Crimes,Cyber Crime,Female,31-45,7372,1174,6198,2925,4447
2010,Urban,Rajasthan,Other Crimes,Corruption,Male,13-17,8454,4698,3756,7428,1026
2004,Rural,Mizoram,Crime Against Men,Extortion,Male,60+,2813,2719,94,2734,79
2003,Urban,Uttar Pradesh,Crime Against Men,Murder,Female,46-60,4041,3312,729,3551,490
2001,Rural,Haryana,Property Crime,Arson,Female,13-17,6926,6861,65,6880,46
2007,Rural,Chhattisgarh,Crime Against Children,Child Abuse,Male,46-60,6274,2886,3388,6201,73
2010,Urban,Haryana,Other Crimes,Drug Offense,Male,18-30,6679,6350,329,6645,34
2003,Urban,Delhi,Other Crimes,Drug Offense,Female,31-45,1050,1005,45,1016,34
2008,Urban,Rajasthan,Property Crime,Burglary,Male,18-30,6003,1499,4504,4342,1661
2002,Urban,Assam,Crime Against Women,Dowry Deaths,Female,46-60,6027,4286,1741,5976,51
2003,Urban,Punjab,Crime Against Women,Domestic Violence,Male,0-12,2956,2478,478,2954,2
2004,Urban,Madhya Pradesh,Other Crimes,Drug Offense,Female,46-60,2827,904,1923,1155,1672
2003,Rural,Madhya Pradesh,Crime Against Men,Murder,Male,31-45,3757,3694,63,3747,10
2006,Rural,Maharashtra,Other Crimes,Drug Offense,Male,60+,6029,1284,4745,2364,3665
2007,Rural,Punjab,Crime Against Men,Robbery,Female,60+,1245,1044,201,1055,190
2005,Urban,Maharashtra,Other Crimes,Cyber Crime,Male,13-17,9513,7240,2273,7426,2087
2002,Urban,Jammu & Kashmir,Other Crimes,Drug Offense,Male,13-17,2975,509,2466,2005,970
2004,Urban,Jammu & Kashmir,Crime Against Men,Robbery,Female,46-60,9707,5588,4119,7157,2550
2008,Urban,Uttar Pradesh,Crime Against Women,Domestic Violence,Male,13-17,2844,1172,1672,2097,747
2008,Urban,Jharkhand,Crime Against Children,Trafficking,Male,60+,7746,158,7588,5763,1983
2009,Urban,Sikkim,Property Crime,Arson,Female,46-60,8858,6613,2245,7462,1396
2006,Rural,Assam,Crime Against Children,Kidnapping,Female,46-60,444,112,332,276,168
2007,Rural,Tamil Nadu,Crime Against Men,Robbery,Female,31-45,6101,2474,3627,2775,3326
2010,Urban,Rajasthan,Other Crimes,Cyber Crime,Male,31-45,4272,2537,1735,3698,574
2006,Urban,Manipur,Crime Against Children,Trafficking,Female,60+,6509,67,6442,4603,1906
2009,Urban,Meghalaya,Crime Against Children,Trafficking,Male,18-30,3852,425,3427,640,3212
2010,Urban,Maharashtra,Crime Against Men,Robbery,Male,31-45,542,227,315,471,71
2009,Rural,Uttarakhand,Property Crime,Vandalism,Female,0-12,3447,1765,1682,2661,786
2008,Rural,Odisha,Other Crimes,Cyber Crime,Male,0-12,7814,6851,963,7296,518
2001,Urban,Meghalaya,Property Crime,Vandalism,Female,18-30,1278,667,611,682,596
2009,Urban,Haryana,Other Crimes,Fraud,Male,60+,698,604,94,658,40
2007,Rural,Rajasthan,Crime Against Men,Robbery,Male,60+,7690,2182,5508,6653,1037
2006,Rural,Telangana,Crime Against Women,Domestic Violence,Female,60+,1329,823,506,1202,127
2001,Urban,Tamil Nadu,Other Crimes,Corruption,Male,31-45,3441,777,2664,1367,2074
2006,Rural,Nagaland,Crime Against Children,Child Labor,Male,18-30,8968,6282,2686,6602,2366
2009,Rural,Manipur,Crime Against Men,Extortion,Female,31-45,680,533,147,563,117
2006,Urban,Uttarakhand,Other Crimes,Corruption,Female,0-12,1804,1561,243,1636,168
2006,Rural,Tamil Nadu,Crime Against Men,Robbery,Female,31-45,3461,896,2565,2781,680
2009,Rural,Uttar Pradesh,Crime Against Men,Murder,Female,31-45,100,15,85,60,40
2004,Rural,Andhra Pradesh,Other Crimes,Drug Offense,Female,18-30,5938,2591,3347,4386,1552
2001,Rural,Karnataka,Crime Against Children,Child Abuse,Male,0-12,7869,3002,4867,7094,775
2006,Urban,Punjab,Crime Against Women,Dowry Deaths,Female,18-30,7746,1811,5935,4125,3621
2001,Rural,Assam,Crime Against Men,Murder,Male,13-17,7386,4538,2848,6682,704
2001,Urban,Kerala,Crime Against Children,Trafficking,Male,13-17,4768,503,4265,1868,2900
2009,Rural,Manipur,Property Crime,Vandalism,Male,18-30,3927,2997,930,3179,748
2010,Rural,Uttarakhand,Property Crime,Vandalism,Male,60+,8275,7059,1216,8151,124
2001,Urban,Tamil Nadu,Crime Against Women,Dowry Deaths,Male,46-60,7678,1587,6091,4050,3628
2006,Urban,Gujarat,Crime Against Women,Domestic Violence,Male,0-12,7651,6217,1434,6442,1209
2006,Rural,Tripura,Crime Against Men,Assault,Male,18-30,7466,4359,3107,5997,1469
2004,Urban,Andhra Pradesh,Crime Against Men,Extortion,Male,31-45,1954,653,1301,999,955
2002,Rural,Goa,Other Crimes,Drug Offense,Female,31-45,6245,2236,4009,5061,1184
2003,Urban,Sikkim,Crime Against Men,Extortion,Male,46-60,3380,1913,1467,2950,430
2010,Rural,Mizoram,Property Crime,Vandalism,Male,13-17,7000,4758,2242,6581,419
2010,Urban,Jammu & Kashmir,Crime Against Children,Child Abuse,Female,0-12,9422,9366,56,9421,1
2010,Rural,Gujarat,Crime Against Men,Assault,Male,31-45,6367,4111,2256,4608,1759
2008,Rural,Manipur,Crime Against Men,Robbery,Female,13-17,6219,5457,762,5840,379
2009,Rural,Nagaland,Crime Against Men,Assault,Male,46-60,8441,5909,2532,8097,344
2003,Rural,Jharkhand,Crime Against Children,Trafficking,Male,0-12,9010,8639,371,8775,235
2005,Urban,Tripura,Crime Against Men,Extortion,Male,13-17,4553,2476,2077,3715,838
2002,Rural,Tripura,Crime Against Men,Robbery,Male,46-60,8161,5577,2584,6238,1923
2008,Urban,Uttarakhand,Crime Against Men,Robbery,Male,18-30,7172,6092,1080,6219,953
2007,Urban,Odisha,Crime Against Men,Robbery,Female,46-60,135,130,5,132,3
2009,Urban,Delhi,Property Crime,Arson,Female,46-60,1794,786,1008,1727,67
2002,Urban,Madhya Pradesh,Crime Against Women,Domestic Violence,Female,0-12,8085,971,7114,1007,7078
2006,Urban,Gujarat,Crime Against Men,Robbery,Male,60+,398,299,99,362,36
2007,Rural,Gujarat,Property Crime,Arson,Male,0-12,8244,5765,2479,6862,1382
2010,Urban,Manipur,Crime Against Children,Trafficking,Female,0-12,3570,2736,834,2804,766
2006,Rural,Tamil Nadu,Crime Against Children,Trafficking,Male,60+,7755,6182,1573,6364,1391
2009,Urban,Uttarakhand,Crime Against Children,Child Labor,Male,31-45,8375,5616,2759,7457,918
2005,Rural,Tamil Nadu,Crime Against Children,Child Abuse,Male,31-45,8707,470,8237,1025,7682
2008,Urban,Maharashtra,Property Crime,Burglary,Female,13-17,2451,2032,419,2033,418
2005,Urban,Himachal Pradesh,Crime Against Men,Robbery,Female,31-45,7950,6003,1947,7466,484
2010,Urban,Rajasthan,Other Crimes,Drug Offense,Female,46-60,9560,6198,3362,9275,285
2005,Urban,Telangana,Crime Against Men,Robbery,Female,18-30,948,605,343,941,7
2005,Rural,Bihar,Crime Against Men,Extortion,Male,31-45,4296,3447,849,4135,161
2010,Urban,Goa,Crime Against Women,Rape,Female,18-30,7768,729,7039,2998,4770
2010,Urban,Meghalaya,Crime Against Children,Trafficking,Male,60+,4641,877,3764,2806,1835
2006,Rural,Meghalaya,Property Crime,Vandalism,Female,13-17,574,99,475,516,58
2004,Rural,Meghalaya,Crime Against Women,Domestic Violence,Female,18-30,7578,2036,5542,7248,330
2004,Rural,Meghalaya,Property Crime,Vandalism,Male,0-12,1835,1520,315,1619,216
2008,Urban,Sikkim,Crime Against Women,Domestic Violence,Female,18-30,3345,2013,1332,2091,1254
2008,Rural,Madhya Pradesh,Crime Against Women,Molestation,Female,46-60,1066,785,281,1027,39
2008,Rural,Arunachal Pradesh,Other Crimes,Corruption,Male,18-30,4820,3666,1154,4443,377
2007,Urban,Maharashtra,Property Crime,Theft,Female,46-60,7029,3550,3479,3820,3209
2005,Rural,Andhra Pradesh,Property Crime,Theft,Female,13-17,779,443,336,657,122
2003,Rural,Uttarakhand,Crime Against Women,Molestation,Male,18-30,6012,2606,3406,4926,1086
2010,Urban,Kerala,Crime Against Children,Child Labor,Female,18-30,7129,153,6976,1558,5571
2001,Urban,Andhra Pradesh,Crime Against Children,Trafficking,Male,18-30,4788,3557,1231,4656,132
2009,Urban,Gujarat,Crime Against Men,Murder,Male,31-45,4299,1455,2844,2059,2240
2004,Urban,Karnataka,Property Crime,Burglary,Male,13-17,5306,1540,3766,3911,1395
2010,Urban,Rajasthan,Property Crime,Theft,Male,13-17,2973,1661,1312,2415,558
2002,Urban,Madhya Pradesh,Crime Against Men,Robbery,Male,13-17,8441,3679,4762,5801,2640
2003,Urban,Delhi,Other Crimes,Corruption,Male,46-60,3443,2778,665,2867,576
2005,Rural,Kerala,Crime Against Women,Molestation,Male,0-12,2332,369,1963,622,1710
2002,Urban,Tamil Nadu,Other Crimes,Fraud,Female,0-12,5166,3074,2092,3550,1616
2004,Urban,Sikkim,Property Crime,Theft,Male,60+,8399,3650,4749,5738,2661
2008,Rural,Punjab,Crime Against Men,Robbery,Male,18-30,8884,498,8386,731,8153
2005,Urban,Jammu & Kashmir,Other Crimes,Fraud,Male,13-17,2275,1182,1093,1250,1025
2002,Rural,Haryana,Property Crime,Vandalism,Female,46-60,813,781,32,787,26
2005,Rural,Tripura,Crime Against Women,Dowry Deaths,Male,60+,8144,5667,2477,6718,1426
2006,Rural,Tamil Nadu,Crime Against Men,Murder,Female,13-17,8312,1583,6729,1983,6329
2001,Urban,Meghalaya,Other Crimes,Drug Offense,Female,13-17,9092,2995,6097,4093,4999
2010,Urban,Delhi,Other Crimes,Cyber Crime,Female,13-17,342,69,273,193,149
2010,Rural,Gujarat,Crime Against Children,Trafficking,Female,60+,6438,3509,2929,4312,2126
2008,Urban,Manipur,Crime Against Women,Domestic Violence,Female,31-45,5317,435,4882,3183,2134
2003,Urban,Karnataka,Crime Against Women,Rape,Female,46-60,3031,2926,105,2996,35
2007,Rural,Odisha,Crime Against Women,Dowry Deaths,Male,0-12,3265,348,2917,2280,985
2009,Rural,Maharashtra,Crime Against Women,Dowry Deaths,Female,18-30,938,152,786,737,201
2010,Urban,West Bengal,Other Crimes,Drug Offense,Male,18-30,9473,8175,1298,8619,854
2002,Urban,West Bengal,Property Crime,Vandalism,Female,60+,8970,4625,4345,6534,2436
2007,Rural,Maharashtra,Other Crimes,Drug Offense,Female,18-30,7783,1689,6094,4544,3239
2002,Urban,Andhra Pradesh,Other Crimes,Corruption,Male,18-30,8700,5543,3157,6558,2142
2003,Rural,Delhi,Crime Against Children,Child Abuse,Female,13-17,7505,1015,6490,6255,1250
2006,Rural,Himachal Pradesh,Crime Against Children,Child Labor,Female,46-60,658,582,76,582,76
2005,Urban,Uttarakhand,Crime Against Children,Child Abuse,Male,13-17,1836,1485,351,1593,243
2002,Urban,Chhattisgarh,Crime Against Men,Extortion,Male,0-12,917,775,142,844,73
2007,Rural,Arunachal Pradesh,Crime Against Children,Trafficking,Female,13-17,3739,1796,1943,2585,1154
2010,Urban,Himachal Pradesh,Other Crimes,Cyber Crime,Male,31-45,7161,5781,1380,6100,1061
2009,Urban,Uttarakhand,Property Crime,Arson,Female,0-12,1910,549,1361,1041,869
2004,Urban,Meghalaya,Crime Against Children,Child Abuse,Female,46-60,9024,4524,4500,6667,2357
2008,Rural,Mizoram,Other Crimes,Cyber Crime,Female,13-17,6765,6677,88,6755,10
2003,Rural,Gujarat,Crime Against Children,Child Labor,Male,31-45,4161,3311,850,3650,511
2001,Urban,Assam,Crime Against Men,Assault,Male,31-45,7383,4050,3333,6432,951
2009,Rural,Goa,Crime Against Men,Robbery,Female,46-60,106,15,91,77,29
2002,Urban,Nagaland,Crime Against Men,Murder,Female,18-30,331,104,227,135,196
2003,Urban,Jammu & Kashmir,Other Crimes,Corruption,Male,60+,6776,1647,5129,2190,4586
2004,Urban,Punjab,Crime Against Children,Kidnapping,Female,46-60,8199,7422,777,7891,308
2002,Rural,Odisha,Property Crime,Burglary,Male,60+,3219,2184,1035,2831,388
2005,Urban,Maharashtra,Crime Against Women,Domestic Violence,Male,0-12,6662,2547,4115,6583,79
2002,Urban,Chhattisgarh,Property Crime,Theft,Female,0-12,1604,700,904,1306,298
2005,Rural,Tamil Nadu,Property Crime,Vandalism,Female,60+,3056,1256,1800,2364,692
2001,Rural,Rajasthan,Crime Against Men,Assault,Female,60+,7014,2811,4203,6844,170
2008,Urban,Andhra Pradesh,Crime Against Women,Molestation,Male,60+,8133,4232,3901,6666,1467
2006,Urban,Delhi,Crime Against Children,Child Abuse,Male,13-17,7242,3400,3842,6164,1078
2004,Rural,West Bengal,Crime Against Men,Murder,Male,13-17,224,117,107,137,87
2009,Rural,Jammu & Kashmir,Crime Against Children,Trafficking,Male,46-60,1356,927,429,1002,354
2001,Urban,Andhra Pradesh,Crime Against Children,Child Labor,Male,31-45,4212,319,3893,2504,1708
2007,Urban,Odisha,Other Crimes,Cyber Crime,Female,46-60,6076,4295,1781,5918,158
2005,Urban,Nagaland,Crime Against Men,Extortion,Male,31-45,8995,8039,956,8730,265
2008,Urban,Mizoram,Other Crimes,Corruption,Male,60+,4916,130,4786,3602,1314
2003,Rural,Gujarat,Other Crimes,Corruption,Male,0-12,1624,1141,483,1300,324
2006,Urban,Punjab,Property Crime,Burglary,Male,13-17,3692,367,3325,796,2896
2003,Urban,Uttar Pradesh,Crime Against Children,Trafficking,Female,0-12,259,135,124,141,118
2002,Rural,Himachal Pradesh,Crime Against Men,Extortion,Male,46-60,9091,497,8594,4615,4476
2005,Urban,West Bengal,Other Crimes,Fraud,Female,0-12,8293,2535,5758,2544,5749
2001,Rural,Arunachal Pradesh,Crime Against Children,Kidnapping,Female,0-12,7859,2362,5497,7828,31
2001,Urban,Goa,Crime Against Women,Molestation,Female,31-45,5647,189,5458,2996,2651
2002,Rural,Himachal Pradesh,Crime Against Children,Kidnapping,Male,31-45,947,239,708,615,332
2007,Urban,Rajasthan,Property Crime,Burglary,Female,18-30,6706,1731,4975,3794,2912
2003,Rural,Assam,Crime Against Children,Kidnapping,Male,60+,7913,7086,827,7520,393
2007,Rural,Tripura,Crime Against Men,Extortion,Male,31-45,9591,5100,4491,7225,2366
2003,Urban,Karnataka,Crime Against Men,Murder,Male,18-30,411,384,27,407,4
2009,Rural,Meghalaya,Property Crime,Theft,Female,60+,8025,3133,4892,6847,1178
2006,Urban,Maharashtra,Property Crime,Arson,Female,46-60,2973,1253,1720,2696,277
2007,Rural,Jharkhand,Crime Against Women,Rape,Female,0-12,5981,707,5274,2076,3905
2009,Rural,Nagaland,Other Crimes,Corruption,Female,31-45,4852,4556,296,4663,189
2007,Rural,Nagaland,Other Crimes,Fraud,Female,31-45,6776,3595,3181,4430,2346
2005,Urban,Punjab,Crime Against Women,Rape,Female,0-12,8381,2593,5788,3840,4541
2007,Rural,Haryana,Property Crime,Vandalism,Male,13-17,1944,747,1197,1918,26
2006,Rural,Assam,Crime Against Men,Assault,Male,46-60,8872,5438,3434,5679,3193
2009,Rural,Madhya Pradesh,Crime Against Women,Dowry Deaths,Male,46-60,9550,1049,8501,7836,1714
2001,Urban,Punjab,Crime Against Women,Molestation,Female,46-60,2987,1326,1661,1454,1533
2010,Rural,West Bengal,Crime Against Men,Murder,Female,46-60,3935,1567,2368,2273,1662
2002,Rural,Assam,Crime Against Women,Dowry Deaths,Female,18-30,5192,3995,1197,4236,956
2009,Urban,Himachal Pradesh,Crime Against Men,Extortion,Female,31-45,5361,3529,1832,4245,1116
2007,Urban,Goa,Crime Against Women,Rape,Female,18-30,6249,5573,676,5668,581
2010,Rural,Assam,Crime Against Children,Kidnapping,Male,0-12,7224,6273,951,6331,893
2007,Urban,Uttarakhand,Property Crime,Arson,Female,13-17,9327,4807,4520,6507,2820
2010,Urban,Manipur,Crime Against Men,Extortion,Male,31-45,5365,3819,1546,3971,1394
2009,Urban,Delhi,Crime Against Children,Child Labor,Male,46-60,8249,1445,6804,1698,6551
2001,Urban,Karnataka,Crime Against Men,Assault,Male,60+,2676,1727,949,2565,111
2004,Urban,Chhattisgarh,Crime Against Women,Dowry Deaths,Male,18-30,8791,408,8383,1594,7197
2007,Rural,Bihar,Crime Against Women,Dowry Deaths,Male,18-30,8689,7592,1097,8502,187
2003,Urban,Gujarat,Property Crime,Vandalism,Female,60+,4902,4614,288,4754,148
2006,Rural,Bihar,Crime Against Women,Molestation,Male,60+,849,58,791,822,27
2005,Urban,Haryana,Crime Against Women,Dowry Deaths,Male,0-12,1679,65,1614,1533,146
2002,Rural,Karnataka,Crime Against Children,Trafficking,Female,60+,2338,921,1417,2277,61
2006,Rural,Mizoram,Crime Against Men,Extortion,Female,46-60,2845,707,2138,2518,327
2009,Rural,Kerala,Property Crime,Vandalism,Female,60+,9558,731,8827,9464,94
2002,Rural,Delhi,Crime Against Children,Trafficking,Male,13-17,2138,165,1973,696,1442
2003,Urban,Delhi,Crime Against Children,Child Labor,Male,31-45,8863,3820,5043,6396,2467
2002,Urban,Arunachal Pradesh,Other Crimes,Fraud,Female,31-45,5375,327,5048,5033,342
2004,Urban,Karnataka,Crime Against Women,Molestation,Male,0-12,2830,2762,68,2793,37
2009,Rural,Mizoram,Property Crime,Vandalism,Male,46-60,1334,420,914,787,547
2009,Urban,Uttar Pradesh,Property Crime,Theft,Female,31-45,2993,1337,1656,2603,390
2008,Urban,Maharashtra,Crime Against Children,Child Labor,Male,18-30,4285,1498,2787,3273,1012
2010,Urban,Andhra Pradesh,Other Crimes,Fraud,Male,0-12,2197,114,2083,1928,269
2010,Rural,Mizoram,Property Crime,Theft,Female,31-45,1512,657,855,1037,475
2008,Urban,Mizoram,Crime Against Children,Child Labor,Female,18-30,2398,513,1885,822,1576
2010,Rural,Meghalaya,Crime Against Women,Domestic Violence,Male,13-17,6948,4609,2339,4879,2069
2003,Rural,Assam,Other Crimes,Cyber Crime,Male,13-17,4628,782,3846,3136,1492
2001,Urban,Andhra Pradesh,Crime Against Men,Robbery,Female,18-30,2221,1283,938,1622,599
2006,Urban,Gujarat,Other Crimes,Drug Offense,Female,18-30,9789,9579,210,9729,60
2006,Rural,Sikkim,Crime Against Children,Trafficking,Female,13-17,1709,1370,339,1555,154
2003,Urban,Meghalaya,Crime Against Men,Robbery,Female,13-17,3475,3445,30,3456,19
2010,Urban,Rajasthan,Other Crimes,Corruption,Female,60+,9892,3973,5919,4076,5816
2004,Urban,Kerala,Other Crimes,Fraud,Female,18-30,5042,2275,2767,3078,1964
2005,Urban,Arunachal Pradesh,Other Crimes,Corruption,Male,60+,7221,5202,2019,6850,371
2001,Rural,Rajasthan,Crime Against Men,Robbery,Male,13-17,816,597,219,657,159
2006,Rural,Arunachal Pradesh,Crime Against Children,Child Abuse,Female,18-30,6811,1120,5691,5785,1026
2002,Rural,Manipur,Crime Against Women,Domestic Violence,Female,0-12,4256,1235,3021,2768,1488
2006,Rural,Arunachal Pradesh,Crime Against Women,Domestic Violence,Female,13-17,6835,4397,2438,6494,341
2001,Urban,Manipur,Other Crimes,Cyber Crime,Female,60+,902,409,493,626,276
2006,Urban,Madhya Pradesh,Crime Against Children,Child Abuse,Male,13-17,6781,2558,4223,3727,3054
2002,Urban,Uttarakhand,Crime Against Men,Murder,Female,13-17,1742,1165,577,1204,538
2003,Rural,Punjab,Crime Against Children,Child Abuse,Female,60+,2562,2430,132,2484,78
2009,Urban,West Bengal,Crime Against Women,Molestation,Male,0-12,8312,1025,7287,4387,3925
2002,Urban,Himachal Pradesh,Crime Against Men,Robbery,Female,46-60,6471,855,5616,5513,958
2007,Urban,Maharashtra,Other Crimes,Fraud,Male,60+,192,135,57,177,15
2005,Rural,Jharkhand,Property Crime,Vandalism,Female,0-12,9081,2425,6656,5487,3594
2009,Urban,Nagaland,Crime Against Children,Kidnapping,Female,18-30,4822,417,4405,1723,3099
2002,Rural,Meghalaya,Property Crime,Arson,Male,13-17,9247,3255,5992,3316,5931
2008,Rural,Tripura,Property Crime,Burglary,Male,13-17,6777,5078,1699,6753,24
2002,Rural,Assam,Crime Against Men,Extortion,Female,46-60,3657,2665,992,3402,255
2009,Urban,Assam,Crime Against Men,Extortion,Male,13-17,7285,1784,5501,6060,1225
2006,Urban,Bihar,Crime Against Children,Child Labor,Male,18-30,6695,455,6240,3623,3072
2003,Rural,Mizoram,Crime Against Men,Extortion,Female,60+,3928,3357,571,3515,413
2003,Rural,Madhya Pradesh,Crime Against Women,Domestic Violence,Female,60+,5599,508,5091,2868,2731
2010,Urban,Tamil Nadu,Crime Against Men,Robbery,Male,18-30,9957,4906,5051,4952,5005
2008,Urban,Madhya Pradesh,Other Crimes,Drug Offense,Female,13-17,3588,932,2656,3081,507
2010,Urban,Jharkhand,Other Crimes,Corruption,Female,0-12,9211,6048,3163,7269,1942
2001,Rural,Himachal Pradesh,Property Crime,Burglary,Male,31-45,5622,4133,1489,4424,1198
2004,Rural,Mizoram,Other Crimes,Cyber Crime,Male,18-30,5147,1629,3518,2573,2574
2007,Urban,Haryana,Property Crime,Vandalism,Female,0-12,9886,1607,8279,9084,802
2004,Urban,Gujarat,Crime Against Men,Assault,Male,46-60,4806,1825,2981,2389,2417
2006,Rural,Tripura,Crime Against Children,Trafficking,Male,13-17,9072,3137,5935,3471,5601
2002,Rural,Nagaland,Crime Against Women,Rape,Male,18-30,6867,3295,3572,6311,556
2006,Urban,Meghalaya,Crime Against Children,Trafficking,Female,31-45,9514,8345,1169,8595,919
2001,Urban,Bihar,Other Crimes,Drug Offense,Male,0-12,5555,2623,2932,3809,1746
2010,Rural,Delhi,Crime Against Men,Assault,Male,46-60,870,862,8,864,6
2002,Urban,Arunachal Pradesh,Crime Against Children,Child Abuse,Female,18-30,9196,2827,6369,8849,347
2002,Urban,Rajasthan,Other Crimes,Drug Offense,Male,18-30,8900,108,8792,2752,6148
2009,Rural,Bihar,Crime Against Men,Murder,Female,0-12,4310,1066,3244,3904,406
2001,Urban,Jharkhand,Crime Against Women,Rape,Female,13-17,5277,3791,1486,4230,1047
2007,Urban,Sikkim,Crime Against Men,Murder,Female,31-45,8982,8651,331,8828,154
2006,Urban,Telangana,Crime Against Women,Molestation,Male,46-60,9473,4906,4567,8467,1006
2006,Urban,Uttarakhand,Crime Against Men,Robbery,Female,31-45,5091,4344,747,4776,315
2009,Urban,Bihar,Crime Against Children,Trafficking,Female,13-17,7637,6178,1459,6889,748
2006,Rural,Haryana,Property Crime,Vandalism,Female,13-17,7740,6248,1492,7373,367
2003,Urban,Tamil Nadu,Other Crimes,Fraud,Male,0-12,1629,122,1507,471,1158
2006,Rural,Chhattisgarh,Property Crime,Burglary,Male,60+,6630,5202,1428,5862,768
2001,Urban,Meghalaya,Other Crimes,Drug Offense,Male,31-45,1057,784,273,794,263
2003,Urban,Karnataka,Other Crimes,Drug Offense,Male,31-45,9408,1626,7782,6126,3282
2008,Rural,Goa,Property Crime,Burglary,Female,46-60,2461,386,2075,1681,780
2001,Urban,Maharashtra,Other Crimes,Corruption,Male,31-45,8597,2443,6154,6798,1799
2003,Urban,West Bengal,Crime Against Men,Murder,Male,18-30,2527,1001,1526,1571,956
2005,Rural,Telangana,Other Crimes,Fraud,Female,13-17,6024,647,5377,650,5374
2003,Rural,Chhattisgarh,Crime Against Men,Robbery,Female,13-17,6886,2204,4682,5901,985
2006,Rural,Meghalaya,Crime Against Children,Kidnapping,Male,13-17,5446,4384,1062,4602,844
2004,Rural,Haryana,Crime Against Children,Kidnapping,Male,46-60,3435,2145,1290,2646,789
2010,Urban,Manipur,Crime Against Men,Murder,Male,18-30,6359,3313,3046,4001,2358
2003,Rural,Tamil Nadu,Property Crime,Burglary,Male,46-60,1369,1365,4,1367,2
2007,Urban,Jammu & Kashmir,Crime Against Women,Molestation,Female,46-60,2750,659,2091,1696,1054
2010,Rural,Uttarakhand,Crime Against Women,Molestation,Male,13-17,1827,1634,193,1812,15
2008,Urban,Sikkim,Crime Against Women,Rape,Female,31-45,8387,2844,5543,7241,1146
2002,Rural,Uttar Pradesh,Property Crime,Arson,Male,31-45,5512,3764,1748,5007,505
2003,Rural,Andhra Pradesh,Crime Against Men,Robbery,Male,60+,2953,2133,820,2136,817
2010,Rural,Punjab,Other Crimes,Drug Offense,Female,18-30,501,30,471,440,61
2010,Rural,Punjab,Crime Against Children,Child Abuse,Male,46-60,8989,710,8279,7468,1521
2007,Rural,Meghalaya,Other Crimes,Fraud,Female,60+,990,103,887,680,310
2007,Rural,Arunachal Pradesh,Property Crime,Arson,Male,31-45,2049,123,1926,836,1213
2003,Rural,Nagaland,Other Crimes,Fraud,Female,60+,9095,1747,7348,1983,7112
2008,Urban,Jharkhand,Crime Against Men,Assault,Female,31-45,7766,4554,3212,4557,3209
2006,Urban,Himachal Pradesh,Crime Against Women,Molestation,Female,18-30,1004,414,590,919,85
2005,Urban,Karnataka,Crime Against Children,Kidnapping,Female,60+,1694,286,1408,886,808
2009,Rural,Tripura,Crime Against Men,Robbery,Male,46-60,452,170,282,227,225
2007,Urban,Haryana,Crime Against Children,Child Abuse,Male,46-60,4708,1876,2832,2549,2159
2009,Rural,Bihar,Other Crimes,Drug Offense,Male,31-45,6057,3860,2197,5977,80
2003,Rural,Uttarakhand,Crime Against Men,Robbery,Male,31-45,9237,8221,1016,9208,29
2003,Rural,Kerala,Other Crimes,Corruption,Male,60+,4820,1063,3757,2016,2804
2010,Rural,Rajasthan,Other Crimes,Drug Offense,Female,13-17,5328,3625,1703,4617,711
2006,Rural,Karnataka,Crime Against Women,Molestation,Female,46-60,5548,1583,3965,2623,2925
2003,Rural,Meghalaya,Other Crimes,Drug Offense,Female,13-17,1412,998,414,1020,392
2004,Rural,Meghalaya,Crime Against Women,Dowry Deaths,Female,13-17,7082,122,6960,4113,2969
2006,Urban,Manipur,Property Crime,Arson,Male,31-45,3253,1462,1791,1502,1751
2001,Urban,Manipur,Property Crime,Vandalism,Male,18-30,9960,5754,4206,8541,1419
2007,Rural,Uttarakhand,Crime Against Children,Kidnapping,Female,31-45,3109,1331,1778,2307,802
2007,Rural,Meghalaya,Crime Against Children,Child Abuse,Female,13-17,7034,397,6637,3525,3509
2007,Urban,Uttarakhand,Other Crimes,Fraud,Male,0-12,8297,5358,2939,5492,2805
2003,Urban,Manipur,Crime Against Men,Robbery,Female,31-45,8030,5317,2713,6461,1569
2010,Rural,Gujarat,Crime Against Children,Child Labor,Female,46-60,2862,574,2288,2429,433
2005,Urban,Assam,Crime Against Children,Child Abuse,Male,60+,3731,1397,2334,2662,1069
2010,Urban,Madhya Pradesh,Property Crime,Vandalism,Female,0-12,2002,398,1604,1657,345
2009,Urban,Himachal Pradesh,Crime Against Women,Molestation,Female,31-45,9041,1237,7804,5848,3193
2003,Rural,Jammu & Kashmir,Crime Against Women,Molestation,Male,46-60,1278,176,1102,1118,160
2006,Rural,Haryana,Other Crimes,Corruption,Male,18-30,3517,2754,763,3502,15
2008,Urban,Goa,Property Crime,Burglary,Female,60+,9951,9303,648,9862,89
2005,Rural,Punjab,Other Crimes,Fraud,Female,31-45,4891,2974,1917,4232,659
2010,Rural,Manipur,Crime Against Men,Assault,Female,46-60,5102,2813,2289,4092,1010
2008,Urban,Nagaland,Property Crime,Arson,Female,13-17,3719,3486,233,3674,45
2009,Rural,Punjab,Property Crime,Vandalism,Female,13-17,6083,2458,3625,4108,1975
2005,Rural,Goa,Crime Against Children,Trafficking,Male,13-17,8746,1898,6848,4275,4471
2006,Rural,Arunachal Pradesh,Crime Against Men,Murder,Female,60+,2719,1,2718,479,2240
2007,Urban,Tamil Nadu,Crime Against Women,Molestation,Male,18-30,1683,475,1208,1229,454
2001,Urban,Goa,Crime Against Women,Dowry Deaths,Female,13-17,7950,4778,3172,7814,136
2001,Urban,Arunachal Pradesh,Crime Against Women,Molestation,Male,60+,7640,5076,2564,7461,179
2007,Rural,Bihar,Crime Against Women,Domestic Violence,Male,13-17,3573,1409,2164,1549,2024
2001,Urban,Bihar,Crime Against Men,Assault,Male,60+,7305,3983,3322,5094,2211
2005,Urban,Himachal Pradesh,Crime Against Children,Child Abuse,Male,60+,9989,406,9583,9820,169
2007,Rural,Andhra Pradesh,Crime Against Children,Child Abuse,Male,60+,1571,1360,211,1543,28
2007,Rural,West Bengal,Crime Against Men,Assault,Male,31-45,9444,2245,7199,6771,2673
2003,Rural,Assam,Crime Against Women,Rape,Male,13-17,7714,3901,3813,6612,1102
2003,Rural,Nagaland,Crime Against Women,Domestic Violence,Female,18-30,3092,873,2219,1766,1326
2003,Urban,Uttar Pradesh,Crime Against Children,Trafficking,Male,60+,7387,5116,2271,7154,233
2003,Urban,Bihar,Crime Against Men,Murder,Female,0-12,5747,4004,1743,4079,1668
2004,Urban,Chhattisgarh,Other Crimes,Corruption,Male,60+,9339,5810,3529,7892,1447
2001,Rural,Manipur,Property Crime,Arson,Male,60+,3702,2481,1221,2719,983
2007,Urban,Rajasthan,Crime Against Children,Kidnapping,Male,13-17,8770,7254,1516,7454,1316
2004,Urban,Odisha,Property Crime,Theft,Male,13-17,2870,981,1889,1038,1832
2005,Urban,Goa,Crime Against Women,Rape,Male,60+,4242,1676,2566,2937,1305
2008,Urban,Nagaland,Property Crime,Burglary,Female,46-60,751,510,241,744,7
2006,Rural,Sikkim,Crime Against Children,Child Abuse,Male,31-45,8291,3985,4306,5868,2423
2003,Urban,Haryana,Crime Against Children,Kidnapping,Male,13-17,7712,2354,5358,2856,4856
2004,Rural,Maharashtra,Property Crime,Burglary,Female,46-60,2266,47,2219,2188,78
2009,Urban,Nagaland,Other Crimes,Corruption,Male,31-45,182,25,157,164,18
2007,Rural,Haryana,Crime Against Women,Rape,Female,0-12,9605,6091,3514,8677,928
2005,Urban,Kerala,Crime Against Men,Extortion,Male,13-17,2362,447,1915,913,1449
2003,Rural,Goa,Crime Against Men,Murder,Female,60+,1156,1142,14,1153,3
2010,Urban,Jharkhand,Other Crimes,Drug Offense,Male,13-17,8080,4788,3292,6354,1726
2009,Rural,Himachal Pradesh,Crime Against Children,Child Abuse,Male,46-60,3209,1068,2141,1584,1625
2005,Rural,Chhattisgarh,Crime Against Children,Child Abuse,Male,60+,2995,1157,1838,1674,1321
2004,Urban,Tripura,Crime Against Women,Domestic Violence,Male,0-12,9617,317,9300,2795,6822
2006,Rural,Uttar Pradesh,Property Crime,Vandalism,Female,60+,1266,1053,213,1217,49
2002,Urban,Mizoram,Crime Against Women,Molestation,Female,31-45,8519,5244,3275,8047,472
2003,Urban,Arunachal Pradesh,Crime Against Children,Child Labor,Female,13-17,571,192,379,544,27
2010,Rural,Assam,Other Crimes,Cyber Crime,Female,60+,1236,906,330,937,299
2009,Urban,Gujarat,Property Crime,Arson,Male,46-60,6846,2726,4120,6685,161
2007,Rural,Gujarat,Other Crimes,Fraud,Female,31-45,1318,1115,203,1271,47
2001,Urban,Chhattisgarh,Property Crime,Burglary,Male,0-12,2690,433,2257,1432,1258
2005,Rural,West Bengal,Other Crimes,Cyber Crime,Female,18-30,287,261,26,273,14
2007,Rural,Punjab,Property Crime,Arson,Male,60+,4468,3419,1049,3978,490
2006,Urban,Uttarakhand,Property Crime,Arson,Female,13-17,7889,3541,4348,3696,4193
2008,Rural,Kerala,Crime Against Children,Child Abuse,Female,18-30,9241,87,9154,5739,3502
2008,Rural,Bihar,Other Crimes,Cyber Crime,Male,31-45,2345,617,1728,1323,1022
2005,Rural,Haryana,Other Crimes,Corruption,Female,0-12,8030,5179,2851,7112,918
2009,Urban,Gujarat,Crime Against Children,Trafficking,Male,13-17,8712,4940,3772,8278,434
2004,Rural,Chhattisgarh,Other Crimes,Corruption,Male,60+,5930,2237,3693,2730,3200
2004,Urban,Kerala,Crime Against Men,Assault,Female,31-45,874,663,211,739,135
2004,Urban,Meghalaya,Crime Against Children,Child Abuse,Male,46-60,2320,552,1768,827,1493
2005,Rural,Punjab,Crime Against Children,Trafficking,Male,60+,719,379,340,652,67
2006,Urban,Jammu & Kashmir,Property Crime,Vandalism,Female,0-12,805,264,541,614,191
2003,Rural,Madhya Pradesh,Property Crime,Burglary,Male,31-45,5699,5360,339,5524,175
2010,Urban,Nagaland,Crime Against Children,Trafficking,Female,13-17,6278,5922,356,6221,57
2006,Urban,Arunachal Pradesh,Property Crime,Arson,Male,31-45,3611,3076,535,3184,427
2001,Rural,Uttar Pradesh,Crime Against Men,Robbery,Female,60+,8194,7280,914,7728,466
2007,Urban,Delhi,Crime Against Children,Kidnapping,Male,46-60,2558,744,1814,2381,177
2007,Urban,Mizoram,Crime Against Men,Murder,Female,13-17,6436,5182,1254,5984,452
2008,Rural,Arunachal Pradesh,Other Crimes,Fraud,Male,31-45,5627,4061,1566,4564,1063
2002,Urban,Nagaland,Crime Against Women,Dowry Deaths,Female,18-30,5984,3762,2222,5766,218
2001,Urban,Arunachal Pradesh,Crime Against Men,Murder,Male,18-30,5023,1689,3334,4057,966
2010,Rural,Manipur,Crime Against Men,Murder,Male,13-17,9678,5085,4593,7388,2290
2007,Urban,Nagaland,Crime Against Children,Child Abuse,Male,31-45,8414,879,7535,4419,3995
2006,Urban,Meghalaya,Property Crime,Theft,Male,46-60,9908,5414,4494,9227,681
2009,Rural,Meghalaya,Other Crimes,Drug Offense,Female,0-12,7176,3352,3824,6128,1048
2001,Urban,Uttarakhand,Crime Against Children,Child Abuse,Female,13-17,3276,1655,1621,2914,362
2009,Urban,Karnataka,Property Crime,Arson,Male,60+,603,384,219,447,156
2005,Urban,Gujarat,Crime Against Women,Domestic Violence,Male,31-45,69,50,19,51,18
2004,Rural,Delhi,Property Crime,Vandalism,Female,18-30,741,580,161,634,107
2004,Rural,Nagaland,Property Crime,Theft,Male,13-17,6630,2387,4243,4517,2113
2007,Urban,Arunachal Pradesh,Crime Against Children,Child Labor,Female,31-45,344,244,100,317,27
2004,Urban,Maharashtra,Property Crime,Theft,Female,0-12,8960,2328,6632,2825,6135
2004,Urban,Tamil Nadu,Other Crimes,Drug Offense,Male,31-45,4961,116,4845,3678,1283
2008,Rural,Mizoram,Property Crime,Arson,Female,18-30,2901,147,2754,1477,1424
2002,Rural,Goa,Crime Against Women,Molestation,Male,13-17,9118,7357,1761,8289,829
2009,Urban,Telangana,Other Crimes,Cyber Crime,Male,46-60,2159,400,1759,516,1643
2009,Urban,Tripura,Crime Against Women,Molestation,Male,46-60,3514,3376,138,3399,115
2006,Rural,Maharashtra,Other Crimes,Fraud,Male,0-12,5110,3665,1445,3880,1230
2010,Rural,Uttarakhand,Crime Against Women,Dowry Deaths,Female,0-12,8481,7028,1453,7079,1402
2009,Urban,Maharashtra,Crime Against Men,Extortion,Female,31-45,2004,143,1861,1303,701
2005,Rural,Chhattisgarh,Crime Against Women,Rape,Female,18-30,7058,4131,2927,6695,363
2007,Urban,Delhi,Crime Against Men,Assault,Male,46-60,4539,1243,3296,4046,493
2003,Rural,Delhi,Crime Against Men,Extortion,Male,0-12,3139,826,2313,2433,706
2004,Rural,Uttar Pradesh,Other Crimes,Cyber Crime,Male,46-60,2137,1948,189,2101,36
2009,Urban,Nagaland,Crime Against Children,Kidnapping,Male,60+,5760,5524,236,5643,117
2008,Urban,Telangana,Crime Against Women,Dowry Deaths,Male,0-12,4444,1354,3090,3013,1431
2006,Urban,Himachal Pradesh,Property Crime,Arson,Male,46-60,8709,5440,3269,7464,1245
2007,Rural,Tamil Nadu,Other Crimes,Cyber Crime,Female,31-45,418,370,48,388,30
2004,Urban,Uttar Pradesh,Property Crime,Vandalism,Male,31-45,5045,2890,2155,3426,1619
2009,Rural,Goa,Other Crimes,Fraud,Male,31-45,6225,2735,3490,4895,1330
2010,Urban,Gujarat,Crime Against Women,Dowry Deaths,Male,46-60,8163,7471,692,7708,455
2006,Rural,Sikkim,Crime Against Men,Murder,Male,13-17,2845,892,1953,1824,1021
2005,Urban,Sikkim,Crime Against Men,Murder,Male,13-17,3950,3933,17,3950,0
2002,Urban,Karnataka,Crime Against Men,Murder,Male,31-45,4379,1155,3224,1823,2556
2008,Urban,Madhya Pradesh,Crime Against Men,Extortion,Female,46-60,2749,371,2378,927,1822
2008,Rural,West Bengal,Crime Against Men,Robbery,Female,0-12,6649,5964,685,5980,669
2010,Rural,Andhra Pradesh,Crime Against Children,Child Labor,Female,0-12,9818,3319,6499,6739,3079
2009,Urban,Nagaland,Crime Against Men,Robbery,Male,18-30,7391,6318,1073,7217,174
2007,Rural,Jharkhand,Property Crime,Arson,Female,13-17,2902,35,2867,966,1936
2006,Rural,Sikkim,Other Crimes,Cyber Crime,Male,18-30,3946,2806,1140,3602,344
2007,Urban,Delhi,Other Crimes,Cyber Crime,Female,0-12,1923,438,1485,1033,890
2004,Urban,Uttar Pradesh,Crime Against Women,Dowry Deaths,Female,46-60,8294,2667,5627,3029,5265
2010,Rural,Assam,Crime Against Women,Molestation,Male,13-17,6765,1297,5468,5057,1708
2006,Urban,West Bengal,Other Crimes,Fraud,Female,18-30,6088,4116,1972,5721,367
2004,Rural,Rajasthan,Crime Against Men,Murder,Female,18-30,9405,5275,4130,7638,1767
2007,Urban,Rajasthan,Other Crimes,Drug Offense,Male,46-60,2788,545,2243,999,1789
2010,Urban,Mizoram,Crime Against Children,Trafficking,Female,46-60,5557,4114,1443,4504,1053
2007,Urban,Tripura,Property Crime,Vandalism,Female,13-17,6192,274,5918,4525,1667
2010,Urban,West Bengal,Crime Against Men,Robbery,Male,18-30,9878,4702,5176,7304,2574
2002,Rural,West Bengal,Crime Against Women,Domestic Violence,Female,18-30,7411,7125,286,7286,125
2004,Urban,Goa,Property Crime,Vandalism,Female,13-17,9886,8566,1320,9683,203
2007,Urban,Arunachal Pradesh,Crime Against Women,Molestation,Male,0-12,4872,1052,3820,1466,3406
2007,Rural,Jammu & Kashmir,Crime Against Men,Extortion,Female,31-45,844,413,431,715,129
2008,Rural,Jharkhand,Other Crimes,Cyber Crime,Male,18-30,7284,2721,4563,5146,2138
2003,Urban,Arunachal Pradesh,Crime Against Children,Child Labor,Male,13-17,804,120,684,274,530
2003,Rural,Goa,Other Crimes,Drug Offense,Female,31-45,3764,1736,2028,2063,1701
2002,Urban,Haryana,Crime Against Children,Kidnapping,Female,18-30,6241,939,5302,5686,555
2001,Urban,Mizoram,Property Crime,Vandalism,Male,46-60,5238,1227,4011,1931,3307
2003,Rural,Bihar,Crime Against Men,Extortion,Male,46-60,9723,9626,97,9660,63
2008,Rural,Jammu & Kashmir,Other Crimes,Corruption,Male,0-12,4461,3896,565,4253,208
2008,Urban,West Bengal,Crime Against Women,Molestation,Female,60+,4717,614,4103,2572,2145
2007,Urban,Manipur,Property Crime,Arson,Female,60+,3940,1386,2554,1427,2513
2007,Urban,Jammu & Kashmir,Other Crimes,Corruption,Male,0-12,4145,2581,1564,3826,319
2005,Rural,Tamil Nadu,Crime Against Men,Murder,Female,0-12,5641,5092,549,5138,503
2001,Rural,Kerala,Other Crimes,Cyber Crime,Male,60+,2130,1739,391,1764,366
2009,Rural,Meghalaya,Other Crimes,Drug Offense,Female,18-30,1069,296,773,734,335
2010,Rural,Sikkim,Crime Against Men,Robbery,Male,18-30,6764,106,6658,5363,1401
2007,Urban,Rajasthan,Crime Against Children,Trafficking,Male,0-12,4311,1925,2386,3399,912
2002,Urban,West Bengal,Crime Against Children,Trafficking,Female,13-17,1143,580,563,645,498
2005,Urban,Chhattisgarh,Crime Against Children,Child Abuse,Male,18-30,3468,1922,1546,2598,870
2004,Urban,Meghalaya,Crime Against Men,Assault,Female,13-17,7601,1474,6127,6073,1528
2007,Rural,Meghalaya,Crime Against Men,Robbery,Male,46-60,7214,6075,1139,6391,823
2008,Urban,Arunachal Pradesh,Other Crimes,Cyber Crime,Male,31-45,2754,1081,1673,2314,440
2007,Rural,Delhi,Property Crime,Vandalism,Female,60+,6293,744,5549,4626,1667
2005,Rural,Uttar Pradesh,Crime Against Men,Assault,Female,13-17,3494,1346,2148,3111,383
2007,Urban,Telangana,Crime Against Children,Trafficking,Female,31-45,3338,2021,1317,2541,797
2010,Rural,Arunachal Pradesh,Other Crimes,Corruption,Female,18-30,64,22,42,38,26
2008,Rural,Odisha,Crime Against Men,Robbery,Female,0-12,6386,5872,514,6327,59
2009,Rural,Rajasthan,Property Crime,Arson,Female,60+,8548,2411,6137,7981,567
2006,Rural,Assam,Crime Against Women,Molestation,Male,31-45,5024,2162,2862,3008,2016
2010,Urban,Tamil Nadu,Crime Against Children,Trafficking,Male,60+,9819,3062,6757,4042,5777
2006,Urban,Arunachal Pradesh,Property Crime,Vandalism,Male,31-45,3191,2055,1136,2834,357
2002,Urban,Punjab,Crime Against Women,Dowry Deaths,Female,0-12,3494,3069,425,3328,166
2010,Urban,Madhya Pradesh,Other Crimes,Fraud,Male,13-17,2871,173,2698,1497,1374
2006,Rural,Madhya Pradesh,Property Crime,Arson,Female,60+,7729,170,7559,5691,2038
2009,Rural,Assam,Crime Against Women,Domestic Violence,Male,18-30,654,164,490,317,337
2004,Urban,Delhi,Crime Against Women,Rape,Female,60+,5950,96,5854,1251,4699
2006,Urban,Odisha,Crime Against Men,Robbery,Female,60+,8634,3825,4809,3996,4638
2006,Urban,Karnataka,Crime Against Men,Robbery,Male,18-30,2712,664,2048,893,1819
2008,Urban,Sikkim,Crime Against Women,Dowry Deaths,Female,31-45,6242,2614,3628,5976,266
2004,Rural,Delhi,Property Crime,Arson,Female,46-60,4581,3635,946,4039,542
2002,Rural,Sikkim,Crime Against Women,Rape,Male,60+,5056,3504,1552,3795,1261
2003,Rural,Goa,Crime Against Men,Assault,Female,18-30,5145,1288,3857,1439,3706
2010,Urban,Jammu & Kashmir,Crime Against Women,Domestic Violence,Male,0-12,9842,5245,4597,6507,3335
2010,Urban,Gujarat,Property Crime,Vandalism,Female,13-17,2430,2405,25,2414,16
2001,Urban,Uttar Pradesh,Crime Against Children,Child Labor,Female,18-30,9386,6402,2984,9048,338
2009,Rural,West Bengal,Crime Against Women,Domestic Violence,Female,18-30,4243,1131,3112,2294,1949
2010,Urban,Bihar,Property Crime,Theft,Male,46-60,8149,7842,307,7942,207
2004,Urban,Haryana,Other Crimes,Cyber Crime,Male,0-12,7805,4349,3456,7094,711
2009,Urban,Sikkim,Crime Against Women,Dowry Deaths,Male,46-60,1100,163,937,164,936
2004,Rural,Jharkhand,Other Crimes,Corruption,Male,18-30,2017,352,1665,1398,619
2003,Urban,Odisha,Crime Against Women,Domestic Violence,Male,46-60,5069,3555,1514,3846,1223
2004,Rural,Bihar,Other Crimes,Cyber Crime,Male,60+,888,298,590,303,585
2004,Urban,Chhattisgarh,Property Crime,Theft,Female,18-30,7793,162,7631,911,6882
2006,Urban,Jharkhand,Other Crimes,Fraud,Male,31-45,4490,2828,1662,2935,1555
2005,Urban,Odisha,Crime Against Women,Dowry Deaths,Male,31-45,7756,2362,5394,5165,2591
2009,Urban,Assam,Crime Against Men,Murder,Male,0-12,7635,258,7377,613,7022
2007,Urban,Delhi,Crime Against Men,Assault,Female,18-30,2284,1008,1276,1360,924
2003,Urban,Tamil Nadu,Crime Against Children,Child Labor,Male,31-45,6844,2291,4553,4252,2592
2006,Rural,Gujarat,Crime Against Children,Trafficking,Female,31-45,7393,2991,4402,4574,2819
2007,Urban,Meghalaya,Property Crime,Arson,Male,60+,6562,5434,1128,5826,736
2010,Urban,Delhi,Crime Against Children,Child Labor,Male,0-12,4741,4411,330,4441,300
2009,Rural,Gujarat,Property Crime,Vandalism,Male,13-17,4685,2824,1861,3465,1220
2009,Rural,Karnataka,Property Crime,Burglary,Female,31-45,8152,2262,5890,8059,93
2007,Urban,Bihar,Crime Against Children,Child Abuse,Female,31-45,619,465,154,506,113
2009,Urban,Goa,Other Crimes,Cyber Crime,Male,18-30,4497,2908,1589,3173,1324
2002,Rural,Bihar,Crime Against Children,Child Abuse,Female,0-12,6755,5091,1664,6240,515
2003,Urban,Rajasthan,Crime Against Men,Robbery,Female,13-17,1697,838,859,1080,617
2006,Rural,Goa,Other Crimes,Corruption,Male,31-45,4883,2713,2170,4839,44
2008,Urban,Meghalaya,Crime Against Children,Child Labor,Female,18-30,2765,1233,1532,2104,661
2008,Rural,Chhattisgarh,Crime Against Children,Kidnapping,Female,31-45,8896,5879,3017,5901,2995
2001,Rural,Delhi,Other Crimes,Drug Offense,Male,31-45,8745,7510,1235,8418,327
2008,Rural,Haryana,Crime Against Women,Molestation,Female,18-30,311,192,119,309,2
2004,Rural,Meghalaya,Crime Against Children,Trafficking,Male,46-60,6105,5482,623,5579,526
2009,Rural,Goa,Other Crimes,Fraud,Male,0-12,790,361,429,376,414
2009,Rural,Jharkhand,Crime Against Men,Assault,Male,60+,4681,2214,2467,3259,1422
2004,Rural,Tamil Nadu,Other Crimes,Fraud,Female,46-60,9034,3763,5271,7288,1746
2006,Urban,Bihar,Property Crime,Theft,Female,31-45,1931,1611,320,1673,258
2003,Rural,Karnataka,Crime Against Women,Domestic Violence,Male,18-30,6273,2838,3435,3016,3257
2002,Urban,West Bengal,Other Crimes,Drug Offense,Female,31-45,571,462,109,478,93
2009,Urban,Haryana,Property Crime,Vandalism,Female,46-60,6823,6154,669,6588,235
2005,Urban,Arunachal Pradesh,Property Crime,Arson,Female,60+,8973,27,8946,3759,5214
2002,Urban,Madhya Pradesh,Property Crime,Burglary,Female,31-45,5067,3985,1082,4055,1012
2002,Rural,West Bengal,Crime Against Children,Child Labor,Female,13-17,9953,2927,7026,9539,414
2008,Rural,Odisha,Crime Against Men,Assault,Female,0-12,5573,4727,846,5466,107
2005,Rural,Haryana,Crime Against Men,Assault,Female,13-17,2549,949,1600,1334,1215
2007,Urban,Maharashtra,Other Crimes,Fraud,Female,60+,8042,4086,3956,4697,3345
2002,Rural,Kerala,Crime Against Women,Domestic Violence,Male,46-60,8056,3507,4549,3815,4241
2006,Urban,Arunachal Pradesh,Other Crimes,Fraud,Female,0-12,1098,111,987,174,924
2008,Urban,Bihar,Other Crimes,Drug Offense,Female,31-45,7757,4577,3180,6973,784
2007,Urban,Punjab,Crime Against Children,Child Labor,Male,18-30,2066,1950,116,1964,102
2001,Rural,Karnataka,Crime Against Women,Molestation,Female,13-17,5410,5330,80,5385,25
2005,Urban,Jharkhand,Crime Against Children,Child Abuse,Male,13-17,3844,1406,2438,3252,592
2008,Urban,Meghalaya,Other Crimes,Fraud,Male,46-60,4973,3906,1067,4529,444
2009,Urban,Punjab,Crime Against Women,Domestic Violence,Male,46-60,3934,3836,98,3893,41
2008,Rural,Rajasthan,Crime Against Women,Domestic Violence,Female,13-17,5455,1528,3927,3494,1961
2001,Urban,Bihar,Crime Against Children,Kidnapping,Female,18-30,9456,5396,4060,7125,2331
2003,Urban,Assam,Crime Against Children,Child Labor,Female,0-12,5899,4171,1728,5302,597
2007,Urban,Karnataka,Crime Against Children,Kidnapping,Female,13-17,6830,3579,3251,4820,2010
2006,Rural,Meghalaya,Other Crimes,Corruption,Male,31-45,5125,669,4456,2648,2477
2005,Rural,Punjab,Other Crimes,Cyber Crime,Female,60+,3694,2075,1619,3126,568
2005,Rural,Meghalaya,Crime Against Children,Child Labor,Female,13-17,3323,907,2416,3032,291
2008,Rural,Arunachal Pradesh,Crime Against Men,Robbery,Male,60+,5644,2429,3215,3583,2061
2004,Urban,Tripura,Other Crimes,Cyber Crime,Male,18-30,1981,1350,631,1461,520
2006,Urban,Karnataka,Crime Against Men,Extortion,Female,18-30,5568,4105,1463,4351,1217
2001,Rural,Arunachal Pradesh,Crime Against Men,Extortion,Female,46-60,9470,4171,5299,4191,5279
2002,Rural,Manipur,Property Crime,Arson,Female,46-60,2804,774,2030,874,1930
2002,Rural,Karnataka,Crime Against Children,Kidnapping,Male,0-12,7926,4407,3519,5617,2309
2009,Urban,Uttar Pradesh,Crime Against Women,Rape,Male,18-30,9999,6514,3485,8337,1662
2003,Urban,Andhra Pradesh,Crime Against Women,Domestic Violence,Male,18-30,5922,2605,3317,3486,2436
2005,Urban,Goa,Crime Against Men,Murder,Male,18-30,193,78,115,184,9
2002,Urban,Arunachal Pradesh,Crime Against Men,Robbery,Male,46-60,372,83,289,169,203
2001,Rural,Madhya Pradesh,Property Crime,Theft,Male,18-30,3797,1672,2125,2529,1268
2003,Urban,Kerala,Crime Against Men,Murder,Female,46-60,2120,870,1250,1945,175
2007,Rural,Jammu & Kashmir,Other Crimes,Fraud,Female,13-17,5046,1016,4030,1542,3504
2009,Rural,Sikkim,Other Crimes,Drug Offense,Female,46-60,3964,572,3392,1997,1967
2010,Urban,Tamil Nadu,Crime Against Women,Molestation,Female,46-60,8188,4518,3670,4834,3354
2003,Urban,Telangana,Other Crimes,Corruption,Female,18-30,7967,7371,596,7731,236
2002,Rural,Kerala,Crime Against Women,Dowry Deaths,Female,60+,4416,2671,1745,2769,1647
2002,Urban,Uttar Pradesh,Crime Against Men,Assault,Male,13-17,4184,2556,1628,4035,149
2004,Rural,Uttarakhand,Crime Against Children,Child Labor,Female,13-17,292,140,152,289,3
2007,Rural,Rajasthan,Crime Against Women,Domestic Violence,Male,46-60,6778,1769,5009,2294,4484
2009,Rural,Tripura,Crime Against Children,Trafficking,Male,0-12,1412,465,947,1164,248
2010,Rural,Nagaland,Property Crime,Burglary,Female,13-17,7793,5090,2703,6455,1338
2004,Rural,Madhya Pradesh,Crime Against Women,Molestation,Female,13-17,5363,348,5015,627,4736
2010,Urban,Chhattisgarh,Crime Against Men,Assault,Female,0-12,138,46,92,48,90
2002,Rural,Nagaland,Other Crimes,Cyber Crime,Female,13-17,2718,1778,940,2235,483
2001,Urban,Arunachal Pradesh,Crime Against Men,Robbery,Male,0-12,4891,2511,2380,3537,1354
2001,Rural,Tamil Nadu,Property Crime,Burglary,Female,46-60,4816,4335,481,4520,296
2007,Rural,Bihar,Crime Against Children,Child Abuse,Male,46-60,2347,1686,661,1766,581
2004,Urban,Tamil Nadu,Crime Against Men,Extortion,Female,60+,1447,295,1152,794,653
2010,Rural,Delhi,Other Crimes,Corruption,Female,31-45,6210,675,5535,2360,3850
2007,Urban,Uttarakhand,Other Crimes,Fraud,Male,13-17,5019,1772,3247,1909,3110
2003,Urban,Himachal Pradesh,Crime Against Men,Extortion,Male,0-12,7801,1402,6399,7180,621
2003,Urban,Himachal Pradesh,Other Crimes,Drug Offense,Male,0-12,3892,2201,1691,2905,987
2008,Rural,Chhattisgarh,Crime Against Women,Rape,Male,31-45,2861,2193,668,2779,82
2004,Rural,Uttar Pradesh,Crime Against Children,Child Labor,Male,18-30,4568,1729,2839,4184,384
2003,Rural,Jammu & Kashmir,Property Crime,Arson,Male,60+,4180,1087,3093,3984,196
2010,Urban,Jammu & Kashmir,Crime Against Children,Kidnapping,Female,60+,6505,1829,4676,3453,3052
2008,Urban,West Bengal,Other Crimes,Drug Offense,Male,60+,2687,1818,869,2281,406
2009,Urban,Rajasthan,Property Crime,Arson,Female,60+,5934,979,4955,1529,4405
2003,Rural,Jammu & Kashmir,Crime Against Women,Domestic Violence,Female,0-12,3359,1181,2178,2686,673
2010,Urban,Haryana,Crime Against Women,Dowry Deaths,Male,60+,7905,6430,1475,7753,152
2009,Urban,Assam,Property Crime,Burglary,Female,31-45,5752,4497,1255,5736,16
2004,Rural,Madhya Pradesh,Property Crime,Theft,Male,0-12,892,769,123,887,5
2006,Rural,Himachal Pradesh,Crime Against Men,Assault,Male,18-30,990,684,306,741,249
2007,Rural,Madhya Pradesh,Crime Against Men,Robbery,Female,31-45,1449,969,480,1115,334
2004,Rural,Bihar,Crime Against Men,Assault,Female,31-45,9179,2792,6387,3457,5722
2008,Rural,Assam,Crime Against Women,Rape,Male,46-60,149,134,15,149,0
2005,Urban,Andhra Pradesh,Property Crime,Theft,Male,0-12,5506,3181,2325,3925,1581
2010,Urban,Uttar Pradesh,Crime Against Children,Child Labor,Male,46-60,5872,5375,497,5381,491
2004,Urban,Jharkhand,Crime Against Children,Child Labor,Female,60+,6756,127,6629,5031,1725
2004,Urban,Sikkim,Crime Against Men,Assault,Female,31-45,3130,461,2669,2226,904
2009,Rural,Bihar,Crime Against Men,Assault,Male,60+,1699,1580,119,1639,60
2006,Rural,Maharashtra,Crime Against Women,Domestic Violence,Male,0-12,7113,1989,5124,5430,1683
2008,Rural,Himachal Pradesh,Crime Against Women,Molestation,Male,18-30,1071,910,161,964,107
2002,Urban,Himachal Pradesh,Crime Against Children,Trafficking,Male,0-12,635,5,630,228,407
2004,Rural,Nagaland,Other Crimes,Corruption,Male,31-45,8407,652,7755,852,7555
2009,Rural,Gujarat,Other Crimes,Drug Offense,Female,13-17,7262,5709,1553,6067,1195
2006,Rural,Uttarakhand,Other Crimes,Corruption,Male,13-17,3260,45,3215,3080,180
2003,Rural,Bihar,Crime Against Children,Kidnapping,Female,31-45,6473,4258,2215,6368,105
2008,Rural,Telangana,Property Crime,Arson,Female,18-30,8060,3959,4101,6220,1840
2008,Rural,Delhi,Crime Against Women,Dowry Deaths,Male,60+,450,17,433,252,198
2005,Rural,Arunachal Pradesh,Crime Against Children,Child Abuse,Female,0-12,536,379,157,523,13
2008,Rural,Arunachal Pradesh,Other Crimes,Cyber Crime,Male,60+,3964,1466,2498,3644,320
2005,Urban,Nagaland,Crime Against Children,Kidnapping,Male,0-12,407,6,401,164,243
2010,Urban,Bihar,Other Crimes,Fraud,Male,31-45,8938,6115,2823,7077,1861
2001,Urban,Odisha,Crime Against Men,Robbery,Female,60+,6446,1459,4987,2156,4290
2004,Urban,West Bengal,Crime Against Women,Domestic Violence,Male,46-60,7517,124,7393,2669,4848
2004,Urban,Haryana,Crime Against Men,Assault,Male,18-30,8976,357,8619,2343,6633
2006,Urban,Madhya Pradesh,Crime Against Children,Child Abuse,Male,0-12,2250,295,1955,1162,1088
2003,Urban,Sikkim,Crime Against Women,Rape,Female,46-60,553,61,492,408,145
2001,Urban,Nagaland,Crime Against Women,Domestic Violence,Male,31-45,7529,1235,6294,1751,5778
2010,Rural,Bihar,Crime Against Women,Rape,Male,60+,7390,441,6949,6384,1006
2005,Urban,Rajasthan,Property Crime,Vandalism,Male,46-60,9893,9771,122,9869,24
2008,Rural,Uttar Pradesh,Property Crime,Burglary,Male,46-60,1279,448,831,1188,91
2001,Rural,Mizoram,Crime Against Women,Dowry Deaths,Female,60+,6021,1950,4071,3923,2098
2009,Rural,Arunachal Pradesh,Crime Against Children,Child Labor,Female,46-60,2680,724,1956,1425,1255
2004,Urban,Kerala,Property Crime,Vandalism,Male,46-60,4113,1023,3090,1540,2573
2006,Rural,Arunachal Pradesh,Crime Against Children,Child Labor,Female,60+,4546,589,3957,1370,3176
2005,Rural,Tamil Nadu,Crime Against Children,Trafficking,Female,60+,7995,6480,1515,6874,1121
2003,Rural,Nagaland,Other Crimes,Drug Offense,Male,46-60,9680,6181,3499,7502,2178
2008,Rural,Karnataka,Crime Against Children,Kidnapping,Female,60+,2215,836,1379,1463,752
2010,Rural,Manipur,Crime Against Children,Child Labor,Female,18-30,3324,276,3048,2561,763
2003,Rural,Sikkim,Property Crime,Arson,Male,46-60,8404,3663,4741,4653,3751
2005,Rural,Kerala,Property Crime,Vandalism,Male,60+,7945,5619,2326,6631,1314
2004,Rural,Kerala,Other Crimes,Cyber Crime,Male,18-30,5720,3415,2305,3746,1974
2002,Urban,Bihar,Crime Against Women,Molestation,Female,0-12,2785,1800,985,2634,151
2007,Rural,Bihar,Crime Against Women,Rape,Female,31-45,8175,3843,4332,5376,2799
2010,Rural,Punjab,Crime Against Men,Assault,Female,60+,1182,346,836,509,673
2007,Rural,Andhra Pradesh,Crime Against Women,Rape,Female,31-45,1959,65,1894,1489,470
2007,Urban,Punjab,Crime Against Men,Robbery,Female,31-45,3234,3161,73,3199,35
2003,Urban,Sikkim,Crime Against Children,Kidnapping,Male,0-12,2895,825,2070,1592,1303
2007,Urban,Maharashtra,Other Crimes,Fraud,Male,18-30,3957,1189,2768,3319,638
2005,Urban,Goa,Crime Against Men,Robbery,Female,46-60,1887,1672,215,1739,148
2004,Rural,Uttarakhand,Other Crimes,Drug Offense,Female,18-30,2708,639,2069,1460,1248
2008,Rural,Tamil Nadu,Crime Against Children,Child Labor,Female,60+,1960,92,1868,149,1811
2005,Urban,Telangana,Other Crimes,Cyber Crime,Female,31-45,8239,6575,1664,6827,1412
2004,Urban,Rajasthan,Crime Against Children,Child Abuse,Male,31-45,8695,533,8162,5793,2902
2009,Rural,Bihar,Crime Against Men,Assault,Female,18-30,7984,2801,5183,4661,3323
2008,Rural,Arunachal Pradesh,Crime Against Children,Kidnapping,Male,60+,3023,201,2822,1939,1084
2003,Urban,Arunachal Pradesh,Property Crime,Theft,Female,0-12,9878,9376,502,9549,329
2007,Urban,Arunachal Pradesh,Crime Against Men,Murder,Male,31-45,5755,4261,1494,4529,1226
2005,Urban,Meghalaya,Other Crimes,Cyber Crime,Female,60+,4942,190,4752,4647,295
2008,Rural,Haryana,Crime Against Men,Assault,Male,46-60,7593,563,7030,599,6994
2005,Rural,Chhattisgarh,Crime Against Children,Trafficking,Male,18-30,511,57,454,73,438
2002,Urban,Mizoram,Crime Against Men,Murder,Male,31-45,1550,975,575,1361,189
2010,Urban,Andhra Pradesh,Crime Against Men,Robbery,Male,60+,4976,818,4158,2848,2128
2010,Rural,Delhi,Crime Against Children,Child Labor,Female,46-60,7632,1232,6400,2848,4784
2009,Rural,Goa,Crime Against Women,Molestation,Female,13-17,4111,1541,2570,2841,1270
2002,Rural,Assam,Crime Against Women,Domestic Violence,Male,18-30,9318,8737,581,8884,434
2003,Urban,Jammu & Kashmir,Crime Against Children,Kidnapping,Male,60+,999,286,713,439,560
2005,Urban,Tamil Nadu,Crime Against Women,Rape,Female,46-60,3272,2996,276,3261,11
2008,Rural,Jharkhand,Crime Against Women,Dowry Deaths,Male,13-17,1721,1186,535,1688,33
2002,Rural,Delhi,Crime Against Men,Extortion,Female,60+,5931,4561,1370,5124,807
2004,Rural,Sikkim,Crime Against Women,Domestic Violence,Male,60+,3201,2117,1084,3055,146
2008,Rural,Goa,Crime Against Men,Murder,Male,60+,5671,163,5508,4662,1009
2006,Rural,Arunachal Pradesh,Property Crime,Theft,Female,18-30,8034,5207,2827,5786,2248
2005,Urban,Tripura,Other Crimes,Corruption,Male,13-17,1503,849,654,1289,214
2001,Rural,Uttarakhand,Other Crimes,Corruption,Male,13-17,2173,1950,223,2083,90
2005,Rural,Bihar,Crime Against Women,Dowry Deaths,Female,18-30,6559,2324,4235,4880,1679
2010,Urban,Assam,Property Crime,Burglary,Male,13-17,7906,7467,439,7490,416
2006,Urban,Rajasthan,Crime Against Children,Trafficking,Male,18-30,8915,227,8688,4558,4357
2010,Urban,West Bengal,Crime Against Men,Murder,Male,13-17,1545,25,1520,345,1200
2002,Rural,Andhra Pradesh,Crime Against Men,Extortion,Female,13-17,7199,2669,4530,5436,1763
2004,Rural,Maharashtra,Crime Against Children,Child Labor,Male,31-45,6499,4923,1576,6417,82
2003,Urban,Chhattisgarh,Crime Against Men,Assault,Female,46-60,7931,6581,1350,7345,586
2003,Urban,Meghalaya,Crime Against Men,Extortion,Female,31-45,1385,27,1358,250,1135
2010,Urban,Jammu & Kashmir,Crime Against Children,Child Labor,Male,13-17,989,209,780,476,513
2002,Rural,Maharashtra,Crime Against Children,Trafficking,Female,31-45,8929,7786,1143,7821,1108
2007,Urban,Kerala,Crime Against Women,Molestation,Male,0-12,2102,1697,405,1967,135
2008,Rural,Uttarakhand,Crime Against Men,Robbery,Female,31-45,7184,2766,4418,7137,47
2007,Rural,Delhi,Crime Against Children,Kidnapping,Female,18-30,3457,1608,1849,1612,1845
2008,Urban,Maharashtra,Crime Against Women,Domestic Violence,Male,46-60,3690,219,3471,3190,500
2005,Rural,Tamil Nadu,Crime Against Children,Child Abuse,Female,31-45,6956,3153,3803,3690,3266
2006,Urban,Assam,Crime Against Men,Robbery,Male,46-60,6833,1050,5783,4631,2202
2004,Rural,Maharashtra,Crime Against Children,Child Labor,Female,0-12,4158,214,3944,2445,1713
2001,Urban,Delhi,Crime Against Women,Molestation,Female,0-12,5429,2356,3073,4189,1240
2005,Urban,Madhya Pradesh,Crime Against Men,Robbery,Female,18-30,1348,337,1011,601,747
2006,Urban,Bihar,Other Crimes,Corruption,Female,13-17,4155,3136,1019,3212,943
2001,Rural,Rajasthan,Crime Against Men,Extortion,Female,0-12,1057,676,381,828,229
2009,Urban,Kerala,Crime Against Children,Kidnapping,Female,13-17,8326,5281,3045,5334,2992
2001,Rural,Madhya Pradesh,Property Crime,Arson,Female,18-30,7642,615,7027,2595,5047
2001,Rural,Jammu & Kashmir,Crime Against Men,Murder,Female,46-60,1232,894,338,934,298
2008,Urban,Odisha,Crime Against Children,Child Labor,Female,13-17,7013,2774,4239,2834,4179
2007,Rural,Madhya Pradesh,Property Crime,Vandalism,Female,0-12,1665,1096,569,1197,468
2008,Rural,Nagaland,Crime Against Men,Assault,Female,13-17,1158,351,807,834,324
2005,Urban,Jammu & Kashmir,Other Crimes,Fraud,Female,0-12,9043,5852,3191,7259,1784
2002,Rural,Manipur,Other Crimes,Corruption,Male,13-17,5904,3706,2198,4195,1709
2003,Urban,Assam,Crime Against Men,Robbery,Male,31-45,1363,1203,160,1262,101
2003,Urban,Andhra Pradesh,Other Crimes,Corruption,Female,0-12,628,191,437,484,144
2007,Rural,Goa,Crime Against Men,Extortion,Male,60+,1082,782,300,993,89
2003,Urban,Assam,Crime Against Men,Murder,Female,31-45,7375,2500,4875,4469,2906
2005,Rural,Rajasthan,Crime Against Children,Child Abuse,Male,0-12,8661,4677,3984,8255,406
2007,Rural,Gujarat,Crime Against Children,Kidnapping,Male,46-60,5037,4849,188,4989,48
2001,Urban,Punjab,Crime Against Men,Robbery,Male,60+,2246,2197,49,2215,31
2007,Urban,Delhi,Other Crimes,Drug Offense,Male,13-17,2571,51,2520,1775,796
2009,Urban,Rajasthan,Other Crimes,Drug Offense,Male,0-12,7802,1426,6376,6264,1538
2004,Urban,West Bengal,Crime Against Children,Kidnapping,Male,13-17,7816,5536,2280,7049,767
2007,Urban,West Bengal,Crime Against Men,Robbery,Male,31-45,3070,222,2848,681,2389
2008,Urban,Kerala,Crime Against Men,Assault,Male,18-30,8943,5248,3695,5289,3654
2008,Urban,Jammu & Kashmir,Property Crime,Arson,Female,31-45,407,20,387,79,328
2004,Rural,Uttar Pradesh,Crime Against Women,Rape,Male,46-60,6081,1398,4683,2557,3524
2005,Rural,Maharashtra,Crime Against Children,Child Labor,Male,46-60,3746,1212,2534,3180,566
2001,Urban,Jammu & Kashmir,Crime Against Women,Domestic Violence,Male,60+,6617,932,5685,6422,195
2009,Urban,Maharashtra,Other Crimes,Drug Offense,Male,0-12,9037,3079,5958,6822,2215
2008,Urban,Mizoram,Crime Against Men,Assault,Female,13-17,4966,4957,9,4964,2
2004,Rural,Maharashtra,Other Crimes,Cyber Crime,Female,31-45,2713,1140,1573,1653,1060
2009,Urban,Sikkim,Crime Against Women,Molestation,Female,0-12,6768,6019,749,6636,132
2005,Rural,Mizoram,Crime Against Children,Kidnapping,Female,0-12,8861,3794,5067,4733,4128
2007,Rural,Sikkim,Crime Against Children,Child Labor,Male,31-45,3427,409,3018,680,2747
2003,Urban,Telangana,Property Crime,Theft,Male,46-60,1417,851,566,1221,196
2007,Urban,Tamil Nadu,Crime Against Children,Trafficking,Male,0-12,5902,1077,4825,5523,379
2008,Rural,Madhya Pradesh,Crime Against Men,Assault,Male,31-45,3089,233,2856,2931,158
2010,Urban,Uttar Pradesh,Property Crime,Vandalism,Female,46-60,4190,882,3308,2752,1438
2009,Rural,Himachal Pradesh,Other Crimes,Corruption,Male,60+,2824,2605,219,2777,47
2005,Rural,Jharkhand,Crime Against Men,Murder,Female,46-60,3082,2198,884,2953,129
2010,Rural,Himachal Pradesh,Crime Against Men,Assault,Female,18-30,289,256,33,264,25
2010,Urban,Mizoram,Crime Against Children,Child Abuse,Male,18-30,5796,5315,481,5596,200
2007,Rural,Delhi,Property Crime,Vandalism,Female,60+,4510,4397,113,4457,53
2007,Urban,Haryana,Other Crimes,Cyber Crime,Female,13-17,1502,379,1123,665,837
2006,Rural,Goa,Crime Against Women,Rape,Male,13-17,9690,5807,3883,6038,3652
2005,Rural,Chhattisgarh,Crime Against Women,Rape,Female,18-30,2013,1415,598,1860,153
2003,Rural,Chhattisgarh,Crime Against Men,Robbery,Female,18-30,7440,6651,789,6827,613
2007,Urban,Bihar,Property Crime,Vandalism,Male,13-17,1184,600,584,692,492
2003,Urban,Karnataka,Crime Against Children,Child Abuse,Male,60+,799,29,770,790,9
2001,Urban,Meghalaya,Crime Against Children,Child Labor,Male,60+,8927,6636,2291,7476,1451
2002,Urban,Manipur,Other Crimes,Drug Offense,Female,18-30,5860,1652,4208,2295,3565
2006,Urban,Goa,Other Crimes,Cyber Crime,Female,31-45,1073,632,441,977,96
2001,Rural,Jharkhand,Property Crime,Arson,Male,31-45,711,416,295,642,69
2010,Urban,Meghalaya,Crime Against Women,Rape,Female,18-30,8002,3973,4029,4859,3143
2008,Rural,Arunachal Pradesh,Crime Against Women,Dowry Deaths,Female,0-12,3422,412,3010,1392,2030
2004,Urban,Sikkim,Crime Against Men,Robbery,Female,46-60,6311,1604,4707,3790,2521
2008,Urban,Delhi,Crime Against Men,Assault,Female,13-17,7584,2316,5268,4595,2989
2010,Rural,Jharkhand,Crime Against Men,Robbery,Female,46-60,8801,6158,2643,8638,163
2010,Urban,Sikkim,Crime Against Women,Rape,Female,46-60,5912,5374,538,5772,140
2004,Rural,Rajasthan,Crime Against Men,Murder,Female,60+,7551,4053,3498,5896,1655
2002,Rural,Karnataka,Crime Against Children,Kidnapping,Female,46-60,3699,813,2886,3444,255
2002,Urban,Gujarat,Property Crime,Vandalism,Male,18-30,9716,6211,3505,9273,443
2003,Rural,Gujarat,Crime Against Women,Molestation,Male,46-60,6282,2724,3558,6099,183
2007,Rural,Assam,Other Crimes,Corruption,Male,60+,3903,847,3056,2562,1341
2010,Urban,Assam,Other Crimes,Drug Offense,Male,13-17,9492,5181,4311,7009,2483
2009,Rural,Chhattisgarh,Crime Against Men,Extortion,Female,31-45,757,336,421,538,219
2002,Rural,Meghalaya,Other Crimes,Drug Offense,Male,60+,7149,5848,1301,6755,394
2003,Urban,Jharkhand,Crime Against Children,Child Abuse,Male,18-30,520,450,70,456,64
2002,Rural,Andhra Pradesh,Crime Against Women,Domestic Violence,Male,60+,6004,2052,3952,3695,2309
2009,Rural,Gujarat,Crime Against Men,Assault,Male,60+,3369,2426,943,2852,517
2010,Rural,Andhra Pradesh,Property Crime,Vandalism,Male,0-12,2460,1484,976,2260,200
2005,Urban,Meghalaya,Crime Against Women,Molestation,Male,13-17,4215,3578,637,3954,261
2005,Rural,Uttar Pradesh,Crime Against Women,Dowry Deaths,Female,13-17,9669,5591,4078,8781,888
2007,Urban,Jharkhand,Crime Against Women,Dowry Deaths,Female,0-12,8006,3680,4326,7808,198
2007,Rural,Tripura,Crime Against Women,Dowry Deaths,Male,46-60,8589,8104,485,8507,82
2010,Urban,Delhi,Property Crime,Vandalism,Male,31-45,6695,4529,2166,5978,717
2002,Rural,Rajasthan,Other Crimes,Drug Offense,Male,0-12,5788,2389,3399,5094,694
2010,Urban,Punjab,Crime Against Men,Extortion,Male,31-45,2169,1845,324,2004,165
2001,Urban,Rajasthan,Crime Against Children,Kidnapping,Female,31-45,8653,2313,6340,2477,6176
2004,Rural,Karnataka,Property Crime,Theft,Male,0-12,6558,4406,2152,6517,41
2010,Rural,Kerala,Property Crime,Arson,Female,0-12,8027,4341,3686,4456,3571
2010,Urban,Assam,Crime Against Children,Kidnapping,Male,18-30,4576,3999,577,4110,466
2009,Urban,Mizoram,Other Crimes,Cyber Crime,Female,31-45,8866,460,8406,3118,5748
2007,Urban,Karnataka,Crime Against Children,Trafficking,Female,13-17,4663,959,3704,1151,3512
2004,Urban,Madhya Pradesh,Property Crime,Burglary,Female,46-60,4096,2082,2014,3716,380
2008,Rural,Nagaland,Crime Against Children,Child Abuse,Male,18-30,7566,2145,5421,3872,3694
2002,Rural,Uttarakhand,Crime Against Men,Assault,Female,46-60,5887,3745,2142,4513,1374
2005,Urban,Gujarat,Property Crime,Vandalism,Female,31-45,1806,893,913,975,831
2004,Rural,Mizoram,Crime Against Women,Rape,Male,0-12,6039,410,5629,3505,2534
2004,Rural,Manipur,Other Crimes,Cyber Crime,Male,0-12,2403,1653,750,1969,434
2004,Urban,Delhi,Crime Against Children,Trafficking,Male,18-30,2633,1748,885,2482,151
2003,Rural,Goa,Crime Against Women,Rape,Male,13-17,1253,1246,7,1247,6
2004,Rural,Jammu & Kashmir,Crime Against Men,Robbery,Male,31-45,1568,437,1131,1221,347
2009,Urban,Madhya Pradesh,Crime Against Women,Rape,Female,60+,1735,1694,41,1718,17
2001,Rural,Sikkim,Crime Against Women,Rape,Male,46-60,5056,2600,2456,3164,1892
2001,Urban,West Bengal,Crime Against Men,Murder,Female,13-17,2390,1911,479,2191,199
2010,Rural,Maharashtra,Crime Against Men,Robbery,Female,0-12,5186,3930,1256,4293,893
2007,Urban,Kerala,Other Crimes,Corruption,Female,0-12,2206,2031,175,2053,153
2002,Rural,Odisha,Crime Against Children,Child Labor,Male,31-45,8703,469,8234,2691,6012
2004,Urban,Maharashtra,Crime Against Men,Robbery,Female,46-60,5211,2148,3063,3885,1326
2010,Rural,Jammu & Kashmir,Crime Against Children,Child Abuse,Female,31-45,7718,4590,3128,6537,1181
2004,Rural,Himachal Pradesh,Crime Against Men,Assault,Male,13-17,1130,659,471,726,404
2010,Urban,Maharashtra,Property Crime,Theft,Female,46-60,8056,3770,4286,4616,3440
2007,Rural,Karnataka,Other Crimes,Cyber Crime,Male,46-60,2484,1132,1352,1548,936
2004,Urban,Meghalaya,Crime Against Men,Murder,Female,0-12,6346,5447,899,6303,43
2005,Urban,Himachal Pradesh,Crime Against Children,Child Labor,Male,46-60,1354,390,964,684,670
2001,Urban,Uttar Pradesh,Other Crimes,Fraud,Male,18-30,483,82,401,336,147
2005,Rural,Jharkhand,Property Crime,Theft,Female,0-12,5947,3262,2685,4807,1140
2002,Rural,Sikkim,Property Crime,Burglary,Female,13-17,7715,2735,4980,3780,3935
2001,Rural,Tripura,Crime Against Women,Rape,Female,13-17,421,116,305,287,134
2003,Rural,Himachal Pradesh,Property Crime,Vandalism,Female,13-17,7562,3974,3588,7407,155
2005,Urban,Tamil Nadu,Property Crime,Arson,Female,18-30,3431,271,3160,851,2580
2002,Rural,Bihar,Crime Against Children,Trafficking,Female,0-12,4650,1334,3316,2954,1696
2002,Urban,Maharashtra,Other Crimes,Corruption,Female,60+,1765,1055,710,1527,238
2001,Rural,Gujarat,Crime Against Children,Child Abuse,Male,31-45,5758,1934,3824,3359,2399
2010,Rural,Bihar,Property Crime,Burglary,Female,0-12,8969,4212,4757,8584,385
2009,Rural,Arunachal Pradesh,Crime Against Women,Dowry Deaths,Female,18-30,6493,5058,1435,6318,175
2009,Rural,Punjab,Crime Against Women,Domestic Violence,Female,60+,4840,3784,1056,3967,873
2009,Urban,Assam,Crime Against Men,Assault,Female,13-17,5529,4078,1451,5028,501
2005,Urban,Gujarat,Crime Against Children,Child Labor,Male,60+,2364,408,1956,1016,1348
2007,Urban,Bihar,Other Crimes,Drug Offense,Male,0-12,7051,4968,2083,5607,1444
2008,Urban,Chhattisgarh,Other Crimes,Fraud,Female,46-60,6046,2103,3943,4253,1793
2007,Urban,Assam,Crime Against Children,Child Abuse,Male,13-17,9135,8045,1090,8719,416
2002,Rural,Tripura,Property Crime,Theft,Male,18-30,2881,1512,1369,2453,428
2010,Rural,Jammu & Kashmir,Crime Against Women,Rape,Female,13-17,7745,5347,2398,5748,1997
2009,Urban,Himachal Pradesh,Other Crimes,Cyber Crime,Male,18-30,1097,529,568,833,264
2006,Rural,Manipur,Other Crimes,Corruption,Female,0-12,5666,5421,245,5628,38
2008,Urban,Kerala,Crime Against Men,Robbery,Male,31-45,7872,5340,2532,6929,943
2003,Rural,Kerala,Other Crimes,Fraud,Female,46-60,8132,7914,218,8128,4
2002,Rural,Manipur,Other Crimes,Fraud,Male,18-30,6127,5479,648,5712,415
2002,Urban,Kerala,Property Crime,Burglary,Male,46-60,8933,7566,1367,8508,425
2006,Urban,Uttarakhand,Crime Against Women,Domestic Violence,Male,31-45,4317,4051,266,4296,21
2001,Rural,Sikkim,Crime Against Women,Rape,Female,13-17,1294,79,1215,946,348
2009,Urban,Himachal Pradesh,Crime Against Men,Robbery,Female,60+,8561,1690,6871,2795,5766
2004,Urban,Nagaland,Other Crimes,Fraud,Male,18-30,7895,4718,3177,6355,1540
2007,Urban,Goa,Other Crimes,Cyber Crime,Female,46-60,7347,5859,1488,7013,334
2010,Rural,Bihar,Other Crimes,Drug Offense,Female,31-45,619,489,130,497,122
2001,Rural,Telangana,Property Crime,Vandalism,Male,18-30,3437,2932,505,3373,64
2008,Urban,Uttar Pradesh,Crime Against Children,Child Abuse,Male,31-45,8164,259,7905,1987,6177
2002,Rural,Assam,Crime Against Women,Dowry Deaths,Male,60+,381,196,185,280,101
2002,Rural,Tripura,Crime Against Children,Kidnapping,Female,60+,9401,5388,4013,8415,986
2009,Urban,Punjab,Crime Against Women,Dowry Deaths,Male,46-60,798,703,95,759,39
2007,Rural,Kerala,Other Crimes,Fraud,Male,18-30,2394,1399,995,2193,201
2009,Rural,Punjab,Crime Against Women,Domestic Violence,Male,31-45,1406,620,786,1356,50
2008,Urban,Mizoram,Crime Against Women,Domestic Violence,Male,31-45,8687,4483,4204,5329,3358
2001,Rural,Nagaland,Crime Against Women,Rape,Female,60+,186,65,121,101,85
2008,Rural,Manipur,Crime Against Men,Murder,Male,18-30,3611,1381,2230,3476,135
2006,Rural,Jammu & Kashmir,Other Crimes,Cyber Crime,Female,60+,6369,3770,2599,5768,601
2004,Urban,Mizoram,Other Crimes,Corruption,Female,31-45,1848,1416,432,1438,410
2003,Urban,Sikkim,Crime Against Men,Robbery,Male,18-30,5148,2570,2578,3637,1511
2004,Rural,Sikkim,Crime Against Children,Child Abuse,Female,0-12,9582,3514,6068,5546,4036
2002,Rural,West Bengal,Crime Against Children,Kidnapping,Male,60+,8575,396,8179,2445,6130
2005,Urban,Rajasthan,Other Crimes,Drug Offense,Female,46-60,8828,6843,1985,7343,1485
2010,Rural,Uttarakhand,Property Crime,Arson,Female,46-60,1609,534,1075,1114,495
2001,Urban,Kerala,Crime Against Children,Child Labor,Male,0-12,3037,1006,2031,2062,975
2006,Rural,Uttarakhand,Property Crime,Theft,Male,31-45,4694,928,3766,3357,1337
2001,Urban,Madhya Pradesh,Property Crime,Arson,Female,60+,766,118,648,575,191
2002,Rural,Jammu & Kashmir,Property Crime,Vandalism,Male,46-60,6995,4766,2229,6369,626
2005,Urban,Kerala,Crime Against Women,Domestic Violence,Female,13-17,6413,4310,2103,6297,116
2007,Rural,Tamil Nadu,Crime Against Women,Rape,Female,31-45,6505,5776,729,6477,28
2004,Rural,Jammu & Kashmir,Crime Against Children,Child Abuse,Female,13-17,4554,595,3959,1038,3516
2003,Urban,Arunachal Pradesh,Property Crime,Vandalism,Female,46-60,5772,4934,838,5162,610
2008,Rural,Sikkim,Crime Against Men,Assault,Male,0-12,6492,3359,3133,4859,1633
2002,Urban,Rajasthan,Property Crime,Arson,Female,46-60,8074,7455,619,7750,324
2006,Urban,Punjab,Other Crimes,Cyber Crime,Female,46-60,7090,5030,2060,5951,1139
2001,Urban,Tamil Nadu,Crime Against Women,Domestic Violence,Female,46-60,4789,3191,1598,3923,866
2002,Urban,Nagaland,Property Crime,Theft,Male,31-45,4568,2823,1745,4234,334
2007,Urban,Telangana,Crime Against Children,Child Labor,Female,46-60,3527,2915,612,3215,312
2008,Rural,Karnataka,Crime Against Men,Extortion,Female,0-12,5389,1038,4351,3961,1428
2010,Rural,Tripura,Other Crimes,Cyber Crime,Female,0-12,1965,1256,709,1294,671
2002,Urban,Goa,Crime Against Women,Rape,Male,0-12,5595,3023,2572,4988,607
2002,Rural,Gujarat,Other Crimes,Cyber Crime,Male,31-45,2614,1377,1237,2092,522
2008,Urban,Karnataka,Other Crimes,Cyber Crime,Female,18-30,8629,2913,5716,3158,5471
2006,Urban,Bihar,Crime Against Children,Trafficking,Male,60+,5702,3249,2453,3941,1761
2003,Rural,Karnataka,Crime Against Children,Child Abuse,Female,31-45,2746,2467,279,2602,144
2009,Rural,Jharkhand,Other Crimes,Drug Offense,Female,31-45,2764,726,2038,874,1890
2001,Rural,Arunachal Pradesh,Other Crimes,Cyber Crime,Female,60+,3661,1987,1674,3442,219
2004,Urban,Tamil Nadu,Crime Against Women,Rape,Male,18-30,845,458,387,652,193
2002,Rural,Gujarat,Crime Against Women,Molestation,Male,60+,7627,1243,6384,7017,610
2008,Rural,Bihar,Other Crimes,Cyber Crime,Male,0-12,8566,8365,201,8553,13
2008,Urban,Jharkhand,Crime Against Children,Child Abuse,Male,60+,2196,572,1624,1766,430
2009,Urban,Uttarakhand,Property Crime,Theft,Male,0-12,1558,1090,468,1277,281
2007,Urban,Tamil Nadu,Property Crime,Burglary,Male,18-30,3209,3084,125,3121,88
2005,Rural,Kerala,Other Crimes,Cyber Crime,Female,31-45,8014,4262,3752,7855,159
2005,Urban,Karnataka,Crime Against Women,Dowry Deaths,Male,46-60,9102,2011,7091,7336,1766
2008,Urban,Meghalaya,Other Crimes,Fraud,Male,31-45,4058,269,3789,1659,2399
2008,Urban,Goa,Crime Against Children,Child Abuse,Male,46-60,5190,3969,1221,4869,321
2009,Urban,Haryana,Other Crimes,Corruption,Female,0-12,1411,9,1402,264,1147
2001,Rural,Tamil Nadu,Other Crimes,Drug Offense,Female,31-45,4909,3194,1715,3910,999
2006,Urban,Karnataka,Crime Against Children,Child Labor,Female,31-45,7869,7662,207,7826,43
2004,Urban,Uttarakhand,Property Crime,Arson,Male,18-30,4389,363,4026,1235,3154
2009,Rural,Haryana,Crime Against Women,Molestation,Male,60+,3114,216,2898,438,2676
2004,Urban,Uttarakhand,Property Crime,Vandalism,Male,13-17,9584,3057,6527,8669,915
2003,Rural,Jharkhand,Crime Against Women,Dowry Deaths,Male,31-45,6204,2835,3369,3677,2527
2005,Rural,Manipur,Crime Against Women,Dowry Deaths,Male,13-17,1765,1572,193,1605,160
2001,Rural,Haryana,Other Crimes,Corruption,Male,60+,7136,2865,4271,4478,2658
2006,Urban,Himachal Pradesh,Property Crime,Vandalism,Female,18-30,4806,4587,219,4608,198
2008,Urban,Delhi,Property Crime,Arson,Female,13-17,2084,1472,612,1626,458
2005,Rural,West Bengal,Other Crimes,Fraud,Male,31-45,7826,6492,1334,6936,890
2006,Urban,Assam,Crime Against Children,Trafficking,Male,0-12,2912,78,2834,790,2122
2004,Urban,Uttar Pradesh,Property Crime,Theft,Female,46-60,4523,4268,255,4315,208
2004,Urban,Telangana,Other Crimes,Fraud,Male,13-17,52,18,34,36,16
2007,Rural,Chhattisgarh,Crime Against Men,Extortion,Female,13-17,9586,7376,2210,7452,2134
2009,Rural,Haryana,Crime Against Children,Trafficking,Female,18-30,5726,2275,3451,2780,2946
2006,Rural,Maharashtra,Crime Against Children,Trafficking,Female,13-17,109,84,25,101,8
2010,Urban,Tripura,Crime Against Women,Rape,Male,13-17,3856,2436,1420,3691,165
2007,Rural,Meghalaya,Crime Against Men,Extortion,Male,60+,5258,2552,2706,2724,2534
2007,Urban,Chhattisgarh,Crime Against Men,Robbery,Female,13-17,2534,1723,811,2468,66
2005,Rural,Uttarakhand,Crime Against Children,Child Labor,Male,18-30,2680,916,1764,1380,1300
2009,Rural,Madhya Pradesh,Property Crime,Theft,Female,18-30,8603,1279,7324,7356,1247
2003,Urban,Bihar,Crime Against Children,Child Labor,Male,0-12,1736,418,1318,1289,447
2002,Rural,Sikkim,Other Crimes,Cyber Crime,Male,31-45,1777,661,1116,1310,467
2002,Rural,Gujarat,Crime Against Children,Kidnapping,Male,18-30,2692,1977,715,2461,231
2005,Rural,Jammu & Kashmir,Crime Against Children,Child Abuse,Female,60+,8549,195,8354,3176,5373
2007,Rural,Uttarakhand,Property Crime,Arson,Female,46-60,7698,5547,2151,6166,1532
2008,Rural,Haryana,Crime Against Children,Kidnapping,Male,46-60,6799,5459,1340,6780,19
2001,Urban,Punjab,Property Crime,Vandalism,Female,31-45,7486,1713,5773,7437,49
2010,Rural,Goa,Other Crimes,Cyber Crime,Male,0-12,2096,569,1527,1962,134
2008,Rural,Punjab,Crime Against Men,Assault,Female,46-60,7125,2848,4277,7030,95
2001,Rural,Haryana,Property Crime,Arson,Female,0-12,4128,1328,2800,2431,1697
2007,Urban,Kerala,Property Crime,Burglary,Male,0-12,2522,1987,535,2019,503
2006,Urban,Punjab,Crime Against Women,Molestation,Male,13-17,1610,524,1086,848,762
2003,Urban,Uttar Pradesh,Crime Against Children,Trafficking,Female,18-30,9395,1094,8301,7874,1521
2001,Urban,Jharkhand,Crime Against Women,Molestation,Female,46-60,338,160,178,323,15
2010,Rural,Chhattisgarh,Crime Against Women,Molestation,Male,46-60,5451,915,4536,926,4525
2006,Rural,Maharashtra,Crime Against Women,Dowry Deaths,Female,13-17,9686,3694,5992,4758,4928
2010,Urban,Haryana,Crime Against Children,Child Labor,Male,46-60,4492,3373,1119,4195,297
2006,Urban,Uttar Pradesh,Crime Against Men,Murder,Male,60+,8264,4270,3994,5942,2322
2002,Rural,Haryana,Crime Against Children,Child Labor,Female,46-60,4339,1321,3018,2744,1595
2007,Urban,Sikkim,Crime Against Women,Rape,Male,13-17,5035,2793,2242,3727,1308
2008,Urban,Uttarakhand,Other Crimes,Fraud,Male,0-12,8457,5532,2925,5669,2788
2006,Rural,Sikkim,Property Crime,Theft,Female,0-12,8506,2894,5612,7747,759
2004,Rural,Karnataka,Crime Against Women,Molestation,Female,0-12,7402,3959,3443,6776,626
2007,Urban,Maharashtra,Other Crimes,Corruption,Male,31-45,3231,588,2643,1556,1675
2004,Rural,Madhya Pradesh,Crime Against Men,Robbery,Male,13-17,8902,4998,3904,8695,207
2003,Urban,Madhya Pradesh,Crime Against Men,Robbery,Female,60+,8048,7218,830,7728,320
2005,Rural,Jammu & Kashmir,Property Crime,Vandalism,Male,46-60,4637,3062,1575,3748,889
2009,Rural,Tamil Nadu,Crime Against Men,Murder,Female,13-17,8852,2611,6241,3313,5539
2001,Urban,Chhattisgarh,Crime Against Men,Robbery,Female,18-30,8699,7750,949,8357,342
2002,Rural,Delhi,Property Crime,Arson,Male,13-17,2273,1068,1205,1330,943
2003,Urban,Mizoram,Crime Against Women,Domestic Violence,Female,31-45,7996,4242,3754,4440,3556
2010,Rural,Andhra Pradesh,Property Crime,Vandalism,Female,13-17,3786,672,3114,3536,250
2009,Urban,Odisha,Crime Against Women,Rape,Male,13-17,2218,1228,990,1237,981
2009,Rural,Maharashtra,Property Crime,Vandalism,Male,13-17,1057,902,155,1002,55
2002,Urban,Karnataka,Other Crimes,Corruption,Female,0-12,4145,670,3475,1135,3010
2007,Rural,Delhi,Crime Against Children,Trafficking,Male,60+,2932,2832,100,2857,75
2009,Rural,Punjab,Property Crime,Arson,Female,46-60,6928,2379,4549,6760,168
2010,Urban,Odisha,Property Crime,Vandalism,Male,31-45,1330,1024,306,1106,224
2009,Rural,Meghalaya,Crime Against Women,Dowry Deaths,Male,31-45,8406,2239,6167,5511,2895
2006,Urban,Nagaland,Other Crimes,Drug Offense,Female,31-45,6193,5930,263,6122,71
2009,Rural,Himachal Pradesh,Crime Against Men,Murder,Female,31-45,269,49,220,184,85
2007,Urban,Mizoram,Crime Against Children,Child Labor,Female,0-12,1331,159,1172,550,781
2005,Rural,Meghalaya,Crime Against Children,Trafficking,Female,18-30,4323,1341,2982,1884,2439
2004,Rural,Telangana,Crime Against Women,Domestic Violence,Male,31-45,6252,2916,3336,4471,1781
2009,Rural,Maharashtra,Crime Against Children,Trafficking,Male,60+,4900,1056,3844,2988,1912
2005,Urban,Bihar,Other Crimes,Cyber Crime,Male,13-17,79,30,49,69,10
2007,Urban,Punjab,Crime Against Women,Molestation,Female,13-17,3757,1370,2387,3219,538
2008,Rural,West Bengal,Crime Against Men,Assault,Female,46-60,2830,1724,1106,1799,1031
2009,Urban,Kerala,Crime Against Children,Kidnapping,Male,46-60,6622,2450,4172,3857,2765
2005,Rural,Gujarat,Crime Against Women,Molestation,Male,31-45,2326,2133,193,2140,186
2003,Rural,Arunachal Pradesh,Crime Against Women,Molestation,Female,31-45,3198,2921,277,2996,202
2001,Rural,Delhi,Crime Against Children,Child Abuse,Male,18-30,9258,4239,5019,5498,3760
2010,Urban,West Bengal,Crime Against Women,Molestation,Female,31-45,4768,207,4561,4594,174
2005,Urban,Tamil Nadu,Crime Against Children,Kidnapping,Female,0-12,7329,3041,4288,6376,953
2001,Urban,Bihar,Other Crimes,Fraud,Female,31-45,4462,2178,2284,4258,204
2003,Rural,Assam,Other Crimes,Drug Offense,Female,46-60,447,2,445,378,69
2003,Urban,Maharashtra,Other Crimes,Fraud,Male,13-17,9859,209,9650,6196,3663
2003,Urban,Uttarakhand,Crime Against Women,Domestic Violence,Male,60+,6544,137,6407,3112,3432
2005,Urban,Delhi,Crime Against Children,Kidnapping,Male,13-17,3072,2622,450,2890,182
2009,Rural,Madhya Pradesh,Crime Against Children,Child Labor,Male,0-12,9358,4579,4779,8190,1168
2008,Rural,West Bengal,Crime Against Men,Robbery,Male,18-30,6009,1086,4923,1095,4914
2001,Urban,Kerala,Property Crime,Theft,Female,0-12,8389,617,7772,6414,1975
2005,Rural,Kerala,Crime Against Men,Robbery,Female,31-45,1095,228,867,858,237
2008,Urban,Assam,Crime Against Women,Dowry Deaths,Male,31-45,824,333,491,624,200
2008,Urban,Goa,Property Crime,Arson,Male,60+,8629,5872,2757,6055,2574
2004,Rural,Uttarakhand,Crime Against Women,Molestation,Female,0-12,6937,529,6408,2119,4818
2006,Urban,Telangana,Other Crimes,Drug Offense,Female,13-17,5381,1272,4109,3631,1750
2010,Urban,Madhya Pradesh,Other Crimes,Corruption,Male,46-60,8013,84,7929,1109,6904
2001,Rural,Karnataka,Property Crime,Burglary,Female,18-30,5318,3329,1989,3668,1650
2001,Rural,Haryana,Crime Against Children,Child Labor,Female,18-30,8666,5983,2683,6065,2601
2006,Rural,Rajasthan,Property Crime,Vandalism,Female,31-45,5132,3989,1143,4710,422
2002,Urban,Madhya Pradesh,Crime Against Children,Child Abuse,Female,18-30,915,616,299,716,199
2010,Rural,Mizoram,Property Crime,Arson,Female,60+,4023,510,3513,1473,2550
2005,Urban,Karnataka,Crime Against Children,Child Labor,Female,18-30,6124,1757,4367,4311,1813
2003,Rural,Haryana,Crime Against Children,Child Labor,Male,0-12,2146,992,1154,2072,74
2004,Rural,Meghalaya,Crime Against Children,Kidnapping,Female,18-30,8168,3542,4626,6431,1737
2007,Rural,Arunachal Pradesh,Crime Against Men,Extortion,Female,46-60,9555,6463,3092,8652,903
2001,Rural,Arunachal Pradesh,Crime Against Men,Assault,Male,60+,8755,2947,5808,3829,4926
2008,Urban,Odisha,Crime Against Women,Dowry Deaths,Female,60+,6137,522,5615,3400,2737
2005,Rural,Andhra Pradesh,Crime Against Children,Child Abuse,Female,46-60,5584,357,5227,1045,4539
2002,Rural,Arunachal Pradesh,Crime Against Women,Rape,Female,0-12,653,53,600,241,412
2001,Rural,Bihar,Property Crime,Burglary,Male,46-60,2753,2715,38,2715,38
2004,Rural,Nagaland,Other Crimes,Cyber Crime,Female,18-30,7821,7696,125,7754,67
2008,Rural,Kerala,Crime Against Women,Rape,Female,60+,4231,1438,2793,3193,1038
2010,Urban,Assam,Crime Against Men,Robbery,Male,31-45,6242,2078,4164,5176,1066
2010,Urban,Rajasthan,Other Crimes,Fraud,Female,13-17,1798,1238,560,1450,348
2006,Urban,Karnataka,Property Crime,Vandalism,Male,18-30,1052,117,935,874,178
2009,Urban,Jammu & Kashmir,Crime Against Children,Trafficking,Male,31-45,3849,1480,2369,1931,1918
2001,Urban,Delhi,Crime Against Women,Rape,Female,0-12,2132,237,1895,319,1813
2008,Rural,Uttarakhand,Crime Against Children,Kidnapping,Male,60+,4560,3098,1462,3231,1329
2006,Urban,Jammu & Kashmir,Crime Against Men,Robbery,Female,46-60,6221,6006,215,6083,138
2007,Rural,Arunachal Pradesh,Property Crime,Theft,Male,18-30,8685,6251,2434,7151,1534
2003,Rural,Arunachal Pradesh,Property Crime,Burglary,Male,13-17,860,627,233,829,31
2005,Urban,Punjab,Property Crime,Theft,Male,18-30,1709,695,1014,1078,631
2001,Rural,Tamil Nadu,Other Crimes,Drug Offense,Male,31-45,1250,947,303,1195,55
2001,Rural,Manipur,Property Crime,Arson,Female,46-60,7711,2439,5272,7222,489
2010,Rural,Nagaland,Crime Against Children,Kidnapping,Female,0-12,7842,3247,4595,6395,1447
2007,Urban,Bihar,Crime Against Men,Extortion,Female,31-45,8121,5539,2582,6993,1128
2010,Rural,Delhi,Crime Against Women,Dowry Deaths,Female,46-60,2990,2393,597,2621,369
2009,Rural,Jharkhand,Property Crime,Vandalism,Male,0-12,9684,3202,6482,3366,6318
2010,Rural,Arunachal Pradesh,Crime Against Men,Murder,Male,13-17,1816,1651,165,1740,76
2007,Rural,Mizoram,Other Crimes,Cyber Crime,Male,31-45,9485,6792,2693,9344,141
2005,Urban,Jharkhand,Crime Against Men,Murder,Female,18-30,2972,2726,246,2924,48
2008,Urban,Uttarakhand,Property Crime,Theft,Female,46-60,5654,1542,4112,3579,2075
2007,Urban,Assam,Crime Against Children,Child Labor,Female,13-17,6416,5151,1265,6276,140
2006,Rural,Uttarakhand,Other Crimes,Corruption,Male,13-17,2375,1857,518,2137,238
2001,Urban,Himachal Pradesh,Crime Against Children,Child Labor,Male,13-17,5675,3603,2072,4331,1344
2005,Rural,Meghalaya,Other Crimes,Drug Offense,Male,13-17,6415,6101,314,6120,295
2001,Rural,Arunachal Pradesh,Property Crime,Arson,Female,0-12,7332,1317,6015,2938,4394
2007,Urban,Jharkhand,Crime Against Men,Extortion,Female,0-12,583,328,255,433,150
2003,Urban,Odisha,Other Crimes,Corruption,Female,31-45,2515,2343,172,2505,10
2010,Rural,Jammu & Kashmir,Property Crime,Arson,Male,31-45,4300,4155,145,4290,10
2003,Rural,Gujarat,Property Crime,Arson,Female,0-12,3842,1520,2322,3165,677
2005,Rural,Uttar Pradesh,Crime Against Children,Kidnapping,Male,60+,369,151,218,290,79
2008,Rural,Madhya Pradesh,Property Crime,Vandalism,Male,13-17,1349,418,931,454,895
2004,Rural,West Bengal,Other Crimes,Drug Offense,Male,18-30,7336,3668,3668,5862,1474
2001,Urban,Rajasthan,Crime Against Women,Dowry Deaths,Male,60+,169,28,141,165,4
2010,Urban,Uttarakhand,Crime Against Men,Extortion,Female,46-60,2129,1994,135,2086,43
2010,Urban,Mizoram,Other Crimes,Cyber Crime,Female,31-45,3682,3435,247,3448,234
2009,Urban,Assam,Crime Against Men,Murder,Male,0-12,1199,1149,50,1167,32
2008,Rural,Mizoram,Crime Against Women,Molestation,Female,18-30,8994,8437,557,8553,441
2010,Rural,Jammu & Kashmir,Crime Against Children,Kidnapping,Male,0-12,8505,1056,7449,2104,6401
2007,Rural,Tripura,Property Crime,Theft,Male,18-30,6426,803,5623,4860,1566
2009,Rural,Himachal Pradesh,Other Crimes,Fraud,Male,0-12,4850,90,4760,1297,3553
2002,Urban,Jharkhand,Crime Against Men,Extortion,Female,60+,4247,1133,3114,3775,472
2008,Urban,Assam,Crime Against Children,Child Labor,Male,0-12,3872,3794,78,3837,35
2003,Rural,Nagaland,Property Crime,Burglary,Female,13-17,5779,5202,577,5331,448
2006,Rural,Rajasthan,Crime Against Women,Molestation,Male,0-12,9007,7039,1968,7596,1411
2002,Rural,Punjab,Crime Against Men,Extortion,Female,18-30,5869,5744,125,5797,72
2002,Rural,Tamil Nadu,Crime Against Women,Dowry Deaths,Female,60+,5654,3592,2062,4551,1103
2005,Rural,Karnataka,Crime Against Women,Domestic Violence,Female,46-60,8894,2969,5925,3598,5296
2005,Urban,Chhattisgarh,Crime Against Children,Kidnapping,Female,60+,4148,69,4079,3371,777
2001,Urban,Jharkhand,Crime Against Women,Rape,Female,46-60,1817,681,1136,1491,326
2009,Rural,Bihar,Property Crime,Arson,Female,18-30,6397,2323,4074,3274,3123
2001,Rural,Maharashtra,Crime Against Children,Kidnapping,Male,31-45,6202,1260,4942,1758,4444
2008,Urban,Himachal Pradesh,Crime Against Women,Molestation,Female,18-30,5283,530,4753,2486,2797
2005,Rural,Kerala,Other Crimes,Fraud,Female,18-30,6283,4900,1383,5954,329
2001,Urban,Uttarakhand,Other Crimes,Cyber Crime,Male,46-60,8492,8149,343,8329,163
2002,Urban,Mizoram,Crime Against Men,Murder,Male,18-30,1140,486,654,563,577
2008,Rural,Goa,Property Crime,Vandalism,Male,46-60,3829,3492,337,3780,49
2007,Urban,Rajasthan,Crime Against Men,Assault,Male,31-45,9822,6268,3554,8071,1751
2001,Urban,Uttar Pradesh,Crime Against Men,Assault,Male,13-17,8012,2498,5514,4159,3853
2002,Rural,Telangana,Crime Against Women,Dowry Deaths,Male,46-60,4661,3942,719,4343,318
2010,Urban,Uttarakhand,Property Crime,Burglary,Male,60+,5907,544,5363,5341,566
2007,Rural,Bihar,Property Crime,Arson,Male,13-17,4225,3380,845,3437,788
2005,Urban,Andhra Pradesh,Crime Against Women,Molestation,Female,46-60,9585,9222,363,9427,158
2007,Rural,Meghalaya,Property Crime,Vandalism,Female,18-30,7307,3231,4076,5008,2299
2004,Rural,West Bengal,Other Crimes,Corruption,Male,0-12,584,64,520,415,169
2001,Urban,Telangana,Crime Against Women,Dowry Deaths,Male,31-45,2052,1702,350,1721,331
2010,Urban,Andhra Pradesh,Crime Against Women,Rape,Male,13-17,3027,1935,1092,2789,238
2006,Urban,Gujarat,Crime Against Children,Kidnapping,Male,13-17,4104,2854,1250,4047,57
2001,Rural,Arunachal Pradesh,Crime Against Children,Trafficking,Male,46-60,9914,9897,17,9897,17
2006,Urban,Madhya Pradesh,Crime Against Children,Child Labor,Female,60+,7955,3339,4616,4753,3202
2006,Urban,Gujarat,Crime Against Women,Rape,Female,13-17,852,781,71,845,7
2008,Urban,Tripura,Crime Against Men,Assault,Male,31-45,9504,7404,2100,9379,125
2007,Urban,Karnataka,Property Crime,Burglary,Male,46-60,7757,4783,2974,6997,760
2009,Rural,Rajasthan,Crime Against Women,Domestic Violence,Male,60+,3266,276,2990,1023,2243
2003,Rural,Kerala,Other Crimes,Corruption,Male,13-17,6970,2473,4497,4217,2753
2009,Urban,Chhattisgarh,Crime Against Women,Domestic Violence,Male,60+,280,169,111,192,88
2006,Rural,Jammu & Kashmir,Crime Against Men,Assault,Male,18-30,7681,1989,5692,4665,3016
2010,Rural,Odisha,Crime Against Children,Kidnapping,Female,0-12,410,11,399,377,33
2008,Urban,Haryana,Other Crimes,Corruption,Female,31-45,6509,1396,5113,2749,3760
2010,Urban,Meghalaya,Crime Against Women,Dowry Deaths,Female,31-45,1387,789,598,909,478
2002,Rural,Uttarakhand,Property Crime,Arson,Male,18-30,2408,581,1827,2154,254
2004,Urban,Arunachal Pradesh,Crime Against Children,Child Labor,Male,0-12,5504,220,5284,3883,1621
2007,Rural,Maharashtra,Crime Against Women,Rape,Female,0-12,3978,2682,1296,3869,109
2010,Rural,West Bengal,Crime Against Women,Molestation,Female,18-30,2419,1418,1001,1950,469
2008,Urban,Rajasthan,Crime Against Children,Trafficking,Male,13-17,2238,28,2210,877,1361
2010,Urban,Himachal Pradesh,Other Crimes,Fraud,Female,13-17,3480,1903,1577,2556,924
2007,Urban,Uttarakhand,Other Crimes,Cyber Crime,Male,60+,5757,4575,1182,4704,1053
2004,Urban,Uttar Pradesh,Crime Against Women,Rape,Female,0-12,1202,1040,162,1078,124
2004,Rural,Tamil Nadu,Crime Against Children,Child Labor,Male,13-17,1528,734,794,845,683
2010,Urban,Sikkim,Crime Against Men,Robbery,Female,60+,3701,2137,1564,2744,957
2006,Rural,Jharkhand,Crime Against Women,Domestic Violence,Male,60+,51,23,28,46,5
2003,Urban,Delhi,Other Crimes,Corruption,Male,0-12,3988,3854,134,3913,75
2010,Rural,Manipur,Crime Against Children,Child Abuse,Female,0-12,3168,2884,284,3011,157
2010,Urban,Himachal Pradesh,Crime Against Children,Child Abuse,Female,31-45,2311,2283,28,2286,25
2009,Rural,Kerala,Other Crimes,Cyber Crime,Male,60+,3989,678,3311,3598,391
2007,Urban,Karnataka,Crime Against Women,Domestic Violence,Female,46-60,4647,758,3889,3481,1166
2005,Urban,West Bengal,Crime Against Children,Kidnapping,Male,0-12,9940,5102,4838,5651,4289
2010,Urban,Madhya Pradesh,Crime Against Men,Extortion,Male,18-30,4639,2453,2186,4551,88
2008,Rural,Jharkhand,Crime Against Women,Rape,Female,18-30,4955,1472,3483,4246,709
2006,Rural,Tamil Nadu,Crime Against Women,Dowry Deaths,Male,31-45,456,158,298,406,50
2010,Rural,Haryana,Other Crimes,Corruption,Male,18-30,2230,39,2191,1833,397
2010,Rural,Kerala,Crime Against Men,Robbery,Male,60+,2736,1889,847,1932,804
2004,Rural,Odisha,Crime Against Men,Assault,Male,31-45,4003,3749,254,3776,227
2004,Rural,Tripura,Crime Against Children,Child Abuse,Male,46-60,8340,7367,973,7456,884
2001,Rural,Tamil Nadu,Other Crimes,Drug Offense,Female,46-60,8935,8847,88,8901,34
2001,Rural,Chhattisgarh,Crime Against Children,Trafficking,Male,0-12,7987,6668,1319,6710,1277
2007,Rural,Goa,Other Crimes,Fraud,Female,31-45,8450,3398,5052,4182,4268
2010,Urban,Tripura,Crime Against Women,Molestation,Male,31-45,758,737,21,740,18
2005,Urban,Himachal Pradesh,Property Crime,Arson,Female,18-30,4655,2590,2065,3103,1552
2006,Rural,Tripura,Crime Against Men,Extortion,Male,0-12,9071,2406,6665,6858,2213
2007,Rural,Uttar Pradesh,Crime Against Men,Murder,Male,46-60,3994,2123,1871,2853,1141
2004,Urban,Goa,Other Crimes,Fraud,Female,60+,5947,244,5703,3516,2431
2009,Urban,Andhra Pradesh,Crime Against Children,Child Abuse,Female,60+,5043,1329,3714,3445,1598
2005,Urban,Uttarakhand,Property Crime,Theft,Male,46-60,2218,1132,1086,2187,31
2008,Rural,Haryana,Crime Against Men,Extortion,Female,46-60,6750,150,6600,1982,4768
2002,Rural,Telangana,Other Crimes,Drug Offense,Female,0-12,8562,7750,812,8290,272
2006,Urban,Rajasthan,Crime Against Children,Trafficking,Female,60+,4652,612,4040,1750,2902
2004,Rural,Tripura,Other Crimes,Cyber Crime,Male,13-17,3681,507,3174,551,3130
2002,Rural,West Bengal,Crime Against Women,Domestic Violence,Male,31-45,8391,1528,6863,8011,380
2002,Rural,Madhya Pradesh,Crime Against Children,Kidnapping,Male,31-45,5535,4729,806,4994,541
2009,Rural,Karnataka,Crime Against Children,Trafficking,Female,0-12,2904,395,2509,1819,1085
2002,Rural,Rajasthan,Crime Against Women,Rape,Female,0-12,9562,7430,2132,9254,308
2001,Urban,Goa,Crime Against Men,Assault,Male,18-30,130,130,0,130,0
2008,Urban,Punjab,Property Crime,Burglary,Female,31-45,5448,4294,1154,4540,908
2004,Rural,Delhi,Other Crimes,Fraud,Male,0-12,1524,867,657,1339,185
2004,Urban,Jammu & Kashmir,Crime Against Women,Dowry Deaths,Male,60+,1878,1703,175,1804,74
2006,Urban,Sikkim,Crime Against Men,Assault,Male,60+,1283,786,497,1209,74
2007,Rural,Assam,Crime Against Women,Domestic Violence,Male,13-17,8754,4713,4041,8446,308
2001,Rural,Haryana,Crime Against Children,Kidnapping,Female,46-60,5707,4880,827,5090,617
2001,Rural,Assam,Other Crimes,Fraud,Male,13-17,8815,8004,811,8377,438
2002,Urban,Sikkim,Property Crime,Arson,Male,60+,3698,1552,2146,2296,1402
2003,Urban,Nagaland,Crime Against Men,Extortion,Male,31-45,540,36,504,310,230
2001,Urban,Jharkhand,Property Crime,Arson,Male,31-45,348,34,314,218,130
2006,Urban,Rajasthan,Crime Against Men,Assault,Male,0-12,4512,1254,3258,2001,2511
2003,Urban,Tripura,Property Crime,Arson,Male,31-45,8954,468,8486,5250,3704
2006,Urban,Assam,Crime Against Children,Child Labor,Female,18-30,449,372,77,401,48
2006,Urban,Mizoram,Crime Against Men,Murder,Female,46-60,2779,1995,784,2342,437
2006,Urban,Karnataka,Crime Against Women,Molestation,Female,60+,5502,5493,9,5502,0
2002,Urban,Chhattisgarh,Property Crime,Theft,Female,13-17,5259,2331,2928,4890,369
2002,Urban,Uttarakhand,Crime Against Children,Child Labor,Female,13-17,6551,6262,289,6419,132
2002,Rural,Telangana,Crime Against Men,Extortion,Female,31-45,3188,1969,1219,2745,443
2010,Urban,Uttarakhand,Crime Against Women,Molestation,Male,13-17,9616,498,9118,9287,329
2005,Urban,Tripura,Crime Against Children,Kidnapping,Male,13-17,6917,3977,2940,4952,1965
2010,Urban,Himachal Pradesh,Other Crimes,Fraud,Male,0-12,4976,689,4287,2161,2815
2005,Rural,Mizoram,Property Crime,Arson,Male,46-60,5041,4538,503,4837,204
2008,Rural,Sikkim,Property Crime,Theft,Female,60+,804,458,346,737,67
2004,Urban,Bihar,Other Crimes,Fraud,Male,60+,8619,8436,183,8593,26
2008,Urban,Punjab,Crime Against Women,Dowry Deaths,Female,18-30,9471,4998,4473,7374,2097
2008,Rural,Chhattisgarh,Property Crime,Burglary,Female,60+,8526,6138,2388,6918,1608
2005,Rural,Haryana,Other Crimes,Corruption,Female,31-45,4649,3467,1182,3624,1025
2008,Urban,Jharkhand,Property Crime,Theft,Male,31-45,3778,992,2786,1999,1779
2004,Urban,Odisha,Crime Against Women,Rape,Female,18-30,7744,7387,357,7743,1
2002,Rural,Punjab,Crime Against Women,Domestic Violence,Female,0-12,2361,431,1930,2163,198
2010,Urban,Uttarakhand,Crime Against Children,Child Labor,Male,18-30,9750,7999,1751,9720,30
2008,Rural,Rajasthan,Other Crimes,Fraud,Male,18-30,7326,5578,1748,6799,527
2008,Rural,Telangana,Property Crime,Theft,Male,18-30,6427,4291,2136,5586,841
2009,Rural,Odisha,Crime Against Men,Murder,Female,46-60,863,208,655,359,504
2007,Urban,Odisha,Crime Against Men,Robbery,Male,60+,8456,1142,7314,3944,4512
2004,Urban,Uttar Pradesh,Crime Against Women,Domestic Violence,Male,0-12,6048,344,5704,1398,4650
2010,Rural,Mizoram,Other Crimes,Corruption,Female,0-12,5757,1512,4245,3594,2163
2003,Urban,Rajasthan,Property Crime,Arson,Male,0-12,6841,1370,5471,5273,1568
2010,Urban,Haryana,Crime Against Women,Rape,Male,0-12,9660,7484,2176,8738,922
2003,Urban,Punjab,Other Crimes,Corruption,Male,31-45,9398,3030,6368,7321,2077
2008,Urban,Punjab,Other Crimes,Drug Offense,Female,0-12,5760,566,5194,3930,1830
2008,Rural,Arunachal Pradesh,Other Crimes,Drug Offense,Male,31-45,5135,4658,477,4970,165
2008,Rural,Nagaland,Crime Against Men,Assault,Female,46-60,8564,1118,7446,3862,4702
2009,Rural,Telangana,Crime Against Children,Child Abuse,Male,46-60,6020,2338,3682,3832,2188
2010,Rural,Mizoram,Crime Against Men,Assault,Female,46-60,1246,935,311,1109,137
2009,Urban,Tripura,Crime Against Women,Rape,Male,46-60,4587,1580,3007,3379,1208
2003,Urban,Jharkhand,Crime Against Men,Assault,Female,60+,9266,8618,648,9101,165
2004,Urban,Goa,Crime Against Children,Trafficking,Male,0-12,5176,3793,1383,3878,1298
2002,Rural,Jammu & Kashmir,Other Crimes,Corruption,Male,18-30,1123,1114,9,1116,7
2001,Urban,Arunachal Pradesh,Other Crimes,Fraud,Female,0-12,5991,1000,4991,3799,2192
2002,Rural,Maharashtra,Crime Against Men,Extortion,Male,60+,7703,4376,3327,7113,590
2003,Urban,Assam,Other Crimes,Fraud,Male,0-12,4199,2576,1623,2798,1401
2008,Rural,Mizoram,Other Crimes,Drug Offense,Female,60+,9223,1678,7545,6803,2420
2003,Rural,Kerala,Crime Against Men,Robbery,Male,0-12,101,70,31,72,29
2008,Urban,Uttarakhand,Other Crimes,Fraud,Male,18-30,4325,4223,102,4301,24
2005,Rural,Madhya Pradesh,Crime Against Women,Dowry Deaths,Female,46-60,6237,5964,273,5968,269
2009,Urban,Uttarakhand,Crime Against Children,Kidnapping,Male,13-17,430,18,412,398,32
2001,Rural,Odisha,Other Crimes,Corruption,Female,60+,7106,439,6667,3951,3155
2010,Rural,Tamil Nadu,Crime Against Children,Kidnapping,Female,31-45,4003,988,3015,2810,1193
2007,Urban,West Bengal,Property Crime,Arson,Female,18-30,2059,13,2046,1578,481
2005,Rural,Kerala,Other Crimes,Corruption,Male,31-45,3922,2554,1368,3294,628
2010,Rural,Manipur,Property Crime,Burglary,Female,13-17,2161,1558,603,1873,288
2005,Rural,Maharashtra,Property Crime,Burglary,Female,18-30,2605,1704,901,2352,253
2003,Urban,Manipur,Other Crimes,Corruption,Male,60+,3613,394,3219,2695,918
2009,Rural,Tamil Nadu,Property Crime,Vandalism,Female,31-45,4390,6,4384,1380,3010
2008,Urban,Uttarakhand,Property Crime,Vandalism,Male,13-17,375,345,30,365,10
2007,Rural,Meghalaya,Property Crime,Burglary,Female,13-17,2058,378,1680,1944,114
2002,Urban,Jammu & Kashmir,Crime Against Women,Molestation,Male,18-30,2602,1017,1585,2068,534
2002,Rural,Jammu & Kashmir,Other Crimes,Fraud,Female,46-60,3121,2343,778,2845,276
2001,Urban,Jharkhand,Property Crime,Vandalism,Female,18-30,7076,3968,3108,5505,1571
2006,Rural,Telangana,Crime Against Women,Rape,Male,31-45,2096,1051,1045,2039,57
2007,Rural,Telangana,Crime Against Women,Molestation,Female,60+,2316,1222,1094,2226,90
2009,Urban,Meghalaya,Crime Against Women,Domestic Violence,Female,31-45,8273,1746,6527,6459,1814
2006,Rural,Arunachal Pradesh,Crime Against Children,Child Labor,Male,0-12,7427,284,7143,1909,5518
2009,Urban,Manipur,Crime Against Women,Rape,Female,60+,966,432,534,572,394
2005,Urban,Bihar,Crime Against Men,Murder,Male,0-12,7344,2443,4901,4628,2716
2004,Urban,Delhi,Crime Against Men,Robbery,Male,60+,2325,251,2074,2023,302
2008,Urban,Andhra Pradesh,Property Crime,Arson,Female,31-45,3199,1978,1221,2511,688
2001,Rural,Mizoram,Crime Against Men,Robbery,Male,0-12,8162,2220,5942,7530,632
2002,Urban,Haryana,Other Crimes,Fraud,Female,46-60,941,552,389,649,292
2003,Urban,Tripura,Property Crime,Vandalism,Female,13-17,1801,1770,31,1781,20
2004,Urban,Bihar,Crime Against Men,Robbery,Male,18-30,1384,919,465,1317,67
2002,Rural,Gujarat,Crime Against Men,Assault,Male,31-45,3235,783,2452,3004,231
2002,Rural,Assam,Property Crime,Theft,Male,0-12,8908,3043,5865,6156,2752
2009,Rural,West Bengal,Other Crimes,Cyber Crime,Male,60+,1699,380,1319,948,751
2003,Rural,Rajasthan,Crime Against Men,Assault,Male,60+,3021,2420,601,2916,105
2008,Rural,Rajasthan,Crime Against Children,Kidnapping,Male,31-45,5601,5067,534,5507,94
2002,Urban,Maharashtra,Crime Against Women,Dowry Deaths,Male,18-30,8455,7726,729,7737,718
2008,Urban,Goa,Other Crimes,Drug Offense,Female,13-17,8643,5982,2661,7473,1170
2010,Rural,Tamil Nadu,Crime Against Children,Kidnapping,Female,46-60,6225,2289,3936,3503,2722
2006,Rural,Mizoram,Property Crime,Theft,Male,18-30,8331,3245,5086,3399,4932
2001,Urban,Sikkim,Property Crime,Burglary,Female,46-60,3544,3024,520,3319,225
2009,Rural,Meghalaya,Property Crime,Arson,Male,60+,1207,653,554,1034,173
2002,Rural,Kerala,Property Crime,Vandalism,Female,0-12,9173,4354,4819,8151,1022
2009,Rural,Punjab,Crime Against Men,Robbery,Female,46-60,8105,3301,4804,6902,1203
2008,Urban,Mizoram,Crime Against Children,Trafficking,Female,31-45,2072,1262,810,1277,795
2003,Urban,West Bengal,Crime Against Women,Rape,Male,46-60,9312,5945,3367,6887,2425
2007,Rural,Uttar Pradesh,Crime Against Men,Robbery,Female,31-45,1592,1139,453,1338,254
2001,Rural,West Bengal,Crime Against Men,Extortion,Male,0-12,9064,217,8847,3310,5754
2004,Urban,West Bengal,Crime Against Men,Assault,Female,46-60,301,138,163,255,46
2009,Urban,Jammu & Kashmir,Crime Against Men,Murder,Male,60+,9870,7396,2474,9733,137
2009,Urban,Rajasthan,Crime Against Children,Kidnapping,Male,31-45,7134,5962,1172,6265,869
2010,Rural,Meghalaya,Property Crime,Burglary,Female,18-30,7471,1617,5854,7045,426
2006,Urban,Odisha,Crime Against Men,Assault,Male,13-17,5682,1017,4665,3779,1903
2009,Rural,Nagaland,Property Crime,Theft,Female,0-12,1404,1013,391,1026,378
2003,Rural,Jharkhand,Property Crime,Arson,Male,13-17,814,484,330,596,218
2003,Rural,West Bengal,Crime Against Women,Domestic Violence,Male,46-60,6408,1141,5267,5811,597
2008,Rural,Punjab,Crime Against Children,Kidnapping,Male,13-17,1187,1147,40,1173,14
2009,Rural,Gujarat,Property Crime,Theft,Male,60+,9505,3591,5914,9053,452
2004,Rural,Sikkim,Other Crimes,Fraud,Male,46-60,6254,5065,1189,5342,912
2006,Rural,Kerala,Crime Against Women,Rape,Female,0-12,9964,6672,3292,8414,1550
2005,Urban,Odisha,Property Crime,Theft,Male,13-17,6647,4632,2015,5420,1227
2007,Rural,Tripura,Crime Against Children,Kidnapping,Male,0-12,7994,6608,1386,7515,479
2003,Urban,Assam,Crime Against Women,Molestation,Male,46-60,4861,3786,1075,4001,860
2003,Rural,Jharkhand,Crime Against Men,Murder,Female,60+,3501,1121,2380,2002,1499
2004,Urban,Jammu & Kashmir,Property Crime,Burglary,Male,13-17,7119,4511,2608,6530,589
2006,Urban,Maharashtra,Crime Against Men,Robbery,Male,31-45,8889,7523,1366,7649,1240
2006,Rural,Gujarat,Crime Against Children,Kidnapping,Female,13-17,5276,3098,2178,3634,1642
2003,Urban,Delhi,Property Crime,Arson,Female,31-45,876,194,682,381,495
2006,Urban,Andhra Pradesh,Crime Against Children,Kidnapping,Female,31-45,4932,1001,3931,1090,3842
2001,Urban,Kerala,Property Crime,Theft,Female,60+,4111,1077,3034,1383,2728
2005,Urban,Bihar,Other Crimes,Fraud,Female,46-60,4136,972,3164,2791,1345
2010,Rural,Himachal Pradesh,Crime Against Women,Molestation,Male,0-12,2462,1952,510,2360,102
2002,Urban,Himachal Pradesh,Property Crime,Burglary,Female,13-17,5454,651,4803,1726,3728
2004,Urban,Jharkhand,Crime Against Men,Murder,Male,31-45,8773,1159,7614,1397,7376
2006,Urban,Mizoram,Crime Against Women,Domestic Violence,Male,60+,7935,4627,3308,6630,1305
2007,Rural,Uttarakhand,Property Crime,Burglary,Male,31-45,7105,4763,2342,5118,1987
2009,Urban,Maharashtra,Crime Against Children,Trafficking,Male,46-60,3841,1317,2524,2219,1622
2010,Urban,Odisha,Crime Against Children,Kidnapping,Female,13-17,365,307,58,315,50
2004,Rural,Odisha,Crime Against Men,Extortion,Female,0-12,504,255,249,495,9
2003,Urban,Chhattisgarh,Crime Against Children,Trafficking,Male,18-30,2756,1579,1177,1931,825
2003,Rural,Bihar,Crime Against Men,Murder,Male,0-12,1276,454,822,1146,130
2003,Urban,Manipur,Crime Against Children,Child Labor,Female,31-45,4203,3549,654,3857,346
2009,Urban,Jharkhand,Crime Against Men,Murder,Female,60+,5989,2829,3160,4535,1454
2003,Rural,Andhra Pradesh,Property Crime,Burglary,Female,60+,3220,2159,1061,2320,900
2010,Rural,Karnataka,Crime Against Children,Kidnapping,Male,31-45,6363,4939,1424,5904,459
2006,Urban,Madhya Pradesh,Other Crimes,Corruption,Male,60+,4417,555,3862,2624,1793
2008,Urban,Uttarakhand,Crime Against Children,Child Abuse,Female,31-45,8895,3440,5455,7894,1001
2010,Rural,Haryana,Other Crimes,Fraud,Male,46-60,9819,6557,3262,8392,1427
2003,Rural,Karnataka,Crime Against Men,Murder,Female,13-17,9178,482,8696,6841,2337
2008,Rural,Manipur,Property Crime,Theft,Male,18-30,8670,5917,2753,8377,293
2010,Urban,Nagaland,Crime Against Children,Trafficking,Female,13-17,4372,1561,2811,3055,1317
2002,Urban,Assam,Crime Against Men,Murder,Male,13-17,7316,4698,2618,6172,1144
2009,Urban,Tamil Nadu,Crime Against Children,Trafficking,Male,0-12,1214,341,873,887,327
2004,Rural,Odisha,Crime Against Children,Child Abuse,Female,31-45,5348,92,5256,2470,2878
2010,Urban,Odisha,Crime Against Men,Murder,Male,46-60,7586,3173,4413,4632,2954
2005,Rural,Sikkim,Crime Against Women,Dowry Deaths,Female,18-30,3580,1568,2012,2736,844
2002,Rural,Kerala,Crime Against Children,Kidnapping,Female,18-30,4401,287,4114,3923,478
2003,Rural,Sikkim,Crime Against Men,Robbery,Female,31-45,5288,2764,2524,4364,924
2004,Rural,Madhya Pradesh,Other Crimes,Fraud,Male,13-17,6056,2779,3277,3139,2917
2003,Rural,Manipur,Other Crimes,Corruption,Male,13-17,884,434,450,812,72
2010,Urban,Tripura,Property Crime,Vandalism,Female,46-60,425,303,122,391,34
2008,Urban,Manipur,Crime Against Men,Robbery,Male,18-30,9871,5313,4558,5972,3899
2002,Urban,Delhi,Property Crime,Arson,Female,46-60,2271,192,2079,2050,221
2009,Rural,Andhra Pradesh,Property Crime,Vandalism,Male,46-60,3846,2150,1696,3271,575
2002,Rural,Uttar Pradesh,Other Crimes,Cyber Crime,Female,31-45,2392,1821,571,2037,355
2003,Urban,Jharkhand,Crime Against Children,Child Abuse,Female,0-12,7517,2511,5006,6591,926
2009,Rural,Uttarakhand,Other Crimes,Corruption,Male,0-12,3406,1361,2045,2786,620
2006,Urban,Kerala,Property Crime,Burglary,Male,46-60,1549,771,778,1277,272
2008,Urban,Odisha,Crime Against Children,Kidnapping,Female,13-17,7672,2738,4934,4327,3345
2007,Rural,West Bengal,Crime Against Children,Kidnapping,Male,46-60,5955,4550,1405,4783,1172
2005,Rural,Kerala,Crime Against Women,Molestation,Female,60+,5817,2721,3096,3331,2486
2007,Rural,Andhra Pradesh,Crime Against Children,Trafficking,Male,60+,2669,1958,711,2405,264
2004,Rural,Kerala,Crime Against Women,Domestic Violence,Male,31-45,3545,1790,1755,2763,782
2007,Urban,Gujarat,Property Crime,Theft,Female,46-60,8008,4124,3884,4938,3070
2007,Rural,Uttarakhand,Property Crime,Arson,Male,60+,8912,5628,3284,8071,841
2010,Urban,Meghalaya,Crime Against Children,Child Labor,Female,13-17,9034,4986,4048,6365,2669
2001,Rural,Assam,Crime Against Men,Extortion,Female,46-60,7746,2775,4971,4850,2896
2005,Rural,Delhi,Crime Against Children,Trafficking,Male,31-45,9127,757,8370,2411,6716
2010,Rural,Chhattisgarh,Crime Against Women,Molestation,Female,0-12,3566,3475,91,3531,35
2007,Rural,Gujarat,Other Crimes,Fraud,Female,18-30,3584,542,3042,999,2585
2010,Urban,Assam,Property Crime,Theft,Male,18-30,9367,8693,674,8924,443
2004,Rural,West Bengal,Crime Against Women,Dowry Deaths,Male,18-30,2755,339,2416,1349,1406
2001,Urban,Karnataka,Crime Against Women,Domestic Violence,Female,31-45,1174,1067,107,1122,52
2004,Urban,Odisha,Crime Against Children,Kidnapping,Female,0-12,2385,2040,345,2216,169
2009,Urban,Nagaland,Property Crime,Theft,Female,60+,3699,589,3110,2138,1561
2002,Urban,Haryana,Property Crime,Vandalism,Male,60+,1384,779,605,849,535
2007,Urban,Meghalaya,Crime Against Women,Molestation,Female,0-12,5186,4812,374,4850,336
2001,Rural,Tamil Nadu,Crime Against Children,Child Labor,Female,46-60,2713,1004,1709,1553,1160
2005,Urban,Bihar,Crime Against Women,Rape,Male,13-17,637,637,0,637,0
2002,Urban,Chhattisgarh,Crime Against Men,Robbery,Female,0-12,2030,1360,670,1604,426
2006,Urban,Manipur,Crime Against Men,Extortion,Female,31-45,7909,4332,3577,6532,1377
2008,Rural,Andhra Pradesh,Other Crimes,Fraud,Female,60+,5806,5395,411,5459,347
2004,Urban,Nagaland,Other Crimes,Drug Offense,Female,46-60,7818,6100,1718,6449,1369
2003,Urban,Bihar,Crime Against Children,Kidnapping,Male,0-12,1979,1537,442,1781,198
2003,Rural,Maharashtra,Crime Against Men,Murder,Male,13-17,7660,3247,4413,4456,3204
2002,Urban,Rajasthan,Crime Against Women,Molestation,Female,31-45,6684,6495,189,6552,132
2008,Urban,West Bengal,Crime Against Men,Extortion,Male,31-45,7570,6331,1239,6451,1119
2005,Rural,Gujarat,Crime Against Children,Child Labor,Female,13-17,5425,2966,2459,4917,508
2007,Rural,Assam,Crime Against Children,Child Abuse,Female,60+,7985,2117,5868,5947,2038
2006,Rural,Madhya Pradesh,Property Crime,Burglary,Female,46-60,2892,2863,29,2866,26
2010,Rural,Uttarakhand,Property Crime,Arson,Female,18-30,2107,1683,424,2041,66
2003,Urban,Manipur,Crime Against Men,Murder,Female,60+,4911,3010,1901,3836,1075
2003,Urban,Mizoram,Crime Against Children,Child Labor,Female,0-12,9148,9140,8,9146,2
2010,Rural,Meghalaya,Crime Against Men,Murder,Female,46-60,252,222,30,232,20
2002,Urban,Meghalaya,Crime Against Women,Rape,Male,31-45,4502,4060,442,4134,368
2006,Rural,Tripura,Property Crime,Theft,Male,13-17,3544,2599,945,3309,235
2010,Urban,Madhya Pradesh,Other Crimes,Cyber Crime,Male,60+,918,783,135,855,63
2005,Urban,Arunachal Pradesh,Property Crime,Burglary,Female,13-17,1887,997,890,1392,495
2001,Rural,Bihar,Crime Against Men,Extortion,Female,46-60,6598,4370,2228,4756,1842
2005,Rural,Karnataka,Crime Against Women,Domestic Violence,Male,31-45,8043,6200,1843,6680,1363
2009,Urban,Assam,Other Crimes,Corruption,Female,46-60,5128,2510,2618,3041,2087
2007,Urban,Uttarakhand,Crime Against Children,Trafficking,Male,60+,3265,842,2423,2286,979
2009,Rural,Uttar Pradesh,Other Crimes,Drug Offense,Female,13-17,5076,790,4286,3206,1870
2009,Rural,Haryana,Crime Against Women,Molestation,Female,31-45,4160,3250,910,3373,787
2009,Rural,Delhi,Property Crime,Burglary,Female,18-30,5086,321,4765,1048,4038
2009,Rural,Himachal Pradesh,Crime Against Men,Assault,Female,18-30,7443,756,6687,6200,1243
2005,Rural,Haryana,Crime Against Men,Robbery,Male,46-60,7431,7370,61,7374,57
2010,Rural,Tripura,Property Crime,Theft,Female,60+,4389,2405,1984,3214,1175
2006,Rural,Arunachal Pradesh,Crime Against Children,Kidnapping,Male,60+,5097,3015,2082,4513,584
2005,Rural,Assam,Crime Against Children,Trafficking,Male,60+,4704,3661,1043,4460,244
2010,Rural,West Bengal,Other Crimes,Drug Offense,Female,31-45,6280,2936,3344,4262,2018
2002,Rural,Karnataka,Crime Against Children,Child Labor,Male,31-45,4405,752,3653,3251,1154
2010,Urban,Tamil Nadu,Crime Against Men,Robbery,Male,60+,408,343,65,349,59
2001,Rural,Manipur,Crime Against Women,Domestic Violence,Female,18-30,9441,2665,6776,5710,3731
2008,Rural,Himachal Pradesh,Other Crimes,Fraud,Male,60+,407,357,50,372,35
2001,Urban,Uttarakhand,Property Crime,Arson,Female,60+,8222,7408,814,7541,681
2004,Urban,Assam,Other Crimes,Drug Offense,Female,31-45,7881,5146,2735,6201,1680
2006,Urban,Telangana,Crime Against Men,Murder,Male,31-45,4391,163,4228,1455,2936
2010,Rural,Jharkhand,Crime Against Men,Extortion,Male,13-17,1869,810,1059,852,1017
2010,Rural,Madhya Pradesh,Property Crime,Vandalism,Female,60+,9583,6921,2662,7578,2005
2010,Urban,Uttarakhand,Crime Against Men,Extortion,Male,31-45,8348,3712,4636,5847,2501
2007,Rural,Manipur,Property Crime,Burglary,Female,0-12,5339,5085,254,5207,132
2009,Rural,Kerala,Crime Against Women,Dowry Deaths,Male,31-45,2667,952,1715,2130,537
2009,Urban,West Bengal,Property Crime,Vandalism,Female,31-45,2201,2141,60,2154,47
2008,Urban,Tripura,Property Crime,Vandalism,Male,13-17,2438,2354,84,2431,7
2008,Urban,Andhra Pradesh,Crime Against Children,Child Abuse,Female,46-60,4624,3019,1605,3849,775
2002,Urban,West Bengal,Crime Against Men,Robbery,Male,60+,1114,510,604,729,385
2003,Urban,Telangana,Property Crime,Theft,Female,46-60,9807,3682,6125,8479,1328
2007,Urban,Uttar Pradesh,Property Crime,Vandalism,Female,31-45,7322,6545,777,6630,692
2006,Rural,Manipur,Crime Against Women,Dowry Deaths,Female,0-12,1490,1084,406,1370,120
2006,Urban,Manipur,Property Crime,Theft,Female,46-60,4546,1203,3343,4186,360
2003,Rural,Punjab,Crime Against Men,Robbery,Male,18-30,1837,383,1454,1594,243
2002,Urban,Tripura,Other Crimes,Fraud,Female,18-30,9240,3084,6156,5784,3456
2006,Rural,Chhattisgarh,Crime Against Children,Child Labor,Male,60+,2306,1252,1054,2075,231
2003,Rural,Maharashtra,Crime Against Men,Extortion,Male,13-17,3133,288,2845,2275,858
2009,Rural,Arunachal Pradesh,Other Crimes,Drug Offense,Male,31-45,3691,2285,1406,2876,815
2006,Urban,Kerala,Crime Against Men,Robbery,Female,18-30,2660,1244,1416,2126,534
2003,Urban,Manipur,Other Crimes,Drug Offense,Male,60+,7152,3990,3162,4136,3016
2004,Rural,Mizoram,Crime Against Men,Murder,Female,31-45,1233,16,1217,1113,120
2001,Rural,West Bengal,Crime Against Children,Kidnapping,Female,0-12,4570,3784,786,4270,300
2006,Urban,Jammu & Kashmir,Other Crimes,Corruption,Female,31-45,5857,832,5025,1323,4534
2009,Rural,Jammu & Kashmir,Crime Against Children,Child Abuse,Female,46-60,6508,5921,587,5927,581
2009,Rural,Uttarakhand,Property Crime,Theft,Male,13-17,4359,851,3508,2634,1725
2006,Urban,Himachal Pradesh,Crime Against Women,Domestic Violence,Male,60+,7617,695,6922,2684,4933
2002,Urban,West Bengal,Crime Against Women,Rape,Male,18-30,8830,3182,5648,6398,2432
2007,Urban,Telangana,Crime Against Women,Rape,Female,0-12,6877,1393,5484,3532,3345
2005,Urban,Himachal Pradesh,Crime Against Children,Child Labor,Female,60+,4604,2576,2028,3253,1351
2003,Rural,Madhya Pradesh,Crime Against Women,Dowry Deaths,Female,46-60,7098,4030,3068,4101,2997
2005,Urban,West Bengal,Property Crime,Theft,Female,46-60,6138,160,5978,2773,3365
2005,Rural,Karnataka,Crime Against Men,Robbery,Male,60+,1106,586,520,882,224
2004,Rural,Mizoram,Crime Against Men,Murder,Female,13-17,6772,5372,1400,6724,48
2007,Rural,Kerala,Crime Against Children,Child Abuse,Male,31-45,1320,850,470,961,359
2002,Urban,Tamil Nadu,Other Crimes,Fraud,Male,46-60,4803,462,4341,4436,367
2004,Urban,Nagaland,Property Crime,Theft,Male,18-30,2026,103,1923,643,1383
2007,Rural,Madhya Pradesh,Property Crime,Arson,Female,46-60,5901,1727,4174,4268,1633
2006,Rural,Tamil Nadu,Crime Against Children,Kidnapping,Female,18-30,277,47,230,274,3
2003,Urban,Telangana,Other Crimes,Drug Offense,Female,46-60,9422,2113,7309,7516,1906
2002,Urban,Punjab,Other Crimes,Cyber Crime,Male,18-30,6245,558,5687,5199,1046
2004,Rural,Andhra Pradesh,Crime Against Women,Dowry Deaths,Male,18-30,313,220,93,289,24
2010,Rural,Tamil Nadu,Crime Against Children,Trafficking,Male,46-60,4127,2470,1657,2680,1447
2007,Urban,Mizoram,Crime Against Men,Assault,Female,0-12,9988,2761,7227,7476,2512
2004,Rural,Madhya Pradesh,Crime Against Women,Domestic Violence,Female,31-45,8147,2907,5240,3168,4979
2006,Rural,Madhya Pradesh,Other Crimes,Cyber Crime,Male,0-12,8575,5001,3574,6404,2171
2006,Rural,Manipur,Crime Against Men,Robbery,Male,13-17,3328,695,2633,3178,150
2006,Urban,Himachal Pradesh,Crime Against Women,Molestation,Male,13-17,7468,7371,97,7377,91
2007,Urban,Punjab,Crime Against Women,Domestic Violence,Male,60+,871,815,56,861,10
2001,Urban,Tamil Nadu,Crime Against Children,Child Abuse,Female,13-17,3793,1354,2439,2497,1296
2008,Rural,Madhya Pradesh,Property Crime,Vandalism,Male,0-12,327,36,291,219,108
2001,Urban,Chhattisgarh,Other Crimes,Drug Offense,Female,31-45,8243,3527,4716,4228,4015
2005,Rural,Madhya Pradesh,Other Crimes,Cyber Crime,Male,13-17,342,271,71,302,40
2005,Urban,Karnataka,Other Crimes,Drug Offense,Female,18-30,6006,1202,4804,2306,3700
2010,Rural,Bihar,Crime Against Men,Assault,Male,31-45,5661,2137,3524,3229,2432
2009,Urban,Rajasthan,Crime Against Men,Assault,Male,0-12,3849,50,3799,180,3669
2003,Urban,Gujarat,Crime Against Children,Trafficking,Male,13-17,3352,1714,1638,1875,1477
2008,Urban,Bihar,Crime Against Women,Rape,Male,31-45,1846,337,1509,1750,96
2010,Urban,Delhi,Crime Against Women,Molestation,Male,31-45,6736,6178,558,6550,186
2003,Rural,Tamil Nadu,Property Crime,Theft,Female,31-45,5732,3225,2507,3512,2220
2006,Urban,Tripura,Crime Against Children,Child Abuse,Female,31-45,393,150,243,191,202
2010,Rural,Tamil Nadu,Other Crimes,Drug Offense,Female,31-45,4182,1968,2214,3977,205
2005,Urban,Andhra Pradesh,Property Crime,Theft,Male,0-12,1319,641,678,946,373
2010,Urban,Odisha,Crime Against Children,Child Labor,Male,46-60,9226,4037,5189,6034,3192
2008,Urban,Delhi,Other Crimes,Fraud,Male,60+,416,108,308,187,229
2006,Rural,Haryana,Crime Against Children,Kidnapping,Female,46-60,588,383,205,498,90
2002,Urban,Kerala,Crime Against Women,Dowry Deaths,Female,31-45,2686,2098,588,2159,527
2008,Rural,Madhya Pradesh,Property Crime,Arson,Male,31-45,9009,2801,6208,8579,430
2005,Urban,Mizoram,Crime Against Women,Rape,Male,18-30,6015,2853,3162,3255,2760
2006,Rural,Odisha,Other Crimes,Cyber Crime,Male,46-60,6100,2503,3597,4950,1150
2008,Urban,Telangana,Crime Against Men,Robbery,Female,13-17,7347,6025,1322,7278,69
2006,Urban,Meghalaya,Other Crimes,Corruption,Female,0-12,2884,2223,661,2779,105
2009,Urban,Haryana,Other Crimes,Corruption,Female,13-17,4755,3324,1431,4127,628
2002,Rural,Jammu & Kashmir,Crime Against Men,Extortion,Female,0-12,8434,864,7570,5833,2601
2008,Rural,Bihar,Crime Against Men,Extortion,Female,18-30,4954,167,4787,4684,270
2009,Rural,Kerala,Crime Against Children,Child Labor,Male,60+,9894,8500,1394,9241,653
2010,Rural,Sikkim,Crime Against Men,Murder,Male,0-12,6976,3541,3435,6321,655
2003,Rural,Uttar Pradesh,Crime Against Children,Child Abuse,Female,0-12,1454,1432,22,1433,21
2005,Urban,Maharashtra,Other Crimes,Drug Offense,Female,13-17,657,413,244,649,8
2009,Rural,Gujarat,Crime Against Women,Rape,Female,0-12,6796,4103,2693,5944,852
2005,Urban,Goa,Property Crime,Burglary,Female,60+,8893,5460,3433,7106,1787
2005,Rural,Gujarat,Crime Against Children,Kidnapping,Female,0-12,5146,3953,1193,4834,312
2009,Urban,Uttar Pradesh,Property Crime,Burglary,Male,60+,600,250,350,495,105
2001,Rural,West Bengal,Other Crimes,Cyber Crime,Male,31-45,1725,1193,532,1662,63
2010,Rural,Tripura,Crime Against Women,Molestation,Male,31-45,2023,579,1444,1059,964
2008,Urban,Himachal Pradesh,Crime Against Men,Robbery,Female,31-45,207,154,53,161,46
2003,Urban,Uttarakhand,Crime Against Women,Domestic Violence,Female,60+,4393,3580,813,4098,295
2004,Rural,Kerala,Crime Against Men,Assault,Male,0-12,5366,5146,220,5169,197
2003,Rural,Jharkhand,Property Crime,Theft,Female,18-30,4666,3486,1180,4625,41
2007,Urban,Meghalaya,Property Crime,Theft,Female,0-12,1266,102,1164,183,1083
2005,Rural,Himachal Pradesh,Crime Against Men,Robbery,Female,13-17,222,206,16,218,4
2010,Urban,Himachal Pradesh,Crime Against Children,Child Labor,Female,60+,4562,3860,702,4102,460
2003,Urban,Karnataka,Other Crimes,Fraud,Male,18-30,312,235,77,259,53
2006,Urban,Uttarakhand,Crime Against Women,Dowry Deaths,Male,13-17,548,312,236,503,45
2007,Urban,Tripura,Crime Against Men,Robbery,Female,18-30,1134,307,827,563,571
2006,Rural,Chhattisgarh,Other Crimes,Cyber Crime,Male,13-17,8053,3245,4808,7614,439
2004,Urban,Madhya Pradesh,Property Crime,Burglary,Male,31-45,5403,2790,2613,4943,460
2004,Rural,Arunachal Pradesh,Property Crime,Theft,Female,31-45,2747,300,2447,2012,735
2009,Urban,Madhya Pradesh,Other Crimes,Drug Offense,Male,60+,7133,5803,1330,6965,168
2005,Urban,Bihar,Crime Against Children,Child Labor,Female,46-60,6221,4563,1658,5000,1221
2008,Urban,Jammu & Kashmir,Crime Against Men,Assault,Male,46-60,9958,5659,4299,7133,2825
2002,Urban,Arunachal Pradesh,Property Crime,Vandalism,Male,31-45,9889,3277,6612,7976,1913
2005,Urban,Haryana,Crime Against Men,Extortion,Male,18-30,8256,7821,435,7976,280
2007,Rural,Rajasthan,Crime Against Men,Extortion,Female,46-60,8455,4090,4365,6719,1736
2006,Urban,Tripura,Other Crimes,Fraud,Female,18-30,140,116,24,130,10
2005,Urban,Rajasthan,Crime Against Men,Murder,Female,0-12,9143,3489,5654,5295,3848
2006,Urban,Karnataka,Other Crimes,Cyber Crime,Female,60+,7160,2784,4376,6039,1121
2006,Rural,West Bengal,Crime Against Women,Molestation,Male,46-60,3458,2300,1158,2666,792
2009,Urban,Andhra Pradesh,Other Crimes,Fraud,Female,60+,9514,883,8631,3118,6396
2003,Rural,Goa,Crime Against Women,Rape,Female,18-30,2839,446,2393,2340,499
2008,Rural,Jharkhand,Other Crimes,Corruption,Female,31-45,2663,1921,742,2010,653
2007,Urban,Bihar,Crime Against Women,Domestic Violence,Female,60+,5443,3277,2166,4519,924
2008,Rural,Manipur,Crime Against Women,Molestation,Female,13-17,8627,327,8300,5146,3481
2007,Urban,Goa,Other Crimes,Corruption,Male,18-30,976,753,223,880,96
2002,Urban,Rajasthan,Crime Against Men,Murder,Female,0-12,3283,2311,972,3050,233
2004,Urban,Haryana,Crime Against Men,Robbery,Female,46-60,8497,3229,5268,6468,2029
2005,Rural,Kerala,Property Crime,Burglary,Female,18-30,6022,3699,2323,5887,135
2009,Urban,Uttarakhand,Property Crime,Theft,Male,46-60,3337,2479,858,3063,274
2005,Urban,Tamil Nadu,Property Crime,Theft,Female,0-12,4362,3571,791,3620,742
2007,Urban,Karnataka,Crime Against Men,Robbery,Female,18-30,1504,716,788,1212,292
2006,Urban,Madhya Pradesh,Crime Against Men,Murder,Male,13-17,5503,4704,799,4812,691
2005,Rural,Chhattisgarh,Property Crime,Burglary,Male,18-30,822,555,267,817,5
2003,Rural,Uttarakhand,Property Crime,Burglary,Male,31-45,4202,859,3343,3745,457
2005,Urban,Sikkim,Crime Against Men,Assault,Female,18-30,2323,656,1667,2098,225
2008,Rural,West Bengal,Crime Against Women,Domestic Violence,Female,0-12,8972,3301,5671,4069,4903
2006,Urban,Bihar,Crime Against Children,Child Abuse,Male,60+,6121,578,5543,5164,957
2002,Rural,Madhya Pradesh,Crime Against Children,Trafficking,Female,60+,5019,3447,1572,4381,638
2002,Rural,Telangana,Other Crimes,Drug Offense,Female,31-45,5285,1876,3409,2473,2812
2007,Rural,Punjab,Crime Against Women,Molestation,Male,31-45,1065,520,545,595,470
2002,Rural,Andhra Pradesh,Crime Against Men,Robbery,Male,18-30,2580,1680,900,2067,513
2002,Rural,Nagaland,Property Crime,Vandalism,Male,60+,8008,3055,4953,4870,3138
2004,Rural,Rajasthan,Other Crimes,Cyber Crime,Male,31-45,351,185,166,328,23
2006,Rural,Arunachal Pradesh,Crime Against Children,Child Abuse,Male,0-12,2548,1188,1360,2293,255
2007,Urban,Tamil Nadu,Crime Against Men,Robbery,Male,13-17,1194,95,1099,164,1030
2005,Urban,Rajasthan,Other Crimes,Corruption,Male,60+,1445,454,991,1228,217
2006,Rural,Manipur,Property Crime,Theft,Male,31-45,2788,1438,1350,2482,306
2007,Urban,Haryana,Property Crime,Burglary,Male,31-45,2933,1464,1469,2495,438
2005,Rural,Arunachal Pradesh,Property Crime,Vandalism,Female,13-17,6976,3566,3410,5688,1288
2008,Urban,Uttarakhand,Property Crime,Arson,Male,0-12,9848,7325,2523,7931,1917
2001,Rural,Manipur,Property Crime,Arson,Male,18-30,2681,171,2510,2525,156
2009,Urban,Himachal Pradesh,Other Crimes,Drug Offense,Male,31-45,9927,6459,3468,7594,2333
2003,Urban,Uttarakhand,Property Crime,Theft,Male,46-60,9261,348,8913,8765,496
2009,Urban,Jammu & Kashmir,Crime Against Children,Child Abuse,Male,0-12,5941,706,5235,5421,520
2006,Rural,Manipur,Crime Against Children,Child Abuse,Male,18-30,5846,5177,669,5614,232
2006,Urban,Uttarakhand,Other Crimes,Drug Offense,Female,31-45,7916,2064,5852,7633,283
2004,Urban,Delhi,Property Crime,Arson,Female,31-45,264,244,20,260,4
2003,Urban,Telangana,Property Crime,Arson,Female,60+,7818,2753,5065,6773,1045
2005,Rural,Bihar,Crime Against Men,Extortion,Male,18-30,1138,205,933,737,401
2001,Urban,Arunachal Pradesh,Property Crime,Arson,Male,13-17,3796,3251,545,3664,132
2007,Rural,Telangana,Property Crime,Arson,Female,13-17,4844,2416,2428,3639,1205
2002,Urban,Telangana,Crime Against Women,Molestation,Male,0-12,3735,1088,2647,2289,1446
2010,Rural,Chhattisgarh,Crime Against Women,Dowry Deaths,Female,46-60,6619,5182,1437,6361,258
2009,Rural,Chhattisgarh,Other Crimes,Cyber Crime,Male,13-17,4355,449,3906,2439,1916
2003,Urban,Mizoram,Property Crime,Theft,Female,46-60,4217,467,3750,2733,1484
2009,Urban,Uttar Pradesh,Crime Against Men,Extortion,Female,0-12,1548,1076,472,1368,180
2006,Rural,Gujarat,Crime Against Women,Molestation,Male,60+,6869,5690,1179,6373,496
2009,Rural,Madhya Pradesh,Crime Against Children,Child Labor,Male,46-60,6057,3451,2606,4065,1992
2006,Rural,Uttarakhand,Other Crimes,Fraud,Female,13-17,4266,719,3547,806,3460
2001,Urban,Jharkhand,Other Crimes,Corruption,Female,46-60,7154,2000,5154,3415,3739
2005,Urban,Andhra Pradesh,Property Crime,Arson,Female,60+,3728,2103,1625,3266,462
2006,Rural,Chhattisgarh,Crime Against Men,Assault,Female,18-30,7545,4902,2643,7517,28
2002,Urban,Arunachal Pradesh,Other Crimes,Drug Offense,Female,31-45,2513,557,1956,2195,318
2009,Rural,Rajasthan,Crime Against Children,Trafficking,Female,46-60,1929,19,1910,1862,67
2009,Urban,Uttar Pradesh,Property Crime,Arson,Female,13-17,4361,2264,2097,3640,721
2002,Urban,West Bengal,Crime Against Children,Child Abuse,Male,60+,2646,88,2558,427,2219
2001,Urban,Tamil Nadu,Crime Against Women,Molestation,Male,18-30,5247,1802,3445,5086,161
2008,Rural,Mizoram,Other Crimes,Fraud,Female,46-60,5996,2585,3411,3016,2980
2004,Rural,Gujarat,Other Crimes,Fraud,Male,46-60,4617,3402,1215,4260,357
2007,Rural,Assam,Other Crimes,Fraud,Male,18-30,5853,2314,3539,3556,2297
2008,Urban,Odisha,Property Crime,Burglary,Female,13-17,9100,8417,683,9023,77
2007,Urban,Karnataka,Property Crime,Arson,Female,0-12,8634,3041,5593,3744,4890
2010,Rural,Sikkim,Crime Against Men,Murder,Male,60+,7419,3106,4313,3299,4120
2006,Urban,Bihar,Crime Against Children,Kidnapping,Male,46-60,5224,2672,2552,3392,1832
2008,Rural,Tamil Nadu,Crime Against Children,Kidnapping,Male,18-30,3881,1466,2415,2334,1547
2008,Rural,Jharkhand,Property Crime,Arson,Female,18-30,235,234,1,235,0
2004,Rural,Haryana,Crime Against Children,Kidnapping,Male,60+,8275,6077,2198,6537,1738
2007,Urban,Tamil Nadu,Crime Against Men,Murder,Male,60+,1901,1125,776,1195,706
2005,Urban,Manipur,Other Crimes,Corruption,Female,18-30,8288,4426,3862,6516,1772
2007,Urban,West Bengal,Crime Against Children,Kidnapping,Male,18-30,6613,1857,4756,1863,4750
2002,Rural,Nagaland,Property Crime,Theft,Female,46-60,4146,1740,2406,4129,17
2003,Urban,Tripura,Other Crimes,Fraud,Male,31-45,5866,2993,2873,5286,580
2003,Urban,Assam,Crime Against Men,Assault,Male,18-30,6382,92,6290,2365,4017
2007,Urban,Tamil Nadu,Crime Against Children,Child Labor,Female,60+,6116,1019,5097,2793,3323
2005,Urban,Tripura,Other Crimes,Corruption,Female,60+,5931,257,5674,3937,1994
2002,Rural,Madhya Pradesh,Crime Against Children,Child Abuse,Female,60+,8735,1797,6938,7565,1170
2003,Rural,Sikkim,Crime Against Children,Child Labor,Female,31-45,6359,11,6348,6023,336
2007,Urban,Kerala,Crime Against Men,Extortion,Female,13-17,6228,136,6092,4250,1978
2004,Urban,Delhi,Property Crime,Burglary,Female,46-60,8891,8119,772,8500,391
2007,Rural,Maharashtra,Property Crime,Theft,Male,46-60,6553,6363,190,6511,42
2010,Rural,Meghalaya,Crime Against Women,Domestic Violence,Male,46-60,1006,741,265,972,34
2002,Rural,Gujarat,Crime Against Men,Robbery,Male,31-45,3864,3144,720,3777,87
2010,Urban,Arunachal Pradesh,Crime Against Children,Trafficking,Male,60+,3328,2018,1310,3188,140
2010,Rural,Andhra Pradesh,Crime Against Women,Domestic Violence,Female,46-60,5716,831,4885,3989,1727
2007,Rural,Telangana,Property Crime,Theft,Male,0-12,1780,435,1345,907,873
2010,Rural,Himachal Pradesh,Crime Against Children,Child Labor,Male,0-12,2844,1749,1095,2196,648
2007,Rural,Jammu & Kashmir,Crime Against Children,Child Labor,Female,18-30,6275,4859,1416,5713,562
2001,Urban,Kerala,Crime Against Men,Assault,Female,18-30,6546,961,5585,5750,796
2009,Rural,Chhattisgarh,Other Crimes,Corruption,Female,60+,4975,2231,2744,3860,1115
2003,Urban,Haryana,Crime Against Women,Dowry Deaths,Male,13-17,6285,3012,3273,3705,2580
2007,Rural,Jharkhand,Crime Against Men,Extortion,Male,0-12,7980,5699,2281,5938,2042
2009,Urban,Odisha,Crime Against Women,Rape,Male,31-45,9578,8112,1466,8212,1366
2005,Urban,Uttar Pradesh,Crime Against Children,Trafficking,Female,46-60,8377,201,8176,1190,7187
2004,Urban,Madhya Pradesh,Property Crime,Burglary,Male,46-60,4808,1552,3256,1924,2884
2001,Urban,Goa,Property Crime,Theft,Female,46-60,3559,457,3102,3442,117
2009,Rural,Tripura,Property Crime,Theft,Female,60+,331,302,29,304,27
2010,Rural,Arunachal Pradesh,Property Crime,Arson,Male,60+,3552,819,2733,3014,538
2008,Rural,Gujarat,Crime Against Men,Assault,Female,18-30,2848,1347,1501,1529,1319
2005,Rural,Uttarakhand,Other Crimes,Cyber Crime,Male,31-45,2296,1912,384,2159,137
2010,Urban,Mizoram,Other Crimes,Fraud,Male,31-45,999,753,246,807,192
2006,Urban,Rajasthan,Crime Against Women,Rape,Female,13-17,7325,4341,2984,6188,1137
2007,Rural,Tripura,Property Crime,Vandalism,Male,13-17,2124,370,1754,445,1679
2007,Urban,Chhattisgarh,Crime Against Children,Child Labor,Male,18-30,7846,1569,6277,3946,3900
2007,Urban,Tamil Nadu,Other Crimes,Corruption,Female,0-12,1464,1381,83,1432,32
2003,Rural,West Bengal,Crime Against Men,Extortion,Male,18-30,6988,3868,3120,4755,2233
2009,Rural,Rajasthan,Property Crime,Arson,Female,31-45,3256,2286,970,3222,34
2004,Urban,Uttar Pradesh,Property Crime,Theft,Male,31-45,5952,3271,2681,3342,2610
2008,Rural,Punjab,Other Crimes,Cyber Crime,Male,18-30,1410,907,503,1319,91
2009,Urban,Manipur,Other Crimes,Cyber Crime,Female,0-12,5044,2209,2835,2416,2628
2007,Rural,Kerala,Property Crime,Vandalism,Female,46-60,1445,1342,103,1371,74
2002,Rural,Gujarat,Crime Against Men,Assault,Female,31-45,375,72,303,162,213
2009,Urban,Sikkim,Property Crime,Vandalism,Male,60+,3849,1172,2677,1448,2401
2004,Rural,Kerala,Crime Against Women,Rape,Male,13-17,2801,1574,1227,2511,290
2001,Urban,Madhya Pradesh,Other Crimes,Drug Offense,Male,13-17,8054,3652,4402,7201,853
2003,Urban,Delhi,Crime Against Women,Molestation,Male,31-45,9347,2461,6886,7736,1611
2005,Rural,Kerala,Crime Against Women,Molestation,Female,0-12,7223,2758,4465,5059,2164
2005,Rural,Chhattisgarh,Crime Against Men,Assault,Male,46-60,8037,6015,2022,7101,936
2001,Urban,Telangana,Other Crimes,Cyber Crime,Female,31-45,548,530,18,531,17
2002,Urban,Goa,Crime Against Children,Trafficking,Female,13-17,7947,3996,3951,5398,2549
2001,Urban,Delhi,Crime Against Men,Robbery,Male,46-60,2449,1510,939,2214,235
2004,Urban,Karnataka,Crime Against Women,Domestic Violence,Male,46-60,7177,3426,3751,4233,2944
2002,Rural,Goa,Other Crimes,Cyber Crime,Female,60+,8865,2700,6165,5922,2943
2001,Rural,Madhya Pradesh,Crime Against Men,Extortion,Male,46-60,5044,3568,1476,4057,987
2008,Rural,Assam,Other Crimes,Cyber Crime,Female,18-30,9311,5864,3447,8844,467
2010,Urban,Arunachal Pradesh,Crime Against Men,Assault,Male,31-45,8640,7501,1139,8403,237
2010,Urban,Jharkhand,Crime Against Children,Kidnapping,Male,60+,1931,1745,186,1747,184
2003,Urban,Uttar Pradesh,Other Crimes,Cyber Crime,Male,18-30,8387,4384,4003,5082,3305
2009,Rural,Andhra Pradesh,Crime Against Men,Extortion,Female,0-12,5604,4987,617,5589,15
2003,Rural,Delhi,Crime Against Men,Murder,Female,46-60,5900,3989,1911,5342,558
2010,Rural,Andhra Pradesh,Other Crimes,Drug Offense,Female,31-45,8709,3192,5517,7513,1196
2002,Rural,West Bengal,Crime Against Men,Robbery,Female,31-45,7637,2078,5559,6046,1591
2002,Urban,Sikkim,Crime Against Children,Child Labor,Female,18-30,4794,3191,1603,4607,187
2002,Urban,Uttar Pradesh,Crime Against Children,Child Labor,Male,31-45,2903,1505,1398,1787,1116
2008,Rural,Telangana,Crime Against Men,Assault,Male,31-45,7557,6610,947,7235,322
2009,Urban,Maharashtra,Property Crime,Theft,Male,31-45,975,935,40,960,15
2006,Rural,Mizoram,Property Crime,Burglary,Female,13-17,4477,2870,1607,3392,1085
2009,Urban,Jammu & Kashmir,Other Crimes,Drug Offense,Male,18-30,1160,1035,125,1076,84
2003,Urban,Gujarat,Property Crime,Vandalism,Female,18-30,2423,2327,96,2417,6
2010,Urban,Odisha,Other Crimes,Cyber Crime,Male,0-12,9354,6505,2849,7243,2111
2004,Urban,Arunachal Pradesh,Property Crime,Theft,Female,18-30,2906,1778,1128,2301,605
2009,Urban,Gujarat,Crime Against Women,Domestic Violence,Female,0-12,7992,2753,5239,6428,1564
2004,Rural,Madhya Pradesh,Crime Against Women,Molestation,Female,31-45,8877,1076,7801,3382,5495
2004,Rural,Uttarakhand,Crime Against Children,Child Abuse,Female,0-12,9419,3934,5485,8597,822
2009,Rural,Tamil Nadu,Other Crimes,Drug Offense,Male,46-60,8061,2756,5305,6439,1622
2003,Urban,Kerala,Crime Against Men,Assault,Female,18-30,6647,5139,1508,5521,1126
2003,Rural,Jharkhand,Crime Against Men,Robbery,Female,31-45,8141,4415,3726,6878,1263
2003,Rural,Nagaland,Other Crimes,Cyber Crime,Male,60+,2259,330,1929,1811,448
2007,Urban,Kerala,Crime Against Men,Robbery,Female,13-17,390,337,53,348,42
2009,Rural,Haryana,Property Crime,Theft,Male,13-17,3645,1936,1709,2253,1392
2009,Urban,Telangana,Property Crime,Theft,Male,46-60,7544,6263,1281,6851,693
2007,Urban,Telangana,Other Crimes,Cyber Crime,Male,13-17,5669,195,5474,3629,2040
2008,Rural,Madhya Pradesh,Other Crimes,Cyber Crime,Male,0-12,4033,3874,159,3977,56
2010,Urban,Manipur,Other Crimes,Corruption,Female,18-30,3698,830,2868,3404,294
2006,Urban,Meghalaya,Other Crimes,Fraud,Female,13-17,4403,83,4320,1699,2704
2004,Rural,Andhra Pradesh,Crime Against Children,Child Labor,Male,60+,6447,6010,437,6088,359
2002,Rural,Arunachal Pradesh,Crime Against Children,Kidnapping,Female,60+,8045,4991,3054,7501,544
2002,Urban,Karnataka,Crime Against Women,Molestation,Male,31-45,7760,5349,2411,7442,318
2002,Urban,Kerala,Crime Against Women,Dowry Deaths,Male,18-30,9425,4614,4811,7137,2288
2001,Urban,Goa,Crime Against Women,Molestation,Male,13-17,5947,128,5819,4625,1322
2001,Urban,Goa,Crime Against Men,Extortion,Female,46-60,3987,647,3340,3968,19
2006,Urban,Uttarakhand,Crime Against Women,Rape,Female,18-30,8114,4670,3444,6628,1486
2004,Rural,Punjab,Crime Against Children,Kidnapping,Female,60+,2505,37,2468,1281,1224
2003,Urban,Kerala,Crime Against Children,Child Labor,Male,60+,1275,551,724,1274,1
2005,Rural,Maharashtra,Crime Against Children,Child Labor,Female,60+,6101,1556,4545,1996,4105
2010,Rural,Andhra Pradesh,Crime Against Children,Kidnapping,Male,18-30,121,95,26,101,20
2003,Rural,Chhattisgarh,Crime Against Men,Murder,Female,18-30,4570,1328,3242,4344,226
2001,Rural,Sikkim,Other Crimes,Cyber Crime,Male,31-45,2209,816,1393,2109,100
2006,Rural,Maharashtra,Crime Against Women,Rape,Female,18-30,8036,6820,1216,7498,538
2002,Rural,Uttar Pradesh,Crime Against Children,Child Abuse,Female,31-45,807,702,105,804,3
2009,Rural,Sikkim,Crime Against Women,Molestation,Female,46-60,4889,4213,676,4408,481
2002,Urban,Tripura,Other Crimes,Cyber Crime,Male,31-45,4402,3405,997,4296,106
2004,Rural,Chhattisgarh,Crime Against Children,Child Labor,Male,18-30,3254,157,3097,655,2599
2002,Urban,Haryana,Crime Against Men,Extortion,Female,13-17,5909,839,5070,4705,1204
2004,Urban,Sikkim,Crime Against Women,Molestation,Male,13-17,4429,318,4111,2236,2193
2003,Urban,Meghalaya,Other Crimes,Corruption,Male,18-30,5358,2587,2771,4074,1284
2007,Urban,Meghalaya,Crime Against Women,Domestic Violence,Female,0-12,8793,3317,5476,8788,5
2002,Urban,Karnataka,Property Crime,Arson,Male,31-45,3093,1964,1129,2202,891
2004,Urban,Goa,Crime Against Men,Murder,Female,0-12,3194,1143,2051,1957,1237
2008,Urban,Nagaland,Other Crimes,Fraud,Female,0-12,8794,5539,3255,6531,2263
2001,Urban,Mizoram,Crime Against Children,Trafficking,Female,13-17,8707,4826,3881,7043,1664
2006,Urban,Punjab,Crime Against Men,Assault,Male,18-30,5766,3421,2345,4913,853
2002,Urban,Tamil Nadu,Crime Against Children,Kidnapping,Male,18-30,7914,2237,5677,2824,5090
2007,Urban,West Bengal,Property Crime,Burglary,Male,13-17,6756,1017,5739,4371,2385
2006,Urban,Odisha,Crime Against Children,Child Labor,Male,13-17,9514,4522,4992,4867,4647
2006,Urban,Andhra Pradesh,Crime Against Women,Rape,Male,46-60,2153,991,1162,1033,1120
2003,Rural,Uttarakhand,Other Crimes,Drug Offense,Male,60+,7424,7128,296,7329,95
2002,Rural,Jharkhand,Crime Against Women,Molestation,Male,31-45,2177,1925,252,1928,249
2005,Urban,Assam,Crime Against Men,Assault,Female,31-45,1102,216,886,490,612
2006,Rural,Arunachal Pradesh,Crime Against Women,Dowry Deaths,Female,0-12,399,355,44,383,16
2005,Urban,Manipur,Crime Against Men,Murder,Male,46-60,829,69,760,124,705
2009,Urban,Mizoram,Crime Against Women,Molestation,Female,13-17,6246,1770,4476,3797,2449
2007,Rural,Madhya Pradesh,Crime Against Children,Trafficking,Female,0-12,323,319,4,322,1
2007,Rural,Telangana,Crime Against Children,Kidnapping,Male,60+,8001,2077,5924,3189,4812
2005,Rural,Odisha,Crime Against Children,Trafficking,Male,60+,4423,2732,1691,2876,1547
2001,Rural,Himachal Pradesh,Crime Against Men,Extortion,Female,46-60,5325,4391,934,4475,850
2002,Rural,Uttarakhand,Crime Against Children,Child Labor,Male,13-17,7174,3322,3852,6615,559
2001,Urban,Haryana,Crime Against Men,Murder,Male,60+,3709,304,3405,875,2834
2005,Urban,Bihar,Other Crimes,Cyber Crime,Female,0-12,129,123,6,123,6
2007,Urban,Assam,Crime Against Men,Assault,Female,0-12,2971,1619,1352,1829,1142
2009,Rural,Meghalaya,Property Crime,Arson,Female,0-12,6777,1482,5295,2792,3985
2010,Urban,Kerala,Crime Against Children,Child Labor,Female,0-12,307,191,116,192,115
2007,Urban,West Bengal,Crime Against Children,Trafficking,Female,46-60,7441,1971,5470,2583,4858
2010,Urban,Punjab,Other Crimes,Corruption,Male,0-12,849,327,522,629,220
2006,Urban,Jammu & Kashmir,Crime Against Children,Child Labor,Male,13-17,7838,1382,6456,4072,3766
2008,Rural,Telangana,Property Crime,Theft,Male,0-12,437,314,123,367,70
2003,Rural,Jharkhand,Crime Against Children,Child Abuse,Male,18-30,3821,1099,2722,1994,1827
2006,Rural,Manipur,Other Crimes,Corruption,Male,46-60,7918,4211,3707,6088,1830
2010,Urban,Nagaland,Crime Against Children,Child Abuse,Female,18-30,3105,1869,1236,2280,825
2004,Rural,Andhra Pradesh,Crime Against Children,Trafficking,Female,0-12,9291,7772,1519,8300,991
2005,Urban,West Bengal,Property Crime,Burglary,Female,0-12,5770,4210,1560,5092,678
2004,Urban,Bihar,Other Crimes,Cyber Crime,Female,18-30,7982,4658,3324,6991,991
2008,Urban,Meghalaya,Property Crime,Vandalism,Male,18-30,1443,1320,123,1427,16
2001,Urban,Bihar,Other Crimes,Corruption,Male,0-12,7869,6702,1167,6900,969
2006,Rural,Mizoram,Crime Against Men,Extortion,Female,0-12,9452,7263,2189,7931,1521
2004,Rural,Rajasthan,Crime Against Children,Kidnapping,Male,60+,5340,1432,3908,2863,2477
2001,Urban,Madhya Pradesh,Crime Against Men,Murder,Female,60+,9750,2900,6850,8286,1464
2003,Urban,Tripura,Crime Against Children,Child Abuse,Male,13-17,9592,9429,163,9528,64
2002,Urban,Chhattisgarh,Crime Against Men,Robbery,Female,0-12,9860,1659,8201,2543,7317
2006,Rural,Haryana,Crime Against Children,Child Abuse,Female,18-30,3310,3215,95,3283,27
2004,Rural,West Bengal,Crime Against Women,Domestic Violence,Male,13-17,5788,3692,2096,5025,763
2006,Urban,Maharashtra,Crime Against Women,Domestic Violence,Male,31-45,6825,1403,5422,2581,4244
2006,Urban,Maharashtra,Property Crime,Burglary,Male,0-12,5356,1996,3360,2418,2938
2004,Urban,Goa,Crime Against Women,Domestic Violence,Male,18-30,1716,669,1047,1387,329
2005,Urban,Tamil Nadu,Crime Against Women,Molestation,Female,0-12,991,937,54,957,34
2009,Rural,Uttar Pradesh,Crime Against Men,Extortion,Female,31-45,305,96,209,144,161
2007,Rural,Madhya Pradesh,Property Crime,Vandalism,Female,13-17,58,21,37,38,20
2006,Urban,Bihar,Crime Against Women,Rape,Male,18-30,5464,3435,2029,3517,1947
2003,Urban,Kerala,Property Crime,Arson,Male,60+,4726,1675,3051,4159,567
2001,Rural,Bihar,Other Crimes,Fraud,Male,13-17,366,90,276,250,116
2010,Urban,Madhya Pradesh,Crime Against Children,Trafficking,Male,60+,1005,686,319,770,235
2004,Rural,West Bengal,Crime Against Women,Domestic Violence,Female,0-12,6305,3193,3112,5051,1254
2006,Urban,Nagaland,Crime Against Men,Assault,Female,13-17,5639,1772,3867,5303,336
2005,Rural,Gujarat,Crime Against Women,Dowry Deaths,Female,13-17,4506,4332,174,4504,2
2008,Urban,Chhattisgarh,Crime Against Women,Domestic Violence,Male,60+,7892,166,7726,463,7429
2008,Rural,Jharkhand,Crime Against Children,Child Abuse,Male,31-45,3079,308,2771,1629,1450
2010,Urban,Chhattisgarh,Crime Against Children,Kidnapping,Female,46-60,9512,4857,4655,8903,609
2008,Urban,Telangana,Crime Against Men,Extortion,Female,31-45,7313,3235,4078,5054,2259
2007,Urban,Maharashtra,Other Crimes,Drug Offense,Male,0-12,8624,2879,5745,5162,3462
2001,Rural,Himachal Pradesh,Property Crime,Theft,Male,18-30,4859,2630,2229,4288,571
2003,Rural,Assam,Property Crime,Vandalism,Male,60+,5507,2585,2922,4024,1483
2005,Rural,Sikkim,Crime Against Women,Dowry Deaths,Male,60+,5234,1027,4207,4103,1131
2001,Rural,Tripura,Other Crimes,Corruption,Female,46-60,2151,350,1801,883,1268
2010,Urban,Gujarat,Crime Against Men,Robbery,Female,18-30,4928,4021,907,4456,472
2010,Rural,Sikkim,Other Crimes,Drug Offense,Female,18-30,2019,1388,631,1663,356
2002,Rural,Jammu & Kashmir,Property Crime,Theft,Male,60+,3147,1998,1149,3120,27
2005,Urban,Tamil Nadu,Crime Against Men,Robbery,Male,46-60,711,107,604,579,132
2006,Rural,Kerala,Crime Against Men,Murder,Male,31-45,8194,1979,6215,3546,4648
2009,Rural,Uttar Pradesh,Property Crime,Burglary,Female,31-45,2587,1449,1138,1555,1032
2002,Urban,Jharkhand,Crime Against Women,Domestic Violence,Male,60+,9215,5848,3367,9027,188
2005,Urban,Punjab,Property Crime,Vandalism,Female,46-60,3840,3183,657,3252,588
2010,Urban,Kerala,Property Crime,Theft,Male,46-60,3319,6,3313,2943,376
2007,Rural,Kerala,Other Crimes,Fraud,Male,60+,2154,199,1955,1651,503
2002,Urban,Tamil Nadu,Crime Against Children,Trafficking,Female,13-17,8606,4800,3806,7758,848
2004,Urban,Karnataka,Property Crime,Burglary,Female,18-30,9462,8102,1360,9047,415
2003,Urban,Tripura,Other Crimes,Fraud,Male,18-30,2994,1979,1015,2658,336
2006,Urban,Chhattisgarh,Crime Against Women,Dowry Deaths,Male,18-30,8718,6815,1903,7295,1423
2007,Urban,Uttar Pradesh,Other Crimes,Corruption,Female,18-30,8994,221,8773,7655,1339
2004,Rural,Nagaland,Crime Against Children,Kidnapping,Female,0-12,7829,3298,4531,6420,1409
2004,Rural,Mizoram,Other Crimes,Fraud,Male,13-17,9884,5910,3974,9000,884
2010,Rural,Arunachal Pradesh,Property Crime,Theft,Female,60+,5094,1440,3654,2396,2698
2001,Urban,Chhattisgarh,Crime Against Women,Rape,Female,60+,9296,1637,7659,3782,5514
2005,Rural,Tamil Nadu,Crime Against Women,Dowry Deaths,Male,60+,2072,559,1513,1876,196
2006,Urban,Odisha,Other Crimes,Corruption,Female,46-60,2136,1168,968,1181,955
2008,Rural,Tamil Nadu,Crime Against Women,Rape,Male,0-12,8118,6470,1648,8081,37
2010,Rural,Kerala,Other Crimes,Cyber Crime,Male,13-17,8072,4887,3185,7151,921
2009,Rural,Tripura,Other Crimes,Cyber Crime,Male,31-45,4578,33,4545,3689,889
2003,Urban,Assam,Crime Against Women,Rape,Female,0-12,220,213,7,220,0
2001,Urban,Odisha,Crime Against Women,Domestic Violence,Male,13-17,1949,1741,208,1938,11
2007,Rural,Telangana,Crime Against Women,Domestic Violence,Female,0-12,878,445,433,467,411
2010,Urban,West Bengal,Crime Against Women,Dowry Deaths,Male,18-30,2029,932,1097,1966,63
2002,Urban,Goa,Property Crime,Theft,Male,18-30,7099,5445,1654,6134,965
2005,Rural,Tripura,Property Crime,Vandalism,Male,31-45,6125,5924,201,5958,167
2009,Urban,Tripura,Other Crimes,Fraud,Male,46-60,6358,3786,2572,4764,1594
2010,Urban,Telangana,Crime Against Children,Child Labor,Female,18-30,2188,209,1979,1250,938
2004,Urban,Gujarat,Crime Against Men,Extortion,Male,0-12,1710,36,1674,1380,330
2003,Urban,Telangana,Crime Against Children,Child Labor,Male,31-45,9509,8102,1407,9197,312
2005,Urban,Delhi,Property Crime,Vandalism,Male,13-17,2430,1313,1117,2005,425
2002,Rural,Bihar,Crime Against Men,Extortion,Male,46-60,6541,861,5680,6145,396
2008,Urban,Andhra Pradesh,Property Crime,Arson,Female,13-17,6119,3196,2923,5364,755
2003,Rural,Assam,Crime Against Women,Dowry Deaths,Female,13-17,2962,2862,100,2885,77
2006,Urban,Himachal Pradesh,Crime Against Children,Kidnapping,Male,31-45,1561,1264,297,1503,58
2002,Rural,Karnataka,Crime Against Children,Child Labor,Female,0-12,9483,3685,5798,6883,2600
2006,Rural,Nagaland,Crime Against Children,Trafficking,Female,0-12,7990,1577,6413,7711,279
2006,Urban,Uttar Pradesh,Crime Against Children,Child Labor,Female,0-12,5210,800,4410,4443,767
2003,Rural,Kerala,Crime Against Women,Domestic Violence,Male,0-12,6811,976,5835,5595,1216
2010,Rural,Assam,Crime Against Children,Kidnapping,Male,0-12,883,173,710,256,627
2006,Rural,Bihar,Other Crimes,Cyber Crime,Male,60+,2706,1932,774,2023,683
2001,Rural,Madhya Pradesh,Crime Against Children,Child Labor,Male,46-60,7801,7519,282,7585,216
2010,Urban,Jammu & Kashmir,Crime Against Women,Domestic Violence,Female,0-12,2892,652,2240,1715,1177
2009,Rural,Karnataka,Property Crime,Theft,Male,60+,7485,1384,6101,4174,3311
2006,Rural,Maharashtra,Crime Against Women,Domestic Violence,Male,31-45,6560,5868,692,6509,51
2001,Rural,Jammu & Kashmir,Other Crimes,Cyber Crime,Female,18-30,2388,966,1422,1583,805
2008,Rural,Nagaland,Other Crimes,Fraud,Male,60+,9001,236,8765,8175,826
2008,Rural,Madhya Pradesh,Crime Against Men,Murder,Female,46-60,1300,631,669,906,394
2001,Rural,Maharashtra,Crime Against Men,Robbery,Male,31-45,4010,707,3303,2527,1483
2003,Urban,Punjab,Crime Against Women,Domestic Violence,Male,13-17,5428,2839,2589,5348,80
2007,Rural,Bihar,Crime Against Children,Child Abuse,Male,60+,5184,2379,2805,4943,241
2006,Rural,Jammu & Kashmir,Crime Against Children,Child Labor,Female,0-12,692,509,183,521,171
2002,Urban,Tripura,Crime Against Men,Assault,Female,31-45,2526,1296,1230,1418,1108
2002,Rural,Karnataka,Crime Against Men,Assault,Female,13-17,1591,491,1100,598,993
2001,Urban,Delhi,Crime Against Women,Molestation,Male,31-45,1751,1220,531,1447,304
2004,Rural,Himachal Pradesh,Other Crimes,Corruption,Female,46-60,4817,4081,736,4427,390
2003,Rural,West Bengal,Property Crime,Theft,Female,18-30,2353,1903,450,2056,297
2010,Rural,Tripura,Crime Against Women,Domestic Violence,Female,31-45,9551,6519,3032,8535,1016
2007,Rural,Assam,Property Crime,Vandalism,Male,0-12,5329,5067,262,5106,223
2004,Rural,Punjab,Property Crime,Burglary,Female,0-12,8599,7377,1222,8530,69
2008,Urban,Bihar,Property Crime,Burglary,Male,46-60,4560,718,3842,1802,2758
2005,Urban,Tamil Nadu,Other Crimes,Drug Offense,Male,13-17,221,193,28,203,18
2008,Rural,Maharashtra,Other Crimes,Corruption,Female,0-12,5989,3388,2601,3717,2272
2009,Urban,Madhya Pradesh,Crime Against Children,Trafficking,Female,13-17,6147,4182,1965,5266,881
2005,Urban,Bihar,Property Crime,Vandalism,Male,60+,9891,3582,6309,7391,2500
2001,Urban,Arunachal Pradesh,Crime Against Men,Assault,Female,46-60,8924,3470,5454,6292,2632
2001,Urban,Madhya Pradesh,Other Crimes,Fraud,Female,13-17,3148,2213,935,2983,165
2006,Rural,Jammu & Kashmir,Crime Against Women,Molestation,Male,60+,1701,1230,471,1234,467
2005,Urban,Bihar,Property Crime,Vandalism,Male,13-17,1699,759,940,1639,60
2003,Urban,Telangana,Crime Against Women,Molestation,Female,46-60,7933,3772,4161,4891,3042
2005,Rural,Gujarat,Property Crime,Vandalism,Male,31-45,8529,2782,5747,3089,5440
2010,Urban,Goa,Other Crimes,Drug Offense,Female,0-12,2020,429,1591,702,1318
2009,Rural,Mizoram,Property Crime,Theft,Male,31-45,2293,1582,711,2111,182
2010,Urban,Kerala,Crime Against Children,Child Labor,Male,60+,3890,674,3216,882,3008
2003,Urban,Bihar,Property Crime,Vandalism,Male,13-17,8353,7596,757,8201,152
2001,Rural,Madhya Pradesh,Crime Against Children,Kidnapping,Male,18-30,384,95,289,348,36
2003,Rural,Punjab,Crime Against Women,Domestic Violence,Female,13-17,3175,2337,838,2908,267
2003,Urban,Maharashtra,Crime Against Women,Rape,Male,60+,1363,751,612,960,403
2006,Urban,Meghalaya,Crime Against Children,Child Abuse,Male,46-60,3804,2435,1369,3799,5
2007,Rural,Odisha,Crime Against Men,Extortion,Female,60+,89,83,6,85,4
2010,Rural,Mizoram,Crime Against Men,Robbery,Male,31-45,5006,1050,3956,4401,605
2005,Urban,Andhra Pradesh,Crime Against Women,Rape,Male,60+,3668,1205,2463,1369,2299
2006,Rural,Gujarat,Other Crimes,Fraud,Male,60+,7983,706,7277,5423,2560
2010,Urban,Tripura,Crime Against Women,Domestic Violence,Male,0-12,794,274,520,314,480
2010,Rural,Uttarakhand,Crime Against Children,Child Labor,Female,60+,1112,85,1027,527,585
2007,Rural,Haryana,Crime Against Children,Trafficking,Female,60+,1336,955,381,975,361
2006,Urban,Rajasthan,Crime Against Children,Kidnapping,Female,13-17,4052,2362,1690,3777,275
2009,Rural,Odisha,Property Crime,Vandalism,Female,0-12,3853,1552,2301,3662,191
2010,Rural,Uttar Pradesh,Crime Against Women,Domestic Violence,Female,46-60,7022,2346,4676,4156,2866
2006,Rural,Assam,Crime Against Women,Domestic Violence,Female,46-60,1871,1255,616,1665,206
2010,Rural,Assam,Crime Against Children,Trafficking,Male,0-12,5431,3657,1774,4377,1054
2003,Rural,Assam,Crime Against Men,Robbery,Male,18-30,7345,4325,3020,6168,1177
2009,Rural,Jammu & Kashmir,Property Crime,Vandalism,Female,18-30,524,232,292,273,251
2002,Rural,Bihar,Other Crimes,Drug Offense,Male,0-12,3249,108,3141,1340,1909
2009,Rural,West Bengal,Crime Against Children,Kidnapping,Male,13-17,4660,250,4410,1539,3121
2009,Urban,Sikkim,Property Crime,Theft,Female,46-60,4262,1607,2655,1701,2561
2008,Urban,Bihar,Crime Against Women,Domestic Violence,Male,18-30,8768,8494,274,8711,57
2009,Rural,Delhi,Other Crimes,Drug Offense,Female,60+,405,319,86,322,83
2008,Urban,Punjab,Crime Against Women,Dowry Deaths,Female,13-17,1259,245,1014,288,971
2007,Urban,Goa,Crime Against Women,Molestation,Female,0-12,1386,187,1199,821,565
2010,Rural,Jharkhand,Other Crimes,Cyber Crime,Female,18-30,5941,2660,3281,4818,1123
2008,Rural,Gujarat,Crime Against Women,Molestation,Male,31-45,1657,420,1237,527,1130
2010,Urban,Karnataka,Crime Against Children,Kidnapping,Female,60+,7986,1647,6339,4362,3624
2008,Rural,Goa,Crime Against Children,Child Abuse,Female,18-30,2014,521,1493,1726,288
2006,Rural,Madhya Pradesh,Property Crime,Arson,Female,31-45,9906,5724,4182,9341,565
2004,Rural,Andhra Pradesh,Crime Against Children,Trafficking,Female,60+,4354,4140,214,4268,86
2010,Urban,Punjab,Crime Against Women,Rape,Female,13-17,8139,3131,5008,8034,105
2004,Urban,Meghalaya,Crime Against Children,Child Labor,Male,31-45,319,198,121,207,112
2004,Urban,Nagaland,Crime Against Children,Trafficking,Male,31-45,8165,298,7867,3483,4682
2006,Rural,Karnataka,Other Crimes,Cyber Crime,Female,0-12,2680,2411,269,2546,134
2002,Rural,Delhi,Property Crime,Arson,Male,13-17,4975,2302,2673,3849,1126
2003,Rural,Chhattisgarh,Crime Against Women,Domestic Violence,Female,13-17,8694,5108,3586,7602,1092
2010,Urban,Assam,Other Crimes,Corruption,Female,31-45,5979,2172,3807,3485,2494
2010,Rural,Goa,Property Crime,Arson,Female,60+,7517,6959,558,7278,239
2008,Rural,Chhattisgarh,Property Crime,Theft,Male,60+,9574,1668,7906,9248,326
2001,Urban,Himachal Pradesh,Crime Against Men,Robbery,Male,31-45,8064,334,7730,2529,5535
2001,Urban,Manipur,Crime Against Men,Robbery,Female,18-30,9793,1193,8600,6539,3254
2010,Urban,Jammu & Kashmir,Crime Against Children,Child Abuse,Female,60+,4619,1827,2792,3981,638
2002,Rural,Uttarakhand,Other Crimes,Cyber Crime,Female,31-45,4754,359,4395,1227,3527
2009,Rural,Meghalaya,Crime Against Women,Domestic Violence,Male,46-60,3002,78,2924,1903,1099
2002,Urban,Arunachal Pradesh,Property Crime,Arson,Male,0-12,5524,5357,167,5513,11
2010,Rural,Tripura,Other Crimes,Fraud,Female,0-12,7538,7210,328,7519,19
2010,Rural,Tripura,Crime Against Women,Rape,Female,18-30,9142,3877,5265,7155,1987
2007,Urban,Maharashtra,Crime Against Women,Dowry Deaths,Male,31-45,3857,678,3179,1665,2192
2007,Rural,Odisha,Crime Against Men,Extortion,Male,31-45,3570,817,2753,1261,2309
2005,Rural,Jammu & Kashmir,Crime Against Women,Domestic Violence,Female,60+,4693,41,4652,3445,1248
2001,Rural,Assam,Crime Against Men,Murder,Female,13-17,1182,75,1107,1089,93
2002,Rural,Himachal Pradesh,Crime Against Children,Trafficking,Female,0-12,5632,3304,2328,4486,1146
2004,Rural,Rajasthan,Crime Against Men,Assault,Female,46-60,971,607,364,761,210
2002,Rural,Chhattisgarh,Crime Against Women,Dowry Deaths,Male,31-45,8178,463,7715,4386,3792
2007,Rural,West Bengal,Other Crimes,Cyber Crime,Female,60+,3468,3049,419,3267,201
2007,Urban,Jammu & Kashmir,Crime Against Women,Domestic Violence,Male,0-12,9391,470,8921,6768,2623
2010,Rural,Himachal Pradesh,Other Crimes,Fraud,Female,60+,8701,6627,2074,7481,1220
2003,Urban,Meghalaya,Crime Against Women,Dowry Deaths,Male,0-12,4041,2706,1335,2964,1077
2002,Rural,Jammu & Kashmir,Crime Against Men,Robbery,Female,13-17,2546,1187,1359,1980,566
2005,Urban,Andhra Pradesh,Crime Against Children,Child Abuse,Female,46-60,302,107,195,270,32
2009,Urban,Mizoram,Crime Against Women,Dowry Deaths,Male,46-60,7052,1295,5757,2638,4414
2005,Rural,Mizoram,Crime Against Men,Robbery,Male,31-45,6069,3028,3041,5391,678
2007,Urban,Haryana,Crime Against Men,Assault,Female,60+,1725,1349,376,1500,225
2001,Urban,Assam,Crime Against Women,Dowry Deaths,Male,60+,9089,8740,349,8867,222
2002,Urban,Kerala,Other Crimes,Drug Offense,Female,13-17,6043,413,5630,668,5375
2002,Rural,Maharashtra,Crime Against Men,Assault,Female,18-30,3862,855,3007,1740,2122
2007,Urban,Goa,Property Crime,Vandalism,Male,13-17,4940,1204,3736,4565,375
2003,Rural,Himachal Pradesh,Crime Against Children,Trafficking,Male,46-60,8030,1910,6120,3104,4926
2004,Rural,Goa,Crime Against Women,Rape,Female,13-17,3707,1045,2662,3059,648
2004,Rural,Meghalaya,Crime Against Children,Child Abuse,Male,60+,8922,7687,1235,8089,833
2007,Urban,Meghalaya,Crime Against Women,Rape,Female,18-30,9645,7871,1774,8095,1550
2006,Urban,Sikkim,Crime Against Women,Domestic Violence,Female,13-17,4629,2479,2150,3837,792
2001,Rural,Sikkim,Property Crime,Arson,Male,31-45,4413,1470,2943,3111,1302
2007,Rural,West Bengal,Crime Against Women,Molestation,Female,18-30,1659,1339,320,1621,38
2002,Rural,West Bengal,Crime Against Women,Domestic Violence,Female,18-30,931,379,552,651,280
2002,Rural,Haryana,Crime Against Women,Dowry Deaths,Male,18-30,7601,7444,157,7526,75
2004,Urban,Maharashtra,Crime Against Children,Child Labor,Male,13-17,7893,2497,5396,6309,1584
2003,Rural,Delhi,Crime Against Men,Robbery,Female,0-12,2218,1482,736,1973,245
2009,Urban,Assam,Crime Against Children,Child Abuse,Male,60+,8999,5802,3197,8312,687
2008,Urban,West Bengal,Property Crime,Arson,Male,0-12,557,225,332,314,243
2010,Urban,Assam,Crime Against Children,Kidnapping,Female,31-45,3927,2011,1916,3546,381
2007,Rural,Telangana,Crime Against Children,Kidnapping,Female,18-30,5686,1163,4523,3698,1988
2008,Rural,Haryana,Crime Against Men,Extortion,Female,60+,2294,1323,971,1710,584
2008,Rural,Karnataka,Crime Against Children,Child Abuse,Male,18-30,2720,1852,868,2529,191
2010,Rural,Punjab,Other Crimes,Cyber Crime,Male,46-60,7927,6460,1467,6666,1261
2009,Urban,Odisha,Crime Against Women,Domestic Violence,Female,46-60,3162,873,2289,1509,1653
2007,Rural,Nagaland,Crime Against Men,Murder,Male,13-17,8697,2286,6411,2361,6336
2009,Rural,Uttar Pradesh,Crime Against Women,Rape,Male,0-12,3078,299,2779,1985,1093
2009,Rural,Andhra Pradesh,Crime Against Women,Dowry Deaths,Male,13-17,6978,5058,1920,5734,1244
2002,Urban,Meghalaya,Crime Against Men,Extortion,Male,46-60,4486,81,4405,2327,2159
2003,Urban,Jammu & Kashmir,Crime Against Children,Child Labor,Male,60+,9327,6790,2537,7129,2198
2002,Urban,Gujarat,Crime Against Children,Trafficking,Female,31-45,7832,3314,4518,6324,1508
2003,Rural,Goa,Property Crime,Theft,Female,18-30,1047,632,415,1035,12
2005,Rural,Tripura,Property Crime,Burglary,Male,60+,6166,1147,5019,2872,3294
2003,Rural,Bihar,Crime Against Women,Domestic Violence,Male,31-45,397,83,314,314,83
2003,Urban,Kerala,Crime Against Women,Rape,Male,60+,9981,2081,7900,7217,2764
2003,Urban,Haryana,Other Crimes,Cyber Crime,Female,0-12,4357,904,3453,1691,2666
2009,Rural,Tamil Nadu,Crime Against Children,Child Abuse,Female,46-60,2028,1571,457,1675,353
2005,Rural,West Bengal,Property Crime,Burglary,Female,18-30,9388,2435,6953,6332,3056
2008,Rural,Meghalaya,Crime Against Women,Molestation,Male,0-12,2119,149,1970,1871,248
2005,Rural,Madhya Pradesh,Other Crimes,Cyber Crime,Female,60+,5097,3752,1345,4595,502
2005,Rural,Jammu & Kashmir,Other Crimes,Fraud,Male,13-17,762,303,459,629,133
2008,Rural,Sikkim,Other Crimes,Drug Offense,Female,46-60,8552,6589,1963,7968,584
2009,Urban,Bihar,Crime Against Men,Assault,Male,18-30,5617,4426,1191,4530,1087
2006,Urban,Telangana,Crime Against Women,Domestic Violence,Male,0-12,7034,4618,2416,6250,784
2001,Urban,Gujarat,Other Crimes,Drug Offense,Male,13-17,6445,2178,4267,5767,678
2001,Rural,Assam,Crime Against Children,Trafficking,Male,31-45,9070,4752,4318,5099,3971
2006,Urban,Tamil Nadu,Other Crimes,Fraud,Female,13-17,9337,8972,365,9304,33
2006,Rural,Sikkim,Other Crimes,Corruption,Female,13-17,271,174,97,230,41
2001,Rural,Maharashtra,Other Crimes,Cyber Crime,Female,0-12,5556,4171,1385,5478,78
2002,Rural,Mizoram,Crime Against Children,Child Abuse,Female,60+,6145,2558,3587,4821,1324
2009,Urban,Rajasthan,Crime Against Men,Robbery,Female,60+,5386,9,5377,2403,2983
2004,Rural,Delhi,Crime Against Men,Assault,Male,31-45,9034,6081,2953,7744,1290
2001,Urban,Jharkhand,Property Crime,Vandalism,Female,46-60,5720,3278,2442,4393,1327
2001,Urban,Nagaland,Other Crimes,Corruption,Female,13-17,5091,71,5020,3468,1623
2002,Rural,Bihar,Crime Against Women,Rape,Female,18-30,6675,1834,4841,6169,506
2009,Rural,Kerala,Crime Against Children,Trafficking,Female,13-17,3838,1120,2718,3755,83
2006,Urban,Goa,Other Crimes,Drug Offense,Male,60+,9510,4342,5168,9258,252
2006,Urban,Goa,Crime Against Children,Child Abuse,Female,13-17,4764,1812,2952,2385,2379
2008,Rural,Himachal Pradesh,Property Crime,Theft,Male,0-12,9877,3107,6770,7287,2590
2005,Urban,Assam,Property Crime,Burglary,Female,46-60,5572,2934,2638,3919,1653
2006,Rural,Bihar,Crime Against Children,Child Labor,Female,60+,3215,1435,1780,3045,170
2010,Rural,Arunachal Pradesh,Crime Against Men,Assault,Female,46-60,4106,1400,2706,1903,2203
2006,Rural,West Bengal,Property Crime,Theft,Male,18-30,5688,4979,709,5525,163
2006,Urban,Telangana,Property Crime,Vandalism,Male,46-60,9144,5092,4052,6613,2531
2009,Rural,Meghalaya,Crime Against Men,Extortion,Female,31-45,7420,129,7291,4989,2431
2003,Rural,Jharkhand,Crime Against Children,Trafficking,Male,46-60,3662,1029,2633,3272,390
2004,Urban,Himachal Pradesh,Crime Against Women,Domestic Violence,Female,18-30,5250,3207,2043,4889,361
2001,Rural,Chhattisgarh,Other Crimes,Fraud,Female,46-60,51,20,31,42,9
2005,Urban,Assam,Crime Against Women,Molestation,Female,60+,301,179,122,219,82
2003,Rural,Meghalaya,Crime Against Men,Assault,Male,46-60,9896,5402,4494,9008,888
2008,Urban,Jharkhand,Crime Against Men,Robbery,Male,31-45,1591,436,1155,1589,2
2008,Rural,Haryana,Crime Against Men,Extortion,Female,13-17,9411,560,8851,8523,888
2010,Urban,Arunachal Pradesh,Other Crimes,Fraud,Female,31-45,9404,3965,5439,8449,955
2005,Rural,Maharashtra,Other Crimes,Cyber Crime,Male,60+,9274,4695,4579,7466,1808
2002,Urban,Andhra Pradesh,Other Crimes,Cyber Crime,Male,60+,7787,5062,2725,5133,2654
2006,Urban,Andhra Pradesh,Other Crimes,Corruption,Female,46-60,7162,1678,5484,4498,2664
2002,Rural,Nagaland,Other Crimes,Cyber Crime,Female,60+,6695,5837,858,5899,796
2002,Urban,Delhi,Other Crimes,Corruption,Female,31-45,4902,365,4537,2655,2247
2007,Urban,Himachal Pradesh,Other Crimes,Drug Offense,Male,60+,7913,6769,1144,6811,1102
2001,Rural,Tamil Nadu,Crime Against Men,Extortion,Female,31-45,4513,2390,2123,3958,555
2001,Rural,Kerala,Crime Against Children,Kidnapping,Male,46-60,9860,2767,7093,9783,77
2010,Urban,Goa,Property Crime,Theft,Male,46-60,2465,1265,1200,2364,101
2001,Urban,Tripura,Property Crime,Vandalism,Male,0-12,340,337,3,337,3
2008,Urban,Odisha,Other Crimes,Fraud,Male,0-12,5455,130,5325,416,5039
2009,Urban,Gujarat,Crime Against Men,Robbery,Female,46-60,5977,1226,4751,5222,755
2005,Rural,Jharkhand,Other Crimes,Drug Offense,Female,18-30,9893,1535,8358,6485,3408
2008,Rural,Uttar Pradesh,Crime Against Men,Extortion,Female,31-45,3100,52,3048,1847,1253
2004,Rural,Jharkhand,Crime Against Children,Kidnapping,Male,60+,4066,2082,1984,3700,366
2001,Urban,Kerala,Property Crime,Vandalism,Female,18-30,3295,2413,882,3197,98
2001,Rural,Telangana,Other Crimes,Drug Offense,Female,31-45,6377,4566,1811,5475,902
2002,Rural,Kerala,Property Crime,Burglary,Female,13-17,4544,2507,2037,4145,399
2005,Urban,Karnataka,Crime Against Women,Rape,Female,46-60,9224,2234,6990,3349,5875
2005,Rural,Jammu & Kashmir,Property Crime,Theft,Male,13-17,8642,7534,1108,7953,689
2007,Urban,Tripura,Property Crime,Burglary,Female,31-45,7524,4032,3492,5232,2292
2001,Urban,Chhattisgarh,Crime Against Men,Extortion,Female,31-45,317,186,131,192,125
2004,Rural,Himachal Pradesh,Other Crimes,Fraud,Female,60+,9520,4024,5496,6206,3314
2002,Urban,Odisha,Property Crime,Vandalism,Male,18-30,1211,112,1099,1035,176
2009,Rural,West Bengal,Property Crime,Arson,Male,60+,316,7,309,52,264
2010,Rural,Bihar,Other Crimes,Cyber Crime,Male,13-17,5942,4680,1262,5646,296
2004,Urban,Odisha,Crime Against Men,Extortion,Male,31-45,2148,2085,63,2094,54
2004,Rural,Arunachal Pradesh,Crime Against Children,Child Labor,Male,18-30,6369,5523,846,6257,112
2009,Rural,Arunachal Pradesh,Crime Against Children,Child Abuse,Female,31-45,7838,1724,6114,6980,858
2007,Urban,Tripura,Property Crime,Theft,Female,31-45,5393,3344,2049,4954,439
2010,Rural,Tamil Nadu,Other Crimes,Drug Offense,Male,60+,8187,1240,6947,8163,24
2004,Urban,Uttar Pradesh,Other Crimes,Corruption,Male,60+,6066,5547,519,5966,100
2008,Rural,Chhattisgarh,Crime Against Children,Trafficking,Male,13-17,8309,2852,5457,4846,3463
2003,Urban,Rajasthan,Crime Against Children,Trafficking,Male,60+,3132,280,2852,2788,344
2006,Rural,Arunachal Pradesh,Crime Against Children,Child Abuse,Female,46-60,1106,914,192,1067,39
2010,Rural,Odisha,Crime Against Children,Child Abuse,Female,18-30,8747,5208,3539,7406,1341
2001,Rural,Nagaland,Crime Against Men,Murder,Male,60+,8675,5683,2992,7982,693
2008,Rural,Assam,Crime Against Men,Murder,Female,60+,2513,2440,73,2494,19
2009,Rural,West Bengal,Crime Against Women,Molestation,Male,46-60,9929,2866,7063,6952,2977
2004,Rural,Tripura,Crime Against Women,Dowry Deaths,Female,46-60,5704,210,5494,2610,3094
2002,Rural,Telangana,Property Crime,Burglary,Female,46-60,5986,2936,3050,3620,2366
2007,Urban,Sikkim,Crime Against Children,Kidnapping,Female,18-30,9953,4099,5854,7563,2390
2002,Rural,Arunachal Pradesh,Crime Against Men,Extortion,Male,0-12,1326,1256,70,1263,63
2007,Urban,Telangana,Crime Against Men,Assault,Male,46-60,9397,4987,4410,6101,3296
2001,Urban,Karnataka,Other Crimes,Drug Offense,Female,60+,988,930,58,953,35
2001,Urban,Arunachal Pradesh,Property Crime,Vandalism,Male,0-12,8103,5503,2600,7896,207
2010,Urban,Andhra Pradesh,Property Crime,Vandalism,Female,13-17,8513,1233,7280,5633,2880
2010,Urban,Delhi,Other Crimes,Fraud,Male,31-45,6425,294,6131,4580,1845
2009,Urban,Assam,Crime Against Women,Dowry Deaths,Female,13-17,1376,347,1029,511,865
2005,Urban,Telangana,Property Crime,Burglary,Male,46-60,5758,2261,3497,4134,1624
2003,Urban,Gujarat,Property Crime,Theft,Male,60+,7332,5521,1811,6326,1006
2003,Urban,Chhattisgarh,Crime Against Men,Assault,Male,13-17,1070,602,468,857,213
2005,Urban,Jammu & Kashmir,Crime Against Men,Robbery,Male,0-12,1373,250,1123,1265,108
2001,Rural,Odisha,Other Crimes,Drug Offense,Female,18-30,7889,5111,2778,7255,634
2007,Rural,Maharashtra,Crime Against Women,Molestation,Male,46-60,2043,359,1684,1486,557
2005,Rural,Odisha,Crime Against Men,Robbery,Male,31-45,288,286,2,287,1
2009,Rural,Odisha,Crime Against Women,Molestation,Female,31-45,8915,135,8780,763,8152
2002,Rural,Tripura,Crime Against Children,Child Abuse,Female,18-30,4572,1854,2718,3002,1570
2005,Urban,Jharkhand,Crime Against Children,Child Abuse,Male,60+,2065,175,1890,414,1651
2002,Urban,Madhya Pradesh,Other Crimes,Cyber Crime,Female,46-60,3011,421,2590,2842,169
2008,Rural,Sikkim,Crime Against Men,Extortion,Female,60+,538,405,133,446,92
2004,Rural,Uttar Pradesh,Crime Against Women,Rape,Male,60+,9779,2066,7713,4391,5388
2009,Urban,Punjab,Other Crimes,Cyber Crime,Male,46-60,8446,2017,6429,5428,3018
2008,Urban,Uttar Pradesh,Crime Against Men,Robbery,Male,13-17,3397,1241,2156,2671,726
2001,Urban,Himachal Pradesh,Other Crimes,Cyber Crime,Male,13-17,833,261,572,311,522
2007,Rural,Himachal Pradesh,Other Crimes,Fraud,Female,60+,1504,580,924,975,529
2008,Urban,Assam,Crime Against Women,Domestic Violence,Female,0-12,6797,4899,1898,5813,984
2009,Rural,Uttar Pradesh,Other Crimes,Fraud,Female,60+,6886,3338,3548,5577,1309
2010,Urban,Goa,Other Crimes,Corruption,Female,31-45,8098,497,7601,7403,695
2007,Urban,Mizoram,Crime Against Children,Kidnapping,Female,18-30,5253,5219,34,5246,7
2007,Urban,Haryana,Crime Against Children,Trafficking,Male,18-30,423,304,119,363,60
2007,Rural,Uttar Pradesh,Crime Against Women,Domestic Violence,Female,46-60,6007,3261,2746,6000,7
2001,Urban,Bihar,Property Crime,Arson,Male,60+,5396,2025,3371,3059,2337
2003,Rural,Rajasthan,Crime Against Men,Assault,Female,0-12,4170,3214,956,3826,344
2001,Rural,Tripura,Crime Against Children,Trafficking,Male,31-45,5712,987,4725,2525,3187
2001,Rural,Karnataka,Other Crimes,Fraud,Female,46-60,7064,5835,1229,6346,718
2007,Rural,Jammu & Kashmir,Other Crimes,Corruption,Male,18-30,4892,4778,114,4787,105
2001,Rural,Himachal Pradesh,Crime Against Children,Kidnapping,Female,18-30,7362,4076,3286,6360,1002
2006,Urban,Uttar Pradesh,Crime Against Women,Domestic Violence,Female,60+,6544,2255,4289,2995,3549
2004,Urban,Sikkim,Crime Against Women,Domestic Violence,Male,18-30,8265,1316,6949,3658,4607
2009,Urban,Chhattisgarh,Property Crime,Burglary,Male,13-17,2543,727,1816,2493,50
2001,Urban,Andhra Pradesh,Other Crimes,Fraud,Male,60+,4381,2950,1431,3416,965
2003,Rural,Jharkhand,Other Crimes,Corruption,Male,31-45,2332,207,2125,634,1698
2006,Urban,Tripura,Other Crimes,Fraud,Female,18-30,8421,5632,2789,6126,2295
2007,Rural,Delhi,Crime Against Men,Robbery,Female,46-60,4281,1988,2293,2278,2003
2005,Urban,Arunachal Pradesh,Crime Against Children,Kidnapping,Male,0-12,120,109,11,114,6
2002,Rural,Goa,Property Crime,Theft,Male,13-17,4508,2761,1747,2939,1569
2007,Rural,West Bengal,Crime Against Children,Child Abuse,Male,46-60,9622,1313,8309,5530,4092
2003,Urban,Gujarat,Crime Against Men,Assault,Male,18-30,1329,927,402,942,387
2003,Urban,Kerala,Crime Against Women,Molestation,Female,46-60,9511,8181,1330,9429,82
2009,Urban,Rajasthan,Crime Against Children,Kidnapping,Male,13-17,4775,3904,871,4375,400
2004,Rural,Rajasthan,Crime Against Men,Assault,Male,0-12,4700,3860,840,4639,61
2004,Urban,Telangana,Property Crime,Burglary,Male,18-30,5829,560,5269,5099,730
2005,Urban,Bihar,Other Crimes,Fraud,Male,60+,1733,1132,601,1245,488
2001,Urban,Maharashtra,Other Crimes,Fraud,Female,18-30,3691,877,2814,2295,1396
2001,Rural,Andhra Pradesh,Crime Against Women,Domestic Violence,Female,60+,5001,1501,3500,3380,1621
2008,Rural,Tamil Nadu,Property Crime,Arson,Female,13-17,9894,8665,1229,9057,837
2008,Rural,Arunachal Pradesh,Crime Against Children,Trafficking,Female,18-30,6268,5228,1040,6151,117
2002,Rural,Bihar,Crime Against Men,Murder,Female,60+,936,790,146,829,107
2009,Rural,Gujarat,Crime Against Men,Extortion,Female,46-60,4285,40,4245,1386,2899
2003,Urban,Jharkhand,Crime Against Women,Dowry Deaths,Male,31-45,5166,315,4851,4488,678
2007,Rural,Meghalaya,Property Crime,Arson,Female,60+,4831,4641,190,4692,139
2003,Rural,Sikkim,Crime Against Women,Domestic Violence,Male,13-17,956,734,222,885,71
2007,Rural,Mizoram,Property Crime,Theft,Male,0-12,6308,2311,3997,2597,3711
2003,Urban,Himachal Pradesh,Other Crimes,Cyber Crime,Female,0-12,873,81,792,612,261
2003,Urban,Chhattisgarh,Crime Against Women,Rape,Female,18-30,6869,3498,3371,6363,506
2005,Rural,Meghalaya,Crime Against Men,Robbery,Male,18-30,4390,231,4159,1774,2616
2006,Rural,Jammu & Kashmir,Crime Against Men,Assault,Male,31-45,8227,6946,1281,7621,606
2002,Urban,Uttarakhand,Crime Against Men,Extortion,Male,31-45,2162,1818,344,1993,169
2008,Urban,Tripura,Property Crime,Arson,Female,60+,7432,5176,2256,5867,1565
2003,Urban,Uttarakhand,Crime Against Children,Kidnapping,Male,60+,4532,4269,263,4338,194
2005,Rural,Sikkim,Crime Against Women,Dowry Deaths,Male,13-17,6441,458,5983,6340,101
2004,Rural,Bihar,Crime Against Women,Molestation,Female,0-12,5643,5482,161,5543,100
2001,Urban,Haryana,Other Crimes,Cyber Crime,Male,18-30,1750,563,1187,814,936
2007,Urban,Tamil Nadu,Property Crime,Arson,Female,18-30,5466,4703,763,5058,408
2010,Urban,Telangana,Crime Against Women,Domestic Violence,Female,0-12,4975,1787,3188,3989,986
2003,Urban,Madhya Pradesh,Other Crimes,Corruption,Male,13-17,2297,1610,687,2026,271
2004,Urban,Himachal Pradesh,Crime Against Men,Assault,Male,31-45,3287,1152,2135,3279,8
2010,Rural,Odisha,Property Crime,Theft,Male,18-30,4034,904,3130,3621,413
2007,Rural,Rajasthan,Crime Against Children,Trafficking,Male,60+,3278,57,3221,715,2563
2002,Rural,Gujarat,Crime Against Children,Child Labor,Male,31-45,5602,2381,3221,5072,530
2008,Urban,Maharashtra,Crime Against Men,Robbery,Female,0-12,2300,2274,26,2291,9
2010,Rural,Bihar,Crime Against Children,Child Labor,Female,0-12,3487,2014,1473,2482,1005
2008,Rural,Haryana,Crime Against Men,Extortion,Male,18-30,4381,261,4120,3756,625
2002,Urban,Tamil Nadu,Crime Against Men,Murder,Female,46-60,5300,65,5235,2813,2487
2001,Urban,Madhya Pradesh,Crime Against Children,Child Labor,Female,0-12,4642,2737,1905,3235,1407
2002,Urban,Tamil Nadu,Crime Against Children,Kidnapping,Male,13-17,666,35,631,260,406
2007,Urban,Manipur,Property Crime,Arson,Male,60+,277,171,106,261,16
2008,Urban,West Bengal,Property Crime,Theft,Female,60+,3350,2348,1002,3161,189
2002,Rural,Madhya Pradesh,Crime Against Women,Rape,Female,0-12,3452,1089,2363,2650,802
2001,Rural,Manipur,Property Crime,Vandalism,Female,0-12,7469,7014,455,7377,92
2009,Urban,Uttarakhand,Other Crimes,Corruption,Female,0-12,6304,2704,3600,3921,2383
2001,Rural,Mizoram,Crime Against Children,Child Labor,Male,60+,2148,1508,640,2094,54
2002,Rural,Uttarakhand,Property Crime,Arson,Male,31-45,5406,3446,1960,3539,1867
2005,Urban,Maharashtra,Crime Against Children,Trafficking,Female,60+,4532,4332,200,4492,40
2009,Urban,Assam,Other Crimes,Drug Offense,Male,31-45,4257,335,3922,4019,238
2006,Rural,Kerala,Crime Against Men,Assault,Male,31-45,4525,3724,801,4199,326
2009,Rural,Assam,Property Crime,Vandalism,Female,18-30,2350,1712,638,2117,233
2005,Rural,Arunachal Pradesh,Crime Against Women,Rape,Female,18-30,1087,366,721,870,217
2001,Rural,Kerala,Other Crimes,Corruption,Female,31-45,9497,8831,666,9026,471
2008,Urban,Madhya Pradesh,Crime Against Children,Child Abuse,Female,18-30,3182,2008,1174,2410,772
2003,Rural,Rajasthan,Property Crime,Arson,Female,13-17,5432,2377,3055,2941,2491
2004,Urban,Tamil Nadu,Crime Against Women,Rape,Female,18-30,5325,2912,2413,5088,237
2002,Urban,Uttar Pradesh,Crime Against Women,Domestic Violence,Male,60+,1450,817,633,1333,117
2008,Urban,Nagaland,Crime Against Women,Molestation,Male,60+,8613,2366,6247,3849,4764
2010,Urban,Telangana,Crime Against Women,Domestic Violence,Male,60+,3718,33,3685,3334,384
2001,Rural,Arunachal Pradesh,Crime Against Children,Child Labor,Female,60+,9625,6450,3175,7135,2490
2005,Urban,Andhra Pradesh,Crime Against Women,Dowry Deaths,Male,31-45,5762,3433,2329,4771,991
2007,Urban,West Bengal,Crime Against Women,Rape,Male,31-45,6400,2757,3643,3812,2588
2007,Urban,Meghalaya,Crime Against Men,Robbery,Female,60+,8922,186,8736,4962,3960
2007,Rural,Manipur,Crime Against Women,Dowry Deaths,Male,46-60,3755,2750,1005,3546,209
2001,Urban,Rajasthan,Crime Against Men,Extortion,Female,60+,4730,3854,876,4710,20
2005,Urban,Haryana,Crime Against Women,Domestic Violence,Female,60+,5340,3856,1484,4204,1136
2010,Urban,Assam,Crime Against Women,Molestation,Female,46-60,9351,4341,5010,6976,2375
2010,Urban,Andhra Pradesh,Property Crime,Theft,Female,13-17,9353,992,8361,6020,3333
2010,Rural,Odisha,Crime Against Women,Rape,Male,46-60,8028,3860,4168,4415,3613
2003,Rural,Telangana,Crime Against Women,Dowry Deaths,Male,18-30,9717,54,9663,8175,1542
2010,Urban,Sikkim,Property Crime,Burglary,Male,31-45,8409,5380,3029,8009,400
2009,Rural,Himachal Pradesh,Property Crime,Arson,Female,60+,3069,2117,952,2242,827
2003,Urban,Sikkim,Property Crime,Theft,Male,18-30,5936,5546,390,5828,108
2009,Urban,Jammu & Kashmir,Crime Against Women,Dowry Deaths,Female,31-45,1441,944,497,1027,414
2007,Rural,West Bengal,Crime Against Children,Kidnapping,Male,18-30,4488,3050,1438,4266,222
2006,Rural,Jharkhand,Property Crime,Theft,Male,13-17,8534,852,7682,5347,3187
2009,Urban,Arunachal Pradesh,Crime Against Men,Extortion,Male,18-30,4245,3785,460,3973,272
2004,Urban,Bihar,Property Crime,Burglary,Male,60+,7482,2756,4726,3165,4317
2001,Rural,Uttar Pradesh,Crime Against Women,Dowry Deaths,Male,0-12,6738,6265,473,6269,469
2007,Urban,Jammu & Kashmir,Other Crimes,Fraud,Male,0-12,1795,1490,305,1683,112
2007,Urban,Kerala,Property Crime,Burglary,Male,31-45,1561,798,763,1233,328
2001,Rural,Uttar Pradesh,Property Crime,Burglary,Female,31-45,4174,3191,983,3819,355
2007,Rural,Madhya Pradesh,Crime Against Men,Robbery,Male,31-45,9754,7718,2036,8299,1455
2002,Urban,Punjab,Other Crimes,Drug Offense,Female,0-12,9514,6239,3275,8286,1228
2007,Rural,Tripura,Other Crimes,Drug Offense,Female,13-17,2966,2794,172,2874,92
2001,Rural,Uttar Pradesh,Other Crimes,Corruption,Male,31-45,8769,3862,4907,5969,2800
2002,Urban,Odisha,Crime Against Children,Trafficking,Male,46-60,2588,1317,1271,2486,102
2007,Rural,Bihar,Crime Against Women,Molestation,Male,18-30,4249,1776,2473,3829,420
2004,Rural,Goa,Crime Against Women,Dowry Deaths,Female,60+,4422,137,4285,251,4171
2006,Rural,Tamil Nadu,Property Crime,Arson,Male,0-12,5161,4919,242,5015,146
2002,Urban,Assam,Crime Against Men,Assault,Male,13-17,1015,174,841,392,623
2004,Urban,Karnataka,Property Crime,Vandalism,Male,46-60,6984,3300,3684,4945,2039
2006,Urban,Mizoram,Crime Against Children,Child Abuse,Female,60+,8704,7540,1164,8409,295
2001,Rural,Delhi,Other Crimes,Corruption,Male,18-30,4741,430,4311,1214,3527
2001,Rural,Kerala,Crime Against Women,Dowry Deaths,Female,18-30,5271,1134,4137,1574,3697
2009,Urban,Delhi,Crime Against Children,Kidnapping,Female,13-17,4146,3633,513,3983,163
2009,Urban,Odisha,Crime Against Men,Robbery,Male,60+,9593,3425,6168,5316,4277
2006,Urban,Bihar,Crime Against Women,Molestation,Female,13-17,3793,3780,13,3783,10
2005,Rural,Mizoram,Crime Against Women,Domestic Violence,Female,46-60,5453,4141,1312,4790,663
2004,Rural,Karnataka,Crime Against Women,Dowry Deaths,Male,31-45,9792,3961,5831,4277,5515
2008,Rural,Arunachal Pradesh,Property Crime,Burglary,Male,60+,111,43,68,111,0
2008,Rural,Gujarat,Crime Against Women,Domestic Violence,Female,60+,6776,4831,1945,5162,1614
2003,Rural,Rajasthan,Crime Against Men,Assault,Female,31-45,3903,3419,484,3702,201
2001,Rural,Punjab,Crime Against Children,Kidnapping,Female,13-17,1849,1807,42,1828,21
2001,Urban,Kerala,Property Crime,Burglary,Female,60+,2408,1961,447,2176,232
2004,Rural,Tripura,Crime Against Children,Child Labor,Male,46-60,8598,6866,1732,6886,1712
2003,Urban,Maharashtra,Crime Against Women,Rape,Female,60+,1527,1499,28,1513,14
2006,Rural,Uttarakhand,Crime Against Women,Molestation,Female,13-17,4028,3365,663,3473,555
2004,Urban,Manipur,Other Crimes,Corruption,Female,60+,6977,5193,1784,6873,104
2006,Urban,Uttar Pradesh,Crime Against Women,Dowry Deaths,Male,13-17,1177,28,1149,827,350
2009,Rural,Haryana,Crime Against Children,Kidnapping,Female,60+,7470,1267,6203,5093,2377
2006,Rural,Uttar Pradesh,Crime Against Women,Dowry Deaths,Male,60+,9324,4707,4617,7239,2085
2003,Urban,Kerala,Property Crime,Burglary,Male,60+,8256,1815,6441,8116,140
2007,Rural,Manipur,Crime Against Men,Robbery,Female,0-12,9905,2832,7073,5556,4349
2005,Rural,Sikkim,Other Crimes,Cyber Crime,Male,18-30,2902,2803,99,2868,34
2004,Urban,Haryana,Property Crime,Arson,Male,0-12,7244,790,6454,1601,5643
2010,Urban,Meghalaya,Crime Against Children,Child Labor,Female,60+,4870,952,3918,2712,2158
2004,Rural,Bihar,Crime Against Men,Robbery,Male,60+,153,9,144,120,33
2006,Rural,Karnataka,Property Crime,Theft,Male,18-30,3649,596,3053,3194,455
2001,Rural,Delhi,Property Crime,Burglary,Female,13-17,6148,1079,5069,5486,662
2001,Rural,Himachal Pradesh,Property Crime,Burglary,Male,31-45,9052,1105,7947,9002,50
2002,Rural,Tamil Nadu,Property Crime,Theft,Male,60+,7314,1099,6215,5883,1431
2009,Urban,Rajasthan,Crime Against Children,Kidnapping,Male,46-60,4191,4170,21,4177,14
2010,Rural,Nagaland,Crime Against Women,Dowry Deaths,Female,60+,79,62,17,68,11
2005,Rural,Assam,Crime Against Children,Kidnapping,Male,13-17,8166,273,7893,841,7325
2007,Rural,Andhra Pradesh,Crime Against Children,Child Abuse,Female,13-17,6652,2797,3855,6470,182
2005,Urban,Karnataka,Property Crime,Vandalism,Male,31-45,2107,1880,227,2073,34
2003,Rural,Telangana,Crime Against Women,Molestation,Female,18-30,9139,1538,7601,8231,908
2002,Urban,Delhi,Other Crimes,Cyber Crime,Female,0-12,6516,5167,1349,5771,745
2007,Rural,Odisha,Other Crimes,Corruption,Male,0-12,4646,1985,2661,3863,783
2001,Rural,Jammu & Kashmir,Crime Against Children,Child Abuse,Female,60+,6301,1432,4869,2462,3839
2005,Urban,West Bengal,Crime Against Women,Rape,Male,0-12,7947,7597,350,7611,336
2001,Urban,Karnataka,Crime Against Men,Extortion,Male,18-30,2065,1065,1000,1082,983
2010,Urban,Bihar,Other Crimes,Fraud,Male,60+,8569,5891,2678,8305,264
2010,Urban,Himachal Pradesh,Other Crimes,Cyber Crime,Female,31-45,8016,4643,3373,5092,2924
2006,Rural,Mizoram,Crime Against Women,Dowry Deaths,Male,0-12,2858,1920,938,2278,580
2006,Urban,Rajasthan,Property Crime,Arson,Male,0-12,6603,6412,191,6497,106
2009,Urban,Chhattisgarh,Crime Against Men,Murder,Female,46-60,7135,3245,3890,6730,405
2006,Urban,Goa,Other Crimes,Fraud,Male,46-60,4166,45,4121,1819,2347
2002,Urban,Madhya Pradesh,Other Crimes,Corruption,Female,13-17,9710,1553,8157,3614,6096
2010,Rural,Karnataka,Crime Against Men,Robbery,Male,60+,9312,7374,1938,7811,1501
2007,Rural,Odisha,Property Crime,Burglary,Male,13-17,8673,1660,7013,6817,1856
2006,Urban,Uttarakhand,Other Crimes,Drug Offense,Female,18-30,88,40,48,76,12
2005,Urban,Uttarakhand,Crime Against Women,Domestic Violence,Male,0-12,313,258,55,301,12
2001,Urban,Jharkhand,Crime Against Women,Domestic Violence,Female,18-30,3793,2852,941,2905,888
2010,Rural,Delhi,Property Crime,Burglary,Female,13-17,6000,3756,2244,4432,1568
2006,Rural,Chhattisgarh,Other Crimes,Corruption,Female,0-12,815,372,443,789,26
2004,Rural,Andhra Pradesh,Other Crimes,Fraud,Male,0-12,7615,6067,1548,7242,373
2002,Urban,Jharkhand,Crime Against Children,Trafficking,Male,60+,3540,3133,407,3139,401
2005,Rural,Andhra Pradesh,Crime Against Men,Robbery,Male,0-12,8008,6831,1177,7144,864
2007,Urban,Gujarat,Crime Against Men,Extortion,Male,31-45,5891,3338,2553,4860,1031
2003,Urban,West Bengal,Crime Against Men,Assault,Male,18-30,7218,2883,4335,5877,1341
2004,Urban,Tripura,Other Crimes,Drug Offense,Male,18-30,6990,1121,5869,4876,2114
2006,Rural,Kerala,Crime Against Women,Rape,Female,18-30,2607,1754,853,2098,509
2007,Rural,Tripura,Crime Against Men,Extortion,Female,46-60,1396,606,790,974,422
2010,Urban,Sikkim,Crime Against Men,Robbery,Female,0-12,9928,8586,1342,9395,533
2002,Urban,Arunachal Pradesh,Crime Against Children,Kidnapping,Male,13-17,4261,1446,2815,4241,20
2002,Urban,Odisha,Other Crimes,Drug Offense,Male,46-60,5372,95,5277,4871,501
2003,Urban,Mizoram,Property Crime,Burglary,Male,31-45,4577,3459,1118,3842,735
2003,Rural,Delhi,Crime Against Men,Extortion,Male,46-60,1961,1898,63,1909,52
2007,Urban,Madhya Pradesh,Crime Against Men,Robbery,Male,13-17,8136,4997,3139,7874,262
2010,Urban,Madhya Pradesh,Crime Against Women,Domestic Violence,Female,60+,1767,289,1478,1672,95
2007,Rural,Jammu & Kashmir,Crime Against Women,Molestation,Male,13-17,4540,1324,3216,2146,2394
2002,Rural,Bihar,Crime Against Men,Murder,Male,31-45,1101,501,600,1033,68
2003,Rural,Manipur,Other Crimes,Fraud,Male,18-30,4529,3125,1404,4214,315
2002,Urban,Manipur,Other Crimes,Corruption,Male,18-30,3788,3101,687,3552,236
2008,Urban,Bihar,Crime Against Children,Trafficking,Female,18-30,1132,497,635,1091,41
2009,Rural,Madhya Pradesh,Crime Against Men,Robbery,Male,60+,3305,1190,2115,1403,1902
2006,Urban,Karnataka,Crime Against Men,Robbery,Female,18-30,2649,1743,906,2458,191
2003,Rural,Uttarakhand,Property Crime,Theft,Female,18-30,4754,3694,1060,4458,296
2008,Rural,West Bengal,Crime Against Children,Trafficking,Male,60+,5931,4253,1678,4676,1255
2002,Urban,Rajasthan,Crime Against Men,Murder,Male,13-17,996,692,304,967,29
2010,Rural,Gujarat,Other Crimes,Drug Offense,Male,31-45,7871,5260,2611,7555,316
2001,Urban,Bihar,Crime Against Women,Molestation,Female,46-60,6320,3373,2947,6184,136
2002,Urban,Rajasthan,Crime Against Men,Extortion,Male,13-17,4302,3091,1211,3593,709
2007,Rural,Meghalaya,Crime Against Men,Assault,Male,0-12,6498,3728,2770,5240,1258
2007,Urban,Madhya Pradesh,Other Crimes,Drug Offense,Male,18-30,7810,1626,6184,4912,2898
2010,Urban,West Bengal,Crime Against Children,Child Labor,Female,18-30,7559,763,6796,3702,3857
2001,Rural,Maharashtra,Crime Against Children,Kidnapping,Male,0-12,3158,84,3074,2260,898
2006,Rural,Nagaland,Crime Against Women,Rape,Male,46-60,3329,2339,990,2941,388
2003,Rural,Odisha,Crime Against Women,Domestic Violence,Male,60+,8822,2567,6255,3311,5511
2005,Urban,Odisha,Crime Against Men,Extortion,Male,13-17,2231,490,1741,1888,343
2003,Rural,Maharashtra,Crime Against Children,Child Labor,Male,31-45,3160,1352,1808,1387,1773
2003,Rural,West Bengal,Crime Against Children,Trafficking,Female,60+,3458,3214,244,3388,70
2003,Urban,Kerala,Property Crime,Theft,Male,46-60,2504,425,2079,2304,200
2003,Urban,Uttar Pradesh,Crime Against Men,Robbery,Female,31-45,2720,602,2118,2549,171
2009,Urban,Odisha,Property Crime,Burglary,Male,46-60,3839,2065,1774,3801,38
2007,Rural,Andhra Pradesh,Other Crimes,Drug Offense,Female,0-12,8195,687,7508,7882,313
2002,Rural,Nagaland,Crime Against Men,Murder,Female,0-12,6485,1835,4650,3267,3218
2001,Urban,Delhi,Property Crime,Arson,Female,0-12,9158,1538,7620,4340,4818
2002,Urban,Jharkhand,Other Crimes,Cyber Crime,Male,18-30,9419,4012,5407,9147,272
2008,Urban,Madhya Pradesh,Crime Against Men,Robbery,Male,60+,9489,2486,7003,2853,6636
2009,Rural,Arunachal Pradesh,Crime Against Women,Domestic Violence,Female,60+,9504,9494,10,9496,8
2004,Rural,Uttar Pradesh,Crime Against Men,Assault,Female,13-17,3172,2757,415,2961,211
2004,Urban,Manipur,Other Crimes,Drug Offense,Male,60+,9426,6727,2699,7002,2424
2001,Rural,Meghalaya,Other Crimes,Corruption,Male,18-30,2447,1,2446,1884,563
2002,Rural,Odisha,Other Crimes,Drug Offense,Male,46-60,3985,1417,2568,1799,2186
2003,Urban,Manipur,Crime Against Children,Kidnapping,Female,18-30,7818,2674,5144,3203,4615
2001,Urban,Andhra Pradesh,Crime Against Men,Robbery,Male,60+,2351,583,1768,849,1502
2002,Urban,Uttarakhand,Crime Against Women,Domestic Violence,Male,13-17,2114,1362,752,1464,650
2001,Rural,Maharashtra,Other Crimes,Corruption,Male,18-30,1496,983,513,1229,267
2007,Rural,Haryana,Property Crime,Theft,Female,46-60,1158,983,175,1082,76
2006,Urban,Mizoram,Crime Against Children,Kidnapping,Male,46-60,9806,1326,8480,1763,8043
2008,Urban,Mizoram,Crime Against Women,Rape,Female,60+,8711,4824,3887,6979,1732
2010,Urban,Jammu & Kashmir,Crime Against Men,Assault,Female,0-12,9320,417,8903,5039,4281
2004,Urban,Nagaland,Crime Against Men,Robbery,Female,18-30,538,78,460,167,371
2003,Rural,Tamil Nadu,Property Crime,Theft,Male,13-17,5462,173,5289,402,5060
2010,Urban,Madhya Pradesh,Other Crimes,Cyber Crime,Male,13-17,8869,4073,4796,4320,4549
2001,Urban,Jharkhand,Crime Against Women,Dowry Deaths,Female,18-30,1151,694,457,1003,148
2004,Rural,West Bengal,Crime Against Women,Dowry Deaths,Male,18-30,1431,1187,244,1352,79
2004,Rural,West Bengal,Crime Against Women,Dowry Deaths,Male,0-12,7844,3059,4785,6476,1368
2001,Urban,Sikkim,Crime Against Men,Assault,Male,46-60,4494,3258,1236,3766,728
2005,Urban,Himachal Pradesh,Crime Against Men,Murder,Female,46-60,1044,1036,8,1037,7
2002,Rural,Tamil Nadu,Other Crimes,Fraud,Female,60+,1795,1320,475,1719,76
2003,Rural,Himachal Pradesh,Crime Against Women,Domestic Violence,Female,60+,6275,749,5526,1563,4712
2007,Rural,Goa,Crime Against Women,Rape,Male,13-17,5297,5284,13,5288,9
2003,Rural,West Bengal,Crime Against Children,Child Labor,Female,13-17,272,167,105,213,59
2005,Rural,Delhi,Crime Against Children,Kidnapping,Male,60+,4085,471,3614,2935,1150
2004,Rural,Karnataka,Property Crime,Burglary,Female,13-17,4373,2467,1906,4012,361
2004,Rural,Delhi,Crime Against Men,Assault,Male,0-12,3788,2,3786,3669,119
2009,Urban,Maharashtra,Crime Against Children,Child Abuse,Female,46-60,5078,3577,1501,4601,477
2003,Urban,Tripura,Crime Against Children,Kidnapping,Male,60+,8890,5530,3360,7990,900
2005,Rural,Madhya Pradesh,Crime Against Children,Kidnapping,Male,0-12,1318,1106,212,1258,60
2006,Rural,Telangana,Crime Against Children,Child Labor,Male,0-12,7693,2820,4873,5267,2426
2007,Rural,Himachal Pradesh,Property Crime,Theft,Male,13-17,6320,1528,4792,5827,493
2010,Rural,Goa,Crime Against Men,Extortion,Male,13-17,8824,754,8070,5278,3546
2002,Rural,Uttar Pradesh,Crime Against Men,Extortion,Male,13-17,99,61,38,98,1
2010,Urban,Manipur,Other Crimes,Cyber Crime,Female,31-45,8259,1000,7259,7954,305
2009,Urban,West Bengal,Other Crimes,Corruption,Male,31-45,3923,3118,805,3583,340
2010,Rural,West Bengal,Other Crimes,Drug Offense,Male,13-17,1576,847,729,1072,504
2007,Rural,Odisha,Crime Against Children,Trafficking,Male,0-12,9335,9036,299,9159,176
2001,Urban,Jharkhand,Crime Against Children,Kidnapping,Male,13-17,8590,6555,2035,7521,1069
2001,Rural,Haryana,Property Crime,Burglary,Male,13-17,2636,2386,250,2576,60
2001,Rural,Punjab,Crime Against Women,Dowry Deaths,Male,13-17,2904,721,2183,1149,1755
2005,Rural,Kerala,Crime Against Women,Molestation,Male,31-45,8112,7703,409,7763,349
2007,Rural,Goa,Other Crimes,Drug Offense,Male,60+,693,353,340,538,155
2010,Urban,Nagaland,Crime Against Children,Kidnapping,Male,60+,6977,911,6066,5102,1875
2007,Rural,Odisha,Crime Against Women,Dowry Deaths,Male,60+,62,36,26,39,23
2004,Rural,Sikkim,Other Crimes,Fraud,Male,0-12,2327,189,2138,592,1735
2001,Urban,Andhra Pradesh,Property Crime,Vandalism,Female,18-30,9988,5649,4339,9242,746
2006,Urban,Kerala,Property Crime,Vandalism,Male,31-45,8648,2981,5667,5975,2673
2010,Urban,Haryana,Crime Against Men,Murder,Male,0-12,8966,1,8965,6806,2160
2002,Rural,Delhi,Crime Against Children,Child Abuse,Male,46-60,4439,1007,3432,2184,2255
2007,Urban,Uttar Pradesh,Crime Against Women,Domestic Violence,Male,13-17,5420,1588,3832,2515,2905
2007,Urban,Meghalaya,Other Crimes,Cyber Crime,Female,31-45,9425,7861,1564,9252,173
2006,Urban,Kerala,Other Crimes,Drug Offense,Female,60+,1274,973,301,1093,181
2003,Rural,Meghalaya,Crime Against Women,Domestic Violence,Male,18-30,9622,7189,2433,8018,1604
2008,Rural,Haryana,Crime Against Children,Trafficking,Male,0-12,3271,599,2672,2709,562
2002,Urban,Manipur,Other Crimes,Fraud,Male,46-60,9096,7025,2071,7270,1826
2002,Urban,Jammu & Kashmir,Crime Against Women,Dowry Deaths,Male,13-17,5474,374,5100,5082,392
2008,Rural,Uttar Pradesh,Crime Against Women,Rape,Female,18-30,3452,2809,643,3296,156
2007,Urban,Madhya Pradesh,Other Crimes,Corruption,Female,31-45,1572,1308,264,1377,195
2010,Rural,Gujarat,Crime Against Women,Rape,Female,60+,7610,385,7225,6401,1209
2010,Urban,Jammu & Kashmir,Other Crimes,Cyber Crime,Female,46-60,6418,6361,57,6411,7
2001,Urban,Sikkim,Crime Against Women,Molestation,Female,31-45,315,154,161,290,25
2005,Rural,Kerala,Crime Against Women,Dowry Deaths,Male,46-60,128,42,86,49,79
2006,Urban,Telangana,Property Crime,Burglary,Male,46-60,3817,2877,940,3072,745
2002,Urban,Bihar,Other Crimes,Corruption,Male,46-60,2593,1395,1198,2168,425
2006,Rural,Jammu & Kashmir,Crime Against Women,Molestation,Male,31-45,698,382,316,654,44
2005,Urban,Odisha,Crime Against Men,Robbery,Male,46-60,1896,1465,431,1760,136
2009,Rural,Madhya Pradesh,Property Crime,Vandalism,Male,60+,3995,2979,1016,3427,568
2002,Rural,Maharashtra,Crime Against Women,Domestic Violence,Female,46-60,8432,2840,5592,7258,1174
2007,Urban,Tamil Nadu,Crime Against Children,Child Abuse,Female,13-17,4051,2762,1289,2913,1138
2010,Urban,Assam,Property Crime,Theft,Female,13-17,3846,2874,972,3612,234
2009,Urban,Delhi,Other Crimes,Corruption,Female,31-45,372,147,225,302,70
2006,Rural,Punjab,Property Crime,Burglary,Male,18-30,6141,5032,1109,5879,262
2004,Urban,Punjab,Other Crimes,Corruption,Male,18-30,94,39,55,84,10
2006,Urban,Meghalaya,Crime Against Men,Robbery,Female,60+,1610,1535,75,1553,57
2010,Rural,Jammu & Kashmir,Other Crimes,Drug Offense,Female,18-30,6405,5674,731,5877,528
2001,Rural,Himachal Pradesh,Crime Against Children,Child Labor,Female,18-30,4806,3899,907,4667,139
2009,Urban,Karnataka,Other Crimes,Corruption,Male,60+,7781,673,7108,6568,1213
2001,Rural,Madhya Pradesh,Crime Against Men,Extortion,Male,0-12,1568,144,1424,510,1058
2002,Urban,Rajasthan,Crime Against Children,Child Abuse,Female,46-60,9569,7236,2333,7329,2240
2006,Urban,Manipur,Crime Against Men,Robbery,Female,46-60,4642,2945,1697,3303,1339
2001,Urban,Jammu & Kashmir,Crime Against Children,Trafficking,Female,60+,9108,7272,1836,9000,108
2010,Urban,Assam,Crime Against Men,Murder,Female,18-30,917,876,41,877,40
2008,Rural,Punjab,Crime Against Men,Robbery,Female,0-12,7377,6513,864,6523,854
2003,Rural,Sikkim,Other Crimes,Corruption,Male,31-45,5599,5025,574,5152,447
2006,Rural,Uttarakhand,Other Crimes,Fraud,Male,60+,5125,4374,751,5018,107
2001,Rural,Mizoram,Crime Against Men,Murder,Male,60+,5704,112,5592,1898,3806
2010,Rural,Arunachal Pradesh,Crime Against Men,Robbery,Female,46-60,8176,3267,4909,7054,1122
2003,Rural,Uttar Pradesh,Property Crime,Arson,Female,46-60,6176,4620,1556,5761,415
2009,Rural,Haryana,Crime Against Men,Extortion,Female,13-17,4372,4254,118,4341,31
2006,Rural,Arunachal Pradesh,Crime Against Children,Trafficking,Male,0-12,7735,145,7590,2452,5283
2007,Rural,Assam,Other Crimes,Corruption,Male,0-12,3960,1320,2640,2049,1911
2006,Rural,West Bengal,Other Crimes,Corruption,Male,31-45,1590,1550,40,1570,20
2003,Rural,Madhya Pradesh,Other Crimes,Fraud,Male,31-45,181,50,131,133,48
2003,Urban,Assam,Other Crimes,Drug Offense,Male,18-30,8767,4218,4549,8351,416
2008,Urban,Manipur,Crime Against Men,Murder,Female,0-12,6471,6101,370,6397,74
2004,Urban,Telangana,Crime Against Women,Domestic Violence,Female,0-12,252,21,231,230,22
2007,Urban,Goa,Property Crime,Burglary,Female,31-45,2875,1039,1836,1366,1509
2002,Rural,Madhya Pradesh,Property Crime,Burglary,Male,46-60,8982,8889,93,8942,40
2003,Urban,Assam,Crime Against Children,Child Abuse,Male,0-12,1583,1311,272,1561,22
2007,Rural,Sikkim,Property Crime,Burglary,Female,31-45,5433,3546,1887,4743,690
2006,Urban,Uttarakhand,Crime Against Men,Murder,Male,18-30,3511,3113,398,3177,334
2006,Urban,Sikkim,Other Crimes,Drug Offense,Female,31-45,7858,3132,4726,4293,3565
2003,Urban,Mizoram,Property Crime,Theft,Male,18-30,5786,2983,2803,3231,2555
2008,Urban,Jharkhand,Other Crimes,Drug Offense,Male,31-45,7884,6455,1429,7080,804
2007,Rural,Delhi,Crime Against Women,Molestation,Male,18-30,4964,4449,515,4639,325
2006,Rural,Goa,Crime Against Women,Domestic Violence,Female,13-17,7061,2464,4597,6542,519
2006,Urban,Andhra Pradesh,Crime Against Women,Rape,Male,0-12,1507,461,1046,1047,460
2006,Urban,Mizoram,Other Crimes,Drug Offense,Male,13-17,7836,2545,5291,2974,4862
2003,Rural,Rajasthan,Crime Against Men,Murder,Female,31-45,8351,3005,5346,8109,242
2004,Rural,Mizoram,Property Crime,Vandalism,Female,0-12,738,449,289,517,221
2004,Urban,Odisha,Other Crimes,Fraud,Male,18-30,1875,1648,227,1816,59
2003,Urban,Tripura,Other Crimes,Cyber Crime,Male,0-12,2747,417,2330,718,2029
2006,Urban,Himachal Pradesh,Other Crimes,Fraud,Female,18-30,9240,2444,6796,3020,6220
2006,Rural,Punjab,Other Crimes,Fraud,Male,18-30,8846,4223,4623,4696,4150
2002,Urban,Andhra Pradesh,Property Crime,Theft,Female,31-45,7514,2810,4704,4708,2806
2006,Urban,Arunachal Pradesh,Property Crime,Vandalism,Female,46-60,9538,158,9380,8991,547
2001,Rural,Karnataka,Crime Against Women,Rape,Female,31-45,9432,5261,4171,5675,3757
2009,Rural,Chhattisgarh,Crime Against Men,Robbery,Male,60+,4790,4304,486,4641,149
2001,Rural,Karnataka,Crime Against Children,Child Labor,Male,60+,6051,2340,3711,4833,1218
2002,Urban,Manipur,Property Crime,Burglary,Female,31-45,7395,435,6960,1846,5549
2004,Urban,Uttar Pradesh,Other Crimes,Cyber Crime,Female,31-45,1472,86,1386,550,922
2001,Urban,Meghalaya,Property Crime,Arson,Female,13-17,4442,443,3999,1145,3297
2009,Urban,Jammu & Kashmir,Crime Against Children,Child Abuse,Male,60+,5137,3418,1719,4641,496
2004,Rural,Karnataka,Crime Against Women,Domestic Violence,Male,31-45,2919,2536,383,2595,324
2001,Rural,Bihar,Crime Against Women,Rape,Female,18-30,9933,5519,4414,9877,56
2002,Rural,Tamil Nadu,Property Crime,Theft,Female,13-17,5581,4540,1041,5115,466
2003,Rural,Telangana,Crime Against Children,Kidnapping,Male,0-12,1485,665,820,1194,291
2008,Urban,Karnataka,Crime Against Women,Rape,Male,46-60,8427,5857,2570,7619,808
2002,Urban,Rajasthan,Crime Against Children,Kidnapping,Female,13-17,1991,1115,876,1529,462
2004,Urban,Haryana,Crime Against Men,Robbery,Male,18-30,8279,5660,2619,7998,281
2009,Urban,Bihar,Crime Against Women,Dowry Deaths,Female,46-60,3740,878,2862,1299,2441
2010,Rural,Telangana,Crime Against Men,Extortion,Male,60+,4053,816,3237,1996,2057
2010,Urban,Sikkim,Property Crime,Arson,Female,31-45,1150,516,634,836,314
2007,Urban,Maharashtra,Crime Against Children,Child Abuse,Male,18-30,6052,914,5138,1610,4442
2006,Urban,Mizoram,Other Crimes,Corruption,Female,31-45,627,475,152,556,71
2008,Urban,Karnataka,Crime Against Women,Rape,Female,46-60,3891,2551,1340,3087,804
2001,Rural,West Bengal,Crime Against Men,Extortion,Female,13-17,7926,6271,1655,6805,1121
2004,Urban,Mizoram,Crime Against Men,Assault,Female,60+,6168,2574,3594,3773,2395
2008,Rural,Haryana,Crime Against Children,Child Abuse,Female,13-17,4150,604,3546,2147,2003
2008,Urban,Nagaland,Crime Against Women,Molestation,Male,31-45,1887,1697,190,1808,79
2010,Rural,Gujarat,Other Crimes,Fraud,Female,60+,5755,3955,1800,4783,972
2005,Rural,Himachal Pradesh,Crime Against Children,Kidnapping,Male,31-45,5937,3969,1968,4999,938
2009,Rural,Nagaland,Crime Against Men,Murder,Male,13-17,937,474,463,520,417
2009,Rural,Rajasthan,Property Crime,Theft,Female,31-45,931,796,135,838,93
2001,Urban,Odisha,Crime Against Women,Molestation,Male,0-12,6813,3238,3575,6509,304
2003,Urban,Meghalaya,Crime Against Men,Murder,Female,60+,8907,3994,4913,4962,3945
2004,Urban,Uttarakhand,Other Crimes,Fraud,Male,0-12,8198,5137,3061,5748,2450
2005,Rural,West Bengal,Crime Against Women,Domestic Violence,Female,0-12,2888,712,2176,2651,237
2009,Urban,Himachal Pradesh,Crime Against Men,Robbery,Male,60+,7341,5641,1700,6573,768
2002,Rural,Manipur,Crime Against Men,Assault,Female,13-17,2000,1884,116,1923,77
2004,Rural,Odisha,Crime Against Children,Child Abuse,Male,0-12,6909,964,5945,3433,3476
2008,Rural,Bihar,Crime Against Women,Dowry Deaths,Female,60+,8087,5116,2971,6411,1676
2006,Urban,Andhra Pradesh,Crime Against Men,Murder,Female,31-45,6886,6828,58,6854,32
2008,Rural,Delhi,Property Crime,Arson,Male,31-45,2846,2756,90,2828,18
2009,Urban,Sikkim,Other Crimes,Fraud,Female,0-12,3854,3081,773,3257,597
2009,Rural,Punjab,Crime Against Children,Trafficking,Female,18-30,3708,117,3591,1039,2669
2005,Rural,Tamil Nadu,Crime Against Women,Molestation,Female,13-17,3867,2690,1177,3179,688
2008,Urban,Punjab,Crime Against Women,Molestation,Female,31-45,1769,1220,549,1371,398
2008,Urban,Arunachal Pradesh,Property Crime,Theft,Male,18-30,1263,4,1259,481,782
2003,Urban,Maharashtra,Crime Against Men,Murder,Female,31-45,9096,8633,463,8742,354
2004,Urban,Punjab,Crime Against Women,Molestation,Male,18-30,5291,4312,979,4845,446
2006,Rural,Nagaland,Crime Against Children,Child Labor,Female,18-30,8316,4146,4170,5419,2897
2005,Urban,Odisha,Other Crimes,Cyber Crime,Male,13-17,5396,1664,3732,3585,1811
2001,Rural,Tripura,Crime Against Children,Kidnapping,Female,18-30,1338,360,978,853,485
2007,Urban,Mizoram,Crime Against Men,Murder,Male,18-30,1575,334,1241,1441,134
2005,Rural,Arunachal Pradesh,Crime Against Women,Molestation,Female,18-30,8667,8494,173,8520,147
2009,Urban,Delhi,Crime Against Men,Murder,Female,18-30,5980,2916,3064,4131,1849
2007,Rural,Telangana,Crime Against Men,Robbery,Female,31-45,3744,1561,2183,2860,884
2004,Urban,Karnataka,Other Crimes,Cyber Crime,Male,60+,284,120,164,133,151
2010,Rural,Manipur,Crime Against Children,Child Abuse,Male,18-30,6895,2891,4004,6270,625
2008,Rural,Maharashtra,Crime Against Men,Robbery,Female,46-60,4860,3717,1143,3961,899
2001,Rural,Telangana,Crime Against Children,Child Abuse,Female,0-12,1219,272,947,599,620
2010,Rural,Gujarat,Crime Against Men,Assault,Female,18-30,9332,4576,4756,8102,1230
2006,Urban,Madhya Pradesh,Other Crimes,Fraud,Male,46-60,825,460,365,825,0
2010,Rural,Karnataka,Property Crime,Burglary,Female,46-60,5145,1805,3340,2198,2947
2001,Urban,Kerala,Property Crime,Arson,Male,13-17,1806,249,1557,1629,177
2008,Rural,Assam,Property Crime,Theft,Female,46-60,7765,7182,583,7740,25
2010,Urban,Haryana,Property Crime,Vandalism,Female,60+,2996,2978,18,2982,14
2002,Urban,Karnataka,Crime Against Women,Rape,Male,0-12,4237,1037,3200,2117,2120
2010,Rural,Punjab,Crime Against Women,Rape,Female,13-17,7473,5379,2094,7345,128
2010,Rural,Chhattisgarh,Crime Against Men,Murder,Male,31-45,1384,1189,195,1300,84
2006,Rural,Chhattisgarh,Other Crimes,Fraud,Female,46-60,1870,941,929,958,912
2006,Rural,Assam,Crime Against Women,Domestic Violence,Female,46-60,5411,3531,1880,5227,184
2004,Urban,Goa,Crime Against Children,Child Labor,Female,31-45,4935,4320,615,4466,469
2008,Urban,Bihar,Property Crime,Vandalism,Female,18-30,421,89,332,90,331
2007,Urban,Karnataka,Property Crime,Arson,Female,0-12,3086,615,2471,2918,168
2005,Rural,Madhya Pradesh,Property Crime,Burglary,Male,31-45,1704,53,1651,414,1290
2003,Urban,Meghalaya,Other Crimes,Drug Offense,Male,13-17,9819,5953,3866,7472,2347
2007,Urban,Haryana,Property Crime,Arson,Male,13-17,5085,437,4648,3414,1671
2006,Urban,Andhra Pradesh,Other Crimes,Corruption,Female,13-17,1300,1107,193,1296,4
2008,Rural,Goa,Crime Against Children,Trafficking,Female,46-60,4132,626,3506,1923,2209
2003,Urban,Maharashtra,Crime Against Women,Rape,Male,18-30,3535,685,2850,1331,2204
2004,Urban,Tripura,Property Crime,Theft,Male,18-30,9291,8627,664,9020,271
2002,Rural,Rajasthan,Property Crime,Vandalism,Male,46-60,7059,1759,5300,2239,4820
2005,Urban,Uttar Pradesh,Crime Against Men,Murder,Female,46-60,298,78,220,271,27
2007,Rural,Andhra Pradesh,Crime Against Women,Molestation,Male,13-17,3801,3302,499,3657,144
2008,Rural,Himachal Pradesh,Crime Against Women,Rape,Male,18-30,9482,6006,3476,8755,727
2010,Urban,Madhya Pradesh,Crime Against Children,Child Labor,Male,31-45,9603,7945,1658,9334,269
2004,Rural,Manipur,Other Crimes,Drug Offense,Female,31-45,107,59,48,93,14
2010,Urban,Uttarakhand,Crime Against Men,Assault,Male,60+,3389,1402,1987,2291,1098
2005,Urban,Rajasthan,Crime Against Children,Kidnapping,Female,13-17,8047,2018,6029,3815,4232
2009,Rural,Rajasthan,Crime Against Women,Domestic Violence,Male,46-60,9970,980,8990,2077,7893
2010,Urban,Goa,Crime Against Women,Molestation,Female,13-17,184,48,136,166,18
2004,Rural,Rajasthan,Crime Against Men,Murder,Female,18-30,5911,151,5760,5362,549
2001,Rural,Odisha,Other Crimes,Corruption,Male,0-12,3508,2939,569,3010,498
2007,Urban,Jharkhand,Crime Against Men,Robbery,Female,13-17,5695,2854,2841,4221,1474
2010,Urban,Odisha,Crime Against Men,Extortion,Female,13-17,1494,526,968,817,677
2003,Rural,Chhattisgarh,Crime Against Women,Domestic Violence,Female,60+,4986,2900,2086,2975,2011
2002,Rural,Delhi,Crime Against Women,Dowry Deaths,Male,18-30,1427,942,485,1128,299
2002,Urban,Himachal Pradesh,Other Crimes,Fraud,Male,0-12,2767,2276,491,2629,138
2003,Rural,Rajasthan,Other Crimes,Cyber Crime,Male,13-17,3635,3086,549,3382,253
2007,Rural,Tripura,Other Crimes,Cyber Crime,Female,31-45,247,27,220,153,94
2007,Urban,Arunachal Pradesh,Property Crime,Burglary,Male,60+,2024,499,1525,1870,154
2002,Rural,Uttar Pradesh,Other Crimes,Corruption,Female,31-45,6846,3028,3818,4024,2822
2006,Urban,West Bengal,Other Crimes,Drug Offense,Male,13-17,4332,344,3988,1773,2559
2010,Urban,Madhya Pradesh,Other Crimes,Cyber Crime,Female,18-30,8810,3438,5372,6338,2472
2002,Urban,Delhi,Crime Against Children,Child Labor,Female,46-60,6261,4764,1497,6110,151
2001,Rural,Kerala,Crime Against Children,Child Labor,Male,31-45,1492,1053,439,1153,339
2001,Rural,Punjab,Crime Against Women,Rape,Female,13-17,7959,18,7941,1033,6926
2010,Urban,Delhi,Property Crime,Theft,Female,18-30,8252,1132,7120,6018,2234
2009,Urban,Jammu & Kashmir,Other Crimes,Cyber Crime,Male,13-17,6265,5506,759,6140,125
2001,Urban,Assam,Crime Against Men,Murder,Female,31-45,4951,3154,1797,4863,88
2010,Urban,Maharashtra,Crime Against Men,Extortion,Female,13-17,5071,3477,1594,4053,1018
2009,Urban,Karnataka,Other Crimes,Drug Offense,Female,18-30,4622,1575,3047,3431,1191
2007,Rural,Chhattisgarh,Crime Against Men,Murder,Female,31-45,4253,3158,1095,3745,508
2004,Urban,Uttar Pradesh,Other Crimes,Drug Offense,Female,31-45,7230,2003,5227,4206,3024
2008,Urban,Kerala,Crime Against Women,Domestic Violence,Female,60+,831,215,616,603,228
2001,Rural,Gujarat,Other Crimes,Corruption,Male,18-30,4093,3744,349,3962,131
2003,Urban,Andhra Pradesh,Crime Against Children,Kidnapping,Female,46-60,5980,4953,1027,5618,362
2002,Urban,Arunachal Pradesh,Other Crimes,Corruption,Female,46-60,7239,6559,680,6607,632
2002,Urban,Maharashtra,Other Crimes,Fraud,Male,0-12,2575,667,1908,1644,931
2009,Rural,Delhi,Crime Against Men,Robbery,Female,0-12,164,73,91,149,15
2005,Urban,Assam,Crime Against Men,Assault,Male,18-30,2787,349,2438,1390,1397
2004,Rural,Jharkhand,Crime Against Women,Rape,Male,0-12,8442,7153,1289,8119,323
2006,Urban,Karnataka,Crime Against Children,Trafficking,Male,60+,968,40,928,178,790
2005,Urban,Karnataka,Crime Against Children,Kidnapping,Male,0-12,9471,1553,7918,9013,458
2001,Rural,Bihar,Other Crimes,Drug Offense,Female,60+,132,50,82,97,35
2007,Rural,Chhattisgarh,Crime Against Women,Molestation,Male,18-30,4656,3166,1490,3498,1158
2005,Rural,Telangana,Crime Against Men,Assault,Male,31-45,4498,4374,124,4471,27
2008,Rural,Chhattisgarh,Property Crime,Vandalism,Female,18-30,8756,1875,6881,5540,3216
2009,Rural,Karnataka,Other Crimes,Corruption,Female,13-17,507,314,193,495,12
2001,Urban,Goa,Other Crimes,Fraud,Male,46-60,2258,503,1755,938,1320
2010,Rural,Meghalaya,Property Crime,Theft,Female,60+,2997,897,2100,2730,267
2003,Rural,Karnataka,Crime Against Men,Extortion,Female,13-17,9799,6873,2926,6907,2892
2009,Rural,Uttarakhand,Crime Against Women,Dowry Deaths,Female,0-12,4947,3845,1102,4246,701
2001,Rural,Assam,Crime Against Women,Molestation,Female,13-17,3573,3455,118,3522,51
2005,Urban,West Bengal,Crime Against Women,Rape,Male,60+,3429,1542,1887,2527,902
2010,Rural,Gujarat,Other Crimes,Drug Offense,Male,46-60,377,342,35,374,3
2004,Rural,Nagaland,Property Crime,Arson,Female,0-12,5507,1266,4241,5162,345
2003,Rural,Bihar,Crime Against Women,Dowry Deaths,Female,0-12,4691,3679,1012,4298,393
2004,Urban,Jammu & Kashmir,Crime Against Children,Child Labor,Male,0-12,2610,2111,499,2510,100
2003,Rural,Punjab,Crime Against Children,Trafficking,Male,31-45,9979,1381,8598,7745,2234
2010,Rural,Assam,Crime Against Children,Child Labor,Female,18-30,1121,509,612,1014,107
2001,Urban,Manipur,Property Crime,Vandalism,Male,18-30,2548,2057,491,2356,192
2008,Rural,Gujarat,Crime Against Children,Kidnapping,Female,13-17,6124,236,5888,619,5505
2001,Rural,Tamil Nadu,Crime Against Children,Kidnapping,Male,46-60,4789,2562,2227,4132,657
2003,Rural,Arunachal Pradesh,Crime Against Men,Assault,Female,0-12,2038,1058,980,1108,930
2004,Urban,Maharashtra,Crime Against Women,Molestation,Male,46-60,2590,1673,917,2000,590
2005,Urban,Bihar,Property Crime,Theft,Female,31-45,4418,3673,745,4120,298
2005,Rural,Tamil Nadu,Property Crime,Burglary,Male,0-12,6561,1491,5070,2375,4186
2007,Urban,Tamil Nadu,Crime Against Men,Murder,Female,31-45,7485,1151,6334,7335,150
2010,Urban,Goa,Other Crimes,Corruption,Female,31-45,9868,389,9479,3864,6004
2009,Urban,Telangana,Property Crime,Vandalism,Female,0-12,3779,890,2889,2353,1426
2010,Rural,Rajasthan,Crime Against Women,Molestation,Female,18-30,9331,3989,5342,7459,1872
2002,Urban,Haryana,Other Crimes,Corruption,Female,0-12,5790,3163,2627,3581,2209
2001,Rural,Rajasthan,Other Crimes,Fraud,Female,0-12,7286,5664,1622,6183,1103
2009,Rural,Bihar,Crime Against Men,Robbery,Male,13-17,2878,1985,893,2464,414
2002,Urban,Rajasthan,Property Crime,Theft,Female,0-12,6697,3961,2736,5048,1649
2006,Rural,Kerala,Crime Against Children,Trafficking,Female,0-12,8332,2961,5371,5955,2377
2010,Rural,Gujarat,Crime Against Women,Domestic Violence,Female,46-60,4544,1403,3141,4394,150
2008,Rural,Bihar,Crime Against Women,Rape,Male,0-12,120,96,24,104,16
2002,Rural,West Bengal,Crime Against Women,Rape,Female,18-30,1014,692,322,878,136
2010,Urban,Haryana,Crime Against Children,Kidnapping,Female,46-60,157,43,114,98,59
2007,Rural,Jammu & Kashmir,Other Crimes,Drug Offense,Female,18-30,512,456,56,473,39
2004,Urban,Jammu & Kashmir,Property Crime,Burglary,Female,46-60,2943,1977,966,2395,548
2009,Urban,Kerala,Crime Against Men,Murder,Male,60+,7852,5323,2529,6259,1593
2003,Rural,Chhattisgarh,Crime Against Women,Domestic Violence,Female,0-12,6725,5954,771,6685,40
2004,Rural,Meghalaya,Crime Against Women,Dowry Deaths,Male,46-60,8777,4327,4450,4599,4178
2006,Rural,Meghalaya,Crime Against Women,Domestic Violence,Female,46-60,7050,5374,1676,5518,1532
2002,Rural,West Bengal,Other Crimes,Corruption,Male,46-60,9448,3141,6307,3284,6164
2009,Urban,Haryana,Other Crimes,Corruption,Male,0-12,5103,1972,3131,4926,177
2010,Urban,Kerala,Other Crimes,Corruption,Male,31-45,6781,3956,2825,5842,939
2008,Rural,Himachal Pradesh,Other Crimes,Cyber Crime,Female,0-12,8575,3617,4958,5946,2629
2004,Rural,Telangana,Crime Against Men,Murder,Female,60+,3994,3133,861,3651,343
2004,Urban,Delhi,Other Crimes,Cyber Crime,Male,46-60,7451,5445,2006,5493,1958
2001,Urban,Telangana,Crime Against Women,Molestation,Female,18-30,6855,2528,4327,6406,449
2007,Rural,Karnataka,Other Crimes,Fraud,Female,31-45,3953,466,3487,2294,1659
2007,Urban,Uttarakhand,Crime Against Women,Molestation,Female,13-17,9918,5954,3964,8231,1687
2001,Rural,Delhi,Crime Against Women,Dowry Deaths,Female,18-30,6799,6059,740,6535,264
2008,Urban,Rajasthan,Crime Against Men,Murder,Female,31-45,6126,256,5870,674,5452
2007,Rural,Nagaland,Property Crime,Theft,Female,31-45,8258,1336,6922,4587,3671
2005,Rural,Sikkim,Crime Against Men,Extortion,Female,46-60,1867,831,1036,1080,787
2005,Rural,Madhya Pradesh,Crime Against Men,Robbery,Female,18-30,5088,4038,1050,4591,497
2004,Urban,Himachal Pradesh,Property Crime,Vandalism,Male,18-30,1248,632,616,972,276
2004,Rural,Jammu & Kashmir,Crime Against Men,Robbery,Female,31-45,3352,2055,1297,3351,1
2006,Rural,Delhi,Crime Against Men,Murder,Male,31-45,517,123,394,311,206
2002,Rural,Tripura,Crime Against Women,Domestic Violence,Male,60+,3845,2095,1750,3704,141
2001,Urban,Himachal Pradesh,Crime Against Men,Extortion,Female,60+,6579,2012,4567,5437,1142
2001,Rural,Maharashtra,Crime Against Children,Kidnapping,Male,31-45,5996,1265,4731,3599,2397
2004,Rural,Odisha,Property Crime,Arson,Female,18-30,8538,3104,5434,4950,3588
2002,Rural,Bihar,Crime Against Women,Dowry Deaths,Male,46-60,3417,2223,1194,2230,1187
2009,Rural,Uttar Pradesh,Crime Against Women,Rape,Male,31-45,2003,1628,375,1965,38
2009,Urban,Sikkim,Property Crime,Vandalism,Female,31-45,9650,6480,3170,9031,619
2002,Rural,Arunachal Pradesh,Property Crime,Burglary,Female,31-45,9931,4775,5156,9127,804
2010,Urban,Delhi,Crime Against Women,Rape,Female,60+,515,232,283,389,126
2003,Rural,Andhra Pradesh,Crime Against Men,Robbery,Male,46-60,3841,1251,2590,3521,320
2005,Rural,Himachal Pradesh,Other Crimes,Fraud,Female,46-60,3639,2283,1356,3206,433
2003,Urban,Uttar Pradesh,Property Crime,Arson,Female,18-30,5024,1416,3608,1562,3462
2004,Rural,Maharashtra,Crime Against Children,Child Abuse,Female,46-60,3711,2094,1617,2920,791
2009,Urban,Sikkim,Other Crimes,Drug Offense,Male,60+,9318,6871,2447,8474,844
2005,Urban,West Bengal,Other Crimes,Cyber Crime,Male,31-45,6720,2246,4474,2781,3939
2009,Urban,Meghalaya,Crime Against Women,Molestation,Female,31-45,8857,2614,6243,5014,3843
2002,Rural,Andhra Pradesh,Crime Against Children,Kidnapping,Male,46-60,5770,2132,3638,4908,862
2006,Rural,Tamil Nadu,Crime Against Men,Assault,Female,18-30,3527,2179,1348,3440,87
2004,Rural,Uttarakhand,Other Crimes,Fraud,Female,60+,8314,6864,1450,6881,1433
2003,Rural,Kerala,Other Crimes,Fraud,Male,46-60,806,332,474,400,406
2004,Rural,Mizoram,Property Crime,Theft,Female,31-45,4880,3853,1027,4318,562
2004,Urban,Madhya Pradesh,Other Crimes,Corruption,Female,46-60,4787,1373,3414,2192,2595
2009,Urban,Karnataka,Other Crimes,Cyber Crime,Male,31-45,6771,1728,5043,4653,2118
2002,Rural,Telangana,Crime Against Women,Molestation,Female,31-45,8420,2356,6064,7129,1291
2007,Rural,Maharashtra,Property Crime,Burglary,Female,46-60,1621,932,689,953,668
2006,Rural,Assam,Crime Against Women,Domestic Violence,Female,13-17,4155,4125,30,4142,13
2006,Urban,Goa,Crime Against Women,Molestation,Male,13-17,6965,3030,3935,3038,3927
2006,Rural,Madhya Pradesh,Other Crimes,Corruption,Female,60+,5448,31,5417,891,4557
2005,Rural,Punjab,Crime Against Men,Robbery,Female,0-12,4722,4112,610,4399,323
2008,Urban,Uttar Pradesh,Crime Against Men,Extortion,Male,18-30,2531,1878,653,2039,492
2003,Rural,Goa,Property Crime,Vandalism,Male,31-45,8499,6235,2264,6348,2151
2002,Rural,Tripura,Crime Against Women,Molestation,Male,18-30,9808,900,8908,2071,7737
2006,Urban,Kerala,Property Crime,Burglary,Female,60+,6384,3660,2724,5677,707
2005,Rural,Haryana,Property Crime,Vandalism,Female,60+,7208,3723,3485,4559,2649
2001,Urban,Arunachal Pradesh,Crime Against Children,Child Abuse,Female,60+,6104,5582,522,6036,68
2004,Urban,Himachal Pradesh,Property Crime,Theft,Female,60+,4306,2415,1891,2547,1759
2008,Rural,Assam,Crime Against Women,Rape,Male,31-45,3052,1156,1896,1684,1368
2008,Rural,Goa,Property Crime,Arson,Female,18-30,3044,1501,1543,1616,1428
2008,Rural,Nagaland,Property Crime,Arson,Male,60+,4814,3342,1472,4327,487
2009,Rural,Uttarakhand,Crime Against Men,Assault,Female,31-45,3885,1415,2470,3418,467
2010,Rural,Meghalaya,Other Crimes,Corruption,Female,60+,5016,3905,1111,4158,858
2002,Rural,Madhya Pradesh,Crime Against Children,Trafficking,Female,13-17,4816,4264,552,4384,432
2010,Urban,Bihar,Crime Against Women,Molestation,Female,46-60,4483,288,4195,1581,2902
2005,Urban,Arunachal Pradesh,Crime Against Women,Domestic Violence,Female,18-30,4388,2252,2136,4128,260
2006,Rural,Meghalaya,Crime Against Men,Assault,Female,13-17,8623,3437,5186,4819,3804
2003,Urban,Uttar Pradesh,Other Crimes,Fraud,Male,60+,8330,7795,535,8290,40
2002,Rural,Uttarakhand,Crime Against Children,Child Abuse,Male,60+,1920,1676,244,1718,202
2005,Urban,Kerala,Crime Against Women,Molestation,Female,46-60,5717,4760,957,5377,340
2004,Rural,Maharashtra,Property Crime,Theft,Female,31-45,2913,1404,1509,2354,559
2009,Urban,Manipur,Other Crimes,Fraud,Female,46-60,3146,367,2779,1649,1497
2010,Urban,Himachal Pradesh,Other Crimes,Drug Offense,Female,18-30,3813,660,3153,1432,2381
2009,Urban,Odisha,Other Crimes,Cyber Crime,Female,46-60,4476,4028,448,4445,31
2005,Rural,Delhi,Property Crime,Arson,Male,0-12,4128,3865,263,3907,221
2002,Urban,Chhattisgarh,Crime Against Men,Murder,Male,31-45,8778,8374,404,8378,400
2009,Urban,Manipur,Other Crimes,Cyber Crime,Female,13-17,1477,1305,172,1477,0
2008,Urban,Telangana,Crime Against Children,Child Labor,Male,13-17,8628,7056,1572,7884,744
2005,Urban,Manipur,Other Crimes,Corruption,Male,60+,2809,489,2320,2679,130
2008,Rural,Punjab,Other Crimes,Fraud,Female,46-60,5151,2105,3046,2176,2975
2004,Rural,Andhra Pradesh,Property Crime,Theft,Male,13-17,1840,215,1625,752,1088
2006,Urban,West Bengal,Property Crime,Burglary,Male,46-60,5993,3652,2341,4303,1690
2003,Urban,Assam,Property Crime,Burglary,Male,18-30,3493,191,3302,3433,60
2005,Urban,Goa,Property Crime,Burglary,Male,18-30,537,45,492,479,58
2010,Rural,Assam,Crime Against Men,Murder,Male,60+,8215,2232,5983,6188,2027
2001,Rural,West Bengal,Crime Against Children,Child Labor,Female,18-30,5450,2613,2837,5032,418
2004,Urban,Tripura,Crime Against Women,Dowry Deaths,Male,0-12,316,92,224,289,27
2004,Rural,Uttarakhand,Other Crimes,Cyber Crime,Male,13-17,8599,7498,1101,8249,350
2004,Urban,Karnataka,Crime Against Children,Child Labor,Male,46-60,374,192,182,328,46
2002,Rural,Maharashtra,Crime Against Children,Child Abuse,Female,60+,9301,1143,8158,8002,1299
2008,Urban,Jammu & Kashmir,Crime Against Children,Trafficking,Female,60+,4819,4115,704,4404,415
2006,Rural,Tripura,Crime Against Women,Rape,Male,18-30,2134,232,1902,258,1876
2002,Rural,Arunachal Pradesh,Crime Against Children,Trafficking,Female,18-30,7048,3174,3874,5893,1155
2001,Urban,Bihar,Crime Against Women,Molestation,Male,31-45,9133,3858,5275,6570,2563
2010,Rural,Assam,Crime Against Children,Kidnapping,Female,0-12,2174,315,1859,349,1825
2003,Urban,Meghalaya,Crime Against Women,Dowry Deaths,Male,18-30,7691,3120,4571,7128,563
2005,Rural,Goa,Crime Against Men,Robbery,Female,18-30,8512,5890,2622,7477,1035
2009,Rural,Gujarat,Crime Against Children,Kidnapping,Female,0-12,4392,908,3484,2799,1593
2002,Urban,Assam,Crime Against Women,Domestic Violence,Male,13-17,110,41,69,99,11
2010,Rural,Uttarakhand,Crime Against Men,Robbery,Male,31-45,4129,567,3562,3385,744
2002,Urban,Uttarakhand,Other Crimes,Cyber Crime,Male,13-17,4306,506,3800,1559,2747
2007,Rural,Jharkhand,Property Crime,Burglary,Male,0-12,1728,1311,417,1552,176
2002,Urban,Goa,Property Crime,Vandalism,Male,31-45,6684,4408,2276,5762,922
2002,Rural,Odisha,Property Crime,Burglary,Male,46-60,1154,629,525,861,293
2009,Rural,Assam,Crime Against Children,Child Labor,Female,18-30,470,309,161,411,59
2001,Rural,Arunachal Pradesh,Crime Against Children,Trafficking,Female,31-45,8307,3188,5119,3580,4727
2004,Urban,Andhra Pradesh,Property Crime,Theft,Male,18-30,2370,486,1884,1637,733
2007,Rural,Assam,Crime Against Women,Dowry Deaths,Female,0-12,1892,80,1812,1465,427
2001,Rural,Himachal Pradesh,Other Crimes,Cyber Crime,Male,46-60,9089,5110,3979,5807,3282
2002,Urban,Himachal Pradesh,Property Crime,Arson,Male,13-17,7598,5103,2495,7196,402
2007,Urban,Andhra Pradesh,Crime Against Women,Rape,Female,18-30,1953,108,1845,711,1242
2006,Urban,Madhya Pradesh,Property Crime,Theft,Female,60+,848,44,804,750,98
2008,Urban,Delhi,Crime Against Women,Dowry Deaths,Male,0-12,3789,1032,2757,3196,593
2005,Rural,Telangana,Crime Against Children,Child Labor,Male,46-60,8401,8075,326,8082,319
2010,Urban,Nagaland,Crime Against Women,Molestation,Male,13-17,4467,907,3560,2963,1504
2004,Rural,Tripura,Crime Against Women,Rape,Female,60+,4231,1254,2977,3876,355
2009,Urban,Meghalaya,Other Crimes,Fraud,Male,46-60,2830,1487,1343,1844,986
2001,Rural,Maharashtra,Other Crimes,Fraud,Female,0-12,6787,4533,2254,5669,1118
2007,Rural,Mizoram,Crime Against Women,Dowry Deaths,Female,18-30,6312,4195,2117,5419,893
2006,Urban,Goa,Other Crimes,Drug Offense,Female,13-17,8191,21,8170,5487,2704
2003,Urban,Odisha,Other Crimes,Fraud,Female,60+,3533,2962,571,3121,412
2008,Rural,Sikkim,Crime Against Children,Child Labor,Male,60+,430,359,71,419,11
2010,Urban,Karnataka,Property Crime,Vandalism,Male,46-60,6683,5023,1660,5339,1344
2005,Rural,Tamil Nadu,Property Crime,Vandalism,Female,13-17,7041,2257,4784,5759,1282
2006,Rural,Rajasthan,Crime Against Women,Domestic Violence,Male,46-60,5335,2187,3148,4435,900
2007,Urban,Assam,Crime Against Women,Rape,Female,46-60,1294,588,706,1004,290
2010,Rural,Telangana,Crime Against Men,Assault,Male,60+,9943,6153,3790,7448,2495
2004,Rural,Chhattisgarh,Property Crime,Theft,Female,60+,2244,1763,481,2139,105
2003,Urban,Meghalaya,Property Crime,Burglary,Female,31-45,4254,3706,548,3907,347
2003,Urban,Gujarat,Crime Against Men,Murder,Male,60+,3721,263,3458,917,2804
2003,Urban,Jharkhand,Other Crimes,Corruption,Male,60+,6644,2781,3863,2822,3822
2007,Rural,Sikkim,Property Crime,Arson,Female,60+,5741,5359,382,5392,349
2002,Rural,Karnataka,Other Crimes,Fraud,Male,60+,7732,5556,2176,7297,435
2004,Urban,Odisha,Other Crimes,Drug Offense,Male,31-45,8665,7103,1562,7655,1010
2001,Rural,Bihar,Crime Against Children,Kidnapping,Male,18-30,119,23,96,75,44
2003,Urban,Tamil Nadu,Other Crimes,Fraud,Male,13-17,2120,1631,489,1840,280
2003,Urban,Assam,Property Crime,Vandalism,Female,46-60,8324,884,7440,1521,6803
2004,Rural,Uttar Pradesh,Other Crimes,Drug Offense,Female,18-30,5846,677,5169,1101,4745
2001,Urban,Uttarakhand,Other Crimes,Drug Offense,Male,0-12,2433,315,2118,782,1651
2001,Urban,Chhattisgarh,Property Crime,Vandalism,Female,60+,9658,8429,1229,8731,927
2004,Urban,Haryana,Crime Against Men,Assault,Male,18-30,2879,263,2616,2307,572
2005,Urban,Punjab,Crime Against Children,Child Labor,Female,46-60,3604,3471,133,3576,28
2006,Rural,Telangana,Crime Against Children,Trafficking,Male,46-60,242,46,196,143,99
2002,Urban,Rajasthan,Crime Against Children,Child Labor,Male,13-17,8171,1869,6302,2711,5460
2006,Rural,Kerala,Crime Against Children,Child Abuse,Female,18-30,1614,154,1460,1483,131
2005,Rural,West Bengal,Crime Against Men,Assault,Male,46-60,278,89,189,245,33
2001,Urban,Madhya Pradesh,Crime Against Children,Child Labor,Male,18-30,9288,6070,3218,8034,1254
2003,Rural,Goa,Crime Against Men,Robbery,Female,0-12,3444,2640,804,2717,727
2009,Rural,Punjab,Crime Against Children,Kidnapping,Female,0-12,4580,1444,3136,2217,2363
2007,Urban,Kerala,Other Crimes,Corruption,Female,0-12,9703,4564,5139,6776,2927
2006,Rural,Goa,Property Crime,Theft,Male,46-60,9644,9088,556,9416,228
2001,Rural,Delhi,Other Crimes,Drug Offense,Male,0-12,1901,703,1198,725,1176
2008,Urban,Sikkim,Crime Against Children,Kidnapping,Male,13-17,2631,662,1969,2012,619
2002,Urban,Nagaland,Property Crime,Burglary,Male,60+,1866,70,1796,960,906
2007,Rural,Uttar Pradesh,Property Crime,Theft,Female,46-60,9591,7617,1974,9546,45
2003,Urban,Tripura,Other Crimes,Cyber Crime,Male,46-60,6020,884,5136,4100,1920
2008,Rural,Odisha,Crime Against Children,Trafficking,Male,18-30,4665,4562,103,4587,78
2010,Urban,Uttarakhand,Crime Against Women,Rape,Female,46-60,3085,1788,1297,2251,834
2009,Urban,Bihar,Crime Against Women,Rape,Male,46-60,4364,980,3384,3564,800
2004,Urban,Delhi,Other Crimes,Fraud,Male,60+,7329,678,6651,5043,2286
2005,Rural,Chhattisgarh,Property Crime,Vandalism,Male,0-12,6600,6213,387,6476,124
2004,Rural,Rajasthan,Crime Against Children,Trafficking,Male,46-60,3533,603,2930,3017,516
2004,Rural,Telangana,Crime Against Children,Trafficking,Male,18-30,7537,6026,1511,7183,354
2005,Urban,Tripura,Crime Against Women,Dowry Deaths,Male,60+,6490,3598,2892,4948,1542
2001,Urban,Goa,Crime Against Men,Murder,Male,31-45,599,215,384,590,9
2003,Urban,Gujarat,Property Crime,Burglary,Female,0-12,8252,6759,1493,7174,1078
2001,Rural,Jharkhand,Property Crime,Arson,Male,0-12,483,329,154,400,83
2006,Urban,Sikkim,Crime Against Men,Extortion,Male,46-60,4815,4471,344,4792,23
2009,Rural,Manipur,Property Crime,Theft,Male,0-12,7634,3649,3985,6111,1523
2008,Rural,Assam,Crime Against Men,Robbery,Female,60+,6593,3983,2610,6500,93
2005,Urban,Mizoram,Crime Against Men,Assault,Female,31-45,1497,827,670,878,619
2002,Rural,Manipur,Crime Against Men,Assault,Male,31-45,3668,3063,605,3583,85
2001,Rural,Telangana,Crime Against Children,Child Labor,Male,60+,9654,9525,129,9574,80
2001,Urban,Mizoram,Other Crimes,Corruption,Male,31-45,4216,2680,1536,4001,215
2001,Urban,Assam,Crime Against Men,Assault,Female,13-17,4341,2767,1574,3602,739
2005,Urban,Chhattisgarh,Crime Against Women,Domestic Violence,Male,60+,4840,823,4017,4083,757
2006,Urban,West Bengal,Crime Against Children,Kidnapping,Female,18-30,6179,2463,3716,3433,2746
2009,Urban,Delhi,Crime Against Women,Domestic Violence,Male,31-45,6720,4592,2128,5885,835
2003,Rural,Himachal Pradesh,Property Crime,Vandalism,Female,46-60,5491,1061,4430,4996,495
2010,Rural,Meghalaya,Crime Against Men,Murder,Female,46-60,1324,986,338,1050,274
2008,Urban,Sikkim,Crime Against Women,Molestation,Male,13-17,9595,2990,6605,7494,2101
2001,Rural,Meghalaya,Crime Against Children,Child Labor,Female,18-30,8980,4900,4080,7510,1470
2005,Urban,Telangana,Crime Against Women,Rape,Male,31-45,6977,5641,1336,5982,995
2004,Urban,Assam,Crime Against Women,Domestic Violence,Male,60+,8795,6214,2581,6877,1918
2001,Urban,Karnataka,Crime Against Women,Domestic Violence,Female,46-60,3392,1267,2125,2939,453
2004,Rural,Gujarat,Crime Against Children,Trafficking,Male,0-12,3302,2466,836,2985,317
2005,Urban,Odisha,Crime Against Children,Trafficking,Female,60+,6548,4105,2443,5499,1049
2003,Rural,Chhattisgarh,Property Crime,Vandalism,Male,13-17,9107,2669,6438,6903,2204
2010,Rural,Meghalaya,Crime Against Men,Extortion,Male,31-45,2232,1702,530,1783,449
2005,Rural,Assam,Property Crime,Arson,Male,0-12,9806,5221,4585,9673,133
2009,Rural,Haryana,Crime Against Men,Assault,Female,13-17,3905,3638,267,3667,238
2005,Rural,Bihar,Property Crime,Theft,Female,13-17,4926,4899,27,4909,17
2003,Rural,Haryana,Other Crimes,Corruption,Male,46-60,9101,7471,1630,9023,78
2007,Urban,Rajasthan,Crime Against Men,Robbery,Male,60+,7131,4961,2170,6985,146
2004,Urban,Gujarat,Property Crime,Vandalism,Male,60+,9648,9207,441,9563,85
2002,Urban,Sikkim,Property Crime,Arson,Female,46-60,4577,411,4166,3025,1552
2006,Urban,Telangana,Crime Against Men,Assault,Female,0-12,2680,502,2178,2175,505
2010,Rural,Nagaland,Property Crime,Theft,Female,0-12,2614,1401,1213,2015,599
2007,Urban,Delhi,Crime Against Men,Murder,Female,18-30,2354,1906,448,2243,111
2009,Urban,Jharkhand,Crime Against Children,Child Abuse,Female,13-17,2685,926,1759,2580,105
2002,Urban,Himachal Pradesh,Property Crime,Arson,Female,60+,119,109,10,110,9
2005,Rural,Delhi,Crime Against Women,Molestation,Male,13-17,2054,24,2030,1690,364
2007,Urban,Tamil Nadu,Crime Against Men,Assault,Male,60+,4729,3635,1094,4215,514
2005,Rural,Rajasthan,Crime Against Women,Domestic Violence,Female,13-17,7849,3031,4818,6385,1464
2009,Urban,Maharashtra,Property Crime,Theft,Female,18-30,6316,6173,143,6186,130
2004,Rural,Chhattisgarh,Other Crimes,Drug Offense,Female,46-60,5741,4149,1592,5671,70
2002,Rural,Nagaland,Other Crimes,Corruption,Male,0-12,270,48,222,131,139
2009,Urban,Manipur,Crime Against Children,Trafficking,Male,60+,6001,3256,2745,3665,2336
2010,Urban,Telangana,Crime Against Women,Domestic Violence,Male,31-45,7457,1277,6180,4455,3002
2005,Urban,Arunachal Pradesh,Property Crime,Vandalism,Male,31-45,3597,1875,1722,3048,549
2006,Urban,Goa,Crime Against Children,Kidnapping,Male,31-45,9951,1878,8073,3224,6727
2008,Urban,Tripura,Crime Against Children,Trafficking,Male,0-12,4162,3204,958,3713,449
2003,Urban,Karnataka,Other Crimes,Fraud,Female,0-12,7184,5185,1999,6631,553
2008,Urban,Odisha,Other Crimes,Corruption,Female,46-60,5676,4736,940,5457,219
2001,Urban,Tripura,Crime Against Children,Child Abuse,Female,18-30,5821,5644,177,5701,120
2007,Rural,Punjab,Other Crimes,Fraud,Female,0-12,4081,638,3443,1611,2470
2006,Urban,Jharkhand,Crime Against Men,Assault,Male,46-60,3162,1076,2086,1230,1932
2008,Rural,Bihar,Crime Against Men,Murder,Male,46-60,9723,5146,4577,7231,2492
2006,Urban,Andhra Pradesh,Property Crime,Vandalism,Female,18-30,3277,2309,968,3218,59
2001,Rural,Goa,Property Crime,Arson,Female,46-60,3319,2596,723,2823,496
2009,Urban,Madhya Pradesh,Crime Against Women,Dowry Deaths,Male,46-60,5363,4030,1333,4161,1202
2003,Rural,Gujarat,Other Crimes,Drug Offense,Female,18-30,4319,672,3647,3545,774
2004,Urban,Karnataka,Crime Against Men,Extortion,Female,13-17,1835,229,1606,1002,833
2003,Rural,Goa,Property Crime,Burglary,Female,18-30,9289,9246,43,9249,40
2007,Rural,Chhattisgarh,Property Crime,Arson,Male,0-12,6210,4265,1945,5504,706
2009,Rural,Telangana,Property Crime,Theft,Male,46-60,3689,239,3450,2636,1053
2010,Rural,Uttar Pradesh,Crime Against Women,Dowry Deaths,Female,46-60,4841,3272,1569,3909,932
2005,Rural,Jharkhand,Crime Against Men,Robbery,Male,31-45,2343,1125,1218,1160,1183
2004,Urban,Uttar Pradesh,Crime Against Children,Kidnapping,Male,18-30,2953,2102,851,2113,840
2002,Urban,Sikkim,Property Crime,Arson,Male,0-12,3804,1863,1941,3034,770
2007,Rural,Himachal Pradesh,Property Crime,Vandalism,Female,60+,5019,3419,1600,4971,48
2004,Urban,Mizoram,Property Crime,Vandalism,Female,18-30,523,31,492,140,383
2007,Urban,Jammu & Kashmir,Property Crime,Vandalism,Female,13-17,2669,1410,1259,2425,244
2009,Urban,Chhattisgarh,Crime Against Men,Assault,Female,31-45,4787,1401,3386,1503,3284
2009,Rural,Nagaland,Crime Against Children,Kidnapping,Female,31-45,4322,2496,1826,2742,1580
2004,Rural,Jharkhand,Crime Against Men,Murder,Female,13-17,8471,2504,5967,6519,1952
2005,Rural,Punjab,Crime Against Children,Child Labor,Female,60+,1289,900,389,1244,45
2005,Rural,Telangana,Property Crime,Vandalism,Female,31-45,4939,3785,1154,4412,527
2010,Urban,Tripura,Other Crimes,Corruption,Female,46-60,9417,3200,6217,3700,5717
2002,Rural,Andhra Pradesh,Crime Against Men,Extortion,Female,46-60,4371,3390,981,3972,399
2005,Rural,Maharashtra,Other Crimes,Fraud,Male,0-12,3910,707,3203,1713,2197
2009,Rural,Jharkhand,Crime Against Women,Dowry Deaths,Male,31-45,6629,822,5807,5051,1578
2003,Rural,Rajasthan,Property Crime,Vandalism,Male,60+,5193,4543,650,4996,197
2002,Rural,Uttar Pradesh,Crime Against Women,Domestic Violence,Male,60+,3420,2039,1381,3407,13
2002,Urban,Mizoram,Crime Against Men,Assault,Female,13-17,5438,2223,3215,4000,1438
2008,Urban,Madhya Pradesh,Crime Against Women,Rape,Female,31-45,6803,4788,2015,6446,357
2004,Rural,Haryana,Crime Against Men,Robbery,Female,60+,8781,4456,4325,6334,2447
2002,Urban,Manipur,Other Crimes,Fraud,Female,13-17,7926,7188,738,7670,256
2010,Rural,Bihar,Other Crimes,Fraud,Male,60+,8554,6134,2420,8479,75
2010,Urban,Andhra Pradesh,Crime Against Women,Molestation,Male,60+,2764,1325,1439,2216,548
2006,Rural,Madhya Pradesh,Property Crime,Burglary,Female,31-45,6528,2934,3594,4615,1913
2004,Urban,Manipur,Crime Against Men,Assault,Female,46-60,3374,1126,2248,2288,1086
2003,Urban,Haryana,Other Crimes,Corruption,Male,13-17,632,590,42,598,34
2009,Urban,Uttar Pradesh,Property Crime,Arson,Male,60+,3116,1060,2056,2404,712
2010,Urban,Manipur,Crime Against Women,Rape,Female,13-17,5417,2820,2597,3268,2149
2005,Rural,Rajasthan,Other Crimes,Drug Offense,Male,60+,9846,8224,1622,9291,555
2010,Urban,Haryana,Crime Against Men,Robbery,Male,60+,2056,491,1565,1702,354
2003,Urban,Jammu & Kashmir,Crime Against Men,Robbery,Female,0-12,4167,434,3733,1088,3079
2008,Rural,Uttar Pradesh,Crime Against Children,Trafficking,Female,0-12,2864,314,2550,2372,492
2006,Rural,West Bengal,Property Crime,Arson,Female,13-17,8070,5625,2445,7910,160
2008,Rural,Bihar,Other Crimes,Cyber Crime,Female,18-30,5300,2594,2706,4219,1081
2007,Urban,Kerala,Crime Against Men,Murder,Male,31-45,2496,2494,2,2495,1
2003,Rural,Telangana,Property Crime,Arson,Male,13-17,9697,8657,1040,9368,329
2003,Rural,Nagaland,Crime Against Men,Murder,Female,18-30,8612,3412,5200,4738,3874
2004,Urban,Assam,Crime Against Children,Trafficking,Male,46-60,2045,1448,597,1558,487
2008,Urban,Meghalaya,Crime Against Women,Domestic Violence,Female,13-17,6436,2162,4274,3170,3266
2010,Urban,West Bengal,Crime Against Children,Child Abuse,Male,18-30,8634,3122,5512,7489,1145
2010,Rural,Uttarakhand,Property Crime,Vandalism,Female,0-12,3897,225,3672,2311,1586
2004,Rural,West Bengal,Crime Against Women,Molestation,Male,46-60,8750,2383,6367,8603,147
2003,Rural,Tripura,Crime Against Children,Trafficking,Male,31-45,4300,2044,2256,3042,1258
2003,Rural,Telangana,Crime Against Women,Molestation,Male,46-60,6030,1136,4894,3493,2537
2009,Rural,Delhi,Crime Against Children,Child Abuse,Female,18-30,9329,7127,2202,8141,1188
2009,Rural,Chhattisgarh,Crime Against Women,Molestation,Male,60+,875,323,552,821,54
2003,Urban,Andhra Pradesh,Crime Against Women,Domestic Violence,Female,60+,6553,2201,4352,5946,607
2002,Rural,Bihar,Crime Against Men,Murder,Male,0-12,1574,1091,483,1504,70
2001,Rural,Sikkim,Crime Against Women,Rape,Female,0-12,6235,3146,3089,5767,468
2009,Rural,Maharashtra,Property Crime,Burglary,Male,46-60,3453,2963,490,3215,238
2004,Urban,Nagaland,Crime Against Men,Robbery,Female,13-17,424,204,220,422,2
2001,Rural,Arunachal Pradesh,Property Crime,Burglary,Male,60+,3751,3532,219,3590,161
2004,Rural,Assam,Crime Against Men,Assault,Male,31-45,9852,6509,3343,6624,3228
2009,Urban,Arunachal Pradesh,Crime Against Children,Trafficking,Male,0-12,1760,727,1033,1339,421
2005,Rural,Odisha,Crime Against Men,Extortion,Female,60+,5137,3411,1726,3684,1453
2008,Rural,Telangana,Crime Against Women,Dowry Deaths,Female,60+,1567,225,1342,1087,480
2003,Rural,Kerala,Other Crimes,Drug Offense,Male,60+,1405,1375,30,1376,29
2006,Rural,Tripura,Crime Against Children,Trafficking,Female,0-12,5947,470,5477,2797,3150
2007,Urban,Odisha,Other Crimes,Cyber Crime,Male,0-12,5333,3469,1864,3575,1758
2004,Urban,Assam,Crime Against Men,Extortion,Male,0-12,7892,4843,3049,5516,2376
2009,Urban,Gujarat,Crime Against Children,Child Labor,Female,60+,775,269,506,345,430
2005,Urban,Telangana,Other Crimes,Cyber Crime,Female,31-45,2892,1094,1798,1741,1151
2004,Urban,Tamil Nadu,Other Crimes,Corruption,Male,60+,6791,2821,3970,4963,1828
2009,Urban,Andhra Pradesh,Crime Against Women,Molestation,Female,46-60,1017,803,214,984,33
2005,Rural,Delhi,Property Crime,Theft,Female,18-30,177,122,55,166,11
2003,Rural,Rajasthan,Crime Against Men,Murder,Male,60+,7097,5696,1401,6369,728
2003,Urban,Bihar,Property Crime,Vandalism,Female,46-60,8439,5282,3157,6885,1554
2007,Urban,Maharashtra,Crime Against Women,Molestation,Female,18-30,9644,9515,129,9631,13
2001,Urban,Tamil Nadu,Crime Against Men,Extortion,Female,18-30,4650,1826,2824,4083,567
2002,Rural,Bihar,Crime Against Men,Assault,Female,60+,9951,4337,5614,4996,4955
2004,Rural,Jharkhand,Crime Against Women,Domestic Violence,Female,60+,6793,4883,1910,5768,1025
2005,Urban,Chhattisgarh,Other Crimes,Corruption,Male,46-60,3814,2439,1375,3436,378
2001,Rural,Tamil Nadu,Crime Against Women,Dowry Deaths,Female,13-17,4889,4469,420,4473,416
2008,Rural,Kerala,Crime Against Men,Extortion,Female,31-45,3466,100,3366,3034,432
2007,Rural,Mizoram,Crime Against Women,Molestation,Male,18-30,2272,2144,128,2190,82
2003,Urban,Jammu & Kashmir,Crime Against Children,Child Abuse,Male,13-17,6604,2464,4140,5384,1220
2001,Rural,Rajasthan,Crime Against Men,Murder,Male,0-12,7373,407,6966,906,6467
2010,Urban,Kerala,Property Crime,Theft,Female,46-60,2213,1825,388,2082,131
2009,Rural,Manipur,Crime Against Men,Murder,Female,60+,6810,2297,4513,4542,2268
2008,Urban,Uttar Pradesh,Crime Against Women,Domestic Violence,Female,13-17,9259,2206,7053,4749,4510
2001,Rural,Sikkim,Property Crime,Vandalism,Male,60+,2886,2782,104,2786,100
2007,Rural,Telangana,Other Crimes,Cyber Crime,Male,31-45,1590,440,1150,1131,459
2003,Rural,Jammu & Kashmir,Crime Against Men,Murder,Female,18-30,3826,283,3543,3772,54
2007,Urban,Kerala,Property Crime,Burglary,Female,18-30,1604,388,1216,702,902
2002,Urban,Uttarakhand,Crime Against Children,Child Labor,Female,13-17,9180,6692,2488,6843,2337
2004,Urban,Kerala,Property Crime,Arson,Female,31-45,9900,5653,4247,7635,2265
2004,Urban,Karnataka,Crime Against Women,Dowry Deaths,Male,18-30,5300,600,4700,3058,2242
2005,Rural,Uttarakhand,Crime Against Men,Assault,Female,18-30,6003,5128,875,5569,434
2004,Urban,Goa,Other Crimes,Fraud,Male,13-17,8621,7662,959,7959,662
2007,Rural,Haryana,Crime Against Women,Rape,Female,13-17,9609,8731,878,9257,352
2001,Urban,Andhra Pradesh,Property Crime,Arson,Female,31-45,6994,5034,1960,5685,1309
2006,Urban,Goa,Crime Against Men,Assault,Female,18-30,4811,106,4705,2243,2568
2003,Rural,West Bengal,Property Crime,Theft,Female,31-45,9748,905,8843,3859,5889
2002,Rural,Mizoram,Crime Against Men,Murder,Female,60+,7507,4614,2893,6263,1244
2010,Urban,Rajasthan,Crime Against Men,Murder,Female,18-30,343,184,159,336,7
2005,Urban,Manipur,Crime Against Women,Domestic Violence,Female,46-60,5137,3117,2020,4103,1034
2004,Urban,Uttarakhand,Crime Against Women,Rape,Male,13-17,7407,2419,4988,6949,458
2001,Urban,Meghalaya,Crime Against Women,Molestation,Female,31-45,3535,2416,1119,3269,266
2006,Rural,Tripura,Crime Against Children,Trafficking,Female,46-60,8643,3131,5512,7147,1496
2005,Urban,Jammu & Kashmir,Crime Against Women,Dowry Deaths,Female,0-12,1515,928,587,1486,29
2006,Urban,Telangana,Crime Against Children,Child Labor,Female,31-45,3987,1161,2826,3018,969
2009,Rural,Haryana,Crime Against Men,Assault,Male,13-17,928,612,316,917,11
2007,Urban,Jammu & Kashmir,Property Crime,Arson,Male,31-45,8218,3837,4381,5450,2768
2008,Urban,Punjab,Other Crimes,Cyber Crime,Female,31-45,5634,1398,4236,2787,2847
2009,Rural,Telangana,Other Crimes,Drug Offense,Male,46-60,5921,1494,4427,4296,1625
2007,Urban,Tripura,Property Crime,Burglary,Female,0-12,1245,72,1173,245,1000
2004,Urban,Uttarakhand,Crime Against Children,Child Abuse,Male,0-12,5550,3385,2165,5343,207
2007,Rural,Tamil Nadu,Property Crime,Vandalism,Female,46-60,7877,325,7552,4029,3848
2009,Urban,Andhra Pradesh,Other Crimes,Corruption,Female,46-60,2095,897,1198,1230,865
2007,Urban,Arunachal Pradesh,Crime Against Men,Robbery,Male,60+,7805,6140,1665,7039,766
2007,Rural,Assam,Crime Against Women,Domestic Violence,Male,46-60,7495,2051,5444,4881,2614
2001,Urban,Jammu & Kashmir,Crime Against Men,Assault,Female,13-17,1300,435,865,1123,177
2009,Urban,Maharashtra,Crime Against Children,Child Labor,Male,60+,447,42,405,312,135
2007,Rural,Haryana,Property Crime,Arson,Female,46-60,7045,424,6621,2285,4760
2003,Rural,Sikkim,Property Crime,Arson,Male,46-60,8320,2268,6052,2588,5732
2009,Rural,Uttarakhand,Crime Against Men,Robbery,Female,0-12,7471,6921,550,7131,340
2005,Urban,Uttar Pradesh,Property Crime,Arson,Male,60+,8282,2997,5285,4273,4009
2001,Rural,Delhi,Crime Against Women,Dowry Deaths,Male,18-30,6646,648,5998,3677,2969
2007,Urban,Tripura,Crime Against Women,Molestation,Female,0-12,4417,486,3931,3851,566
2003,Urban,Telangana,Crime Against Children,Child Abuse,Male,60+,5194,3303,1891,4624,570
2003,Urban,Rajasthan,Crime Against Children,Child Labor,Male,13-17,3237,1072,2165,1076,2161
2007,Rural,Gujarat,Property Crime,Arson,Female,31-45,9164,3326,5838,4814,4350
2003,Urban,Jharkhand,Crime Against Women,Dowry Deaths,Male,31-45,3760,3025,735,3516,244
2005,Rural,Andhra Pradesh,Crime Against Children,Child Abuse,Male,0-12,5702,3959,1743,4490,1212
2009,Urban,Arunachal Pradesh,Crime Against Children,Child Labor,Female,18-30,4322,1629,2693,4280,42
2002,Rural,Jammu & Kashmir,Other Crimes,Cyber Crime,Male,60+,4300,1175,3125,1377,2923
2001,Rural,Mizoram,Crime Against Children,Trafficking,Male,46-60,2246,266,1980,486,1760
2001,Rural,Meghalaya,Crime Against Men,Extortion,Female,46-60,6813,3054,3759,3132,3681
2009,Urban,Rajasthan,Other Crimes,Corruption,Male,13-17,5134,1296,3838,4204,930
2002,Rural,Haryana,Property Crime,Vandalism,Female,0-12,467,380,87,418,49
2008,Rural,Delhi,Property Crime,Vandalism,Female,13-17,6720,4797,1923,5865,855
2005,Rural,Jammu & Kashmir,Crime Against Men,Murder,Male,13-17,3261,2881,380,2928,333
2008,Rural,Mizoram,Crime Against Women,Rape,Female,31-45,2187,297,1890,1034,1153
2003,Urban,Meghalaya,Crime Against Women,Molestation,Male,13-17,7705,401,7304,4091,3614
2005,Urban,Rajasthan,Crime Against Children,Child Labor,Male,13-17,1350,278,1072,820,530
2009,Urban,Meghalaya,Property Crime,Vandalism,Female,46-60,9463,4636,4827,7966,1497
2001,Rural,Mizoram,Crime Against Children,Child Labor,Male,0-12,1592,771,821,1498,94
2003,Urban,Odisha,Crime Against Men,Assault,Female,18-30,6277,780,5497,3628,2649
2001,Urban,Punjab,Crime Against Men,Extortion,Male,13-17,638,65,573,233,405
2002,Rural,Tripura,Property Crime,Burglary,Male,18-30,4512,143,4369,4327,185
2007,Urban,Haryana,Other Crimes,Cyber Crime,Female,46-60,5983,5291,692,5973,10
2005,Urban,Arunachal Pradesh,Other Crimes,Corruption,Female,13-17,4230,534,3696,3350,880
2002,Urban,Jharkhand,Crime Against Children,Child Abuse,Male,0-12,6477,3181,3296,5428,1049
2004,Urban,Bihar,Crime Against Children,Kidnapping,Female,18-30,1049,825,224,871,178
2009,Rural,Tripura,Property Crime,Vandalism,Female,60+,903,327,576,479,424
2008,Rural,Uttarakhand,Crime Against Women,Molestation,Male,18-30,8881,2836,6045,6059,2822
2002,Rural,Madhya Pradesh,Crime Against Women,Rape,Female,31-45,8865,3703,5162,6387,2478
2002,Urban,Punjab,Other Crimes,Cyber Crime,Female,0-12,8220,2063,6157,7802,418
2008,Rural,Tripura,Crime Against Men,Murder,Male,13-17,7150,3279,3871,4163,2987
2007,Urban,Telangana,Property Crime,Vandalism,Female,46-60,1018,179,839,447,571
2002,Rural,Nagaland,Other Crimes,Cyber Crime,Female,13-17,8449,393,8056,6207,2242
2002,Rural,Karnataka,Crime Against Children,Trafficking,Female,13-17,4083,4078,5,4083,0
2008,Rural,Manipur,Crime Against Women,Domestic Violence,Male,60+,6924,3629,3295,4435,2489
2006,Urban,Meghalaya,Property Crime,Arson,Female,46-60,5234,2406,2828,4560,674
2003,Rural,Assam,Crime Against Men,Assault,Male,60+,706,337,369,572,134
2003,Rural,Maharashtra,Crime Against Men,Extortion,Female,60+,8400,6079,2321,8201,199
2007,Rural,Delhi,Property Crime,Vandalism,Female,46-60,4034,775,3259,2086,1948
2009,Rural,Delhi,Property Crime,Theft,Male,31-45,8361,910,7451,7949,412
2003,Urban,Rajasthan,Property Crime,Arson,Male,31-45,7813,1906,5907,5846,1967
2005,Urban,Sikkim,Crime Against Men,Murder,Female,60+,3760,2802,958,3261,499
2009,Urban,Andhra Pradesh,Crime Against Children,Kidnapping,Male,18-30,9014,2218,6796,6567,2447
2004,Rural,Jharkhand,Property Crime,Burglary,Male,13-17,5078,4984,94,5017,61
2009,Urban,Gujarat,Crime Against Men,Murder,Male,0-12,1096,749,347,813,283
2002,Urban,Delhi,Property Crime,Arson,Female,18-30,2097,632,1465,1726,371
2009,Rural,Manipur,Other Crimes,Corruption,Female,13-17,7090,3896,3194,4258,2832
2007,Urban,Rajasthan,Property Crime,Vandalism,Male,60+,9494,8567,927,8578,916
2003,Urban,Rajasthan,Crime Against Children,Child Abuse,Male,31-45,2974,2407,567,2496,478
2006,Rural,Chhattisgarh,Crime Against Women,Dowry Deaths,Male,31-45,2859,1230,1629,2058,801
2006,Rural,Uttarakhand,Property Crime,Theft,Male,0-12,3125,1413,1712,2693,432
2001,Rural,Telangana,Other Crimes,Cyber Crime,Female,31-45,4121,2997,1124,3283,838
2010,Urban,Haryana,Crime Against Women,Domestic Violence,Female,46-60,4358,3575,783,3576,782
2006,Rural,Tripura,Other Crimes,Fraud,Female,18-30,2549,1152,1397,2303,246
2004,Rural,Telangana,Other Crimes,Cyber Crime,Female,46-60,8150,695,7455,3140,5010
2009,Rural,Punjab,Other Crimes,Cyber Crime,Female,46-60,7171,3623,3548,3799,3372
2008,Urban,Uttarakhand,Crime Against Women,Rape,Male,13-17,488,244,244,268,220
2002,Urban,Assam,Crime Against Women,Domestic Violence,Male,13-17,4351,974,3377,4263,88
2002,Rural,Gujarat,Property Crime,Arson,Male,31-45,4249,1440,2809,2718,1531
2002,Rural,Madhya Pradesh,Other Crimes,Cyber Crime,Male,46-60,8527,6323,2204,7127,1400
2008,Urban,Uttarakhand,Crime Against Children,Kidnapping,Male,13-17,2587,2145,442,2564,23
2005,Urban,Odisha,Crime Against Children,Child Labor,Male,13-17,7023,4583,2440,4812,2211
2008,Rural,Andhra Pradesh,Crime Against Children,Trafficking,Female,60+,966,63,903,784,182
2005,Urban,Himachal Pradesh,Property Crime,Vandalism,Male,0-12,6615,3442,3173,6149,466
2008,Urban,Rajasthan,Crime Against Women,Domestic Violence,Male,60+,888,832,56,881,7
2003,Rural,Maharashtra,Crime Against Women,Dowry Deaths,Female,46-60,1444,1041,403,1249,195
2005,Urban,Telangana,Crime Against Men,Extortion,Female,18-30,2788,2102,686,2656,132
2006,Urban,Haryana,Other Crimes,Fraud,Male,60+,1626,766,860,1475,151
2003,Rural,Kerala,Crime Against Children,Child Labor,Male,13-17,7686,5838,1848,6746,940
2004,Urban,Jammu & Kashmir,Crime Against Children,Child Abuse,Male,60+,875,405,470,506,369
2010,Rural,Chhattisgarh,Crime Against Children,Kidnapping,Female,18-30,5649,2944,2705,4406,1243
2006,Urban,Kerala,Other Crimes,Drug Offense,Female,60+,8216,607,7609,7928,288
2001,Rural,Himachal Pradesh,Crime Against Men,Robbery,Female,13-17,4737,3118,1619,3881,856
2006,Rural,Maharashtra,Crime Against Children,Kidnapping,Female,60+,3035,867,2168,2761,274
2008,Rural,Uttar Pradesh,Property Crime,Burglary,Female,60+,4432,1146,3286,1358,3074
2006,Urban,Meghalaya,Crime Against Women,Rape,Male,31-45,6631,5122,1509,5754,877
2002,Rural,Tripura,Crime Against Women,Domestic Violence,Male,46-60,8257,8143,114,8239,18
2010,Rural,Gujarat,Property Crime,Vandalism,Male,46-60,6949,345,6604,3177,3772
2009,Urban,Punjab,Crime Against Children,Kidnapping,Female,60+,3630,2383,1247,3356,274
2002,Urban,Tripura,Property Crime,Arson,Male,60+,5173,4530,643,5164,9
2008,Rural,Himachal Pradesh,Crime Against Children,Child Labor,Male,31-45,3936,3737,199,3810,126
2010,Urban,Delhi,Crime Against Men,Robbery,Female,60+,410,41,369,166,244
2001,Urban,Jammu & Kashmir,Crime Against Children,Kidnapping,Female,18-30,6414,4539,1875,5138,1276
2010,Rural,Bihar,Crime Against Children,Child Abuse,Male,46-60,801,26,775,452,349
2005,Rural,Sikkim,Other Crimes,Corruption,Male,46-60,5148,4602,546,5093,55
2005,Urban,Arunachal Pradesh,Crime Against Women,Molestation,Female,46-60,9278,4233,5045,9120,158
2004,Urban,Odisha,Crime Against Men,Extortion,Male,46-60,2260,1937,323,2057,203
2007,Urban,Tripura,Crime Against Children,Kidnapping,Male,60+,3283,1873,1410,2257,1026
2001,Urban,West Bengal,Crime Against Women,Molestation,Female,18-30,3047,29,3018,2671,376
2004,Urban,Assam,Property Crime,Burglary,Male,18-30,2153,255,1898,2149,4
2001,Rural,Andhra Pradesh,Crime Against Men,Robbery,Male,18-30,1838,762,1076,851,987
2004,Rural,Gujarat,Other Crimes,Drug Offense,Female,31-45,8437,565,7872,2029,6408
2003,Urban,Haryana,Crime Against Children,Child Labor,Female,13-17,7799,5184,2615,7358,441
2008,Urban,Mizoram,Crime Against Women,Rape,Male,0-12,9802,1378,8424,6925,2877
2008,Rural,Haryana,Crime Against Men,Assault,Male,18-30,2443,2198,245,2350,93
2005,Rural,Nagaland,Crime Against Men,Murder,Female,46-60,7546,6184,1362,6823,723
2006,Urban,Gujarat,Property Crime,Theft,Female,13-17,9568,7980,1588,8903,665
2008,Urban,Chhattisgarh,Crime Against Women,Dowry Deaths,Male,60+,9606,2813,6793,7943,1663
2008,Rural,Karnataka,Crime Against Women,Domestic Violence,Male,31-45,7439,6820,619,7251,188
2008,Rural,Gujarat,Crime Against Children,Child Abuse,Male,31-45,4703,2644,2059,3433,1270
2002,Urban,Rajasthan,Crime Against Men,Assault,Male,46-60,5682,5538,144,5666,16
2004,Rural,Maharashtra,Crime Against Women,Dowry Deaths,Male,13-17,1916,1119,797,1537,379
2005,Urban,Andhra Pradesh,Other Crimes,Cyber Crime,Female,31-45,9358,1856,7502,6441,2917
2009,Rural,Delhi,Crime Against Women,Rape,Male,18-30,2228,540,1688,2022,206
2003,Rural,Delhi,Crime Against Children,Child Labor,Female,46-60,5661,4644,1017,5648,13
2004,Urban,Jammu & Kashmir,Crime Against Men,Extortion,Female,60+,4601,2939,1662,2941,1660
2004,Rural,Goa,Crime Against Men,Extortion,Male,18-30,9827,5107,4720,7675,2152
2009,Urban,Delhi,Crime Against Women,Rape,Female,60+,3763,1473,2290,2466,1297
2001,Urban,Chhattisgarh,Other Crimes,Cyber Crime,Male,0-12,8109,7035,1074,7562,547
2010,Rural,Arunachal Pradesh,Crime Against Men,Robbery,Female,13-17,239,203,36,217,22
2003,Urban,Andhra Pradesh,Crime Against Children,Trafficking,Female,0-12,8686,8043,643,8401,285
2001,Urban,Uttarakhand,Crime Against Men,Assault,Male,46-60,1776,1627,149,1679,97
2006,Rural,Delhi,Crime Against Women,Dowry Deaths,Male,13-17,2283,1301,982,1504,779
2010,Urban,Maharashtra,Other Crimes,Fraud,Female,13-17,4194,2989,1205,3760,434
2004,Rural,Nagaland,Crime Against Women,Domestic Violence,Female,31-45,9155,1741,7414,5164,3991
2006,Urban,Nagaland,Crime Against Children,Trafficking,Female,18-30,8397,7807,590,8201,196
2008,Rural,Chhattisgarh,Crime Against Children,Trafficking,Female,60+,7087,6371,716,6381,706
2009,Urban,Odisha,Crime Against Men,Extortion,Male,13-17,7481,5442,2039,6862,619
2002,Rural,Sikkim,Other Crimes,Corruption,Male,60+,4725,2080,2645,3257,1468
2003,Urban,Manipur,Crime Against Women,Domestic Violence,Female,13-17,7018,5444,1574,5972,1046
2008,Rural,Meghalaya,Crime Against Women,Domestic Violence,Male,46-60,6603,192,6411,5172,1431
2001,Urban,Kerala,Property Crime,Theft,Female,46-60,1808,28,1780,1752,56
2001,Urban,Andhra Pradesh,Crime Against Women,Dowry Deaths,Female,13-17,5176,2514,2662,3993,1183
2010,Urban,Tamil Nadu,Crime Against Women,Molestation,Female,60+,2521,1328,1193,2439,82
2003,Rural,Andhra Pradesh,Crime Against Men,Extortion,Male,13-17,5777,4021,1756,4487,1290
2005,Urban,Tamil Nadu,Crime Against Women,Molestation,Male,46-60,9171,1049,8122,4647,4524
2003,Urban,Karnataka,Crime Against Men,Robbery,Female,13-17,2134,314,1820,2033,101
2001,Rural,Tamil Nadu,Other Crimes,Cyber Crime,Male,13-17,6878,5810,1068,6836,42
2003,Urban,Manipur,Crime Against Men,Murder,Male,46-60,463,152,311,334,129
2007,Rural,Karnataka,Other Crimes,Corruption,Female,0-12,458,271,187,335,123
2003,Urban,Himachal Pradesh,Crime Against Children,Child Labor,Male,18-30,8992,1603,7389,6547,2445
2009,Urban,Uttarakhand,Crime Against Women,Domestic Violence,Female,13-17,1858,641,1217,1467,391
2008,Rural,Rajasthan,Crime Against Women,Molestation,Female,46-60,6434,847,5587,4081,2353
2001,Rural,Bihar,Crime Against Men,Murder,Female,60+,84,45,39,50,34
2003,Urban,Jammu & Kashmir,Crime Against Children,Kidnapping,Female,18-30,9118,4994,4124,5461,3657
2004,Urban,Madhya Pradesh,Crime Against Children,Kidnapping,Female,31-45,5595,4537,1058,5407,188
2009,Urban,Mizoram,Other Crimes,Drug Offense,Female,0-12,3128,2805,323,3045,83
2010,Rural,Bihar,Crime Against Children,Trafficking,Female,18-30,9505,1627,7878,4886,4619
2009,Rural,Gujarat,Crime Against Men,Robbery,Male,60+,1672,1625,47,1636,36
2004,Urban,Goa,Crime Against Children,Kidnapping,Male,31-45,5831,2531,3300,2699,3132
2004,Rural,Goa,Crime Against Men,Assault,Male,18-30,899,259,640,821,78
2004,Rural,Rajasthan,Crime Against Children,Trafficking,Female,60+,1657,983,674,987,670
2006,Urban,Jharkhand,Property Crime,Vandalism,Male,0-12,7773,6552,1221,6911,862
2001,Rural,Tamil Nadu,Other Crimes,Cyber Crime,Female,31-45,4064,2318,1746,2926,1138
2004,Rural,Andhra Pradesh,Crime Against Women,Dowry Deaths,Male,46-60,7490,5461,2029,7235,255
2007,Urban,Maharashtra,Crime Against Men,Murder,Female,13-17,2994,1514,1480,2833,161
2001,Rural,Tamil Nadu,Other Crimes,Drug Offense,Male,31-45,6047,4913,1134,4945,1102
2008,Rural,Jharkhand,Crime Against Children,Child Labor,Female,60+,1785,925,860,1649,136
2002,Urban,Telangana,Crime Against Women,Molestation,Male,0-12,141,84,57,137,4
2004,Rural,Kerala,Crime Against Children,Kidnapping,Female,31-45,3659,610,3049,3619,40
2006,Rural,Madhya Pradesh,Crime Against Children,Child Labor,Female,46-60,6854,379,6475,5520,1334
2001,Urban,Karnataka,Crime Against Children,Trafficking,Male,60+,9970,6715,3255,9238,732
2003,Urban,Assam,Crime Against Women,Domestic Violence,Female,0-12,9084,3284,5800,4040,5044
2002,Rural,Meghalaya,Crime Against Women,Domestic Violence,Female,18-30,5673,1158,4515,1302,4371
2004,Rural,Maharashtra,Crime Against Children,Child Abuse,Female,46-60,6872,6333,539,6349,523
2010,Rural,Karnataka,Crime Against Children,Trafficking,Female,46-60,9149,1034,8115,5791,3358
2005,Rural,Nagaland,Property Crime,Arson,Female,0-12,4516,2726,1790,4029,487
2004,Rural,Uttarakhand,Property Crime,Theft,Female,0-12,1934,1173,761,1599,335
2003,Urban,Maharashtra,Crime Against Women,Rape,Male,0-12,5579,4951,628,5506,73
2008,Urban,Jharkhand,Crime Against Men,Murder,Female,46-60,7819,7157,662,7708,111
2010,Rural,Jharkhand,Other Crimes,Corruption,Female,13-17,1326,257,1069,945,381
2007,Urban,Nagaland,Crime Against Children,Child Abuse,Male,13-17,3290,945,2345,1696,1594
2010,Rural,Rajasthan,Property Crime,Arson,Male,60+,6278,318,5960,4920,1358
2006,Urban,Rajasthan,Crime Against Women,Rape,Female,31-45,2038,1635,403,1902,136
2007,Urban,Goa,Crime Against Men,Robbery,Male,60+,6373,1596,4777,4706,1667
2007,Rural,Uttar Pradesh,Property Crime,Theft,Male,18-30,3057,2134,923,2597,460
2003,Rural,Telangana,Crime Against Women,Dowry Deaths,Female,0-12,3949,843,3106,2590,1359
2009,Urban,Jharkhand,Crime Against Men,Assault,Male,18-30,687,90,597,681,6
2009,Rural,Punjab,Other Crimes,Fraud,Female,31-45,7656,2768,4888,5686,1970
2010,Rural,Assam,Property Crime,Burglary,Male,18-30,9112,2543,6569,8229,883
2010,Rural,Kerala,Property Crime,Arson,Male,31-45,7014,6430,584,6635,379
2005,Rural,Mizoram,Crime Against Men,Murder,Male,13-17,811,423,388,569,242
2005,Urban,Assam,Crime Against Children,Kidnapping,Female,18-30,5678,5547,131,5625,53
2003,Urban,Karnataka,Property Crime,Vandalism,Female,13-17,8509,1273,7236,1725,6784
2008,Rural,Himachal Pradesh,Property Crime,Theft,Female,60+,6961,1163,5798,4478,2483
2005,Rural,Uttar Pradesh,Crime Against Men,Assault,Male,31-45,4620,1936,2684,3314,1306
2008,Urban,Maharashtra,Crime Against Children,Child Labor,Male,46-60,1680,1027,653,1186,494
2005,Rural,Chhattisgarh,Other Crimes,Corruption,Female,46-60,9538,9370,168,9428,110
2004,Rural,Arunachal Pradesh,Crime Against Women,Molestation,Female,31-45,1859,1480,379,1622,237
2010,Rural,Himachal Pradesh,Property Crime,Theft,Male,31-45,3163,1891,1272,2187,976
2004,Rural,Jammu & Kashmir,Crime Against Children,Kidnapping,Female,46-60,1901,1158,743,1703,198
2002,Rural,Nagaland,Crime Against Women,Rape,Female,60+,9699,2791,6908,8794,905
2003,Rural,Arunachal Pradesh,Crime Against Women,Domestic Violence,Female,13-17,8046,4446,3600,5323,2723
2010,Rural,Jammu & Kashmir,Property Crime,Vandalism,Female,46-60,5955,4224,1731,4582,1373
2001,Urban,Karnataka,Crime Against Children,Trafficking,Female,60+,9087,5007,4080,8647,440
2002,Rural,Punjab,Property Crime,Theft,Female,18-30,6450,2766,3684,3058,3392
2009,Rural,Punjab,Other Crimes,Corruption,Male,13-17,3375,618,2757,2532,843
2008,Rural,Jharkhand,Crime Against Women,Molestation,Male,31-45,6867,1645,5222,2440,4427
2003,Rural,Uttarakhand,Property Crime,Burglary,Male,46-60,3431,285,3146,2777,654
2008,Rural,Himachal Pradesh,Crime Against Women,Domestic Violence,Female,31-45,8642,4526,4116,4634,4008
2001,Urban,Chhattisgarh,Crime Against Children,Child Labor,Male,18-30,8325,1242,7083,6281,2044
2007,Rural,Arunachal Pradesh,Crime Against Women,Dowry Deaths,Female,46-60,9671,1493,8178,7422,2249
2008,Urban,Delhi,Other Crimes,Drug Offense,Female,31-45,6406,1461,4945,2750,3656
2009,Urban,West Bengal,Crime Against Women,Rape,Female,31-45,9666,889,8777,895,8771
2005,Rural,Manipur,Other Crimes,Cyber Crime,Female,13-17,5518,5296,222,5382,136
2008,Urban,Sikkim,Property Crime,Theft,Male,60+,5217,4884,333,4950,267
2008,Rural,Kerala,Crime Against Men,Assault,Male,18-30,8849,3929,4920,5434,3415
2009,Rural,Arunachal Pradesh,Other Crimes,Cyber Crime,Female,13-17,4530,1385,3145,3260,1270
2003,Rural,Assam,Crime Against Men,Robbery,Male,60+,1476,1313,163,1417,59
2004,Rural,Rajasthan,Crime Against Children,Trafficking,Female,13-17,1197,1156,41,1188,9
2001,Urban,Arunachal Pradesh,Crime Against Men,Extortion,Female,31-45,4325,1135,3190,4114,211
2009,Urban,Goa,Other Crimes,Cyber Crime,Female,0-12,1827,362,1465,1399,428
2005,Urban,Gujarat,Crime Against Men,Assault,Male,31-45,2593,95,2498,1990,603
2004,Urban,Arunachal Pradesh,Crime Against Children,Trafficking,Female,18-30,199,190,9,195,4
2006,Rural,Kerala,Crime Against Women,Dowry Deaths,Female,60+,9507,8553,954,9067,440
2002,Rural,Assam,Crime Against Men,Murder,Male,31-45,439,227,212,264,175
2005,Rural,Kerala,Property Crime,Arson,Female,60+,8121,838,7283,4601,3520
2007,Rural,Arunachal Pradesh,Crime Against Men,Extortion,Female,46-60,8176,3432,4744,7466,710
2007,Urban,Assam,Crime Against Women,Molestation,Male,18-30,8942,930,8012,8208,734
2001,Urban,Tripura,Crime Against Men,Murder,Female,0-12,4988,3071,1917,3403,1585
2010,Urban,Delhi,Crime Against Men,Assault,Male,46-60,9988,3735,6253,4261,5727
2010,Urban,Himachal Pradesh,Other Crimes,Cyber Crime,Male,31-45,8118,4675,3443,5765,2353
2010,Rural,Sikkim,Other Crimes,Corruption,Male,13-17,209,46,163,183,26
2007,Urban,Chhattisgarh,Crime Against Children,Kidnapping,Female,18-30,7540,7468,72,7485,55
2006,Rural,Delhi,Crime Against Children,Kidnapping,Male,13-17,5059,3760,1299,4465,594
2007,Rural,Tripura,Crime Against Men,Murder,Female,46-60,5651,1691,3960,3466,2185
2009,Rural,Jammu & Kashmir,Other Crimes,Cyber Crime,Female,13-17,9963,1505,8458,3427,6536
2005,Rural,Sikkim,Crime Against Women,Dowry Deaths,Female,13-17,5637,3188,2449,4360,1277
2010,Urban,Andhra Pradesh,Crime Against Children,Child Labor,Male,60+,5591,299,5292,512,5079
2010,Rural,Chhattisgarh,Other Crimes,Cyber Crime,Female,13-17,8658,7957,701,8010,648
2001,Urban,Maharashtra,Crime Against Men,Extortion,Female,18-30,4060,1479,2581,3728,332
2004,Urban,Assam,Other Crimes,Drug Offense,Female,13-17,4367,3647,720,4067,300
2003,Rural,Gujarat,Property Crime,Vandalism,Female,31-45,8069,4338,3731,7786,283
2001,Rural,Haryana,Crime Against Men,Extortion,Male,46-60,2448,407,2041,1289,1159
2008,Rural,Punjab,Other Crimes,Cyber Crime,Male,0-12,6557,4452,2105,5073,1484
2004,Urban,Maharashtra,Crime Against Women,Domestic Violence,Male,18-30,8671,2434,6237,5206,3465
2001,Rural,Kerala,Crime Against Children,Kidnapping,Female,0-12,3615,2024,1591,2542,1073
2007,Urban,Manipur,Crime Against Children,Child Labor,Female,31-45,2237,1396,841,2011,226
2001,Rural,Nagaland,Crime Against Children,Child Labor,Female,13-17,6231,4771,1460,5541,690
2004,Rural,Arunachal Pradesh,Crime Against Children,Kidnapping,Male,0-12,7302,3420,3882,4993,2309
2005,Urban,Jammu & Kashmir,Property Crime,Burglary,Female,31-45,5412,809,4603,4227,1185
2001,Urban,Andhra Pradesh,Crime Against Children,Child Abuse,Female,46-60,6435,3422,3013,4418,2017
2007,Rural,Himachal Pradesh,Property Crime,Arson,Male,0-12,3703,3477,226,3488,215
2009,Rural,Kerala,Crime Against Men,Assault,Female,46-60,7511,4676,2835,6341,1170
2006,Rural,Nagaland,Property Crime,Vandalism,Female,46-60,4409,3257,1152,4133,276
2002,Rural,Telangana,Crime Against Men,Extortion,Female,31-45,1398,615,783,1013,385
2010,Urban,Meghalaya,Other Crimes,Fraud,Female,18-30,70,70,0,70,0
2008,Rural,Uttarakhand,Crime Against Children,Child Abuse,Female,13-17,4796,1182,3614,1720,3076
2010,Rural,Tamil Nadu,Crime Against Women,Molestation,Female,18-30,5961,3222,2739,4026,1935
2007,Urban,Punjab,Other Crimes,Drug Offense,Female,31-45,5947,5010,937,5354,593
2003,Urban,Delhi,Crime Against Women,Domestic Violence,Male,18-30,1057,830,227,928,129
2006,Urban,Rajasthan,Crime Against Children,Trafficking,Female,60+,9188,7727,1461,8458,730
2001,Urban,Odisha,Property Crime,Burglary,Male,31-45,1611,697,914,1016,595
2009,Urban,Jharkhand,Crime Against Women,Rape,Female,13-17,1134,367,767,668,466
2001,Rural,West Bengal,Crime Against Men,Murder,Female,0-12,8425,2203,6222,3740,4685
2010,Rural,Bihar,Crime Against Women,Domestic Violence,Male,0-12,5568,1391,4177,4802,766
2003,Rural,Rajasthan,Other Crimes,Cyber Crime,Female,31-45,1286,638,648,776,510
2006,Rural,West Bengal,Property Crime,Burglary,Male,46-60,6879,4517,2362,4950,1929
2007,Urban,Chhattisgarh,Other Crimes,Corruption,Female,46-60,6387,3798,2589,4339,2048
2001,Rural,Tamil Nadu,Property Crime,Vandalism,Male,60+,3850,1303,2547,2594,1256
2008,Rural,Telangana,Crime Against Men,Extortion,Female,0-12,1776,1761,15,1768,8
2010,Urban,Gujarat,Crime Against Men,Robbery,Female,13-17,7867,2727,5140,2826,5041
2001,Urban,Himachal Pradesh,Other Crimes,Fraud,Male,46-60,5792,2837,2955,3573,2219
2007,Urban,Andhra Pradesh,Crime Against Men,Extortion,Female,46-60,3157,1394,1763,1812,1345
2001,Urban,Goa,Property Crime,Burglary,Female,31-45,9962,3608,6354,6711,3251
2010,Urban,Madhya Pradesh,Crime Against Women,Molestation,Female,13-17,6308,3068,3240,3333,2975
2003,Rural,Himachal Pradesh,Property Crime,Arson,Male,0-12,6575,3277,3298,3805,2770
2003,Rural,Assam,Other Crimes,Drug Offense,Female,31-45,5200,3902,1298,4511,689
2005,Urban,Odisha,Crime Against Women,Dowry Deaths,Female,31-45,4143,2730,1413,2992,1151
2008,Urban,Madhya Pradesh,Crime Against Women,Dowry Deaths,Female,60+,3098,1777,1321,2995,103
2004,Rural,Kerala,Crime Against Children,Kidnapping,Female,46-60,3594,3508,86,3591,3
2004,Rural,Manipur,Crime Against Women,Dowry Deaths,Female,13-17,4835,1752,3083,1864,2971
2003,Rural,Arunachal Pradesh,Crime Against Children,Trafficking,Female,46-60,8016,1442,6574,1845,6171
2010,Rural,Delhi,Property Crime,Arson,Female,18-30,5767,2676,3091,2742,3025
2009,Rural,Assam,Property Crime,Vandalism,Female,60+,8719,7195,1524,7261,1458
2005,Rural,Chhattisgarh,Property Crime,Burglary,Male,18-30,693,267,426,300,393
2001,Rural,Assam,Crime Against Women,Rape,Male,46-60,9717,3221,6496,3426,6291
2003,Rural,Uttar Pradesh,Crime Against Women,Molestation,Male,0-12,1433,1013,420,1034,399
2005,Urban,Jammu & Kashmir,Crime Against Men,Extortion,Female,60+,8334,4252,4082,4581,3753
2006,Urban,Odisha,Other Crimes,Drug Offense,Female,18-30,3649,1438,2211,2811,838
2002,Urban,Bihar,Crime Against Men,Murder,Male,18-30,340,160,180,182,158
2009,Urban,Odisha,Crime Against Children,Child Abuse,Female,60+,3524,576,2948,816,2708
2006,Urban,Assam,Crime Against Children,Kidnapping,Male,46-60,9165,7512,1653,7741,1424
2008,Rural,Assam,Crime Against Women,Molestation,Female,13-17,9951,7162,2789,8257,1694
2003,Rural,Mizoram,Crime Against Men,Assault,Female,60+,264,92,172,143,121
2002,Urban,West Bengal,Property Crime,Vandalism,Male,18-30,139,129,10,132,7
2005,Urban,Gujarat,Other Crimes,Fraud,Male,0-12,2373,1305,1068,1971,402
2003,Rural,Himachal Pradesh,Crime Against Women,Domestic Violence,Male,60+,2942,1174,1768,2446,496
2009,Rural,Rajasthan,Other Crimes,Cyber Crime,Female,31-45,2305,2257,48,2287,18
2004,Rural,Punjab,Crime Against Men,Extortion,Female,60+,5722,2813,2909,3698,2024
2007,Rural,Kerala,Crime Against Men,Robbery,Female,0-12,6224,5981,243,6147,77
2006,Rural,Meghalaya,Property Crime,Vandalism,Female,18-30,5714,196,5518,4961,753
2006,Urban,Telangana,Property Crime,Burglary,Female,46-60,2776,818,1958,1118,1658
2006,Urban,Uttar Pradesh,Crime Against Children,Kidnapping,Female,31-45,3736,3117,619,3728,8
2002,Rural,Uttarakhand,Crime Against Women,Domestic Violence,Male,18-30,239,82,157,109,130
2008,Rural,Gujarat,Crime Against Children,Trafficking,Female,13-17,684,230,454,659,25
2008,Rural,Nagaland,Crime Against Men,Assault,Male,13-17,714,46,668,597,117
2009,Urban,Sikkim,Other Crimes,Corruption,Female,60+,9414,1429,7985,7623,1791
2010,Rural,Tamil Nadu,Crime Against Children,Child Abuse,Male,31-45,6118,5439,679,5639,479
2008,Rural,Madhya Pradesh,Crime Against Women,Dowry Deaths,Female,46-60,9573,5447,4126,8928,645
2004,Rural,Manipur,Property Crime,Theft,Female,0-12,4479,156,4323,1985,2494
2007,Rural,Sikkim,Crime Against Men,Extortion,Female,46-60,9346,5991,3355,8781,565
2006,Urban,Mizoram,Crime Against Children,Child Labor,Male,18-30,5826,425,5401,3339,2487
2006,Rural,Chhattisgarh,Crime Against Children,Child Abuse,Male,13-17,1083,953,130,1044,39
2008,Rural,West Bengal,Crime Against Men,Extortion,Female,0-12,6180,3748,2432,6016,164
2002,Rural,Karnataka,Other Crimes,Corruption,Male,46-60,6474,2395,4079,5676,798
2009,Urban,Uttar Pradesh,Crime Against Children,Trafficking,Male,46-60,6826,2882,3944,4009,2817
2008,Urban,Gujarat,Crime Against Women,Molestation,Female,0-12,123,20,103,100,23
2003,Rural,Haryana,Crime Against Men,Extortion,Female,13-17,6843,5096,1747,5488,1355
2005,Rural,Madhya Pradesh,Other Crimes,Cyber Crime,Female,31-45,9925,4574,5351,8533,1392
2004,Rural,Chhattisgarh,Crime Against Children,Trafficking,Male,13-17,9350,8686,664,8950,400
2001,Rural,Haryana,Crime Against Women,Dowry Deaths,Female,18-30,6514,5880,634,6395,119
2008,Urban,Tripura,Crime Against Children,Child Abuse,Female,0-12,862,728,134,823,39
2006,Rural,Jharkhand,Property Crime,Burglary,Female,18-30,5680,2943,2737,4163,1517
2002,Rural,Punjab,Other Crimes,Fraud,Female,60+,4850,4689,161,4708,142
2005,Urban,Goa,Crime Against Women,Rape,Male,13-17,2051,2024,27,2042,9
2009,Rural,Rajasthan,Crime Against Men,Extortion,Female,0-12,8136,7645,491,7986,150
2007,Rural,Manipur,Property Crime,Theft,Female,18-30,3608,1633,1975,3320,288
2005,Urban,Uttarakhand,Other Crimes,Cyber Crime,Female,46-60,4686,4645,41,4649,37
2007,Rural,Uttar Pradesh,Crime Against Men,Extortion,Male,0-12,8376,2401,5975,4113,4263
2005,Urban,Manipur,Crime Against Men,Extortion,Male,18-30,6300,5019,1281,5183,1117
2004,Urban,Assam,Crime Against Women,Molestation,Male,31-45,9251,4490,4761,7545,1706
2005,Urban,Uttar Pradesh,Property Crime,Arson,Female,60+,2113,1314,799,1454,659
2002,Rural,Sikkim,Crime Against Children,Child Labor,Male,0-12,5677,4642,1035,5383,294
2004,Rural,Manipur,Crime Against Men,Robbery,Female,0-12,7828,3515,4313,5162,2666
2006,Urban,Nagaland,Crime Against Men,Murder,Female,60+,8311,7955,356,8210,101
2006,Urban,Tamil Nadu,Other Crimes,Fraud,Female,31-45,4331,1706,2625,2579,1752
2003,Rural,Arunachal Pradesh,Crime Against Children,Child Labor,Male,13-17,1103,600,503,843,260
2010,Urban,Maharashtra,Crime Against Women,Molestation,Female,18-30,7250,426,6824,6450,800
2009,Urban,Nagaland,Other Crimes,Drug Offense,Female,18-30,4411,12,4399,3932,479
2005,Urban,Kerala,Crime Against Women,Rape,Female,0-12,6615,4603,2012,5826,789
2002,Urban,Maharashtra,Crime Against Men,Assault,Female,0-12,8998,8229,769,8986,12
2004,Urban,Gujarat,Property Crime,Arson,Male,18-30,4799,4579,220,4678,121
2008,Urban,Assam,Crime Against Women,Domestic Violence,Male,13-17,9399,8342,1057,9117,282
2001,Rural,Bihar,Crime Against Women,Molestation,Male,46-60,9889,1047,8842,7253,2636
2005,Rural,Andhra Pradesh,Crime Against Women,Rape,Female,18-30,7201,5771,1430,6773,428
2010,Urban,Punjab,Other Crimes,Fraud,Female,13-17,7735,7661,74,7662,73
2008,Rural,Mizoram,Property Crime,Theft,Male,46-60,6318,3976,2342,5020,1298
2005,Urban,Uttar Pradesh,Crime Against Women,Dowry Deaths,Male,0-12,7605,4536,3069,5616,1989
2003,Urban,Delhi,Crime Against Children,Child Abuse,Female,60+,5118,4345,773,4906,212
2003,Urban,Arunachal Pradesh,Crime Against Men,Assault,Female,0-12,1813,1702,111,1714,99
2001,Rural,Jammu & Kashmir,Crime Against Men,Extortion,Female,18-30,9912,1728,8184,8077,1835
2005,Urban,Telangana,Other Crimes,Cyber Crime,Female,46-60,4327,3352,975,3988,339
2008,Rural,Telangana,Property Crime,Theft,Female,18-30,9022,3390,5632,5139,3883
2008,Urban,Assam,Crime Against Children,Child Abuse,Female,0-12,3873,3282,591,3581,292
2007,Rural,Odisha,Property Crime,Arson,Female,31-45,4358,3451,907,3512,846
2006,Urban,Jharkhand,Other Crimes,Fraud,Male,31-45,6787,5733,1054,6183,604
2009,Rural,Gujarat,Crime Against Children,Child Labor,Female,0-12,1062,882,180,917,145
2004,Rural,Punjab,Crime Against Men,Murder,Male,31-45,5123,194,4929,2135,2988
2005,Rural,Arunachal Pradesh,Crime Against Women,Dowry Deaths,Female,13-17,228,40,188,195,33
2001,Rural,Rajasthan,Other Crimes,Fraud,Female,0-12,3858,1653,2205,3634,224
2005,Urban,Uttarakhand,Other Crimes,Fraud,Female,46-60,9870,8886,984,9073,797
2009,Urban,Delhi,Other Crimes,Cyber Crime,Male,13-17,2746,1692,1054,2261,485
2004,Rural,Manipur,Crime Against Women,Dowry Deaths,Female,46-60,5263,2241,3022,5031,232
2001,Urban,Tripura,Crime Against Men,Extortion,Male,0-12,2191,30,2161,1826,365
2004,Urban,Tripura,Crime Against Women,Domestic Violence,Female,13-17,6371,1515,4856,2389,3982
2003,Urban,Odisha,Crime Against Children,Kidnapping,Male,60+,4760,3091,1669,3669,1091
2005,Urban,Odisha,Crime Against Women,Rape,Female,13-17,2199,1468,731,1895,304
2001,Urban,Chhattisgarh,Crime Against Men,Extortion,Female,13-17,4725,1045,3680,3752,973
2002,Rural,Tripura,Crime Against Men,Assault,Female,46-60,9154,3384,5770,5180,3974
2005,Urban,Odisha,Other Crimes,Drug Offense,Male,60+,5301,4294,1007,4350,951
2009,Urban,Delhi,Other Crimes,Drug Offense,Male,60+,7037,998,6039,3048,3989
2004,Urban,Jharkhand,Crime Against Children,Child Abuse,Female,18-30,6956,5099,1857,5766,1190
2003,Urban,Andhra Pradesh,Property Crime,Burglary,Male,46-60,7479,2916,4563,6046,1433
2009,Urban,Meghalaya,Crime Against Men,Extortion,Male,31-45,7859,1078,6781,4487,3372
2005,Rural,Tripura,Other Crimes,Fraud,Female,60+,8726,1642,7084,8558,168
2003,Rural,Uttarakhand,Other Crimes,Fraud,Male,46-60,4196,1797,2399,2999,1197
2002,Urban,Uttar Pradesh,Crime Against Women,Dowry Deaths,Female,0-12,9959,461,9498,4908,5051
2009,Urban,Haryana,Property Crime,Theft,Male,46-60,8646,7299,1347,7412,1234
2010,Urban,Madhya Pradesh,Other Crimes,Fraud,Male,60+,5030,3220,1810,4584,446
2002,Rural,Manipur,Property Crime,Theft,Female,31-45,1180,396,784,883,297
2009,Urban,Manipur,Crime Against Children,Child Labor,Female,60+,379,310,69,367,12
2003,Urban,Madhya Pradesh,Property Crime,Burglary,Male,0-12,6494,2368,4126,3154,3340
2010,Rural,Arunachal Pradesh,Crime Against Men,Extortion,Female,46-60,7773,6499,1274,7527,246
2005,Urban,Himachal Pradesh,Property Crime,Theft,Male,60+,9474,4003,5471,9425,49
2006,Urban,Goa,Crime Against Women,Rape,Male,18-30,8634,1025,7609,3039,5595
2005,Rural,Gujarat,Crime Against Children,Child Abuse,Male,18-30,915,94,821,508,407
2006,Urban,Assam,Crime Against Women,Rape,Female,18-30,4186,910,3276,2631,1555
2004,Rural,Delhi,Other Crimes,Drug Offense,Male,13-17,5462,4746,716,5162,300
2010,Urban,Punjab,Property Crime,Vandalism,Male,46-60,1938,539,1399,1361,577
2003,Rural,Uttar Pradesh,Crime Against Women,Rape,Female,18-30,3169,2241,928,2859,310
2002,Rural,Nagaland,Other Crimes,Cyber Crime,Female,31-45,9841,2002,7839,5669,4172
2004,Urban,West Bengal,Other Crimes,Corruption,Female,31-45,8230,7787,443,8018,212
2005,Rural,Gujarat,Other Crimes,Cyber Crime,Female,0-12,969,160,809,910,59
2009,Urban,Odisha,Property Crime,Burglary,Male,13-17,2733,567,2166,2353,380
2002,Rural,Jharkhand,Property Crime,Vandalism,Female,0-12,4709,3069,1640,4189,520
2006,Rural,Bihar,Property Crime,Burglary,Female,13-17,9704,3068,6636,3120,6584
2010,Rural,Uttarakhand,Crime Against Children,Child Labor,Female,31-45,5044,2630,2414,4114,930
2010,Rural,Sikkim,Property Crime,Theft,Male,46-60,4228,4181,47,4186,42
2004,Rural,Arunachal Pradesh,Other Crimes,Fraud,Male,13-17,4181,1199,2982,3519,662
2001,Urban,Andhra Pradesh,Crime Against Children,Kidnapping,Female,0-12,673,198,475,592,81
2007,Urban,Manipur,Crime Against Children,Child Abuse,Male,60+,6898,541,6357,5957,941
2006,Rural,Jammu & Kashmir,Crime Against Men,Robbery,Female,31-45,5896,5438,458,5860,36
2002,Urban,Telangana,Property Crime,Burglary,Male,18-30,2120,1701,419,1945,175
2008,Rural,Uttar Pradesh,Property Crime,Burglary,Female,60+,6554,4858,1696,5754,800
2002,Rural,Jharkhand,Property Crime,Theft,Female,0-12,7415,4107,3308,6582,833
2010,Urban,Manipur,Property Crime,Theft,Male,13-17,3759,1805,1954,3036,723
2008,Urban,Odisha,Property Crime,Theft,Male,0-12,4352,2551,1801,3030,1322
2007,Rural,Assam,Other Crimes,Drug Offense,Male,0-12,4775,1325,3450,2644,2131
2009,Urban,Delhi,Other Crimes,Corruption,Female,31-45,6310,2105,4205,2688,3622
2002,Rural,Kerala,Property Crime,Arson,Male,31-45,1478,916,562,1044,434
2006,Rural,Karnataka,Crime Against Men,Extortion,Female,60+,7834,6599,1235,7702,132
2004,Urban,Chhattisgarh,Other Crimes,Drug Offense,Male,13-17,1792,750,1042,850,942
2007,Urban,Uttarakhand,Property Crime,Burglary,Male,18-30,2748,1155,1593,1922,826
2007,Rural,Madhya Pradesh,Property Crime,Vandalism,Female,31-45,6314,370,5944,2269,4045
2010,Rural,Odisha,Crime Against Women,Rape,Male,13-17,2088,1365,723,1533,555
2008,Urban,Odisha,Crime Against Men,Extortion,Female,46-60,3561,367,3194,1205,2356
2004,Rural,Goa,Crime Against Children,Trafficking,Male,60+,4190,585,3605,3530,660
2009,Rural,Tripura,Other Crimes,Fraud,Female,31-45,990,348,642,887,103
2005,Urban,Nagaland,Crime Against Women,Molestation,Female,18-30,2897,2074,823,2461,436
2007,Urban,Delhi,Property Crime,Arson,Male,46-60,3892,3499,393,3859,33
2004,Rural,Uttar Pradesh,Crime Against Women,Molestation,Male,46-60,8010,2013,5997,4453,3557
2006,Rural,West Bengal,Other Crimes,Corruption,Female,46-60,3928,2501,1427,3592,336
2005,Urban,Uttar Pradesh,Crime Against Women,Rape,Female,46-60,2566,7,2559,2234,332
2004,Urban,Andhra Pradesh,Property Crime,Theft,Female,60+,3454,2627,827,2888,566
2003,Rural,Madhya Pradesh,Property Crime,Arson,Female,60+,898,585,313,870,28
2001,Urban,Telangana,Crime Against Children,Child Labor,Female,13-17,696,129,567,472,224
2002,Rural,Madhya Pradesh,Crime Against Men,Robbery,Female,18-30,3631,1300,2331,3477,154
2007,Urban,Kerala,Crime Against Men,Murder,Female,60+,5299,2268,3031,2943,2356
2005,Urban,West Bengal,Other Crimes,Drug Offense,Male,18-30,8915,1201,7714,4430,4485
2002,Urban,Arunachal Pradesh,Other Crimes,Drug Offense,Female,46-60,4748,2597,2151,4096,652
2005,Rural,Tripura,Crime Against Children,Kidnapping,Male,0-12,4860,1302,3558,3966,894
2005,Urban,Chhattisgarh,Other Crimes,Cyber Crime,Male,18-30,9768,7782,1986,8615,1153
2009,Rural,Bihar,Crime Against Children,Kidnapping,Male,46-60,4753,3247,1506,3928,825
2001,Rural,Punjab,Crime Against Children,Kidnapping,Female,46-60,7744,4412,3332,5499,2245
2003,Rural,Bihar,Crime Against Children,Kidnapping,Male,13-17,7782,6013,1769,7115,667
2009,Rural,Tripura,Crime Against Children,Trafficking,Female,60+,3163,2085,1078,3064,99
2006,Rural,Punjab,Crime Against Children,Child Abuse,Female,46-60,8190,3368,4822,3954,4236
2006,Rural,Uttar Pradesh,Other Crimes,Fraud,Male,18-30,9134,8763,371,9042,92
2006,Urban,Assam,Crime Against Men,Murder,Male,18-30,2590,492,2098,2172,418
2002,Urban,Sikkim,Crime Against Women,Rape,Female,60+,5017,2299,2718,3052,1965
2005,Urban,Goa,Crime Against Women,Rape,Male,60+,4260,2974,1286,3135,1125
2006,Urban,Kerala,Other Crimes,Drug Offense,Male,60+,2123,1214,909,1691,432
2003,Rural,Nagaland,Crime Against Men,Extortion,Male,46-60,864,559,305,830,34
2007,Rural,Tripura,Crime Against Women,Domestic Violence,Male,18-30,3573,703,2870,2315,1258
2010,Urban,Nagaland,Other Crimes,Cyber Crime,Female,60+,9564,381,9183,7134,2430
2007,Rural,Telangana,Crime Against Children,Child Abuse,Male,18-30,2771,657,2114,2695,76
2009,Rural,Bihar,Property Crime,Theft,Female,13-17,4891,2971,1920,3192,1699
2003,Rural,Odisha,Crime Against Men,Robbery,Male,31-45,1191,293,898,850,341
2002,Urban,Madhya Pradesh,Property Crime,Vandalism,Female,46-60,8259,7140,1119,7688,571
2003,Urban,Odisha,Crime Against Women,Molestation,Female,0-12,6773,840,5933,4957,1816
2007,Urban,Arunachal Pradesh,Crime Against Women,Molestation,Female,31-45,5684,654,5030,2090,3594
2006,Urban,Maharashtra,Crime Against Children,Trafficking,Male,0-12,9026,8214,812,8895,131
2001,Urban,Goa,Crime Against Children,Child Labor,Female,13-17,9769,7968,1801,8566,1203
2008,Urban,Madhya Pradesh,Property Crime,Arson,Female,46-60,7310,4246,3064,6524,786
2008,Urban,Gujarat,Crime Against Men,Assault,Male,60+,1124,422,702,654,470
2004,Urban,Telangana,Other Crimes,Drug Offense,Male,0-12,5316,1887,3429,4272,1044
2001,Urban,Uttar Pradesh,Other Crimes,Drug Offense,Male,13-17,5852,3817,2035,4278,1574
2002,Urban,Mizoram,Property Crime,Theft,Female,60+,7441,408,7033,5448,1993
2007,Rural,Tripura,Other Crimes,Fraud,Male,13-17,6551,3053,3498,5712,839
2008,Rural,West Bengal,Property Crime,Theft,Male,0-12,9839,8418,1421,8868,971
2007,Rural,Haryana,Crime Against Men,Murder,Male,13-17,7084,2671,4413,5456,1628
2009,Urban,Jammu & Kashmir,Other Crimes,Corruption,Female,60+,98,39,59,95,3
2010,Urban,Bihar,Crime Against Women,Molestation,Female,13-17,3952,1647,2305,2189,1763
2010,Urban,Bihar,Other Crimes,Corruption,Female,31-45,1168,494,674,559,609
2006,Urban,Jharkhand,Other Crimes,Corruption,Female,0-12,5943,5793,150,5936,7
2007,Urban,Jharkhand,Crime Against Women,Domestic Violence,Female,18-30,3695,1545,2150,2531,1164
2007,Rural,Kerala,Crime Against Children,Kidnapping,Female,31-45,5642,1694,3948,2438,3204
2007,Urban,Andhra Pradesh,Other Crimes,Corruption,Female,13-17,6309,1810,4499,2277,4032
2001,Rural,Kerala,Property Crime,Vandalism,Male,60+,1217,157,1060,1126,91
2008,Urban,Gujarat,Property Crime,Burglary,Female,46-60,620,471,149,562,58
2009,Rural,West Bengal,Other Crimes,Cyber Crime,Male,13-17,8066,7658,408,8040,26
2005,Rural,Delhi,Other Crimes,Cyber Crime,Female,18-30,8565,3195,5370,8303,262
2007,Rural,Uttar Pradesh,Crime Against Men,Extortion,Male,13-17,5027,4720,307,4785,242
2006,Rural,Goa,Other Crimes,Fraud,Female,31-45,9444,474,8970,4627,4817
2005,Rural,Arunachal Pradesh,Crime Against Men,Extortion,Male,13-17,1097,624,473,748,349
2006,Rural,Chhattisgarh,Crime Against Men,Extortion,Male,31-45,4091,3881,210,3982,109
2007,Rural,Himachal Pradesh,Crime Against Children,Trafficking,Male,18-30,472,438,34,455,17
2009,Urban,Uttar Pradesh,Crime Against Women,Rape,Female,0-12,6619,430,6189,5396,1223
2009,Urban,Andhra Pradesh,Crime Against Children,Kidnapping,Female,18-30,3368,2606,762,2785,583
2010,Urban,Himachal Pradesh,Property Crime,Arson,Male,13-17,8089,4218,3871,5795,2294
2006,Rural,Haryana,Crime Against Men,Extortion,Female,60+,8067,6241,1826,6583,1484
2004,Rural,Rajasthan,Crime Against Men,Assault,Male,31-45,7994,3257,4737,6516,1478
2003,Urban,Uttarakhand,Other Crimes,Corruption,Female,0-12,5390,2601,2789,4616,774
2005,Rural,Telangana,Crime Against Men,Murder,Female,18-30,8208,5880,2328,8024,184
2001,Rural,Odisha,Crime Against Women,Molestation,Male,60+,6792,638,6154,4514,2278
2001,Rural,Chhattisgarh,Property Crime,Theft,Female,60+,5445,5033,412,5241,204
2006,Urban,Tripura,Other Crimes,Cyber Crime,Female,46-60,6651,3361,3290,4741,1910
2007,Rural,Odisha,Crime Against Men,Murder,Male,31-45,6135,713,5422,1050,5085
2004,Urban,Delhi,Crime Against Children,Trafficking,Female,46-60,9835,2078,7757,2872,6963
2001,Rural,Meghalaya,Crime Against Children,Child Labor,Female,46-60,9613,533,9080,4610,5003
2004,Rural,Meghalaya,Crime Against Women,Domestic Violence,Male,0-12,7781,4692,3089,6070,1711
2007,Urban,Delhi,Other Crimes,Drug Offense,Female,13-17,7549,5072,2477,7547,2
2006,Rural,Himachal Pradesh,Crime Against Women,Domestic Violence,Male,46-60,8380,195,8185,2144,6236
2001,Rural,Arunachal Pradesh,Other Crimes,Drug Offense,Male,18-30,69,28,41,50,19
2006,Rural,Uttar Pradesh,Crime Against Children,Trafficking,Male,13-17,8710,6590,2120,8004,706
2004,Urban,Maharashtra,Other Crimes,Cyber Crime,Female,18-30,2258,1124,1134,1433,825
2008,Urban,Telangana,Crime Against Children,Kidnapping,Male,0-12,6795,1223,5572,3006,3789
2009,Rural,Meghalaya,Property Crime,Vandalism,Female,0-12,6355,3679,2676,4080,2275
2003,Urban,Tamil Nadu,Crime Against Men,Assault,Male,31-45,294,37,257,256,38
2005,Urban,Chhattisgarh,Crime Against Children,Trafficking,Female,60+,9256,897,8359,6614,2642
2010,Urban,Kerala,Crime Against Children,Child Labor,Male,60+,4942,484,4458,4357,585
2007,Rural,Arunachal Pradesh,Property Crime,Arson,Female,60+,9966,7798,2168,7902,2064
2004,Urban,Assam,Property Crime,Theft,Male,31-45,55,22,33,25,30
2005,Urban,Jharkhand,Other Crimes,Drug Offense,Male,60+,8011,5677,2334,6200,1811
2003,Urban,Mizoram,Crime Against Women,Dowry Deaths,Male,31-45,6032,5585,447,5998,34
2005,Rural,Jammu & Kashmir,Property Crime,Burglary,Male,31-45,5825,4069,1756,4739,1086
2007,Urban,Meghalaya,Crime Against Women,Molestation,Male,46-60,3463,1908,1555,2811,652
2003,Urban,Karnataka,Property Crime,Vandalism,Male,0-12,8714,7881,833,8159,555
2002,Rural,Nagaland,Crime Against Women,Molestation,Male,18-30,8185,3325,4860,5988,2197
2009,Rural,Kerala,Crime Against Women,Domestic Violence,Male,0-12,6578,4309,2269,5796,782
2002,Rural,West Bengal,Crime Against Men,Extortion,Male,60+,8277,491,7786,1860,6417
2008,Urban,Karnataka,Crime Against Women,Dowry Deaths,Female,0-12,7501,3771,3730,6961,540
2003,Urban,Odisha,Other Crimes,Fraud,Female,60+,5072,2413,2659,3160,1912
2010,Urban,Madhya Pradesh,Crime Against Women,Dowry Deaths,Female,0-12,333,311,22,331,2
2006,Rural,Andhra Pradesh,Other Crimes,Fraud,Female,60+,5894,5414,480,5812,82
2005,Urban,Assam,Crime Against Children,Trafficking,Male,31-45,3733,2740,993,3500,233
2004,Urban,Madhya Pradesh,Other Crimes,Drug Offense,Female,46-60,3336,539,2797,2352,984
2006,Rural,Jharkhand,Crime Against Children,Child Abuse,Male,13-17,4401,2404,1997,3372,1029
2003,Rural,West Bengal,Crime Against Children,Child Abuse,Female,31-45,8070,882,7188,7774,296
2005,Rural,Bihar,Crime Against Women,Molestation,Male,31-45,5519,3813,1706,3983,1536
2003,Urban,Nagaland,Property Crime,Vandalism,Male,60+,7866,5235,2631,7114,752
2002,Rural,Chhattisgarh,Crime Against Women,Domestic Violence,Female,60+,6262,1347,4915,2938,3324
2001,Urban,Maharashtra,Crime Against Women,Molestation,Female,18-30,4415,2474,1941,3810,605
2007,Rural,Odisha,Other Crimes,Cyber Crime,Female,18-30,1064,192,872,715,349
2007,Rural,Goa,Crime Against Women,Molestation,Male,13-17,1496,157,1339,305,1191
2008,Urban,Uttar Pradesh,Other Crimes,Corruption,Male,13-17,7331,2488,4843,5697,1634
2002,Urban,Meghalaya,Crime Against Men,Robbery,Male,0-12,9841,8092,1749,9061,780
2010,Rural,West Bengal,Property Crime,Vandalism,Female,31-45,1174,590,584,932,242
2003,Rural,Kerala,Crime Against Women,Dowry Deaths,Female,13-17,510,345,165,451,59
2006,Urban,Uttar Pradesh,Crime Against Children,Trafficking,Female,13-17,2434,689,1745,961,1473
2001,Rural,Manipur,Crime Against Women,Molestation,Male,46-60,269,30,239,59,210
2003,Rural,Delhi,Crime Against Men,Extortion,Female,46-60,7718,503,7215,2571,5147
2010,Urban,Bihar,Crime Against Men,Murder,Female,0-12,8353,6923,1430,7603,750
2006,Rural,West Bengal,Crime Against Women,Dowry Deaths,Male,46-60,3989,233,3756,870,3119
2008,Rural,Chhattisgarh,Crime Against Men,Murder,Male,60+,9800,3227,6573,9314,486
2009,Rural,Sikkim,Crime Against Children,Trafficking,Male,0-12,9784,5375,4409,8194,1590
2003,Rural,Punjab,Property Crime,Burglary,Female,18-30,738,486,252,570,168
2003,Rural,Rajasthan,Crime Against Children,Trafficking,Female,31-45,9961,9539,422,9911,50
2002,Rural,Rajasthan,Crime Against Men,Extortion,Male,60+,9012,158,8854,6772,2240
2008,Rural,Odisha,Crime Against Children,Child Abuse,Female,13-17,2190,594,1596,1585,605
2009,Rural,Mizoram,Other Crimes,Cyber Crime,Male,60+,3928,2026,1902,2714,1214
2010,Rural,Sikkim,Crime Against Men,Extortion,Female,0-12,2802,1726,1076,2528,274
2005,Urban,Maharashtra,Crime Against Children,Child Labor,Male,0-12,4844,583,4261,4225,619
2005,Rural,Telangana,Crime Against Children,Child Abuse,Female,31-45,5684,4756,928,5119,565
2006,Urban,Punjab,Property Crime,Arson,Male,13-17,4901,2211,2690,2715,2186
2005,Urban,Haryana,Crime Against Men,Robbery,Female,13-17,155,13,142,34,121
2003,Urban,Meghalaya,Property Crime,Vandalism,Male,0-12,4171,3771,400,3971,200
2003,Rural,Manipur,Crime Against Children,Child Labor,Male,60+,986,74,912,581,405
2010,Rural,Uttarakhand,Crime Against Women,Rape,Male,18-30,7804,4887,2917,5247,2557
2003,Rural,Jammu & Kashmir,Crime Against Women,Rape,Male,18-30,6554,2674,3880,5634,920
2002,Rural,Odisha,Other Crimes,Corruption,Male,13-17,6123,6003,120,6039,84
2002,Rural,Kerala,Crime Against Children,Trafficking,Male,31-45,3476,1447,2029,2645,831
2010,Urban,Madhya Pradesh,Property Crime,Burglary,Male,18-30,5967,1394,4573,5647,320
2003,Urban,Rajasthan,Other Crimes,Fraud,Female,0-12,6807,6332,475,6351,456
2005,Urban,Maharashtra,Other Crimes,Corruption,Male,46-60,5518,4567,951,5294,224
2006,Urban,Rajasthan,Crime Against Men,Murder,Female,0-12,2986,1542,1444,1548,1438
2007,Urban,Delhi,Crime Against Men,Extortion,Male,31-45,3696,3147,549,3431,265
2005,Rural,Andhra Pradesh,Crime Against Children,Child Abuse,Female,18-30,5533,245,5288,4433,1100
2010,Urban,Punjab,Other Crimes,Cyber Crime,Male,60+,3555,2971,584,3432,123
2008,Rural,Punjab,Crime Against Men,Murder,Female,18-30,3320,2466,854,2485,835
2010,Urban,Tripura,Property Crime,Theft,Female,46-60,3395,1635,1760,1894,1501
2008,Rural,Uttar Pradesh,Other Crimes,Cyber Crime,Female,46-60,427,293,134,383,44
2006,Rural,Delhi,Other Crimes,Fraud,Female,18-30,8838,8688,150,8818,20
2002,Rural,West Bengal,Property Crime,Arson,Male,13-17,717,321,396,527,190
2003,Urban,Maharashtra,Crime Against Women,Domestic Violence,Female,13-17,6184,2878,3306,3005,3179
2010,Urban,Uttar Pradesh,Crime Against Children,Child Labor,Female,60+,8991,6867,2124,7206,1785
2002,Rural,Haryana,Crime Against Men,Robbery,Female,60+,6969,4541,2428,6701,268
2008,Rural,Karnataka,Crime Against Children,Trafficking,Male,13-17,3812,2552,1260,3476,336
2009,Urban,Rajasthan,Other Crimes,Fraud,Male,18-30,8402,6152,2250,7677,725
2001,Urban,Uttar Pradesh,Other Crimes,Cyber Crime,Male,13-17,6516,3637,2879,5459,1057
2008,Rural,Arunachal Pradesh,Property Crime,Arson,Female,31-45,4934,1470,3464,3110,1824
2006,Urban,Meghalaya,Crime Against Women,Molestation,Male,0-12,2276,200,2076,889,1387
2004,Rural,Gujarat,Other Crimes,Drug Offense,Male,60+,6699,3823,2876,5354,1345
2003,Rural,Assam,Crime Against Women,Rape,Male,0-12,9561,428,9133,6875,2686
2002,Urban,Tripura,Crime Against Children,Kidnapping,Female,31-45,1077,1000,77,1048,29
2005,Urban,Jharkhand,Crime Against Children,Kidnapping,Male,13-17,3357,2292,1065,2509,848
2003,Rural,Kerala,Crime Against Children,Child Labor,Male,0-12,1445,780,665,1278,167
2009,Urban,Telangana,Crime Against Women,Dowry Deaths,Female,0-12,2078,1806,272,2049,29
2006,Rural,Punjab,Property Crime,Theft,Female,0-12,399,262,137,369,30
2008,Rural,Jharkhand,Other Crimes,Corruption,Male,13-17,9013,2500,6513,6881,2132
2003,Rural,Haryana,Crime Against Women,Rape,Male,46-60,8270,904,7366,8216,54
2008,Rural,Meghalaya,Crime Against Children,Kidnapping,Female,31-45,4138,1162,2976,3411,727
2002,Rural,Tamil Nadu,Crime Against Women,Rape,Female,0-12,2777,133,2644,1335,1442
2005,Urban,Mizoram,Crime Against Children,Trafficking,Female,60+,4962,627,4335,3811,1151
2001,Urban,Goa,Crime Against Children,Kidnapping,Female,60+,9325,1093,8232,2690,6635
2010,Rural,West Bengal,Property Crime,Vandalism,Female,0-12,4450,1836,2614,3705,745
2001,Urban,Telangana,Crime Against Children,Child Abuse,Male,31-45,3936,420,3516,1029,2907
2008,Rural,Rajasthan,Other Crimes,Fraud,Female,60+,5954,2281,3673,4798,1156
2008,Rural,Bihar,Crime Against Men,Murder,Male,0-12,7488,7125,363,7346,142
2005,Urban,Madhya Pradesh,Crime Against Children,Trafficking,Female,13-17,2936,2199,737,2281,655
2005,Urban,Madhya Pradesh,Crime Against Men,Murder,Male,31-45,9049,232,8817,6063,2986
2010,Rural,Sikkim,Crime Against Children,Child Labor,Male,31-45,2180,1890,290,2154,26
2003,Urban,Manipur,Crime Against Children,Trafficking,Male,0-12,3488,2705,783,2749,739
2003,Rural,Telangana,Property Crime,Burglary,Female,0-12,6233,996,5237,3069,3164
2006,Rural,Jammu & Kashmir,Crime Against Children,Child Abuse,Male,60+,5627,2559,3068,3142,2485
2009,Urban,Maharashtra,Property Crime,Vandalism,Male,31-45,7536,4772,2764,5096,2440
2008,Urban,Madhya Pradesh,Crime Against Women,Dowry Deaths,Male,46-60,7394,1068,6326,2229,5165
2007,Urban,Tamil Nadu,Other Crimes,Corruption,Female,18-30,9043,2002,7041,2319,6724
2007,Rural,Jharkhand,Crime Against Children,Child Abuse,Female,46-60,9706,7923,1783,8592,1114
2003,Urban,Assam,Other Crimes,Fraud,Male,18-30,1539,1013,526,1053,486
2001,Rural,Tripura,Property Crime,Arson,Male,0-12,5046,3430,1616,4199,847
2004,Urban,Nagaland,Crime Against Children,Child Abuse,Female,13-17,8425,2570,5855,6496,1929
2004,Rural,Madhya Pradesh,Property Crime,Arson,Male,31-45,2986,1881,1105,2047,939
2005,Rural,Sikkim,Property Crime,Theft,Female,60+,135,75,60,103,32
2009,Urban,Arunachal Pradesh,Other Crimes,Drug Offense,Male,13-17,4613,675,3938,3449,1164
2010,Rural,Madhya Pradesh,Crime Against Children,Child Labor,Male,46-60,5249,3897,1352,5193,56
2008,Rural,Madhya Pradesh,Crime Against Men,Extortion,Female,46-60,1852,1612,240,1694,158
2008,Urban,Haryana,Crime Against Children,Kidnapping,Female,13-17,5597,1217,4380,5068,529
2006,Rural,Assam,Property Crime,Burglary,Female,31-45,675,233,442,339,336
2010,Urban,Haryana,Other Crimes,Drug Offense,Female,31-45,3821,3564,257,3714,107
2005,Urban,Himachal Pradesh,Other Crimes,Corruption,Female,18-30,7776,5652,2124,7277,499
2002,Rural,Maharashtra,Crime Against Women,Molestation,Female,60+,1614,473,1141,1468,146
2008,Urban,Jammu & Kashmir,Property Crime,Burglary,Male,0-12,3709,1080,2629,1667,2042
2004,Rural,Tamil Nadu,Other Crimes,Fraud,Male,18-30,1690,1319,371,1627,63
2005,Rural,Manipur,Crime Against Men,Robbery,Female,31-45,4854,2072,2782,4543,311
2010,Urban,Himachal Pradesh,Crime Against Children,Child Abuse,Male,18-30,69,18,51,41,28
2005,Urban,Mizoram,Crime Against Children,Child Abuse,Male,0-12,8627,2162,6465,5412,3215
2006,Rural,Assam,Property Crime,Theft,Female,60+,7201,1622,5579,5817,1384
2010,Rural,Assam,Crime Against Women,Domestic Violence,Female,31-45,6605,5027,1578,6372,233
2006,Urban,Assam,Crime Against Men,Murder,Male,18-30,5163,2520,2643,4555,608
2006,Rural,Jammu & Kashmir,Property Crime,Burglary,Female,46-60,3686,970,2716,3547,139
2007,Rural,Telangana,Crime Against Children,Child Abuse,Female,46-60,9734,4630,5104,6238,3496
2006,Rural,Delhi,Property Crime,Arson,Female,18-30,5163,2271,2892,4032,1131
2006,Rural,Jammu & Kashmir,Property Crime,Vandalism,Male,31-45,9428,7483,1945,8450,978
2002,Rural,Arunachal Pradesh,Crime Against Women,Domestic Violence,Male,31-45,3024,1959,1065,2637,387
2010,Urban,Rajasthan,Crime Against Men,Murder,Male,0-12,4624,3771,853,3892,732
2008,Rural,Haryana,Other Crimes,Fraud,Female,60+,7546,319,7227,6875,671
2005,Urban,Bihar,Property Crime,Arson,Female,60+,4376,565,3811,752,3624
2001,Rural,Chhattisgarh,Other Crimes,Corruption,Female,18-30,8507,1191,7316,5661,2846
2008,Rural,Manipur,Crime Against Women,Molestation,Female,60+,7772,4292,3480,5747,2025
2010,Rural,Himachal Pradesh,Other Crimes,Cyber Crime,Male,46-60,2327,404,1923,2055,272
2003,Rural,West Bengal,Other Crimes,Drug Offense,Female,46-60,8788,5170,3618,7636,1152
2008,Rural,Chhattisgarh,Crime Against Children,Child Abuse,Female,0-12,6274,355,5919,1499,4775
2004,Rural,Uttar Pradesh,Crime Against Children,Kidnapping,Female,60+,9693,1964,7729,2339,7354
2005,Urban,Kerala,Other Crimes,Fraud,Female,18-30,4167,680,3487,3931,236
2010,Urban,Karnataka,Other Crimes,Corruption,Female,31-45,9821,9273,548,9523,298
2009,Rural,Karnataka,Other Crimes,Corruption,Male,0-12,2073,1673,400,2066,7
2007,Urban,Uttarakhand,Crime Against Men,Assault,Male,46-60,6906,1461,5445,5642,1264
2007,Urban,Karnataka,Other Crimes,Fraud,Female,18-30,9304,6796,2508,7420,1884
2003,Urban,Meghalaya,Crime Against Men,Robbery,Male,31-45,1382,117,1265,965,417
2002,Urban,Maharashtra,Property Crime,Vandalism,Male,46-60,7969,6977,992,7455,514
2010,Urban,Tamil Nadu,Crime Against Men,Extortion,Male,0-12,9199,4463,4736,5865,3334
2007,Urban,Andhra Pradesh,Crime Against Children,Child Labor,Female,18-30,5402,2247,3155,4726,676
2007,Urban,Odisha,Crime Against Children,Kidnapping,Female,13-17,9683,7360,2323,7592,2091
2005,Urban,Karnataka,Other Crimes,Drug Offense,Female,60+,1986,466,1520,1602,384
2008,Urban,Madhya Pradesh,Other Crimes,Cyber Crime,Male,60+,6099,5550,549,5848,251
2008,Urban,Karnataka,Crime Against Women,Molestation,Male,46-60,5715,994,4721,4600,1115
2006,Rural,Telangana,Property Crime,Theft,Male,46-60,2200,975,1225,1154,1046
2008,Urban,Tamil Nadu,Other Crimes,Fraud,Male,18-30,8237,148,8089,2484,5753
2007,Rural,Karnataka,Crime Against Children,Child Abuse,Female,0-12,6201,2364,3837,4694,1507
2008,Rural,Uttar Pradesh,Crime Against Children,Trafficking,Female,60+,1860,1432,428,1606,254
2001,Urban,Bihar,Property Crime,Vandalism,Male,31-45,7345,1151,6194,3267,4078
2009,Urban,Assam,Other Crimes,Cyber Crime,Female,0-12,6473,2274,4199,3089,3384
2009,Rural,Punjab,Crime Against Children,Child Abuse,Male,13-17,1080,358,722,829,251
2007,Urban,Assam,Crime Against Children,Kidnapping,Female,18-30,2163,804,1359,1795,368
2001,Rural,Haryana,Crime Against Men,Extortion,Male,46-60,9927,1314,8613,8845,1082
2005,Rural,Telangana,Property Crime,Arson,Male,31-45,5084,4423,661,4786,298
2004,Urban,Madhya Pradesh,Other Crimes,Drug Offense,Female,31-45,1472,500,972,563,909
2004,Rural,Himachal Pradesh,Crime Against Women,Dowry Deaths,Female,18-30,9576,5844,3732,8394,1182
2008,Rural,West Bengal,Crime Against Men,Extortion,Female,0-12,9057,938,8119,4168,4889
2003,Rural,Tamil Nadu,Other Crimes,Corruption,Female,46-60,4203,504,3699,1399,2804
2006,Rural,Mizoram,Other Crimes,Corruption,Male,13-17,2938,738,2200,2756,182
2001,Urban,Andhra Pradesh,Crime Against Children,Child Abuse,Male,0-12,9169,8241,928,8628,541
2001,Urban,Goa,Property Crime,Burglary,Female,31-45,1474,622,852,1046,428
2002,Urban,Haryana,Crime Against Men,Murder,Female,31-45,4554,337,4217,3240,1314
2005,Urban,Telangana,Other Crimes,Corruption,Female,60+,3478,2896,582,3115,363
2006,Urban,Assam,Property Crime,Arson,Male,0-12,3313,2734,579,2893,420
2006,Rural,Uttarakhand,Property Crime,Burglary,Female,60+,1981,920,1061,1639,342
2009,Rural,Odisha,Crime Against Children,Trafficking,Male,46-60,127,101,26,103,24
2004,Urban,Odisha,Crime Against Men,Robbery,Male,13-17,9136,5540,3596,8953,183
2004,Rural,Assam,Property Crime,Theft,Female,60+,9852,626,9226,9231,621
2001,Urban,Tripura,Crime Against Women,Rape,Female,46-60,9990,1506,8484,3809,6181
2009,Rural,Goa,Crime Against Men,Extortion,Female,18-30,4330,247,4083,3022,1308
2007,Urban,Mizoram,Other Crimes,Drug Offense,Female,13-17,1886,761,1125,806,1080
2004,Rural,Uttar Pradesh,Property Crime,Vandalism,Female,0-12,8946,6914,2032,7685,1261
2009,Rural,Andhra Pradesh,Other Crimes,Cyber Crime,Female,18-30,890,250,640,706,184
2010,Urban,Uttarakhand,Property Crime,Arson,Male,0-12,9372,9352,20,9355,17
2010,Urban,Rajasthan,Other Crimes,Corruption,Male,13-17,450,256,194,340,110
2009,Rural,Andhra Pradesh,Property Crime,Burglary,Female,18-30,8358,2328,6030,3277,5081
2003,Urban,Chhattisgarh,Other Crimes,Fraud,Male,13-17,8752,8616,136,8655,97
2002,Urban,Rajasthan,Crime Against Men,Murder,Female,31-45,3844,1854,1990,3301,543
2002,Rural,Rajasthan,Other Crimes,Corruption,Female,46-60,3112,790,2322,2951,161
2007,Rural,Andhra Pradesh,Crime Against Children,Child Abuse,Male,13-17,5187,4029,1158,4133,1054
2007,Urban,Haryana,Crime Against Children,Trafficking,Female,46-60,1820,643,1177,1775,45
2004,Urban,Arunachal Pradesh,Crime Against Children,Kidnapping,Female,31-45,2723,158,2565,1819,904
2001,Urban,Mizoram,Other Crimes,Corruption,Male,60+,6098,3142,2956,4837,1261
2006,Rural,Mizoram,Other Crimes,Fraud,Female,31-45,3129,2633,496,2998,131
2009,Rural,Manipur,Crime Against Children,Trafficking,Female,60+,6589,3290,3299,6420,169
2006,Urban,Odisha,Crime Against Women,Domestic Violence,Male,46-60,290,262,28,267,23
2007,Urban,Chhattisgarh,Crime Against Men,Extortion,Male,13-17,4279,3291,988,3759,520
2004,Rural,Haryana,Property Crime,Theft,Male,60+,7735,3658,4077,6684,1051
2001,Rural,Assam,Other Crimes,Cyber Crime,Female,13-17,1049,112,937,427,622
2003,Rural,Kerala,Crime Against Women,Domestic Violence,Female,0-12,6442,3047,3395,3695,2747
2005,Urban,Nagaland,Crime Against Women,Domestic Violence,Female,31-45,4199,4062,137,4080,119
2002,Rural,Manipur,Property Crime,Theft,Male,60+,5582,4427,1155,5187,395
2002,Urban,Maharashtra,Crime Against Women,Domestic Violence,Female,0-12,4939,4410,529,4665,274
2001,Rural,Meghalaya,Other Crimes,Corruption,Female,18-30,791,535,256,723,68
2008,Urban,Uttarakhand,Crime Against Children,Child Abuse,Female,60+,4047,3122,925,3546,501
2006,Urban,Jharkhand,Crime Against Women,Rape,Female,13-17,8654,2031,6623,4997,3657
2001,Rural,Kerala,Crime Against Women,Domestic Violence,Male,46-60,3076,603,2473,1043,2033
2006,Urban,Karnataka,Crime Against Women,Dowry Deaths,Female,31-45,7832,1244,6588,3682,4150
2006,Urban,Chhattisgarh,Crime Against Women,Domestic Violence,Female,60+,8409,3673,4736,4425,3984
2009,Rural,Kerala,Other Crimes,Corruption,Female,31-45,6639,152,6487,1326,5313
2004,Rural,Kerala,Crime Against Children,Kidnapping,Male,46-60,5516,4512,1004,5185,331
2009,Urban,Jharkhand,Crime Against Women,Molestation,Female,0-12,8909,5954,2955,7737,1172
2003,Urban,Gujarat,Property Crime,Arson,Female,31-45,4815,2421,2394,3068,1747
2001,Rural,Manipur,Crime Against Women,Molestation,Male,60+,8426,2554,5872,8300,126
2003,Rural,Tamil Nadu,Crime Against Children,Child Abuse,Male,18-30,9436,9317,119,9387,49
2010,Rural,Madhya Pradesh,Crime Against Men,Murder,Male,18-30,3885,1269,2616,1765,2120
2005,Rural,Haryana,Other Crimes,Fraud,Male,31-45,6166,4904,1262,5361,805
2007,Urban,Chhattisgarh,Property Crime,Vandalism,Male,60+,2245,2097,148,2235,10
2008,Urban,Tripura,Property Crime,Theft,Female,0-12,9779,3513,6266,5212,4567
2001,Rural,Telangana,Crime Against Women,Molestation,Male,13-17,3425,905,2520,1460,1965
2002,Rural,Rajasthan,Crime Against Children,Child Abuse,Female,18-30,1276,741,535,1275,1
2004,Urban,Himachal Pradesh,Crime Against Men,Extortion,Male,18-30,4256,3392,864,4065,191
2005,Urban,Rajasthan,Property Crime,Vandalism,Male,31-45,6486,6431,55,6486,0
2010,Rural,Uttarakhand,Other Crimes,Drug Offense,Female,0-12,2224,1057,1167,1910,314
2003,Rural,Meghalaya,Crime Against Women,Molestation,Male,13-17,8102,6495,1607,7413,689
2004,Rural,Sikkim,Other Crimes,Cyber Crime,Female,46-60,929,8,921,729,200
2005,Rural,Mizoram,Crime Against Women,Domestic Violence,Male,46-60,5216,5165,51,5200,16
2006,Urban,Arunachal Pradesh,Crime Against Men,Murder,Male,60+,1733,1701,32,1701,32
2007,Urban,Delhi,Crime Against Children,Child Abuse,Male,46-60,7883,6398,1485,7451,432
2010,Rural,Maharashtra,Property Crime,Vandalism,Female,0-12,8043,3293,4750,4599,3444
2004,Urban,Meghalaya,Crime Against Children,Trafficking,Female,46-60,7533,5617,1916,6295,1238
2001,Rural,Tripura,Other Crimes,Fraud,Female,46-60,2014,159,1855,1751,263
2001,Urban,Mizoram,Property Crime,Arson,Male,46-60,9306,1926,7380,6004,3302
2009,Rural,Karnataka,Crime Against Children,Child Abuse,Male,18-30,796,131,665,161,635
2003,Rural,Maharashtra,Property Crime,Vandalism,Male,31-45,3388,2031,1357,2359,1029
2006,Urban,Assam,Property Crime,Vandalism,Female,18-30,9020,5991,3029,8350,670
2010,Urban,Telangana,Other Crimes,Fraud,Female,31-45,7843,3849,3994,4609,3234
2006,Urban,Mizoram,Crime Against Men,Robbery,Female,60+,2385,474,1911,1561,824
2006,Urban,Himachal Pradesh,Crime Against Women,Molestation,Male,0-12,7466,2963,4503,4510,2956
2006,Rural,Jammu & Kashmir,Crime Against Women,Molestation,Female,31-45,1327,1178,149,1272,55
2010,Urban,Manipur,Crime Against Children,Trafficking,Female,18-30,6327,4778,1549,6270,57
2003,Rural,Karnataka,Crime Against Children,Child Abuse,Female,46-60,5154,4993,161,5053,101
2001,Urban,Bihar,Crime Against Women,Domestic Violence,Female,60+,7971,2914,5057,7474,497
2007,Rural,Punjab,Crime Against Men,Extortion,Male,60+,8049,6500,1549,7289,760
2004,Urban,Odisha,Other Crimes,Corruption,Male,60+,2798,399,2399,1655,1143
2001,Rural,Maharashtra,Other Crimes,Drug Offense,Male,0-12,4866,3148,1718,3375,1491
2001,Urban,Telangana,Crime Against Children,Child Labor,Female,46-60,6571,1353,5218,5731,840
2007,Urban,Himachal Pradesh,Other Crimes,Corruption,Male,46-60,6400,5958,442,6237,163
2002,Rural,Gujarat,Crime Against Children,Child Labor,Male,60+,7135,5054,2081,6938,197
2004,Rural,Bihar,Crime Against Children,Child Labor,Female,31-45,6978,3584,3394,6411,567
2008,Urban,Uttar Pradesh,Property Crime,Burglary,Male,31-45,9938,1265,8673,6698,3240
2005,Urban,Andhra Pradesh,Crime Against Men,Extortion,Female,46-60,6556,319,6237,2956,3600
2005,Urban,Goa,Property Crime,Burglary,Male,31-45,8089,2637,5452,4540,3549
2008,Rural,Gujarat,Property Crime,Arson,Male,31-45,8926,542,8384,1166,7760
2004,Urban,Karnataka,Other Crimes,Fraud,Male,13-17,7950,4216,3734,5445,2505
2003,Rural,Gujarat,Other Crimes,Corruption,Male,13-17,7292,1612,5680,5472,1820
2001,Rural,Manipur,Crime Against Children,Kidnapping,Female,31-45,5703,3817,1886,4270,1433
2004,Urban,Punjab,Other Crimes,Cyber Crime,Male,46-60,3382,749,2633,2287,1095
2005,Rural,Gujarat,Crime Against Women,Molestation,Male,60+,6511,5138,1373,5685,826
2001,Rural,Manipur,Other Crimes,Fraud,Female,46-60,3123,1596,1527,1893,1230
2009,Urban,Gujarat,Other Crimes,Cyber Crime,Male,60+,3619,2414,1205,3308,311
2008,Urban,Tamil Nadu,Crime Against Women,Rape,Male,31-45,5766,2317,3449,5598,168
2002,Urban,Andhra Pradesh,Crime Against Children,Child Labor,Female,60+,3045,918,2127,1971,1074
2005,Urban,Haryana,Crime Against Women,Molestation,Male,18-30,2484,186,2298,1461,1023
2005,Rural,Gujarat,Property Crime,Theft,Male,13-17,6086,3160,2926,3309,2777
2006,Rural,Telangana,Crime Against Children,Trafficking,Male,13-17,265,142,123,188,77
2008,Rural,Meghalaya,Crime Against Men,Robbery,Male,13-17,4898,2736,2162,3893,1005
2009,Urban,Assam,Crime Against Men,Murder,Male,31-45,3329,322,3007,1557,1772
2003,Rural,Jharkhand,Other Crimes,Fraud,Male,13-17,6687,2200,4487,6645,42
2005,Urban,Goa,Crime Against Men,Assault,Female,18-30,1912,1116,796,1557,355
2004,Rural,Goa,Other Crimes,Fraud,Female,13-17,9717,6924,2793,7996,1721
2006,Rural,Sikkim,Crime Against Women,Dowry Deaths,Male,18-30,4773,1591,3182,1807,2966
2008,Rural,Arunachal Pradesh,Crime Against Men,Robbery,Female,46-60,84,83,1,83,1
2006,Urban,Manipur,Other Crimes,Cyber Crime,Male,18-30,633,300,333,602,31
2007,Urban,Mizoram,Other Crimes,Fraud,Male,0-12,4706,1853,2853,2122,2584
2006,Rural,Telangana,Crime Against Children,Child Abuse,Female,60+,9329,6115,3214,9278,51
2005,Urban,Jharkhand,Property Crime,Arson,Male,0-12,5274,1201,4073,5174,100
2008,Urban,Telangana,Crime Against Children,Child Abuse,Female,18-30,5433,2919,2514,3968,1465
2008,Urban,Punjab,Crime Against Children,Kidnapping,Male,46-60,4040,2119,1921,3574,466
2002,Rural,Himachal Pradesh,Crime Against Children,Trafficking,Male,13-17,4620,401,4219,1624,2996
2006,Urban,Jharkhand,Crime Against Women,Rape,Male,60+,9088,4290,4798,4776,4312
2006,Rural,Jammu & Kashmir,Other Crimes,Fraud,Female,46-60,7455,6883,572,7213,242
2001,Rural,Haryana,Crime Against Women,Molestation,Male,18-30,1175,1028,147,1104,71
2001,Urban,Madhya Pradesh,Other Crimes,Cyber Crime,Male,31-45,6664,4169,2495,5066,1598
2001,Rural,Uttar Pradesh,Other Crimes,Fraud,Female,13-17,6077,6061,16,6063,14
2004,Urban,Haryana,Crime Against Women,Rape,Male,0-12,4886,2164,2722,2911,1975
2001,Urban,Haryana,Property Crime,Burglary,Male,60+,271,154,117,216,55
2003,Rural,Madhya Pradesh,Property Crime,Burglary,Female,60+,7094,3113,3981,3290,3804
2005,Rural,Meghalaya,Crime Against Women,Rape,Male,46-60,701,92,609,481,220
2001,Urban,Gujarat,Other Crimes,Fraud,Male,46-60,7750,3437,4313,6887,863
2001,Urban,Haryana,Property Crime,Vandalism,Male,60+,361,284,77,299,62
2001,Urban,Andhra Pradesh,Property Crime,Burglary,Male,31-45,9408,7345,2063,7571,1837
2004,Rural,Chhattisgarh,Crime Against Women,Molestation,Male,60+,7222,274,6948,3759,3463
2002,Rural,Goa,Crime Against Children,Child Labor,Male,13-17,6116,2735,3381,3403,2713
2005,Rural,Haryana,Property Crime,Burglary,Female,0-12,9794,9229,565,9689,105
2010,Urban,Meghalaya,Crime Against Men,Murder,Female,60+,2074,1496,578,1942,132
2001,Urban,Odisha,Property Crime,Burglary,Female,0-12,7917,4298,3619,4511,3406
2008,Urban,Nagaland,Crime Against Children,Child Labor,Male,60+,9966,640,9326,6449,3517
2003,Rural,Manipur,Property Crime,Vandalism,Female,31-45,8282,193,8089,2145,6137
2001,Urban,Karnataka,Crime Against Women,Molestation,Female,60+,4477,3227,1250,4233,244
2007,Urban,Uttarakhand,Property Crime,Vandalism,Female,46-60,5514,212,5302,5335,179
2004,Urban,Maharashtra,Other Crimes,Cyber Crime,Female,46-60,6969,2074,4895,2413,4556
2010,Urban,Jharkhand,Property Crime,Vandalism,Female,0-12,440,298,142,339,101
2008,Urban,Chhattisgarh,Crime Against Women,Rape,Female,60+,1502,175,1327,343,1159
2001,Urban,Chhattisgarh,Crime Against Men,Murder,Female,46-60,8240,5645,2595,6385,1855
2009,Rural,West Bengal,Crime Against Women,Dowry Deaths,Male,13-17,6706,456,6250,5506,1200
2009,Urban,Punjab,Crime Against Men,Robbery,Female,60+,1353,614,739,987,366
2009,Urban,Meghalaya,Crime Against Women,Molestation,Male,0-12,6013,2044,3969,4557,1456
2005,Rural,Uttarakhand,Crime Against Women,Dowry Deaths,Male,0-12,4957,4380,577,4448,509
2008,Urban,Manipur,Crime Against Women,Dowry Deaths,Female,0-12,180,130,50,177,3
2005,Urban,Assam,Property Crime,Burglary,Female,13-17,1542,1187,355,1242,300
2007,Urban,Himachal Pradesh,Crime Against Women,Dowry Deaths,Female,60+,395,133,262,295,100
2005,Urban,Manipur,Other Crimes,Drug Offense,Female,13-17,1963,1300,663,1542,421
2002,Urban,Maharashtra,Property Crime,Theft,Male,31-45,1115,820,295,1084,31
2005,Urban,Goa,Crime Against Children,Child Abuse,Female,60+,8618,7046,1572,7350,1268
2005,Urban,Manipur,Crime Against Children,Trafficking,Female,18-30,6869,4409,2460,5964,905
2005,Urban,Bihar,Crime Against Women,Rape,Female,0-12,7457,943,6514,2444,5013
2001,Rural,Assam,Crime Against Children,Kidnapping,Male,0-12,3478,1248,2230,2833,645
2001,Urban,Karnataka,Crime Against Children,Child Abuse,Male,46-60,2626,1603,1023,2490,136
2003,Rural,Haryana,Crime Against Women,Domestic Violence,Female,60+,6122,1836,4286,3103,3019
2004,Rural,Kerala,Crime Against Women,Molestation,Female,46-60,4498,3045,1453,4094,404
2008,Urban,Sikkim,Crime Against Men,Extortion,Male,60+,100,38,62,97,3
2009,Urban,Kerala,Property Crime,Vandalism,Male,46-60,4347,3930,417,4270,77
2007,Rural,West Bengal,Other Crimes,Corruption,Male,60+,634,453,181,605,29
2009,Urban,Gujarat,Property Crime,Burglary,Female,60+,2457,2342,115,2359,98
2007,Rural,Jammu & Kashmir,Crime Against Children,Trafficking,Female,31-45,9833,995,8838,4065,5768
2002,Rural,Arunachal Pradesh,Crime Against Children,Trafficking,Female,18-30,4185,1747,2438,2868,1317
2008,Urban,Karnataka,Crime Against Women,Rape,Female,46-60,4431,1081,3350,2929,1502
2002,Rural,Maharashtra,Crime Against Children,Trafficking,Male,60+,6551,879,5672,5074,1477
2003,Rural,Bihar,Crime Against Men,Assault,Male,0-12,6273,6237,36,6268,5
2002,Urban,Maharashtra,Crime Against Children,Kidnapping,Male,18-30,8640,5372,3268,6629,2011
2007,Urban,Rajasthan,Property Crime,Theft,Male,13-17,2997,2095,902,2637,360
2007,Rural,West Bengal,Other Crimes,Cyber Crime,Female,13-17,403,6,397,124,279
2007,Rural,Andhra Pradesh,Crime Against Men,Robbery,Female,46-60,5664,5472,192,5627,37
2010,Urban,Sikkim,Crime Against Women,Rape,Male,46-60,4435,4159,276,4340,95
2002,Urban,Uttar Pradesh,Crime Against Men,Robbery,Female,18-30,6077,1319,4758,1855,4222
2003,Urban,Tripura,Crime Against Children,Child Abuse,Male,46-60,9783,7773,2010,8429,1354
2007,Urban,Manipur,Crime Against Women,Dowry Deaths,Female,60+,1163,832,331,1068,95
2008,Rural,Rajasthan,Property Crime,Arson,Female,13-17,6757,1462,5295,5016,1741
2007,Urban,Gujarat,Crime Against Women,Rape,Female,46-60,2069,953,1116,1807,262
2010,Rural,Sikkim,Crime Against Women,Molestation,Female,18-30,6150,3403,2747,4410,1740
2002,Rural,Telangana,Crime Against Men,Murder,Male,31-45,4746,4679,67,4730,16
2007,Rural,Karnataka,Crime Against Children,Kidnapping,Female,18-30,552,366,186,455,97
2004,Rural,Assam,Crime Against Men,Extortion,Female,0-12,6932,5699,1233,5836,1096
2006,Urban,Manipur,Other Crimes,Cyber Crime,Female,60+,9466,4465,5001,5652,3814
2001,Rural,West Bengal,Property Crime,Vandalism,Female,31-45,3168,2290,878,2492,676
2002,Rural,Haryana,Crime Against Women,Molestation,Male,0-12,6430,1640,4790,1675,4755
2010,Urban,Karnataka,Crime Against Children,Kidnapping,Male,60+,9024,391,8633,6109,2915
2010,Rural,Meghalaya,Crime Against Children,Trafficking,Female,13-17,7173,4965,2208,5797,1376
2009,Urban,Mizoram,Other Crimes,Corruption,Female,13-17,7057,5210,1847,6262,795
2001,Rural,Delhi,Crime Against Children,Child Labor,Female,31-45,8351,4408,3943,6336,2015
2001,Rural,Rajasthan,Crime Against Children,Trafficking,Male,31-45,3460,761,2699,1182,2278
2008,Rural,Madhya Pradesh,Crime Against Children,Child Abuse,Female,31-45,294,73,221,170,124
2001,Urban,West Bengal,Crime Against Men,Murder,Male,60+,9546,8191,1355,9500,46
2009,Rural,Jammu & Kashmir,Crime Against Women,Dowry Deaths,Female,0-12,9693,3530,6163,3847,5846
2004,Urban,Karnataka,Property Crime,Arson,Male,13-17,5643,4100,1543,5122,521
2003,Urban,Karnataka,Crime Against Women,Domestic Violence,Female,60+,3182,1021,2161,1095,2087
2006,Urban,Rajasthan,Other Crimes,Cyber Crime,Female,31-45,2651,546,2105,1622,1029
2003,Urban,Chhattisgarh,Crime Against Women,Molestation,Female,13-17,2635,2119,516,2408,227
2005,Rural,West Bengal,Crime Against Women,Domestic Violence,Female,60+,2015,94,1921,474,1541
2009,Urban,Delhi,Crime Against Men,Extortion,Male,0-12,5116,3525,1591,3785,1331
2009,Urban,West Bengal,Other Crimes,Fraud,Male,13-17,6333,2387,3946,4960,1373
2009,Rural,Tamil Nadu,Property Crime,Burglary,Male,46-60,8256,6385,1871,7115,1141
2004,Rural,Assam,Crime Against Children,Trafficking,Male,31-45,5850,5069,781,5805,45
2002,Urban,Punjab,Property Crime,Arson,Female,46-60,9536,8542,994,8693,843
2007,Rural,Odisha,Property Crime,Arson,Male,60+,2909,317,2592,1565,1344
2003,Urban,Jharkhand,Property Crime,Vandalism,Male,0-12,3303,403,2900,1027,2276
2002,Urban,Chhattisgarh,Crime Against Men,Assault,Female,31-45,584,155,429,443,141
2006,Urban,Goa,Property Crime,Arson,Male,60+,4471,4275,196,4419,52
2001,Rural,Madhya Pradesh,Crime Against Children,Kidnapping,Male,46-60,1711,1348,363,1577,134
2008,Rural,Rajasthan,Other Crimes,Cyber Crime,Male,13-17,7183,1067,6116,7010,173
2009,Rural,Odisha,Crime Against Men,Extortion,Female,13-17,1684,1675,9,1678,6
2003,Rural,Uttar Pradesh,Crime Against Men,Robbery,Female,13-17,3417,2565,852,3389,28
2007,Urban,Nagaland,Crime Against Women,Domestic Violence,Male,31-45,7491,1982,5509,3155,4336
2007,Urban,Karnataka,Crime Against Children,Child Abuse,Female,46-60,1025,556,469,674,351
2007,Urban,Maharashtra,Property Crime,Burglary,Female,46-60,3229,814,2415,1595,1634
2002,Urban,Assam,Other Crimes,Drug Offense,Male,60+,9402,3824,5578,8544,858
2010,Rural,Himachal Pradesh,Property Crime,Burglary,Female,46-60,5249,2111,3138,4415,834
2002,Urban,West Bengal,Property Crime,Vandalism,Female,46-60,3993,2604,1389,3877,116
2007,Rural,Punjab,Other Crimes,Cyber Crime,Female,60+,8005,844,7161,3613,4392
2006,Urban,Goa,Crime Against Children,Child Labor,Female,13-17,1997,422,1575,1440,557
2003,Rural,Tamil Nadu,Crime Against Children,Kidnapping,Male,13-17,3376,2971,405,3347,29
2007,Urban,Gujarat,Crime Against Women,Dowry Deaths,Female,0-12,4665,3579,1086,4657,8
2002,Rural,Goa,Other Crimes,Drug Offense,Female,31-45,5918,2949,2969,4774,1144
2008,Rural,Odisha,Other Crimes,Fraud,Male,31-45,7619,5650,1969,7334,285
2004,Rural,Chhattisgarh,Other Crimes,Drug Offense,Female,18-30,9838,3379,6459,4554,5284
2008,Rural,Kerala,Property Crime,Arson,Male,60+,187,10,177,99,88
2010,Urban,Kerala,Crime Against Men,Extortion,Female,31-45,409,386,23,402,7
2001,Rural,Maharashtra,Crime Against Children,Kidnapping,Male,0-12,6294,5903,391,6191,103
2003,Rural,Andhra Pradesh,Crime Against Children,Child Labor,Male,60+,5250,4283,967,4807,443
2002,Urban,Delhi,Property Crime,Theft,Female,13-17,2405,692,1713,1778,627
2007,Urban,Madhya Pradesh,Property Crime,Vandalism,Male,31-45,9330,1603,7727,3407,5923
2005,Urban,Delhi,Other Crimes,Corruption,Female,46-60,5321,1001,4320,5249,72
2001,Urban,Bihar,Other Crimes,Drug Offense,Male,46-60,434,336,98,408,26
2001,Rural,Sikkim,Crime Against Women,Molestation,Male,31-45,6800,2479,4321,5736,1064
2001,Urban,Maharashtra,Other Crimes,Fraud,Male,0-12,1075,399,676,417,658
2008,Urban,Punjab,Crime Against Women,Rape,Male,46-60,5434,927,4507,3349,2085
2006,Urban,Delhi,Property Crime,Arson,Male,13-17,1865,1843,22,1846,19
2006,Rural,Nagaland,Crime Against Children,Child Abuse,Male,18-30,5028,3322,1706,4992,36
2009,Rural,Assam,Crime Against Children,Kidnapping,Male,0-12,4474,2451,2023,3690,784
2001,Urban,Meghalaya,Property Crime,Arson,Male,13-17,9018,96,8922,2085,6933
2001,Urban,Punjab,Property Crime,Theft,Female,31-45,5128,3424,1704,5041,87
2002,Urban,Maharashtra,Crime Against Men,Robbery,Female,0-12,2812,1648,1164,2413,399
2010,Rural,Chhattisgarh,Crime Against Women,Dowry Deaths,Female,13-17,850,678,172,715,135
2010,Urban,Maharashtra,Property Crime,Burglary,Female,18-30,1626,1177,449,1487,139
2008,Rural,Manipur,Other Crimes,Cyber Crime,Male,0-12,8284,3663,4621,6074,2210
2005,Rural,Jharkhand,Crime Against Men,Robbery,Female,18-30,2713,2421,292,2485,228
2007,Urban,Punjab,Crime Against Men,Robbery,Male,13-17,3837,2600,1237,3292,545
2001,Urban,Jharkhand,Property Crime,Vandalism,Female,46-60,2243,927,1316,2179,64
2001,Urban,Jammu & Kashmir,Crime Against Men,Murder,Male,18-30,639,147,492,588,51
2006,Urban,Odisha,Crime Against Men,Assault,Female,46-60,6947,5535,1412,6066,881
2001,Urban,Tripura,Property Crime,Arson,Female,31-45,6541,3513,3028,5999,542
2006,Urban,Tamil Nadu,Crime Against Men,Murder,Female,13-17,258,44,214,246,12
2007,Urban,Manipur,Other Crimes,Cyber Crime,Male,31-45,8606,235,8371,4759,3847
2010,Rural,Odisha,Crime Against Men,Assault,Male,0-12,6262,2937,3325,4490,1772
2005,Rural,Chhattisgarh,Crime Against Men,Assault,Male,46-60,1880,762,1118,1737,143
2004,Urban,Mizoram,Crime Against Men,Assault,Female,13-17,9964,6389,3575,6955,3009
2009,Urban,Uttarakhand,Property Crime,Vandalism,Male,31-45,7079,1189,5890,6339,740
2007,Rural,Tripura,Crime Against Men,Assault,Female,60+,8948,6392,2556,6453,2495
2003,Urban,Punjab,Crime Against Men,Assault,Female,18-30,3578,1801,1777,2389,1189
2001,Urban,Uttar Pradesh,Crime Against Children,Child Labor,Male,46-60,4389,2019,2370,3542,847
2005,Rural,Mizoram,Crime Against Women,Molestation,Female,60+,1520,1233,287,1341,179
2006,Rural,Karnataka,Crime Against Women,Molestation,Male,60+,7921,6936,985,7182,739
2001,Rural,Assam,Crime Against Men,Murder,Female,13-17,3055,2114,941,2705,350
2007,Urban,Meghalaya,Property Crime,Theft,Female,0-12,119,57,62,69,50
2007,Urban,Chhattisgarh,Crime Against Women,Dowry Deaths,Female,46-60,9416,261,9155,2988,6428
2009,Urban,Goa,Crime Against Women,Dowry Deaths,Male,60+,6063,5276,787,5779,284
2007,Rural,Gujarat,Other Crimes,Drug Offense,Male,46-60,7259,3378,3881,5456,1803
2004,Rural,Telangana,Property Crime,Vandalism,Female,0-12,4142,2297,1845,2885,1257
2009,Rural,Jammu & Kashmir,Other Crimes,Fraud,Male,18-30,8571,1393,7178,5397,3174
2002,Rural,Rajasthan,Property Crime,Arson,Male,46-60,7626,3633,3993,7245,381
2010,Rural,Arunachal Pradesh,Other Crimes,Cyber Crime,Male,13-17,431,310,121,392,39
2001,Urban,Uttarakhand,Property Crime,Burglary,Female,60+,1123,927,196,1117,6
2002,Rural,Nagaland,Crime Against Women,Domestic Violence,Female,31-45,9328,2196,7132,2650,6678
2006,Rural,Uttar Pradesh,Crime Against Women,Domestic Violence,Male,13-17,411,89,322,341,70
2009,Rural,Bihar,Property Crime,Vandalism,Female,18-30,2030,707,1323,752,1278
2001,Rural,Mizoram,Crime Against Men,Robbery,Female,31-45,6064,2152,3912,3649,2415
2003,Rural,Maharashtra,Crime Against Men,Murder,Female,46-60,1756,1565,191,1567,189
2001,Rural,Assam,Crime Against Women,Rape,Female,0-12,8577,6315,2262,7901,676
2005,Rural,Jammu & Kashmir,Crime Against Men,Murder,Male,13-17,311,43,268,49,262
2007,Urban,Punjab,Crime Against Women,Dowry Deaths,Female,31-45,2200,464,1736,1520,680
2001,Rural,Sikkim,Crime Against Children,Trafficking,Female,60+,5967,2379,3588,2983,2984
2006,Rural,Kerala,Crime Against Men,Assault,Female,13-17,9100,5736,3364,6199,2901
2010,Rural,Maharashtra,Crime Against Children,Child Abuse,Male,18-30,5369,2157,3212,4516,853
2007,Rural,Uttarakhand,Crime Against Men,Extortion,Female,46-60,1654,126,1528,1634,20
2003,Urban,Nagaland,Crime Against Children,Child Labor,Male,60+,5856,1368,4488,5283,573
2001,Rural,Tripura,Crime Against Children,Child Labor,Female,46-60,1424,30,1394,811,613
2006,Rural,Jharkhand,Crime Against Women,Dowry Deaths,Female,13-17,9043,1988,7055,4812,4231
2005,Rural,Manipur,Property Crime,Vandalism,Female,60+,151,88,63,140,11
2009,Urban,Uttarakhand,Crime Against Men,Murder,Female,31-45,1795,1520,275,1532,263
2002,Urban,Maharashtra,Crime Against Women,Domestic Violence,Male,46-60,137,106,31,133,4
2010,Rural,Maharashtra,Crime Against Children,Child Abuse,Male,31-45,8786,2303,6483,3969,4817
2010,Urban,Odisha,Crime Against Children,Kidnapping,Female,60+,7513,6640,873,7178,335
2005,Urban,West Bengal,Other Crimes,Cyber Crime,Female,46-60,4869,3327,1542,3440,1429
2005,Rural,Karnataka,Property Crime,Arson,Female,46-60,8804,5832,2972,6165,2639
2002,Urban,Himachal Pradesh,Property Crime,Burglary,Male,0-12,7020,1596,5424,6949,71
2010,Rural,Karnataka,Other Crimes,Drug Offense,Female,46-60,6162,603,5559,3495,2667
2004,Urban,Haryana,Crime Against Children,Trafficking,Male,18-30,9367,283,9084,5441,3926
2006,Rural,Andhra Pradesh,Crime Against Children,Child Labor,Male,31-45,1933,357,1576,451,1482
2009,Urban,Tripura,Other Crimes,Fraud,Male,60+,492,315,177,388,104
2009,Rural,Rajasthan,Crime Against Children,Trafficking,Female,31-45,280,41,239,83,197
2006,Urban,Kerala,Crime Against Men,Robbery,Female,46-60,8331,70,8261,3775,4556
2009,Urban,Chhattisgarh,Crime Against Children,Kidnapping,Female,31-45,8247,3874,4373,5728,2519
2010,Urban,Arunachal Pradesh,Other Crimes,Cyber Crime,Female,31-45,2289,1037,1252,2239,50
2007,Rural,Jammu & Kashmir,Crime Against Children,Kidnapping,Male,0-12,1260,227,1033,672,588
2003,Urban,Assam,Property Crime,Theft,Female,18-30,356,128,228,281,75
2008,Urban,Odisha,Crime Against Children,Kidnapping,Female,46-60,4229,270,3959,3910,319
2005,Urban,Rajasthan,Crime Against Women,Rape,Female,0-12,8250,3733,4517,4523,3727
2003,Urban,Kerala,Property Crime,Theft,Male,13-17,9562,5948,3614,7295,2267
2004,Urban,Maharashtra,Crime Against Children,Child Abuse,Female,60+,1859,218,1641,1851,8
2003,Rural,Maharashtra,Crime Against Men,Assault,Female,0-12,4498,1537,2961,2355,2143
2003,Urban,Andhra Pradesh,Other Crimes,Fraud,Male,46-60,1430,532,898,966,464
2006,Rural,Meghalaya,Crime Against Children,Child Abuse,Male,46-60,9266,8244,1022,8651,615
2009,Rural,Rajasthan,Crime Against Men,Robbery,Male,31-45,2392,1477,915,1824,568
2005,Urban,Chhattisgarh,Crime Against Women,Rape,Female,31-45,6890,3836,3054,4116,2774
2008,Urban,Manipur,Crime Against Women,Dowry Deaths,Female,0-12,4874,751,4123,4488,386
2005,Rural,Nagaland,Crime Against Women,Molestation,Female,31-45,6976,1923,5053,3411,3565
2002,Urban,Uttarakhand,Property Crime,Theft,Male,13-17,9916,621,9295,3856,6060
2006,Urban,Bihar,Crime Against Children,Kidnapping,Male,0-12,9682,86,9596,2330,7352
2002,Urban,Bihar,Property Crime,Theft,Male,0-12,5466,4780,686,4901,565
2004,Urban,Telangana,Crime Against Women,Molestation,Female,18-30,9446,4359,5087,5461,3985
2005,Rural,Jammu & Kashmir,Crime Against Children,Trafficking,Male,46-60,5635,2191,3444,2723,2912
2006,Urban,Tamil Nadu,Crime Against Women,Molestation,Female,60+,4618,2253,2365,4558,60
2004,Rural,Bihar,Property Crime,Burglary,Male,60+,527,297,230,423,104
2007,Urban,Meghalaya,Crime Against Women,Dowry Deaths,Female,31-45,3043,1080,1963,1501,1542
2001,Urban,Uttarakhand,Crime Against Women,Dowry Deaths,Female,31-45,7266,880,6386,5219,2047
2005,Urban,Himachal Pradesh,Other Crimes,Fraud,Male,31-45,7592,6662,930,7411,181
2004,Rural,Uttar Pradesh,Property Crime,Vandalism,Male,0-12,9184,7713,1471,7888,1296
2005,Urban,Jharkhand,Crime Against Men,Extortion,Male,31-45,2814,984,1830,1914,900
2010,Rural,Madhya Pradesh,Other Crimes,Corruption,Female,18-30,4613,114,4499,1707,2906
2003,Rural,Maharashtra,Crime Against Men,Assault,Female,31-45,9084,4620,4464,7959,1125
2004,Urban,Telangana,Property Crime,Arson,Male,60+,732,663,69,704,28
2004,Urban,Bihar,Other Crimes,Cyber Crime,Female,46-60,9847,9318,529,9833,14
2006,Urban,Karnataka,Property Crime,Burglary,Male,18-30,3532,3003,529,3115,417
2001,Rural,Arunachal Pradesh,Crime Against Men,Murder,Male,60+,8285,4840,3445,7303,982
2009,Urban,Andhra Pradesh,Other Crimes,Corruption,Female,60+,5691,2091,3600,5520,171
2003,Rural,Odisha,Crime Against Women,Rape,Male,0-12,8543,3982,4561,5050,3493
2008,Urban,Punjab,Crime Against Children,Child Abuse,Male,13-17,968,812,156,821,147
2008,Urban,Jharkhand,Property Crime,Theft,Female,18-30,8834,384,8450,3917,4917
2008,Rural,Chhattisgarh,Other Crimes,Cyber Crime,Female,60+,1417,1093,324,1390,27
2007,Rural,Mizoram,Crime Against Children,Child Labor,Female,0-12,9731,5184,4547,7462,2269
2010,Rural,Karnataka,Other Crimes,Cyber Crime,Female,18-30,7175,7144,31,7173,2
2005,Rural,Sikkim,Crime Against Children,Kidnapping,Female,18-30,4258,1599,2659,4163,95
2010,Urban,Madhya Pradesh,Other Crimes,Fraud,Male,46-60,2238,1532,706,2208,30
2002,Urban,Delhi,Property Crime,Theft,Female,13-17,7686,6503,1183,7598,88
2001,Urban,West Bengal,Property Crime,Burglary,Male,46-60,369,320,49,330,39
2005,Urban,Maharashtra,Property Crime,Burglary,Female,60+,245,178,67,215,30
2001,Rural,Sikkim,Crime Against Men,Assault,Male,31-45,98,65,33,84,14
2005,Urban,Uttar Pradesh,Crime Against Men,Robbery,Male,0-12,777,53,724,714,63
2010,Rural,Odisha,Other Crimes,Corruption,Male,18-30,4297,3137,1160,3681,616
2008,Rural,Punjab,Crime Against Men,Robbery,Female,46-60,4709,2458,2251,3653,1056
2003,Rural,Andhra Pradesh,Other Crimes,Fraud,Male,0-12,8848,1603,7245,5228,3620
2009,Urban,Uttar Pradesh,Crime Against Women,Molestation,Female,60+,6418,2119,4299,2740,3678
2002,Urban,Maharashtra,Other Crimes,Fraud,Male,18-30,5654,3632,2022,3844,1810
2007,Urban,Delhi,Crime Against Women,Domestic Violence,Female,31-45,7962,3830,4132,4031,3931
2010,Urban,Jammu & Kashmir,Crime Against Women,Molestation,Female,18-30,6521,4790,1731,5688,833
2004,Rural,Kerala,Other Crimes,Fraud,Female,46-60,6192,4249,1943,5561,631
2006,Rural,Jharkhand,Crime Against Men,Assault,Male,18-30,7961,7193,768,7348,613
2001,Rural,Odisha,Property Crime,Vandalism,Female,31-45,2456,2414,42,2417,39
2008,Urban,Telangana,Crime Against Men,Extortion,Female,13-17,7864,3737,4127,6534,1330
2001,Urban,Jammu & Kashmir,Crime Against Women,Domestic Violence,Male,60+,2187,1242,945,1909,278
2006,Urban,Jammu & Kashmir,Property Crime,Arson,Male,31-45,970,67,903,177,793
2004,Urban,Delhi,Property Crime,Burglary,Male,18-30,3083,162,2921,2316,767
2004,Rural,Maharashtra,Crime Against Children,Kidnapping,Male,0-12,9550,5342,4208,7658,1892
2005,Urban,Meghalaya,Crime Against Children,Kidnapping,Male,18-30,5025,2294,2731,2564,2461
2003,Rural,Andhra Pradesh,Property Crime,Theft,Female,31-45,6038,2164,3874,4702,1336
2006,Rural,Goa,Crime Against Women,Dowry Deaths,Female,46-60,7847,4817,3030,6157,1690
2005,Rural,Karnataka,Other Crimes,Corruption,Male,13-17,7084,6773,311,7077,7
2006,Rural,Odisha,Property Crime,Vandalism,Female,18-30,1245,854,391,994,251
2006,Urban,Telangana,Crime Against Women,Domestic Violence,Female,31-45,5716,4733,983,5466,250
2009,Urban,Haryana,Other Crimes,Fraud,Female,13-17,5227,2240,2987,2956,2271
2004,Urban,Tamil Nadu,Crime Against Children,Child Labor,Female,46-60,9907,68,9839,5735,4172
2001,Rural,Uttar Pradesh,Crime Against Children,Child Labor,Male,31-45,6997,6093,904,6816,181
2006,Rural,West Bengal,Crime Against Children,Kidnapping,Female,60+,4961,3140,1821,4516,445
2002,Rural,Goa,Crime Against Women,Domestic Violence,Female,18-30,2061,55,2006,313,1748
2006,Urban,Tamil Nadu,Crime Against Men,Extortion,Male,13-17,2918,2361,557,2889,29
2007,Urban,Manipur,Crime Against Men,Robbery,Female,46-60,2098,1713,385,1977,121
2006,Rural,Punjab,Crime Against Men,Murder,Female,31-45,4176,283,3893,1417,2759
2010,Urban,Telangana,Crime Against Children,Child Labor,Male,60+,6210,1934,4276,3846,2364
2010,Rural,Gujarat,Property Crime,Theft,Male,46-60,5329,1059,4270,1729,3600
2001,Urban,Uttar Pradesh,Property Crime,Burglary,Female,46-60,8647,1701,6946,7977,670
2003,Urban,Odisha,Crime Against Children,Child Abuse,Female,13-17,8402,7114,1288,7758,644
2010,Rural,Manipur,Crime Against Men,Murder,Male,60+,6112,196,5916,4444,1668
2003,Rural,West Bengal,Crime Against Children,Child Abuse,Male,18-30,5205,2193,3012,3931,1274
2010,Urban,Madhya Pradesh,Other Crimes,Fraud,Male,46-60,4853,142,4711,3107,1746
2005,Urban,Odisha,Other Crimes,Drug Offense,Male,18-30,4264,2612,1652,2865,1399
2003,Rural,Madhya Pradesh,Property Crime,Arson,Female,0-12,6670,3653,3017,6666,4
2009,Urban,Nagaland,Crime Against Men,Extortion,Female,0-12,6651,271,6380,5317,1334
2002,Rural,Karnataka,Other Crimes,Cyber Crime,Male,0-12,3258,1438,1820,1860,1398
2001,Urban,Manipur,Property Crime,Vandalism,Male,60+,9246,7134,2112,9122,124
2004,Rural,Bihar,Property Crime,Vandalism,Female,60+,265,53,212,182,83
2003,Urban,Sikkim,Crime Against Men,Murder,Female,60+,2460,1759,701,1908,552
2002,Rural,Tripura,Crime Against Men,Extortion,Male,31-45,4419,3241,1178,4072,347
2007,Urban,Chhattisgarh,Crime Against Women,Dowry Deaths,Female,31-45,9339,1624,7715,8436,903
2002,Rural,Arunachal Pradesh,Other Crimes,Drug Offense,Female,13-17,1235,1021,214,1140,95
2007,Rural,Sikkim,Crime Against Men,Assault,Male,46-60,121,26,95,73,48
2003,Urban,Karnataka,Crime Against Men,Extortion,Male,18-30,1288,805,483,1219,69
2008,Rural,Punjab,Crime Against Children,Child Abuse,Female,46-60,2054,1410,644,1631,423
2006,Rural,Odisha,Other Crimes,Drug Offense,Female,13-17,3039,178,2861,616,2423
2006,Rural,Manipur,Crime Against Men,Extortion,Male,46-60,2931,2416,515,2440,491
2002,Rural,Gujarat,Crime Against Women,Dowry Deaths,Female,60+,5993,5776,217,5899,94
2010,Urban,Assam,Property Crime,Arson,Female,13-17,3512,704,2808,2694,818
2010,Rural,Telangana,Crime Against Children,Child Abuse,Male,18-30,469,78,391,270,199
2001,Urban,Uttarakhand,Crime Against Women,Domestic Violence,Female,46-60,677,41,636,363,314
2010,Rural,Sikkim,Crime Against Women,Molestation,Male,13-17,4383,2833,1550,3854,529
2006,Rural,Tripura,Crime Against Women,Rape,Female,60+,6099,2289,3810,2463,3636
2002,Rural,Delhi,Crime Against Men,Murder,Male,31-45,9535,6176,3359,9389,146
2005,Rural,Andhra Pradesh,Crime Against Children,Trafficking,Female,31-45,1129,37,1092,900,229
2008,Urban,Arunachal Pradesh,Crime Against Children,Kidnapping,Female,18-30,3458,333,3125,2839,619
2007,Rural,Jammu & Kashmir,Crime Against Children,Child Labor,Female,31-45,3040,2537,503,2959,81
2008,Rural,Odisha,Other Crimes,Fraud,Female,18-30,6914,5379,1535,6650,264
2005,Rural,Jammu & Kashmir,Crime Against Men,Murder,Female,46-60,8295,6136,2159,7145,1150
2009,Rural,Jharkhand,Crime Against Women,Domestic Violence,Male,13-17,6447,561,5886,799,5648
2010,Rural,Kerala,Crime Against Children,Trafficking,Male,31-45,9388,6086,3302,7981,1407
2006,Rural,Telangana,Crime Against Children,Child Labor,Male,0-12,1520,1350,170,1423,97
2003,Urban,Uttar Pradesh,Crime Against Women,Dowry Deaths,Male,13-17,5092,4718,374,4853,239
2004,Rural,Uttar Pradesh,Crime Against Children,Child Abuse,Female,13-17,2224,2155,69,2186,38
2010,Rural,Himachal Pradesh,Crime Against Women,Domestic Violence,Female,31-45,6477,4870,1607,6163,314
2007,Rural,Karnataka,Crime Against Men,Extortion,Male,13-17,9968,7537,2431,8409,1559
2006,Rural,Nagaland,Property Crime,Burglary,Female,0-12,7165,3977,3188,5632,1533
2001,Rural,Odisha,Crime Against Men,Extortion,Female,31-45,7621,6356,1265,7365,256
2003,Urban,Assam,Crime Against Women,Rape,Female,0-12,9557,873,8684,8508,1049
2009,Urban,Tripura,Crime Against Children,Child Abuse,Male,60+,924,192,732,654,270
2006,Urban,Haryana,Other Crimes,Drug Offense,Female,18-30,5507,1262,4245,1338,4169
2010,Urban,Haryana,Other Crimes,Corruption,Female,60+,3414,235,3179,3062,352
2006,Rural,Haryana,Other Crimes,Corruption,Female,0-12,5655,901,4754,1752,3903
2003,Urban,Punjab,Crime Against Children,Trafficking,Female,13-17,9043,5427,3616,5538,3505
2008,Urban,Manipur,Crime Against Women,Rape,Female,60+,8755,768,7987,3686,5069
2008,Urban,Goa,Crime Against Men,Robbery,Female,0-12,2473,1694,779,2370,103
2004,Urban,Uttar Pradesh,Crime Against Men,Extortion,Male,31-45,7430,1468,5962,7393,37
2006,Urban,Odisha,Crime Against Men,Assault,Male,0-12,1629,1455,174,1464,165
2001,Urban,Uttar Pradesh,Other Crimes,Fraud,Male,60+,4944,1726,3218,3861,1083
2008,Rural,Rajasthan,Crime Against Men,Assault,Male,60+,3983,2954,1029,3555,428
2003,Urban,Odisha,Crime Against Women,Dowry Deaths,Male,18-30,8058,2768,5290,7411,647
2010,Urban,Kerala,Crime Against Women,Domestic Violence,Female,31-45,2094,128,1966,1541,553
2001,Urban,West Bengal,Property Crime,Arson,Female,60+,8004,704,7300,4035,3969
2005,Rural,Bihar,Crime Against Women,Dowry Deaths,Male,31-45,1145,978,167,1014,131
2006,Urban,Goa,Property Crime,Arson,Male,60+,7160,451,6709,3376,3784
2007,Urban,Maharashtra,Crime Against Men,Assault,Male,18-30,8758,1714,7044,7112,1646
2010,Rural,Haryana,Other Crimes,Drug Offense,Female,13-17,8076,4249,3827,5941,2135
2004,Urban,Tamil Nadu,Crime Against Women,Dowry Deaths,Female,13-17,7466,6810,656,6974,492
2003,Rural,Punjab,Crime Against Children,Child Abuse,Male,60+,5279,325,4954,1138,4141
2007,Urban,Jammu & Kashmir,Property Crime,Theft,Female,60+,4788,1238,3550,4486,302
2009,Rural,Punjab,Property Crime,Arson,Male,60+,9256,3345,5911,7955,1301
2001,Urban,Uttarakhand,Crime Against Children,Kidnapping,Female,18-30,9302,3082,6220,5358,3944
2006,Rural,Kerala,Crime Against Women,Rape,Male,0-12,9623,9426,197,9518,105
2010,Urban,Goa,Property Crime,Burglary,Female,18-30,9552,4555,4997,6697,2855
2010,Urban,Rajasthan,Crime Against Women,Dowry Deaths,Female,31-45,8601,25,8576,8285,316
2006,Rural,Arunachal Pradesh,Crime Against Men,Robbery,Male,31-45,8235,2403,5832,7395,840
2005,Urban,Arunachal Pradesh,Crime Against Men,Robbery,Female,18-30,6335,665,5670,4166,2169
2009,Rural,Tamil Nadu,Crime Against Children,Trafficking,Male,0-12,3229,652,2577,1420,1809
2003,Urban,Arunachal Pradesh,Crime Against Children,Child Labor,Male,0-12,3288,1554,1734,1712,1576
2002,Urban,Delhi,Property Crime,Theft,Male,46-60,3508,3493,15,3499,9
2001,Rural,Bihar,Other Crimes,Fraud,Male,60+,7312,5973,1339,6704,608
2002,Urban,Haryana,Other Crimes,Corruption,Female,46-60,5062,4710,352,5001,61
2004,Rural,Maharashtra,Crime Against Women,Molestation,Male,31-45,6922,5788,1134,6273,649
2006,Urban,Assam,Crime Against Children,Child Abuse,Male,31-45,759,326,433,724,35
2009,Rural,Karnataka,Crime Against Men,Extortion,Female,18-30,2051,465,1586,1223,828
2002,Urban,Delhi,Crime Against Children,Trafficking,Female,18-30,8855,4837,4018,8715,140
2008,Rural,Karnataka,Property Crime,Vandalism,Male,13-17,2147,300,1847,971,1176
2006,Urban,Tripura,Crime Against Men,Extortion,Female,0-12,6761,929,5832,4299,2462
2010,Rural,Maharashtra,Crime Against Children,Trafficking,Male,60+,6025,531,5494,1908,4117
2010,Urban,Karnataka,Other Crimes,Cyber Crime,Male,0-12,7944,3441,4503,7833,111
2001,Urban,Rajasthan,Property Crime,Arson,Female,31-45,8348,3297,5051,5712,2636
2003,Urban,Mizoram,Crime Against Men,Assault,Male,13-17,8708,1984,6724,3448,5260
2009,Rural,Nagaland,Crime Against Children,Kidnapping,Female,46-60,6834,5608,1226,6045,789
2006,Urban,Andhra Pradesh,Other Crimes,Corruption,Female,0-12,5771,2468,3303,4057,1714
2007,Urban,Tamil Nadu,Crime Against Children,Child Labor,Male,0-12,2078,332,1746,598,1480
2010,Urban,Gujarat,Property Crime,Vandalism,Male,46-60,8852,4481,4371,7232,1620
2010,Rural,Delhi,Crime Against Children,Kidnapping,Female,13-17,64,23,41,30,34
2009,Urban,Goa,Crime Against Children,Trafficking,Female,18-30,5472,1791,3681,2413,3059
2006,Urban,Tamil Nadu,Crime Against Men,Robbery,Female,31-45,4941,4422,519,4511,430
2007,Rural,Arunachal Pradesh,Crime Against Men,Assault,Male,18-30,6990,3018,3972,3378,3612
2007,Rural,Mizoram,Property Crime,Burglary,Male,13-17,2102,334,1768,1587,515
2007,Urban,Arunachal Pradesh,Property Crime,Arson,Female,31-45,4722,539,4183,2280,2442
2004,Rural,Himachal Pradesh,Crime Against Children,Kidnapping,Female,46-60,7878,6516,1362,7273,605
2005,Rural,Meghalaya,Crime Against Men,Murder,Female,13-17,4869,2368,2501,4246,623
2005,Rural,Assam,Crime Against Women,Molestation,Male,18-30,6580,6338,242,6381,199
2010,Urban,Mizoram,Crime Against Children,Child Abuse,Male,31-45,6781,454,6327,4227,2554
2008,Rural,Telangana,Crime Against Children,Kidnapping,Female,13-17,6478,3819,2659,3964,2514
2004,Rural,Odisha,Other Crimes,Corruption,Female,46-60,9638,3600,6038,9347,291
2006,Rural,Meghalaya,Crime Against Women,Dowry Deaths,Male,31-45,6684,5896,788,6187,497
2009,Rural,Kerala,Other Crimes,Cyber Crime,Male,13-17,9121,4885,4236,5780,3341
2001,Urban,Manipur,Property Crime,Theft,Female,13-17,1599,310,1289,1158,441
2009,Rural,Telangana,Crime Against Women,Dowry Deaths,Male,18-30,2451,1248,1203,2269,182
2001,Urban,Rajasthan,Property Crime,Vandalism,Male,31-45,8688,6458,2230,6650,2038
2010,Rural,Telangana,Property Crime,Vandalism,Male,13-17,3059,3033,26,3059,0
2004,Rural,Assam,Crime Against Men,Robbery,Male,0-12,260,148,112,173,87
2002,Rural,Tripura,Other Crimes,Corruption,Male,0-12,8522,6805,1717,8438,84
2009,Rural,Arunachal Pradesh,Property Crime,Burglary,Male,46-60,7687,1598,6089,4973,2714
2006,Urban,Sikkim,Other Crimes,Fraud,Male,18-30,4173,3463,710,3487,686
2006,Rural,Mizoram,Other Crimes,Corruption,Male,0-12,7049,5721,1328,6332,717
2010,Urban,Goa,Other Crimes,Corruption,Male,31-45,2446,2238,208,2311,135
2003,Rural,Delhi,Other Crimes,Drug Offense,Female,0-12,2190,1221,969,1416,774
2004,Rural,Tamil Nadu,Crime Against Children,Trafficking,Male,0-12,8867,7049,1818,8256,611
2008,Rural,Odisha,Crime Against Children,Kidnapping,Male,60+,6452,325,6127,5244,1208
2001,Rural,Sikkim,Crime Against Women,Rape,Female,13-17,9611,9447,164,9578,33
2007,Urban,Nagaland,Crime Against Children,Child Labor,Male,18-30,7250,3919,3331,6220,1030
2004,Urban,Arunachal Pradesh,Property Crime,Burglary,Female,18-30,5713,840,4873,1260,4453
2006,Urban,Kerala,Crime Against Women,Domestic Violence,Male,31-45,572,452,120,556,16
2010,Urban,Arunachal Pradesh,Crime Against Men,Extortion,Male,0-12,2044,659,1385,1261,783
2006,Urban,Nagaland,Crime Against Men,Murder,Male,31-45,9526,9065,461,9518,8
2001,Rural,Sikkim,Other Crimes,Drug Offense,Male,46-60,6282,5409,873,5524,758
2009,Rural,Haryana,Other Crimes,Corruption,Male,18-30,7776,1313,6463,3837,3939
2005,Rural,Madhya Pradesh,Other Crimes,Corruption,Male,18-30,5508,3507,2001,4887,621
2005,Rural,Jharkhand,Other Crimes,Fraud,Male,0-12,3103,818,2285,1355,1748
2001,Rural,Goa,Crime Against Men,Assault,Female,0-12,735,108,627,505,230
2007,Rural,Uttarakhand,Other Crimes,Corruption,Female,18-30,7350,274,7076,1834,5516
2006,Urban,Goa,Crime Against Children,Child Labor,Male,13-17,1671,1557,114,1574,97
2005,Urban,Meghalaya,Crime Against Men,Murder,Female,31-45,5953,5360,593,5706,247
2009,Urban,Telangana,Crime Against Men,Extortion,Female,31-45,3531,104,3427,933,2598
2008,Urban,Delhi,Crime Against Women,Domestic Violence,Female,60+,5857,3443,2414,3873,1984
2005,Rural,Telangana,Other Crimes,Drug Offense,Male,46-60,1950,146,1804,1881,69
2001,Rural,Manipur,Crime Against Women,Domestic Violence,Female,60+,6800,5839,961,6341,459
2003,Rural,Meghalaya,Crime Against Women,Dowry Deaths,Female,13-17,608,382,226,500,108
2006,Rural,Punjab,Crime Against Men,Extortion,Male,31-45,9969,6881,3088,8568,1401
2004,Rural,Chhattisgarh,Other Crimes,Fraud,Female,60+,206,159,47,203,3
2005,Urban,Goa,Crime Against Men,Extortion,Female,31-45,7883,7639,244,7820,63
2004,Rural,Meghalaya,Crime Against Children,Kidnapping,Female,18-30,5027,3848,1179,4834,193
2001,Urban,Maharashtra,Property Crime,Burglary,Female,31-45,4152,2706,1446,3365,787
2010,Rural,Sikkim,Property Crime,Theft,Female,0-12,9128,7115,2013,8633,495
2004,Rural,Telangana,Crime Against Men,Extortion,Female,46-60,1289,181,1108,906,383
2001,Rural,Telangana,Property Crime,Burglary,Male,13-17,8264,7520,744,7779,485
2001,Rural,Assam,Crime Against Women,Rape,Female,0-12,190,31,159,106,84
2002,Rural,Andhra Pradesh,Crime Against Men,Extortion,Male,31-45,559,462,97,485,74
2004,Rural,Sikkim,Property Crime,Theft,Female,31-45,5348,2342,3006,4414,934
2009,Urban,Karnataka,Crime Against Children,Child Labor,Male,46-60,3273,2197,1076,2238,1035
2008,Rural,Madhya Pradesh,Crime Against Men,Extortion,Male,18-30,3747,1808,1939,2662,1085
2004,Urban,Odisha,Other Crimes,Fraud,Female,13-17,3900,2464,1436,3873,27
2004,Rural,Bihar,Crime Against Men,Extortion,Female,18-30,7878,3890,3988,6917,961
2005,Rural,West Bengal,Crime Against Women,Rape,Female,13-17,5460,3477,1983,4462,998
2004,Urban,Odisha,Crime Against Children,Trafficking,Female,46-60,762,587,175,749,13
2003,Urban,Uttarakhand,Crime Against Women,Domestic Violence,Female,60+,3154,2486,668,2902,252
2008,Urban,Arunachal Pradesh,Other Crimes,Corruption,Female,46-60,6160,6003,157,6146,14
2010,Urban,Kerala,Other Crimes,Cyber Crime,Female,46-60,6910,938,5972,6316,594
2010,Rural,Odisha,Crime Against Men,Assault,Female,18-30,6872,3271,3601,4928,1944
2006,Rural,Punjab,Crime Against Women,Rape,Male,31-45,9985,4148,5837,4859,5126
2009,Urban,Manipur,Other Crimes,Corruption,Male,0-12,9022,3801,5221,4115,4907
2003,Urban,Kerala,Crime Against Children,Kidnapping,Female,46-60,1764,27,1737,1557,207
2002,Rural,Uttarakhand,Other Crimes,Cyber Crime,Female,60+,992,846,146,876,116
2010,Urban,Goa,Crime Against Women,Molestation,Male,46-60,6903,4348,2555,4349,2554
2008,Rural,Himachal Pradesh,Crime Against Children,Trafficking,Male,0-12,5547,1472,4075,1803,3744
2002,Urban,Meghalaya,Property Crime,Arson,Male,31-45,8009,4717,3292,5813,2196
2010,Urban,Himachal Pradesh,Crime Against Children,Child Labor,Female,13-17,3716,1122,2594,1664,2052
2004,Rural,Odisha,Other Crimes,Fraud,Male,60+,4459,2172,2287,2393,2066
2004,Urban,Assam,Crime Against Men,Assault,Male,31-45,778,675,103,706,72
2006,Urban,Nagaland,Crime Against Men,Extortion,Male,60+,1985,1122,863,1581,404
2002,Urban,Manipur,Property Crime,Vandalism,Female,13-17,1896,240,1656,1717,179
2006,Rural,Punjab,Other Crimes,Corruption,Male,13-17,6853,794,6059,3137,3716
2010,Urban,Kerala,Other Crimes,Drug Offense,Female,0-12,9395,1406,7989,1729,7666
2005,Urban,Meghalaya,Crime Against Men,Murder,Female,18-30,9615,806,8809,6514,3101
2005,Rural,Tamil Nadu,Crime Against Children,Kidnapping,Female,46-60,969,454,515,600,369
2005,Urban,Mizoram,Crime Against Women,Molestation,Female,31-45,395,6,389,45,350
2002,Rural,Nagaland,Crime Against Women,Domestic Violence,Male,31-45,9535,1934,7601,4794,4741
2004,Urban,Kerala,Crime Against Men,Murder,Male,13-17,7238,187,7051,1119,6119
2001,Urban,Assam,Crime Against Women,Dowry Deaths,Female,46-60,7728,1866,5862,2345,5383
2009,Urban,Tamil Nadu,Crime Against Women,Dowry Deaths,Female,46-60,9621,4959,4662,8002,1619
2004,Rural,Jammu & Kashmir,Property Crime,Vandalism,Male,18-30,5739,5376,363,5637,102
2010,Urban,Andhra Pradesh,Crime Against Men,Extortion,Male,31-45,4082,114,3968,2564,1518
2003,Urban,Tamil Nadu,Other Crimes,Corruption,Female,13-17,4832,2168,2664,4688,144
2006,Rural,Jammu & Kashmir,Crime Against Children,Child Labor,Male,0-12,3076,2682,394,3000,76
2005,Urban,Punjab,Crime Against Children,Trafficking,Female,13-17,4324,1836,2488,3067,1257
2004,Urban,Odisha,Other Crimes,Fraud,Male,18-30,7024,3121,3903,5691,1333
2002,Urban,Madhya Pradesh,Crime Against Children,Trafficking,Male,31-45,311,192,119,221,90
2002,Rural,Telangana,Property Crime,Theft,Female,18-30,8507,4120,4387,4924,3583
2004,Rural,Kerala,Crime Against Men,Assault,Male,60+,3485,3417,68,3480,5
2008,Urban,Odisha,Crime Against Children,Child Labor,Female,31-45,7579,4880,2699,5722,1857
2003,Rural,Kerala,Property Crime,Arson,Female,46-60,4530,2458,2072,3455,1075
2005,Rural,Karnataka,Crime Against Women,Dowry Deaths,Male,60+,9242,2781,6461,5607,3635
2007,Urban,Tripura,Crime Against Children,Child Abuse,Male,31-45,2567,1387,1180,2473,94
2002,Rural,Punjab,Crime Against Men,Murder,Male,31-45,8029,2711,5318,4358,3671
2010,Rural,Odisha,Other Crimes,Corruption,Female,60+,1990,1601,389,1813,177
2010,Rural,Goa,Crime Against Women,Rape,Female,60+,5189,506,4683,3354,1835
2008,Urban,Punjab,Crime Against Women,Dowry Deaths,Male,46-60,7557,961,6596,4820,2737
2008,Rural,Mizoram,Property Crime,Burglary,Female,46-60,4133,3251,882,3651,482
2006,Urban,Assam,Other Crimes,Cyber Crime,Female,18-30,4308,28,4280,770,3538
2010,Urban,Rajasthan,Crime Against Women,Domestic Violence,Female,31-45,1243,915,328,1032,211
2009,Rural,Sikkim,Other Crimes,Fraud,Female,46-60,6111,4698,1413,5838,273
2010,Rural,Tamil Nadu,Crime Against Women,Domestic Violence,Female,13-17,384,120,264,171,213
2005,Rural,Chhattisgarh,Crime Against Children,Child Abuse,Male,60+,1375,222,1153,1374,1
2007,Urban,Rajasthan,Crime Against Women,Rape,Male,13-17,870,50,820,603,267
2003,Rural,Assam,Other Crimes,Fraud,Female,0-12,1697,408,1289,641,1056
2002,Urban,Gujarat,Crime Against Men,Assault,Male,31-45,1644,1403,241,1553,91
2007,Rural,Sikkim,Crime Against Men,Assault,Female,18-30,7235,1943,5292,5650,1585
2008,Rural,Tamil Nadu,Crime Against Men,Assault,Female,31-45,5235,100,5135,4634,601
2010,Rural,Punjab,Other Crimes,Fraud,Male,60+,2935,2150,785,2445,490
2003,Rural,Andhra Pradesh,Crime Against Women,Molestation,Female,13-17,8561,1831,6730,4404,4157
2003,Urban,Karnataka,Property Crime,Arson,Male,60+,1003,817,186,994,9
2006,Rural,Uttarakhand,Crime Against Women,Rape,Female,13-17,819,693,126,801,18
2002,Rural,Sikkim,Crime Against Women,Rape,Female,0-12,6863,2770,4093,6559,304
2003,Urban,Manipur,Property Crime,Theft,Male,13-17,3332,2468,864,3193,139
2008,Urban,Haryana,Crime Against Women,Domestic Violence,Male,60+,6035,4445,1590,4796,1239
2002,Urban,Telangana,Property Crime,Theft,Female,18-30,2263,1627,636,2230,33
2009,Urban,Maharashtra,Crime Against Children,Child Abuse,Male,13-17,4619,3357,1262,3604,1015
2005,Urban,Telangana,Crime Against Men,Extortion,Male,18-30,5627,173,5454,3420,2207
2008,Rural,Arunachal Pradesh,Crime Against Children,Child Labor,Male,18-30,4444,1833,2611,3425,1019
2007,Rural,Manipur,Crime Against Men,Assault,Male,0-12,9803,3614,6189,3740,6063
2008,Rural,Nagaland,Crime Against Children,Child Labor,Male,13-17,9669,4840,4829,7700,1969
2003,Urban,Maharashtra,Crime Against Children,Child Labor,Male,60+,4004,3245,759,3954,50
2005,Rural,Chhattisgarh,Crime Against Women,Domestic Violence,Male,60+,2316,1622,694,2249,67
2010,Urban,Gujarat,Crime Against Children,Child Abuse,Male,46-60,9772,8685,1087,9717,55
2005,Urban,Haryana,Other Crimes,Corruption,Male,0-12,2713,2391,322,2688,25
2006,Rural,Rajasthan,Crime Against Women,Molestation,Female,13-17,8768,6743,2025,8530,238
2010,Urban,Goa,Crime Against Children,Trafficking,Male,60+,8731,8134,597,8653,78
2003,Rural,Uttar Pradesh,Property Crime,Arson,Male,0-12,566,194,372,222,344
2007,Urban,Punjab,Crime Against Children,Kidnapping,Male,46-60,5460,3560,1900,4868,592
2004,Urban,West Bengal,Crime Against Men,Assault,Female,31-45,2399,1140,1259,1626,773
2003,Rural,Uttar Pradesh,Property Crime,Burglary,Male,60+,101,5,96,67,34
2003,Urban,Haryana,Crime Against Women,Molestation,Female,46-60,5033,756,4277,3287,1746
2001,Rural,Jammu & Kashmir,Crime Against Women,Molestation,Male,18-30,8171,7288,883,7848,323
2002,Urban,Punjab,Crime Against Women,Dowry Deaths,Male,46-60,1584,446,1138,1568,16
2008,Rural,Tripura,Other Crimes,Drug Offense,Male,18-30,3699,1977,1722,2682,1017
2003,Rural,Odisha,Crime Against Men,Assault,Female,31-45,7743,5976,1767,6925,818
2008,Rural,Haryana,Crime Against Men,Extortion,Male,18-30,2186,2063,123,2068,118
2006,Rural,Madhya Pradesh,Crime Against Men,Extortion,Male,31-45,5486,1915,3571,3161,2325
2009,Rural,Meghalaya,Property Crime,Vandalism,Male,18-30,2643,997,1646,2173,470
2005,Rural,Punjab,Crime Against Men,Robbery,Male,31-45,692,248,444,607,85
2003,Rural,Uttarakhand,Crime Against Women,Rape,Female,31-45,3954,2672,1282,3150,804
2008,Rural,Rajasthan,Crime Against Men,Murder,Male,46-60,1935,1678,257,1770,165
2008,Rural,Telangana,Crime Against Women,Domestic Violence,Female,60+,5309,0,5309,5259,50
2010,Rural,Bihar,Crime Against Men,Extortion,Female,13-17,8610,1581,7029,5335,3275
2009,Rural,Odisha,Other Crimes,Corruption,Male,60+,3778,3033,745,3520,258
2002,Rural,Assam,Other Crimes,Corruption,Female,46-60,7502,419,7083,1965,5537
2007,Urban,Gujarat,Crime Against Children,Kidnapping,Male,46-60,1832,346,1486,950,882
2001,Rural,Jammu & Kashmir,Crime Against Women,Dowry Deaths,Female,31-45,4404,1819,2585,2227,2177
2004,Rural,Himachal Pradesh,Crime Against Men,Assault,Female,60+,8297,818,7479,4006,4291
2002,Urban,Punjab,Crime Against Women,Domestic Violence,Female,0-12,2375,916,1459,2257,118
2005,Urban,Chhattisgarh,Other Crimes,Cyber Crime,Female,0-12,102,79,23,93,9
2002,Rural,Assam,Property Crime,Vandalism,Male,18-30,4046,419,3627,1827,2219
2004,Urban,Arunachal Pradesh,Other Crimes,Fraud,Male,31-45,6189,2422,3767,5169,1020
2005,Rural,Haryana,Crime Against Children,Kidnapping,Female,60+,3944,911,3033,2215,1729
2005,Urban,Madhya Pradesh,Crime Against Women,Domestic Violence,Male,31-45,3212,2585,627,3006,206
2009,Rural,Delhi,Crime Against Men,Murder,Male,46-60,1050,361,689,902,148
2006,Rural,Arunachal Pradesh,Crime Against Children,Child Labor,Female,31-45,6266,2076,4190,5800,466
2010,Rural,Goa,Crime Against Women,Dowry Deaths,Male,0-12,2345,605,1740,1412,933
2010,Rural,Haryana,Other Crimes,Drug Offense,Female,60+,5234,812,4422,2735,2499
2001,Rural,Uttar Pradesh,Crime Against Women,Molestation,Male,0-12,230,134,96,173,57
2009,Urban,Tripura,Other Crimes,Corruption,Female,0-12,748,497,251,542,206
2001,Urban,Himachal Pradesh,Other Crimes,Cyber Crime,Male,18-30,1923,1889,34,1902,21
2001,Rural,Andhra Pradesh,Property Crime,Arson,Female,46-60,6875,3653,3222,5991,884
2004,Urban,Meghalaya,Crime Against Men,Robbery,Male,46-60,9457,3451,6006,6124,3333
2007,Urban,Uttarakhand,Crime Against Women,Rape,Male,60+,5556,3793,1763,4799,757
2005,Urban,Bihar,Other Crimes,Corruption,Male,46-60,1632,1092,540,1387,245
2005,Rural,Haryana,Property Crime,Vandalism,Female,13-17,3039,112,2927,1357,1682
2005,Rural,Mizoram,Crime Against Children,Kidnapping,Male,46-60,218,79,139,101,117
2007,Rural,Andhra Pradesh,Other Crimes,Corruption,Male,18-30,9072,8222,850,8677,395
2005,Urban,Manipur,Property Crime,Burglary,Female,46-60,4396,2810,1586,3583,813
2001,Urban,Jharkhand,Property Crime,Vandalism,Female,31-45,1057,1021,36,1055,2
2009,Rural,Tamil Nadu,Property Crime,Arson,Male,18-30,8629,6915,1714,8579,50
2008,Urban,Meghalaya,Other Crimes,Drug Offense,Male,0-12,8118,2596,5522,3269,4849
2002,Urban,Chhattisgarh,Crime Against Children,Child Abuse,Male,13-17,3208,496,2712,1594,1614
2006,Urban,Delhi,Crime Against Women,Domestic Violence,Female,13-17,3758,292,3466,1801,1957
2001,Urban,Mizoram,Crime Against Women,Dowry Deaths,Female,13-17,2122,320,1802,1740,382
2006,Rural,Himachal Pradesh,Crime Against Women,Domestic Violence,Female,13-17,6021,330,5691,5686,335
2003,Urban,Maharashtra,Crime Against Children,Child Labor,Male,60+,6861,3363,3498,3744,3117
2001,Rural,Uttar Pradesh,Property Crime,Theft,Female,46-60,9085,5659,3426,6808,2277
2008,Rural,Karnataka,Property Crime,Theft,Male,0-12,7982,6945,1037,7017,965
2006,Rural,Gujarat,Crime Against Children,Child Labor,Female,31-45,8994,3867,5127,8256,738
2003,Urban,West Bengal,Property Crime,Theft,Male,13-17,6198,5584,614,5744,454
2005,Rural,Delhi,Crime Against Women,Domestic Violence,Male,31-45,1521,463,1058,870,651
2006,Rural,Karnataka,Other Crimes,Drug Offense,Male,46-60,1459,1186,273,1406,53
2009,Rural,Mizoram,Other Crimes,Corruption,Male,31-45,8786,8406,380,8550,236
2005,Urban,Odisha,Other Crimes,Corruption,Male,46-60,4631,999,3632,2585,2046
2004,Rural,Delhi,Property Crime,Burglary,Male,46-60,2633,0,2633,2348,285
2003,Rural,Tripura,Crime Against Children,Trafficking,Female,60+,4278,2964,1314,3428,850
2010,Rural,Arunachal Pradesh,Crime Against Women,Rape,Male,60+,5683,1585,4098,4484,1199
2001,Urban,Arunachal Pradesh,Crime Against Children,Kidnapping,Male,13-17,4713,1224,3489,1856,2857
2007,Urban,Manipur,Property Crime,Arson,Male,18-30,3635,99,3536,2761,874
2008,Rural,Uttarakhand,Other Crimes,Drug Offense,Female,60+,1137,70,1067,668,469
2009,Urban,Delhi,Property Crime,Arson,Female,13-17,4444,2218,2226,2768,1676
2010,Urban,Jharkhand,Other Crimes,Cyber Crime,Male,13-17,731,329,402,345,386
2001,Urban,Uttarakhand,Other Crimes,Fraud,Female,0-12,1171,1142,29,1143,28
2007,Urban,Bihar,Crime Against Children,Child Labor,Female,18-30,811,658,153,722,89
2006,Urban,Nagaland,Other Crimes,Cyber Crime,Female,0-12,225,53,172,121,104
2005,Urban,Chhattisgarh,Crime Against Men,Extortion,Female,46-60,6106,590,5516,5404,702
2002,Rural,Maharashtra,Crime Against Men,Murder,Female,46-60,1827,1187,640,1732,95
2009,Rural,Maharashtra,Crime Against Men,Extortion,Male,13-17,203,171,32,184,19
2008,Urban,Arunachal Pradesh,Property Crime,Theft,Female,31-45,7054,876,6178,3528,3526
2010,Rural,Haryana,Crime Against Children,Child Labor,Male,31-45,5445,1056,4389,3635,1810
2009,Urban,Assam,Other Crimes,Drug Offense,Female,13-17,3015,25,2990,1163,1852
2002,Urban,Jharkhand,Property Crime,Arson,Male,60+,8969,1712,7257,8903,66
2006,Rural,Manipur,Crime Against Men,Assault,Male,46-60,6806,5945,861,6439,367
2008,Rural,Himachal Pradesh,Property Crime,Vandalism,Female,31-45,5856,1972,3884,4085,1771
2001,Urban,Rajasthan,Crime Against Children,Child Labor,Female,18-30,2463,158,2305,1451,1012
2010,Rural,Chhattisgarh,Crime Against Women,Domestic Violence,Female,18-30,4286,3450,836,4098,188
2010,Urban,Meghalaya,Other Crimes,Corruption,Male,13-17,8771,583,8188,6910,1861
2005,Rural,West Bengal,Crime Against Women,Molestation,Male,31-45,5444,1428,4016,4851,593
2009,Rural,Odisha,Other Crimes,Drug Offense,Female,46-60,4202,3644,558,3666,536
2008,Rural,Jammu & Kashmir,Property Crime,Vandalism,Female,18-30,3213,885,2328,2708,505
2009,Rural,Jharkhand,Crime Against Children,Child Abuse,Female,46-60,6376,1671,4705,6223,153
2006,Rural,Himachal Pradesh,Crime Against Men,Murder,Female,46-60,2765,1702,1063,1780,985
2010,Rural,Telangana,Other Crimes,Corruption,Male,60+,175,175,0,175,0
2010,Rural,Nagaland,Other Crimes,Corruption,Male,13-17,2629,1433,1196,1636,993
2008,Rural,Assam,Property Crime,Arson,Male,46-60,5216,4788,428,4922,294
2008,Rural,Arunachal Pradesh,Crime Against Children,Trafficking,Male,60+,3839,2367,1472,2969,870
2006,Urban,Manipur,Crime Against Children,Kidnapping,Female,13-17,4005,3986,19,4005,0
2006,Rural,Chhattisgarh,Crime Against Women,Dowry Deaths,Male,18-30,7107,109,6998,6710,397
2005,Rural,Kerala,Other Crimes,Cyber Crime,Male,18-30,7524,5249,2275,6132,1392
2006,Urban,West Bengal,Crime Against Women,Dowry Deaths,Male,31-45,2322,1829,493,2170,152
2009,Rural,Tamil Nadu,Property Crime,Theft,Male,31-45,6785,1855,4930,3370,3415
2004,Urban,Himachal Pradesh,Crime Against Children,Kidnapping,Female,18-30,9782,6039,3743,6304,3478
2005,Urban,Kerala,Crime Against Women,Domestic Violence,Female,60+,6746,2468,4278,4492,2254
2004,Urban,Nagaland,Crime Against Women,Dowry Deaths,Female,31-45,94,58,36,94,0
2002,Rural,Maharashtra,Other Crimes,Corruption,Male,60+,5486,3978,1508,4271,1215
2001,Rural,Goa,Other Crimes,Drug Offense,Female,46-60,2670,2520,150,2670,0
2002,Urban,Telangana,Other Crimes,Corruption,Female,60+,7699,297,7402,3221,4478
2002,Urban,Nagaland,Property Crime,Burglary,Female,18-30,9202,1159,8043,1226,7976
2005,Rural,Goa,Crime Against Women,Dowry Deaths,Female,18-30,8192,5213,2979,6773,1419
2010,Urban,Maharashtra,Other Crimes,Cyber Crime,Female,0-12,4000,2943,1057,3223,777
2009,Rural,West Bengal,Crime Against Women,Molestation,Female,31-45,133,20,113,79,54
2008,Rural,Karnataka,Property Crime,Theft,Female,18-30,2608,2240,368,2544,64
2008,Urban,Andhra Pradesh,Crime Against Children,Child Abuse,Female,60+,4608,712,3896,3818,790
2006,Rural,Maharashtra,Crime Against Men,Assault,Male,31-45,3557,1307,2250,1782,1775
2010,Rural,Jharkhand,Property Crime,Vandalism,Female,60+,8208,146,8062,3935,4273
2010,Urban,Karnataka,Other Crimes,Cyber Crime,Male,46-60,7792,2861,4931,5401,2391
2009,Rural,Haryana,Crime Against Men,Robbery,Male,18-30,426,155,271,409,17
2008,Urban,Nagaland,Crime Against Men,Extortion,Male,46-60,1460,870,590,1162,298
2001,Rural,Mizoram,Other Crimes,Fraud,Female,0-12,9646,353,9293,4313,5333
2009,Rural,Tripura,Crime Against Children,Child Labor,Female,31-45,3322,2007,1315,2368,954
2006,Urban,Himachal Pradesh,Property Crime,Vandalism,Female,46-60,9166,8258,908,8939,227
2004,Urban,Kerala,Crime Against Children,Kidnapping,Female,31-45,5135,4546,589,4787,348
2009,Rural,Jharkhand,Property Crime,Theft,Female,13-17,1625,240,1385,498,1127
2005,Rural,Madhya Pradesh,Other Crimes,Drug Offense,Male,13-17,8572,1294,7278,2073,6499
2003,Urban,Sikkim,Crime Against Children,Trafficking,Male,0-12,1481,170,1311,818,663
2005,Rural,West Bengal,Crime Against Women,Dowry Deaths,Female,0-12,5047,1761,3286,4843,204
2009,Rural,Odisha,Crime Against Children,Trafficking,Male,13-17,4152,4099,53,4112,40
2003,Urban,Manipur,Crime Against Men,Extortion,Male,46-60,5591,2117,3474,3560,2031
2004,Rural,Sikkim,Crime Against Children,Trafficking,Male,13-17,8508,1376,7132,1965,6543
2005,Rural,Nagaland,Crime Against Women,Dowry Deaths,Male,46-60,3880,2755,1125,3070,810
2005,Urban,Manipur,Other Crimes,Corruption,Female,31-45,4597,3427,1170,4116,481
2010,Rural,Madhya Pradesh,Crime Against Men,Murder,Male,13-17,9094,6193,2901,8491,603
2005,Urban,Tamil Nadu,Property Crime,Vandalism,Male,18-30,8483,4800,3683,8439,44
2002,Urban,Gujarat,Crime Against Children,Trafficking,Female,31-45,2608,109,2499,698,1910
2009,Rural,West Bengal,Property Crime,Vandalism,Male,31-45,892,30,862,733,159
2005,Urban,Delhi,Other Crimes,Drug Offense,Female,18-30,3151,755,2396,1438,1713
2001,Rural,Mizoram,Crime Against Men,Murder,Female,0-12,2486,1441,1045,1461,1025
2009,Rural,Nagaland,Property Crime,Burglary,Male,18-30,2979,2097,882,2747,232
2009,Urban,Punjab,Crime Against Women,Domestic Violence,Female,18-30,187,40,147,40,147
2008,Urban,Tripura,Property Crime,Arson,Female,18-30,522,341,181,465,57
2006,Urban,Telangana,Crime Against Men,Murder,Female,31-45,912,509,403,564,348
2005,Urban,Madhya Pradesh,Property Crime,Theft,Female,60+,2934,2880,54,2913,21
2008,Urban,Uttar Pradesh,Crime Against Men,Murder,Female,60+,6112,811,5301,2594,3518
2009,Rural,Tripura,Property Crime,Burglary,Male,60+,7505,1634,5871,5081,2424
2007,Urban,Meghalaya,Crime Against Women,Molestation,Female,18-30,2979,1706,1273,2200,779
2006,Urban,Bihar,Crime Against Women,Rape,Male,0-12,5304,2176,3128,2279,3025
2005,Urban,Uttarakhand,Other Crimes,Cyber Crime,Female,46-60,3678,935,2743,3087,591
2010,Urban,Jharkhand,Crime Against Men,Assault,Male,60+,279,273,6,273,6
2006,Rural,Tripura,Property Crime,Burglary,Female,13-17,8221,2324,5897,7880,341
2006,Rural,Karnataka,Crime Against Children,Child Labor,Male,18-30,5980,3957,2023,5216,764
2007,Rural,Goa,Crime Against Children,Kidnapping,Male,13-17,9620,3857,5763,8789,831
2009,Urban,Madhya Pradesh,Crime Against Men,Extortion,Male,60+,9366,6993,2373,7489,1877
2006,Rural,Uttar Pradesh,Other Crimes,Corruption,Female,0-12,8190,2250,5940,7965,225
2003,Urban,Goa,Other Crimes,Fraud,Male,60+,6182,5400,782,5603,579
2007,Urban,Haryana,Crime Against Children,Child Abuse,Female,46-60,5755,5061,694,5091,664
2010,Urban,Telangana,Crime Against Men,Extortion,Male,31-45,3316,1491,1825,2125,1191
2010,Urban,Jammu & Kashmir,Other Crimes,Fraud,Male,13-17,6999,3956,3043,6754,245
2010,Rural,Himachal Pradesh,Crime Against Women,Molestation,Male,18-30,617,282,335,409,208
2001,Urban,Himachal Pradesh,Crime Against Men,Extortion,Male,46-60,7392,4495,2897,5487,1905
2001,Urban,Gujarat,Other Crimes,Cyber Crime,Female,0-12,6793,609,6184,1379,5414
2003,Urban,Arunachal Pradesh,Crime Against Men,Robbery,Male,0-12,5084,680,4404,4790,294
2006,Rural,Chhattisgarh,Property Crime,Burglary,Male,13-17,6584,1709,4875,4461,2123
2004,Rural,Jharkhand,Crime Against Men,Extortion,Female,13-17,9106,8527,579,8742,364
2002,Urban,Assam,Other Crimes,Corruption,Male,31-45,7559,1321,6238,1333,6226
2009,Rural,Goa,Crime Against Women,Rape,Female,31-45,3894,3030,864,3544,350
2004,Rural,Maharashtra,Other Crimes,Corruption,Male,18-30,7031,6105,926,6263,768
2004,Rural,Arunachal Pradesh,Crime Against Men,Extortion,Male,31-45,8175,3490,4685,4789,3386
2007,Urban,Telangana,Property Crime,Arson,Male,13-17,6108,4228,1880,4772,1336
2010,Urban,Delhi,Crime Against Women,Dowry Deaths,Male,60+,2871,278,2593,2406,465
2001,Urban,Gujarat,Crime Against Women,Domestic Violence,Male,46-60,6883,6043,840,6668,215
2007,Urban,Mizoram,Property Crime,Vandalism,Female,60+,2237,1412,825,2023,214
2007,Rural,Arunachal Pradesh,Other Crimes,Fraud,Female,60+,9528,6323,3205,7208,2320
2004,Urban,West Bengal,Crime Against Children,Child Labor,Male,60+,5983,3564,2419,4805,1178
2005,Rural,Madhya Pradesh,Crime Against Women,Molestation,Male,46-60,3211,1429,1782,2485,726
2001,Urban,Delhi,Property Crime,Theft,Male,46-60,7347,677,6670,5688,1659
2010,Rural,West Bengal,Property Crime,Theft,Female,18-30,3349,2426,923,2522,827
2005,Urban,Punjab,Property Crime,Vandalism,Male,0-12,7259,5069,2190,5311,1948
2003,Rural,Odisha,Crime Against Men,Robbery,Female,31-45,3235,1997,1238,2051,1184
2002,Rural,Arunachal Pradesh,Crime Against Children,Trafficking,Female,31-45,7229,1459,5770,5496,1733
2004,Rural,Telangana,Crime Against Women,Domestic Violence,Male,0-12,4701,3356,1345,4563,138
2005,Urban,Bihar,Crime Against Men,Extortion,Male,18-30,2461,426,2035,1549,912
2001,Rural,Maharashtra,Crime Against Women,Molestation,Male,46-60,9076,8148,928,8847,229
2007,Rural,Jharkhand,Other Crimes,Cyber Crime,Male,0-12,9526,2479,7047,3174,6352
2007,Rural,Uttar Pradesh,Crime Against Men,Murder,Female,0-12,9047,8067,980,8367,680
2010,Rural,Manipur,Crime Against Children,Child Abuse,Female,13-17,4011,2325,1686,2615,1396
2006,Rural,Bihar,Crime Against Children,Trafficking,Female,31-45,6046,3778,2268,5576,470
2004,Urban,Arunachal Pradesh,Property Crime,Burglary,Male,31-45,9468,2349,7119,4715,4753
2009,Urban,Jharkhand,Property Crime,Burglary,Male,18-30,6154,3624,2530,5453,701
2008,Rural,Jammu & Kashmir,Property Crime,Arson,Male,46-60,9493,8101,1392,8587,906
2002,Urban,Jammu & Kashmir,Crime Against Children,Child Labor,Female,60+,6580,4332,2248,4476,2104
2002,Urban,Punjab,Crime Against Men,Robbery,Male,31-45,9922,8131,1791,9017,905
2006,Urban,Sikkim,Crime Against Children,Child Abuse,Male,46-60,7173,4957,2216,5626,1547
2006,Urban,Bihar,Crime Against Men,Assault,Male,31-45,5693,2711,2982,3215,2478
2002,Rural,Punjab,Crime Against Children,Kidnapping,Female,46-60,3005,817,2188,2431,574
2010,Urban,Uttar Pradesh,Crime Against Men,Assault,Male,46-60,9196,925,8271,1941,7255
2006,Urban,Sikkim,Crime Against Children,Child Abuse,Female,13-17,1841,606,1235,1484,357
2004,Rural,Delhi,Crime Against Men,Assault,Male,0-12,1938,529,1409,1739,199
2003,Rural,Meghalaya,Crime Against Women,Domestic Violence,Male,60+,1783,1256,527,1366,417
2002,Rural,Bihar,Other Crimes,Drug Offense,Female,18-30,2530,1844,686,2242,288
2008,Urban,Gujarat,Crime Against Men,Assault,Male,18-30,1689,717,972,1209,480
2006,Rural,Rajasthan,Other Crimes,Drug Offense,Female,46-60,8886,8474,412,8610,276
2008,Rural,Assam,Crime Against Children,Child Abuse,Male,46-60,1655,1464,191,1638,17
2004,Rural,Karnataka,Property Crime,Burglary,Male,0-12,9358,904,8454,8424,934
2006,Rural,Sikkim,Crime Against Children,Child Abuse,Male,60+,5642,784,4858,1504,4138
2005,Rural,Madhya Pradesh,Crime Against Women,Rape,Female,13-17,4732,3991,741,4312,420
2005,Rural,Jharkhand,Other Crimes,Fraud,Male,18-30,6660,6479,181,6516,144
2009,Rural,Maharashtra,Other Crimes,Fraud,Male,0-12,4227,855,3372,2839,1388
2002,Urban,Jharkhand,Crime Against Women,Rape,Male,18-30,8548,5638,2910,7049,1499
2010,Rural,West Bengal,Crime Against Children,Child Labor,Male,0-12,5812,5131,681,5636,176
2005,Rural,Gujarat,Crime Against Women,Dowry Deaths,Male,0-12,8347,6958,1389,7414,933
2005,Rural,Uttarakhand,Property Crime,Arson,Female,18-30,603,469,134,593,10
2010,Rural,Madhya Pradesh,Crime Against Children,Kidnapping,Female,13-17,4738,640,4098,3796,942
2009,Urban,Mizoram,Property Crime,Theft,Female,46-60,3597,1032,2565,2114,1483
2009,Urban,Assam,Crime Against Children,Child Labor,Male,18-30,8577,6730,1847,7284,1293
2001,Rural,Gujarat,Crime Against Women,Dowry Deaths,Female,60+,4121,1665,2456,3528,593
2001,Urban,Rajasthan,Other Crimes,Cyber Crime,Female,60+,7467,2663,4804,6286,1181
2010,Rural,Odisha,Other Crimes,Corruption,Female,46-60,2975,2072,903,2319,656
2002,Rural,Odisha,Crime Against Children,Trafficking,Female,0-12,4634,689,3945,3391,1243
2004,Urban,Mizoram,Crime Against Women,Rape,Male,0-12,9644,5808,3836,7344,2300
2003,Urban,Chhattisgarh,Property Crime,Vandalism,Female,18-30,8250,4453,3797,7252,998
2007,Rural,Delhi,Other Crimes,Cyber Crime,Male,13-17,4405,3941,464,4317,88
2010,Rural,Assam,Crime Against Women,Molestation,Male,18-30,9681,8995,686,9380,301
2006,Rural,West Bengal,Crime Against Men,Murder,Female,60+,7066,5385,1681,6611,455
2010,Rural,Meghalaya,Other Crimes,Cyber Crime,Female,60+,1530,1037,493,1189,341
2002,Urban,Punjab,Property Crime,Arson,Female,18-30,7108,2483,4625,6372,736
2002,Urban,Bihar,Crime Against Women,Molestation,Male,31-45,8556,2026,6530,4526,4030
2001,Rural,Tamil Nadu,Crime Against Children,Child Labor,Male,60+,319,162,157,281,38
2009,Rural,Odisha,Other Crimes,Corruption,Male,18-30,231,194,37,197,34
2010,Rural,Karnataka,Property Crime,Arson,Male,13-17,7504,4389,3115,6430,1074
2009,Urban,Manipur,Property Crime,Burglary,Female,0-12,7292,3604,3688,4966,2326
2006,Urban,Tripura,Other Crimes,Drug Offense,Female,46-60,7453,7047,406,7236,217
2005,Rural,Karnataka,Crime Against Men,Robbery,Male,18-30,7124,1034,6090,5587,1537
2002,Rural,Andhra Pradesh,Other Crimes,Corruption,Female,46-60,5230,1915,3315,4138,1092
2008,Rural,Chhattisgarh,Property Crime,Burglary,Male,60+,4540,2323,2217,2392,2148
2005,Urban,Himachal Pradesh,Crime Against Women,Dowry Deaths,Male,18-30,8383,3003,5380,8339,44
2001,Rural,Odisha,Crime Against Women,Molestation,Female,13-17,6542,3173,3369,6537,5
2006,Urban,Telangana,Crime Against Children,Trafficking,Male,46-60,6579,6093,486,6524,55
2007,Rural,Haryana,Crime Against Women,Rape,Male,60+,903,145,758,351,552
2009,Rural,Meghalaya,Crime Against Children,Trafficking,Male,31-45,6216,6163,53,6169,47
2010,Rural,Arunachal Pradesh,Crime Against Women,Molestation,Female,18-30,5609,4218,1391,4814,795
2003,Rural,Odisha,Crime Against Women,Domestic Violence,Female,13-17,7839,42,7797,1714,6125
2006,Urban,Tamil Nadu,Crime Against Women,Dowry Deaths,Male,0-12,1365,743,622,1318,47
2007,Rural,Uttar Pradesh,Crime Against Women,Domestic Violence,Female,60+,8169,734,7435,5046,3123
2003,Rural,Chhattisgarh,Crime Against Children,Child Labor,Male,13-17,9670,5136,4534,9326,344
2003,Urban,Tamil Nadu,Crime Against Children,Child Abuse,Female,18-30,5261,1740,3521,3256,2005
2007,Urban,Meghalaya,Property Crime,Theft,Female,18-30,2107,873,1234,1447,660
2004,Urban,Arunachal Pradesh,Other Crimes,Drug Offense,Male,18-30,1493,782,711,1256,237
2004,Urban,Odisha,Other Crimes,Corruption,Male,46-60,9022,2174,6848,4589,4433
2009,Urban,Jharkhand,Crime Against Children,Child Labor,Female,13-17,9289,4901,4388,4948,4341
2004,Rural,West Bengal,Crime Against Children,Child Labor,Female,31-45,9047,4715,4332,7929,1118
2003,Rural,Maharashtra,Property Crime,Arson,Male,18-30,5762,5735,27,5735,27
2002,Rural,Haryana,Crime Against Men,Assault,Male,13-17,2890,815,2075,1937,953
2006,Urban,Mizoram,Property Crime,Vandalism,Female,31-45,4248,3079,1169,3935,313
2002,Rural,Jammu & Kashmir,Crime Against Women,Domestic Violence,Male,0-12,6373,4614,1759,4958,1415
2009,Urban,Meghalaya,Other Crimes,Drug Offense,Male,31-45,6965,790,6175,4179,2786
2007,Urban,Odisha,Property Crime,Burglary,Male,46-60,3223,1785,1438,3077,146
2004,Rural,Delhi,Property Crime,Vandalism,Female,18-30,7462,7101,361,7326,136
2010,Urban,Jammu & Kashmir,Property Crime,Theft,Male,18-30,6163,4120,2043,4175,1988
2004,Urban,Arunachal Pradesh,Other Crimes,Cyber Crime,Male,46-60,279,261,18,276,3
2001,Rural,Meghalaya,Crime Against Men,Assault,Female,0-12,652,252,400,418,234
2008,Rural,Bihar,Crime Against Women,Domestic Violence,Male,13-17,3173,2527,646,2590,583
2001,Urban,Rajasthan,Crime Against Men,Murder,Female,46-60,839,720,119,781,58
2008,Urban,Gujarat,Property Crime,Vandalism,Female,18-30,1381,750,631,851,530
2001,Rural,Madhya Pradesh,Crime Against Children,Kidnapping,Female,46-60,3577,2955,622,3109,468
2009,Urban,Sikkim,Crime Against Men,Robbery,Female,60+,6361,5331,1030,5959,402
2007,Rural,Manipur,Crime Against Women,Dowry Deaths,Female,18-30,2658,364,2294,375,2283
2004,Urban,Kerala,Property Crime,Vandalism,Male,0-12,7937,5477,2460,7810,127
2003,Rural,Nagaland,Property Crime,Burglary,Female,31-45,9877,5037,4840,6456,3421
2003,Rural,Rajasthan,Property Crime,Theft,Male,46-60,1402,1327,75,1384,18
2006,Urban,Odisha,Crime Against Women,Domestic Violence,Male,13-17,272,236,36,236,36
2003,Urban,Punjab,Property Crime,Arson,Male,13-17,4296,2068,2228,3011,1285
2007,Rural,Gujarat,Other Crimes,Cyber Crime,Male,0-12,4868,4564,304,4647,221
2001,Urban,Rajasthan,Other Crimes,Drug Offense,Male,18-30,5726,4383,1343,4907,819
2001,Rural,Haryana,Crime Against Children,Child Labor,Male,18-30,8480,7801,679,8321,159
2010,Urban,Andhra Pradesh,Other Crimes,Fraud,Male,13-17,710,177,533,331,379
2007,Rural,Madhya Pradesh,Crime Against Children,Child Labor,Female,46-60,7893,301,7592,6059,1834
2008,Rural,West Bengal,Crime Against Men,Extortion,Female,18-30,7238,4860,2378,6753,485
2002,Urban,Sikkim,Crime Against Women,Molestation,Male,46-60,3876,2595,1281,3418,458
2010,Rural,Himachal Pradesh,Crime Against Men,Extortion,Male,60+,4864,4862,2,4862,2
2008,Urban,Kerala,Crime Against Women,Rape,Female,31-45,6872,2492,4380,5989,883
2007,Urban,Gujarat,Other Crimes,Drug Offense,Male,0-12,4841,2894,1947,4645,196
2010,Rural,Odisha,Crime Against Men,Assault,Female,13-17,7527,38,7489,2553,4974
2007,Rural,Jharkhand,Crime Against Men,Extortion,Female,18-30,9131,7056,2075,8504,627
2008,Rural,Himachal Pradesh,Crime Against Children,Trafficking,Male,46-60,5505,1628,3877,3363,2142
2003,Urban,Maharashtra,Crime Against Men,Robbery,Female,46-60,6399,4730,1669,6087,312
2005,Rural,Nagaland,Property Crime,Vandalism,Male,0-12,1940,869,1071,1829,111
2009,Rural,Chhattisgarh,Crime Against Children,Child Labor,Male,0-12,3876,2333,1543,2551,1325
2005,Rural,Meghalaya,Crime Against Children,Child Labor,Male,60+,1148,1131,17,1145,3
2010,Urban,Telangana,Crime Against Men,Assault,Male,13-17,1305,198,1107,754,551
2001,Urban,Haryana,Property Crime,Vandalism,Male,0-12,5924,4961,963,5035,889
2008,Urban,Rajasthan,Crime Against Children,Kidnapping,Male,46-60,8002,1085,6917,6088,1914
2007,Rural,Punjab,Crime Against Children,Child Labor,Male,31-45,7085,1716,5369,2236,4849
2005,Urban,Himachal Pradesh,Crime Against Men,Extortion,Female,60+,9858,8510,1348,9529,329
2007,Rural,Sikkim,Crime Against Women,Rape,Male,18-30,6023,2675,3348,5581,442
2010,Rural,Arunachal Pradesh,Crime Against Women,Molestation,Male,0-12,7614,5285,2329,5650,1964
2005,Rural,Andhra Pradesh,Crime Against Children,Child Abuse,Female,60+,9406,4301,5105,7885,1521
2010,Urban,Jammu & Kashmir,Other Crimes,Cyber Crime,Male,18-30,2430,1915,515,2148,282
2004,Urban,Sikkim,Other Crimes,Fraud,Male,46-60,6598,2399,4199,4968,1630
2001,Urban,Assam,Crime Against Women,Dowry Deaths,Male,46-60,9103,6073,3030,7545,1558
2001,Urban,Sikkim,Crime Against Children,Child Abuse,Male,13-17,762,105,657,331,431
2007,Urban,Andhra Pradesh,Crime Against Men,Extortion,Male,46-60,5154,1175,3979,1515,3639
2006,Urban,Gujarat,Crime Against Women,Rape,Male,18-30,4360,342,4018,2104,2256
2001,Urban,Madhya Pradesh,Crime Against Women,Dowry Deaths,Male,0-12,3237,2673,564,3073,164
2005,Rural,Maharashtra,Crime Against Women,Domestic Violence,Female,31-45,7379,1850,5529,5475,1904
2001,Urban,Mizoram,Property Crime,Burglary,Female,46-60,8111,4570,3541,6823,1288
2002,Urban,Bihar,Property Crime,Theft,Female,0-12,9340,7334,2006,9040,300
2004,Urban,Jammu & Kashmir,Crime Against Women,Domestic Violence,Male,46-60,9729,7753,1976,8225,1504
2004,Rural,Chhattisgarh,Crime Against Women,Dowry Deaths,Male,13-17,8084,3304,4780,5899,2185
2009,Rural,Telangana,Other Crimes,Drug Offense,Female,46-60,1129,812,317,816,313
2007,Rural,Uttar Pradesh,Property Crime,Theft,Female,0-12,6800,4011,2789,6308,492
2004,Rural,West Bengal,Crime Against Men,Extortion,Female,46-60,5299,4928,371,5103,196
2001,Urban,Maharashtra,Property Crime,Theft,Female,18-30,3362,530,2832,1205,2157
2010,Urban,Gujarat,Crime Against Women,Dowry Deaths,Female,0-12,1062,272,790,747,315
2008,Urban,Gujarat,Property Crime,Vandalism,Male,31-45,191,82,109,157,34
2003,Urban,Jharkhand,Crime Against Women,Domestic Violence,Female,46-60,4306,1516,2790,3425,881
2009,Rural,Andhra Pradesh,Crime Against Women,Molestation,Female,31-45,3029,1775,1254,2586,443
2008,Rural,Tripura,Property Crime,Arson,Male,18-30,8146,6025,2121,7199,947
2009,Urban,Kerala,Crime Against Women,Domestic Violence,Female,0-12,2261,214,2047,655,1606
2008,Urban,Arunachal Pradesh,Crime Against Men,Murder,Male,31-45,9680,8025,1655,8036,1644
2003,Rural,Chhattisgarh,Crime Against Men,Murder,Male,60+,596,455,141,462,134
2003,Urban,Gujarat,Crime Against Women,Molestation,Female,31-45,7049,2705,4344,3627,3422
2006,Rural,Chhattisgarh,Crime Against Children,Kidnapping,Male,46-60,5532,1753,3779,2492,3040
2005,Rural,Maharashtra,Crime Against Men,Murder,Male,13-17,9850,8282,1568,9048,802
2007,Urban,Uttarakhand,Other Crimes,Cyber Crime,Female,31-45,1708,1217,491,1383,325
2004,Urban,Meghalaya,Crime Against Children,Trafficking,Female,13-17,2008,64,1944,1778,230
2003,Rural,Manipur,Crime Against Women,Domestic Violence,Female,0-12,2220,1671,549,2066,154
2003,Rural,Himachal Pradesh,Crime Against Children,Child Labor,Female,18-30,5782,4199,1583,5443,339
2002,Urban,Tamil Nadu,Crime Against Women,Molestation,Male,31-45,124,48,76,105,19
2006,Rural,Jammu & Kashmir,Property Crime,Burglary,Female,60+,2222,1211,1011,1592,630
2008,Rural,Mizoram,Crime Against Men,Extortion,Female,31-45,8151,5593,2558,6537,1614
2010,Rural,Meghalaya,Property Crime,Arson,Female,31-45,6066,4356,1710,4792,1274
2008,Urban,Odisha,Other Crimes,Corruption,Female,31-45,2331,1424,907,2192,139
2007,Urban,Kerala,Crime Against Men,Murder,Female,60+,7740,2187,5553,6701,1039
2004,Rural,Uttarakhand,Crime Against Women,Domestic Violence,Male,0-12,2910,2559,351,2838,72
2008,Rural,Madhya Pradesh,Crime Against Men,Extortion,Male,0-12,7689,5490,2199,6451,1238
2003,Rural,Chhattisgarh,Other Crimes,Fraud,Male,0-12,1651,1434,217,1540,111
2004,Urban,Himachal Pradesh,Crime Against Men,Extortion,Female,46-60,1714,1482,232,1534,180
2009,Rural,Madhya Pradesh,Crime Against Men,Murder,Male,0-12,8014,1063,6951,3974,4040
2008,Urban,Andhra Pradesh,Crime Against Women,Rape,Female,0-12,9750,499,9251,8448,1302
2005,Urban,Mizoram,Property Crime,Arson,Female,18-30,1199,484,715,761,438
2006,Rural,Arunachal Pradesh,Property Crime,Vandalism,Female,18-30,7375,1146,6229,3359,4016
2008,Urban,Haryana,Crime Against Children,Child Labor,Female,31-45,7083,5155,1928,5763,1320
2005,Rural,Manipur,Property Crime,Theft,Female,46-60,2609,871,1738,1800,809
2008,Rural,Meghalaya,Crime Against Children,Child Abuse,Male,60+,2288,403,1885,2175,113
2005,Urban,Mizoram,Crime Against Women,Domestic Violence,Female,18-30,8462,7264,1198,8356,106
2010,Rural,Tamil Nadu,Crime Against Children,Child Labor,Female,13-17,6045,1579,4466,3713,2332
2006,Urban,Maharashtra,Crime Against Children,Trafficking,Female,46-60,5458,1545,3913,4495,963
2005,Urban,Uttarakhand,Crime Against Women,Dowry Deaths,Male,31-45,9540,7171,2369,9005,535
2009,Rural,Jharkhand,Crime Against Men,Assault,Female,18-30,2679,2280,399,2298,381
2004,Rural,Bihar,Property Crime,Burglary,Male,13-17,3564,185,3379,2779,785
2001,Rural,Meghalaya,Crime Against Women,Domestic Violence,Male,31-45,5339,3105,2234,4103,1236
2004,Urban,Jharkhand,Property Crime,Vandalism,Female,46-60,9632,3624,6008,4222,5410
2008,Rural,Tripura,Crime Against Women,Molestation,Female,60+,8744,490,8254,1823,6921
2001,Rural,Goa,Crime Against Men,Extortion,Female,46-60,9857,3423,6434,9854,3
2002,Rural,Bihar,Crime Against Men,Assault,Female,31-45,4157,3923,234,3945,212
2007,Rural,Uttar Pradesh,Crime Against Men,Murder,Female,31-45,2898,1802,1096,2165,733
2006,Rural,Kerala,Property Crime,Arson,Female,18-30,9613,5478,4135,9542,71
2003,Urban,Tripura,Other Crimes,Cyber Crime,Male,31-45,2771,265,2506,2548,223
2009,Urban,Delhi,Crime Against Women,Dowry Deaths,Male,46-60,5520,4485,1035,4670,850
2001,Urban,Tamil Nadu,Property Crime,Theft,Male,46-60,6619,1205,5414,2209,4410
2005,Rural,Rajasthan,Crime Against Women,Molestation,Male,46-60,5086,3376,1710,3455,1631
2004,Rural,Madhya Pradesh,Crime Against Children,Kidnapping,Male,13-17,5089,1804,3285,2397,2692
2005,Urban,Nagaland,Other Crimes,Fraud,Male,18-30,9387,6322,3065,6814,2573
2009,Urban,Goa,Other Crimes,Cyber Crime,Male,60+,2970,433,2537,2893,77
2004,Urban,Jammu & Kashmir,Crime Against Children,Child Labor,Female,46-60,4519,364,4155,495,4024
2004,Urban,Uttarakhand,Crime Against Women,Domestic Violence,Male,18-30,6328,3421,2907,3870,2458
2007,Rural,Odisha,Crime Against Men,Assault,Female,31-45,9258,5608,3650,8790,468
2007,Rural,Maharashtra,Other Crimes,Fraud,Female,31-45,6240,2250,3990,3524,2716
2009,Rural,Arunachal Pradesh,Crime Against Men,Extortion,Female,31-45,5355,4076,1279,4967,388
2007,Rural,Tamil Nadu,Other Crimes,Corruption,Female,13-17,8476,2280,6196,7129,1347
2010,Urban,Jharkhand,Crime Against Men,Robbery,Female,46-60,4248,4177,71,4246,2
2009,Urban,Nagaland,Crime Against Women,Domestic Violence,Male,13-17,4381,1217,3164,2172,2209
2001,Urban,Gujarat,Other Crimes,Cyber Crime,Female,0-12,1819,156,1663,1285,534
2006,Rural,Uttarakhand,Crime Against Children,Kidnapping,Female,31-45,1336,275,1061,1074,262
2006,Urban,Telangana,Crime Against Children,Trafficking,Male,13-17,7492,5247,2245,5340,2152
2003,Urban,Bihar,Crime Against Women,Dowry Deaths,Male,0-12,3120,2915,205,3053,67
2006,Rural,Chhattisgarh,Crime Against Men,Assault,Male,0-12,7280,1775,5505,3855,3425
2010,Rural,Chhattisgarh,Crime Against Children,Kidnapping,Female,0-12,3587,2780,807,3181,406
2004,Urban,Goa,Other Crimes,Drug Offense,Male,0-12,3959,2281,1678,3868,91
2008,Urban,Madhya Pradesh,Crime Against Men,Extortion,Male,31-45,6509,1619,4890,2406,4103
2008,Urban,Delhi,Crime Against Women,Rape,Male,18-30,7691,1264,6427,7638,53
2003,Urban,Meghalaya,Crime Against Men,Murder,Male,60+,7913,6080,1833,7407,506
2001,Urban,Uttarakhand,Crime Against Children,Child Labor,Female,60+,5894,5632,262,5747,147
2010,Urban,Mizoram,Property Crime,Burglary,Male,60+,7590,3828,3762,3948,3642
2003,Rural,Jammu & Kashmir,Crime Against Men,Assault,Female,13-17,4142,933,3209,2671,1471
2003,Rural,Gujarat,Property Crime,Theft,Male,13-17,9925,8777,1148,9646,279
2009,Urban,Gujarat,Property Crime,Theft,Female,31-45,2478,1125,1353,1502,976
2005,Urban,Tripura,Crime Against Women,Dowry Deaths,Female,46-60,3343,1954,1389,2222,1121
2006,Rural,Haryana,Crime Against Men,Robbery,Male,60+,5051,117,4934,2898,2153
2010,Rural,Jammu & Kashmir,Other Crimes,Drug Offense,Female,18-30,346,231,115,294,52
2004,Rural,Punjab,Crime Against Women,Dowry Deaths,Male,31-45,4515,812,3703,3600,915
2001,Rural,Goa,Crime Against Women,Rape,Male,60+,5695,5300,395,5527,168
2005,Urban,Jharkhand,Crime Against Women,Molestation,Male,46-60,4778,2835,1943,4622,156
2002,Urban,Tripura,Crime Against Men,Murder,Female,13-17,6201,2811,3390,4063,2138
2004,Rural,Maharashtra,Property Crime,Theft,Female,31-45,7149,3383,3766,3683,3466
2006,Urban,Goa,Crime Against Children,Kidnapping,Female,0-12,2513,2221,292,2457,56
2007,Urban,Rajasthan,Other Crimes,Cyber Crime,Female,46-60,4777,1588,3189,2149,2628
2005,Urban,Uttar Pradesh,Crime Against Men,Robbery,Female,18-30,3701,1658,2043,2548,1153
2002,Rural,Andhra Pradesh,Crime Against Men,Assault,Female,31-45,4747,42,4705,482,4265
2009,Rural,Uttar Pradesh,Property Crime,Burglary,Female,60+,846,679,167,801,45
2010,Rural,Odisha,Property Crime,Burglary,Male,18-30,5474,3634,1840,4933,541
2007,Rural,Arunachal Pradesh,Property Crime,Theft,Male,13-17,7923,3956,3967,6537,1386
2005,Rural,Nagaland,Property Crime,Theft,Male,31-45,5484,4419,1065,4468,1016
2010,Rural,Odisha,Crime Against Women,Domestic Violence,Male,31-45,6946,2184,4762,3889,3057
2010,Rural,Uttar Pradesh,Crime Against Men,Murder,Female,18-30,7995,2009,5986,3051,4944
2006,Rural,Sikkim,Crime Against Children,Child Labor,Male,46-60,4557,2107,2450,2693,1864
2004,Urban,Meghalaya,Crime Against Men,Robbery,Male,46-60,9236,2408,6828,4414,4822
2001,Rural,Himachal Pradesh,Crime Against Women,Dowry Deaths,Female,31-45,1200,728,472,764,436
2007,Urban,Manipur,Crime Against Children,Child Abuse,Male,46-60,102,22,80,81,21
2002,Rural,Gujarat,Crime Against Children,Trafficking,Male,18-30,2366,617,1749,702,1664
2009,Urban,Sikkim,Other Crimes,Cyber Crime,Female,13-17,1450,366,1084,383,1067
2001,Urban,Andhra Pradesh,Other Crimes,Cyber Crime,Male,31-45,361,234,127,270,91
2009,Urban,Uttarakhand,Crime Against Men,Extortion,Female,60+,6158,1936,4222,5009,1149
2006,Rural,Karnataka,Crime Against Children,Trafficking,Male,60+,5692,407,5285,4001,1691
2004,Rural,Madhya Pradesh,Property Crime,Burglary,Male,18-30,3744,3649,95,3743,1
2002,Urban,Telangana,Property Crime,Burglary,Male,31-45,4614,4462,152,4471,143
2001,Urban,Tripura,Crime Against Children,Child Abuse,Male,60+,2687,1178,1509,1698,989
2007,Rural,Bihar,Crime Against Children,Child Labor,Male,46-60,8055,3550,4505,7560,495
2002,Urban,Odisha,Property Crime,Vandalism,Female,0-12,4235,2779,1456,3372,863
2003,Rural,Goa,Property Crime,Theft,Male,46-60,8769,6646,2123,7777,992
2006,Urban,Delhi,Crime Against Women,Domestic Violence,Male,46-60,5434,177,5257,1103,4331
2008,Urban,Madhya Pradesh,Crime Against Children,Child Labor,Female,18-30,2607,1402,1205,2205,402
2003,Rural,Himachal Pradesh,Crime Against Children,Child Labor,Male,18-30,6167,5966,201,6027,140
2008,Rural,Tamil Nadu,Other Crimes,Cyber Crime,Male,0-12,8680,6730,1950,8439,241
2003,Urban,Assam,Crime Against Men,Extortion,Female,0-12,76,10,66,54,22
2002,Urban,Madhya Pradesh,Property Crime,Burglary,Male,60+,2223,2185,38,2214,9
2010,Urban,Sikkim,Crime Against Men,Robbery,Male,13-17,4141,1801,2340,3380,761
2002,Urban,Odisha,Property Crime,Burglary,Female,31-45,9046,7463,1583,8397,649
2003,Rural,Nagaland,Crime Against Men,Assault,Female,13-17,4230,3303,927,3362,868
2002,Rural,Tripura,Property Crime,Arson,Male,18-30,153,54,99,117,36
2001,Urban,Delhi,Crime Against Women,Dowry Deaths,Female,46-60,8453,8114,339,8180,273
2006,Rural,Gujarat,Crime Against Children,Child Abuse,Male,60+,3965,3550,415,3777,188
2004,Urban,Punjab,Crime Against Children,Kidnapping,Male,60+,3501,695,2806,2784,717
2001,Rural,Rajasthan,Crime Against Women,Molestation,Male,13-17,2524,1077,1447,1384,1140
2008,Urban,Rajasthan,Other Crimes,Fraud,Female,31-45,4257,4219,38,4231,26
2001,Rural,Rajasthan,Property Crime,Arson,Male,31-45,1303,1024,279,1039,264
2007,Rural,Tamil Nadu,Crime Against Children,Kidnapping,Female,31-45,715,426,289,548,167
2005,Rural,Gujarat,Other Crimes,Drug Offense,Female,31-45,630,330,300,371,259
2003,Urban,Mizoram,Property Crime,Vandalism,Male,0-12,4378,1014,3364,2153,2225
2008,Urban,Manipur,Other Crimes,Cyber Crime,Male,31-45,8088,7957,131,7997,91
2005,Urban,Tripura,Crime Against Men,Extortion,Female,13-17,4976,124,4852,662,4314
2002,Rural,Nagaland,Other Crimes,Cyber Crime,Female,13-17,1798,388,1410,752,1046
2004,Urban,Meghalaya,Crime Against Men,Extortion,Female,13-17,8889,6960,1929,8344,545
2006,Rural,Gujarat,Property Crime,Theft,Male,18-30,1700,41,1659,1266,434
2004,Rural,Madhya Pradesh,Property Crime,Arson,Female,46-60,6590,6271,319,6404,186
2009,Rural,Andhra Pradesh,Crime Against Men,Murder,Male,60+,387,85,302,352,35
2001,Rural,Tamil Nadu,Property Crime,Arson,Female,60+,7634,419,7215,2220,5414
2001,Urban,Odisha,Property Crime,Theft,Female,60+,4543,1144,3399,1615,2928
2010,Rural,Maharashtra,Crime Against Men,Assault,Female,46-60,7631,2102,5529,5542,2089
2003,Urban,Jammu & Kashmir,Crime Against Men,Murder,Female,31-45,7414,4064,3350,5652,1762
2002,Urban,Nagaland,Crime Against Children,Kidnapping,Male,31-45,87,66,21,71,16
2002,Rural,Meghalaya,Crime Against Women,Dowry Deaths,Female,46-60,8004,4976,3028,7577,427
2002,Rural,Haryana,Property Crime,Arson,Male,18-30,6321,5770,551,6134,187
2008,Urban,Haryana,Property Crime,Burglary,Female,18-30,9041,4359,4682,5205,3836
2002,Rural,Tamil Nadu,Other Crimes,Drug Offense,Male,0-12,7847,2690,5157,2774,5073
2009,Rural,Tripura,Other Crimes,Drug Offense,Male,18-30,9457,6790,2667,6985,2472
2003,Urban,Kerala,Crime Against Women,Rape,Female,46-60,3129,2132,997,3033,96
2005,Rural,Gujarat,Other Crimes,Fraud,Female,0-12,6907,665,6242,4785,2122
2006,Rural,Jammu & Kashmir,Crime Against Children,Child Abuse,Female,18-30,7286,6208,1078,6956,330
2001,Urban,Punjab,Crime Against Women,Molestation,Male,46-60,7008,4336,2672,5351,1657
2008,Urban,Chhattisgarh,Crime Against Children,Kidnapping,Female,13-17,8272,8086,186,8170,102
2009,Urban,Delhi,Crime Against Women,Dowry Deaths,Female,13-17,9843,3195,6648,4548,5295
2006,Rural,Madhya Pradesh,Crime Against Men,Assault,Female,46-60,8547,4066,4481,8093,454
2004,Rural,Punjab,Other Crimes,Drug Offense,Female,0-12,5486,966,4520,2883,2603
2005,Rural,Uttarakhand,Other Crimes,Fraud,Female,0-12,8243,5038,3205,7588,655
2009,Urban,Meghalaya,Crime Against Men,Murder,Female,13-17,2973,1398,1575,2838,135
2002,Rural,Tripura,Crime Against Children,Child Labor,Male,60+,3302,1344,1958,2732,570
2010,Urban,Rajasthan,Crime Against Men,Robbery,Male,46-60,5382,82,5300,1678,3704
2003,Urban,Odisha,Crime Against Children,Trafficking,Female,31-45,9712,9372,340,9602,110
2008,Urban,Chhattisgarh,Crime Against Children,Child Abuse,Female,46-60,5346,4389,957,5330,16
2007,Urban,Uttarakhand,Property Crime,Theft,Male,60+,3527,502,3025,1748,1779
2005,Urban,Uttarakhand,Other Crimes,Corruption,Female,13-17,7363,2150,5213,4982,2381
2010,Urban,Assam,Crime Against Men,Assault,Female,31-45,1675,1263,412,1580,95
2008,Rural,Himachal Pradesh,Crime Against Women,Molestation,Female,0-12,4172,4019,153,4107,65
2009,Rural,Arunachal Pradesh,Other Crimes,Fraud,Male,18-30,5348,4128,1220,4345,1003
2004,Rural,Karnataka,Property Crime,Arson,Female,0-12,3377,3146,231,3332,45
2010,Urban,Andhra Pradesh,Property Crime,Vandalism,Male,60+,9958,5150,4808,8832,1126
2010,Rural,Chhattisgarh,Crime Against Children,Trafficking,Male,60+,8048,7338,710,7925,123
2010,Urban,Jharkhand,Crime Against Women,Dowry Deaths,Female,18-30,8263,824,7439,4324,3939
2001,Urban,Tripura,Crime Against Women,Rape,Male,18-30,5752,2507,3245,5449,303
2009,Rural,Andhra Pradesh,Other Crimes,Drug Offense,Male,46-60,8255,186,8069,2143,6112
2004,Urban,Delhi,Crime Against Children,Child Labor,Female,13-17,108,11,97,88,20
2004,Urban,Bihar,Property Crime,Vandalism,Male,13-17,4745,3779,966,4077,668
2007,Rural,Punjab,Crime Against Women,Dowry Deaths,Female,13-17,7750,3080,4670,7043,707
2004,Rural,Meghalaya,Crime Against Children,Child Labor,Female,31-45,8639,6747,1892,8101,538
2009,Urban,Madhya Pradesh,Property Crime,Burglary,Female,0-12,976,600,376,775,201
2010,Rural,Delhi,Other Crimes,Cyber Crime,Male,0-12,6880,3305,3575,3362,3518
2007,Rural,Gujarat,Crime Against Women,Dowry Deaths,Male,18-30,2187,1020,1167,1372,815
2006,Urban,Assam,Crime Against Children,Child Labor,Female,0-12,5786,3978,1808,4223,1563
2006,Rural,Delhi,Crime Against Women,Molestation,Male,46-60,978,169,809,795,183
2010,Urban,Maharashtra,Other Crimes,Drug Offense,Female,31-45,9114,7974,1140,8071,1043
2010,Rural,Odisha,Crime Against Men,Assault,Female,13-17,7973,4334,3639,4919,3054
2006,Urban,West Bengal,Property Crime,Arson,Male,60+,1137,953,184,967,170
2006,Rural,Uttar Pradesh,Crime Against Children,Child Abuse,Female,31-45,9064,2335,6729,6197,2867
2001,Urban,Andhra Pradesh,Property Crime,Arson,Male,31-45,5521,5115,406,5494,27
2006,Rural,Uttar Pradesh,Crime Against Men,Murder,Female,13-17,1872,438,1434,1461,411
2009,Rural,Nagaland,Crime Against Men,Extortion,Female,31-45,7094,6730,364,6752,342
2002,Urban,Goa,Other Crimes,Cyber Crime,Female,46-60,9966,6753,3213,9924,42
2001,Rural,Tripura,Crime Against Men,Murder,Female,18-30,7571,1102,6469,5138,2433
2004,Urban,Bihar,Crime Against Children,Child Labor,Female,0-12,6650,3258,3392,3864,2786
2005,Rural,Bihar,Property Crime,Vandalism,Male,60+,7033,1264,5769,4572,2461
2006,Rural,Karnataka,Property Crime,Burglary,Male,0-12,7562,1513,6049,7426,136
2010,Rural,Madhya Pradesh,Crime Against Women,Rape,Female,60+,9515,8579,936,9021,494
2004,Rural,Mizoram,Crime Against Children,Kidnapping,Male,18-30,7890,580,7310,618,7272
2002,Urban,Telangana,Crime Against Women,Dowry Deaths,Male,31-45,4195,1112,3083,2300,1895
2002,Urban,Rajasthan,Other Crimes,Corruption,Female,46-60,5635,2560,3075,4304,1331
2007,Urban,Tripura,Crime Against Women,Molestation,Male,60+,8881,6447,2434,8122,759
2008,Rural,Odisha,Property Crime,Vandalism,Male,18-30,2327,2143,184,2214,113
2010,Urban,Assam,Property Crime,Vandalism,Male,18-30,5618,1038,4580,5359,259
2005,Rural,Maharashtra,Crime Against Men,Robbery,Male,46-60,3283,463,2820,1270,2013
2007,Rural,Telangana,Other Crimes,Fraud,Female,18-30,5593,1694,3899,1732,3861
2003,Urban,Jammu & Kashmir,Crime Against Women,Dowry Deaths,Female,0-12,7377,5469,1908,7277,100
2003,Rural,Jharkhand,Other Crimes,Drug Offense,Male,18-30,6429,989,5440,1706,4723
2005,Urban,Uttarakhand,Crime Against Men,Extortion,Male,60+,1584,1408,176,1464,120
2002,Rural,Rajasthan,Crime Against Children,Trafficking,Male,18-30,3479,1668,1811,1838,1641
2009,Rural,Haryana,Crime Against Women,Domestic Violence,Male,31-45,5996,3793,2203,5271,725
2003,Rural,Odisha,Crime Against Women,Dowry Deaths,Male,31-45,3598,2467,1131,3523,75
2006,Rural,Goa,Crime Against Men,Assault,Male,13-17,9659,3177,6482,4635,5024
2003,Rural,Tamil Nadu,Crime Against Women,Domestic Violence,Female,46-60,5259,426,4833,1580,3679
2005,Urban,Uttarakhand,Other Crimes,Drug Offense,Male,60+,6425,4984,1441,6340,85
2004,Rural,Uttar Pradesh,Crime Against Women,Dowry Deaths,Male,46-60,4756,4631,125,4651,105
2009,Urban,Uttarakhand,Crime Against Men,Murder,Female,46-60,7503,938,6565,4589,2914
2004,Rural,Haryana,Property Crime,Vandalism,Male,31-45,7328,6369,959,7037,291
2009,Urban,Tripura,Crime Against Children,Kidnapping,Male,18-30,7213,4438,2775,5485,1728
2003,Rural,Andhra Pradesh,Crime Against Men,Murder,Male,0-12,9577,1483,8094,7621,1956
2002,Urban,Jammu & Kashmir,Crime Against Men,Robbery,Male,18-30,8321,1894,6427,1911,6410
2002,Rural,Karnataka,Crime Against Women,Domestic Violence,Female,0-12,6731,3794,2937,5745,986
2010,Urban,Punjab,Crime Against Children,Child Labor,Male,31-45,6282,4039,2243,4358,1924
2006,Urban,Uttarakhand,Crime Against Children,Child Abuse,Male,18-30,7994,2274,5720,5839,2155
2002,Urban,Jammu & Kashmir,Other Crimes,Fraud,Male,13-17,1274,851,423,930,344
2008,Urban,Nagaland,Crime Against Children,Kidnapping,Male,0-12,6840,6462,378,6583,257
2009,Rural,Bihar,Crime Against Men,Assault,Female,46-60,2161,585,1576,2158,3
2001,Urban,Chhattisgarh,Crime Against Children,Child Labor,Female,13-17,5469,823,4646,1898,3571
2007,Urban,Karnataka,Property Crime,Theft,Female,46-60,2239,2189,50,2220,19
2009,Urban,Odisha,Crime Against Men,Assault,Female,13-17,6844,3532,3312,3862,2982
2001,Urban,Uttarakhand,Crime Against Men,Murder,Female,60+,6724,3619,3105,4332,2392
2001,Rural,Kerala,Other Crimes,Cyber Crime,Male,31-45,8190,5352,2838,6741,1449
2004,Urban,Maharashtra,Crime Against Women,Rape,Female,18-30,4304,105,4199,1013,3291
2004,Rural,Jammu & Kashmir,Crime Against Men,Extortion,Male,18-30,757,394,363,622,135
2005,Rural,Rajasthan,Crime Against Men,Assault,Female,18-30,8105,1271,6834,1509,6596
2002,Urban,Kerala,Property Crime,Arson,Female,13-17,5481,334,5147,3336,2145
2005,Urban,Sikkim,Other Crimes,Corruption,Male,60+,6577,1088,5489,6397,180
2007,Urban,Bihar,Property Crime,Arson,Male,60+,6693,5795,898,6074,619
2007,Rural,Bihar,Crime Against Men,Extortion,Female,60+,7613,2345,5268,7454,159
2010,Urban,Bihar,Crime Against Children,Child Abuse,Female,18-30,5955,3731,2224,4488,1467
2006,Rural,Uttar Pradesh,Property Crime,Burglary,Female,0-12,2612,1800,812,2301,311
2002,Urban,Kerala,Crime Against Women,Rape,Male,60+,5527,3474,2053,3971,1556
2008,Rural,Telangana,Property Crime,Vandalism,Male,13-17,5877,5538,339,5757,120
2003,Urban,Arunachal Pradesh,Crime Against Women,Rape,Male,18-30,2476,382,2094,1233,1243
2010,Urban,Karnataka,Crime Against Children,Trafficking,Male,46-60,2628,2373,255,2465,163
2006,Rural,Madhya Pradesh,Crime Against Children,Child Labor,Female,60+,833,415,418,716,117
2007,Urban,Haryana,Crime Against Men,Murder,Female,0-12,7259,6508,751,6634,625
2006,Rural,Punjab,Property Crime,Vandalism,Male,31-45,6534,7,6527,3007,3527
2006,Rural,Manipur,Crime Against Children,Kidnapping,Female,60+,8653,2293,6360,5247,3406
2003,Urban,Maharashtra,Crime Against Children,Child Labor,Female,46-60,1539,1031,508,1417,122
2005,Rural,Gujarat,Other Crimes,Corruption,Female,60+,8866,3234,5632,8168,698
2007,Rural,Himachal Pradesh,Crime Against Women,Dowry Deaths,Female,13-17,7442,5877,1565,6060,1382
2002,Urban,Meghalaya,Property Crime,Burglary,Female,46-60,8006,6785,1221,7350,656
2002,Rural,Goa,Crime Against Women,Dowry Deaths,Male,18-30,2760,148,2612,986,1774
2010,Urban,Kerala,Crime Against Men,Robbery,Male,60+,7342,6251,1091,6295,1047
2010,Urban,Nagaland,Property Crime,Burglary,Female,31-45,3105,737,2368,1483,1622
2008,Rural,Bihar,Crime Against Children,Kidnapping,Female,31-45,4766,2316,2450,2658,2108
2007,Rural,Gujarat,Crime Against Children,Child Labor,Male,31-45,512,132,380,452,60
2003,Urban,Nagaland,Other Crimes,Fraud,Female,60+,9863,8219,1644,8706,1157
2002,Rural,West Bengal,Other Crimes,Drug Offense,Male,13-17,9436,3606,5830,5350,4086
2005,Urban,West Bengal,Crime Against Men,Assault,Male,13-17,5063,5042,21,5061,2
2005,Urban,Andhra Pradesh,Crime Against Men,Murder,Male,31-45,2401,228,2173,2118,283
2009,Rural,Kerala,Crime Against Children,Trafficking,Male,0-12,9517,5694,3823,8213,1304
2002,Urban,Haryana,Crime Against Women,Rape,Male,60+,1847,1796,51,1824,23
2009,Urban,Assam,Crime Against Children,Child Labor,Female,31-45,9496,5980,3516,8720,776
2002,Urban,Odisha,Crime Against Men,Assault,Female,31-45,1965,166,1799,1879,86
2007,Urban,Haryana,Crime Against Men,Murder,Female,13-17,1494,790,704,1124,370
2003,Urban,Punjab,Property Crime,Vandalism,Male,18-30,7203,3844,3359,6354,849
2009,Rural,Andhra Pradesh,Property Crime,Vandalism,Female,31-45,702,441,261,606,96
2002,Rural,Uttarakhand,Crime Against Children,Child Labor,Female,13-17,2707,2029,678,2204,503
2005,Rural,Tamil Nadu,Crime Against Women,Domestic Violence,Female,18-30,6925,6432,493,6515,410
2008,Rural,Odisha,Other Crimes,Drug Offense,Female,60+,4830,4226,604,4809,21
2008,Urban,Jharkhand,Other Crimes,Drug Offense,Female,31-45,2279,1219,1060,1825,454
2010,Rural,Sikkim,Crime Against Women,Domestic Violence,Female,18-30,7168,5738,1430,6780,388
2009,Rural,Uttarakhand,Other Crimes,Fraud,Male,13-17,4784,2819,1965,4124,660
2008,Rural,Gujarat,Crime Against Children,Child Abuse,Male,46-60,4972,2886,2086,3594,1378
2004,Rural,Jharkhand,Crime Against Children,Child Labor,Female,31-45,2596,1570,1026,2056,540
2002,Urban,Uttar Pradesh,Property Crime,Arson,Male,0-12,3384,3365,19,3374,10
2010,Urban,Haryana,Crime Against Women,Dowry Deaths,Female,60+,6718,283,6435,1119,5599
2008,Rural,Himachal Pradesh,Crime Against Children,Trafficking,Female,46-60,5703,1311,4392,4569,1134
2010,Urban,Jharkhand,Crime Against Children,Child Labor,Female,31-45,9036,7560,1476,8092,944
2009,Urban,Telangana,Crime Against Men,Extortion,Female,31-45,2155,1559,596,1602,553
2004,Urban,Maharashtra,Crime Against Children,Child Abuse,Female,60+,9901,4147,5754,8986,915
2002,Rural,Jammu & Kashmir,Other Crimes,Fraud,Male,31-45,3297,2905,392,3244,53
2004,Urban,Nagaland,Crime Against Men,Murder,Female,31-45,344,199,145,276,68
2006,Rural,Jharkhand,Property Crime,Arson,Female,31-45,2353,2334,19,2342,11
2010,Urban,Kerala,Crime Against Women,Rape,Female,31-45,464,308,156,415,49
2001,Rural,Rajasthan,Crime Against Men,Assault,Female,46-60,2563,1918,645,2479,84
2002,Urban,Punjab,Crime Against Women,Domestic Violence,Female,31-45,8406,2045,6361,5906,2500
2010,Urban,Mizoram,Crime Against Children,Child Abuse,Male,0-12,5524,621,4903,1619,3905
2003,Urban,Himachal Pradesh,Crime Against Children,Kidnapping,Male,46-60,4375,3782,593,3807,568
2010,Urban,Kerala,Crime Against Women,Molestation,Male,18-30,2235,361,1874,644,1591
2008,Rural,Jammu & Kashmir,Other Crimes,Drug Offense,Female,46-60,6493,510,5983,1253,5240
2003,Rural,Tamil Nadu,Crime Against Children,Kidnapping,Female,46-60,9265,8518,747,8949,316
2007,Urban,Gujarat,Other Crimes,Fraud,Male,31-45,5609,4441,1168,5322,287
2002,Rural,West Bengal,Crime Against Children,Trafficking,Female,18-30,8749,4620,4129,6078,2671
2005,Urban,Manipur,Property Crime,Arson,Male,46-60,1674,225,1449,831,843
2008,Urban,Tamil Nadu,Property Crime,Vandalism,Male,46-60,3101,1059,2042,2685,416
2010,Urban,Uttar Pradesh,Crime Against Children,Kidnapping,Male,0-12,2429,122,2307,1664,765
2009,Rural,Karnataka,Crime Against Men,Murder,Female,60+,820,657,163,710,110
2009,Rural,Assam,Crime Against Women,Molestation,Male,18-30,7478,4654,2824,5765,1713
2002,Urban,Chhattisgarh,Crime Against Women,Dowry Deaths,Male,60+,4357,2522,1835,2965,1392
2001,Urban,Sikkim,Crime Against Children,Child Abuse,Female,0-12,3008,90,2918,116,2892
2008,Urban,Odisha,Other Crimes,Drug Offense,Female,60+,3910,133,3777,3060,850
2008,Urban,Chhattisgarh,Crime Against Women,Domestic Violence,Female,0-12,5771,335,5436,3487,2284
2001,Urban,Maharashtra,Property Crime,Theft,Male,60+,7344,4900,2444,5645,1699
2001,Urban,Nagaland,Property Crime,Theft,Male,60+,2562,1358,1204,2312,250
2009,Rural,Mizoram,Crime Against Children,Child Labor,Male,60+,6933,5758,1175,6450,483
2005,Rural,Jharkhand,Other Crimes,Cyber Crime,Male,13-17,4716,3387,1329,3623,1093
2002,Urban,Goa,Crime Against Women,Dowry Deaths,Female,31-45,8771,6545,2226,8455,316
2010,Urban,Chhattisgarh,Crime Against Men,Robbery,Female,0-12,7262,2586,4676,6938,324
2004,Rural,Mizoram,Crime Against Children,Kidnapping,Female,13-17,1232,693,539,804,428
2001,Rural,Kerala,Property Crime,Vandalism,Male,0-12,9274,8781,493,8832,442
2005,Urban,Jammu & Kashmir,Crime Against Men,Assault,Male,0-12,4337,3333,1004,4050,287
2005,Urban,Jammu & Kashmir,Crime Against Women,Molestation,Female,13-17,5809,831,4978,3553,2256
2008,Urban,Arunachal Pradesh,Crime Against Children,Child Abuse,Male,60+,6170,5578,592,5743,427
2010,Rural,Arunachal Pradesh,Crime Against Women,Dowry Deaths,Male,13-17,3564,2066,1498,3061,503
2010,Rural,Jharkhand,Crime Against Women,Dowry Deaths,Female,60+,7710,3465,4245,6068,1642
2010,Urban,Kerala,Property Crime,Theft,Male,46-60,1239,308,931,944,295
2004,Urban,West Bengal,Crime Against Women,Molestation,Female,46-60,581,229,352,269,312
2009,Urban,Assam,Crime Against Women,Molestation,Female,60+,8219,5074,3145,7463,756
2005,Rural,Himachal Pradesh,Crime Against Women,Rape,Male,0-12,6287,1787,4500,5756,531
2008,Urban,Uttarakhand,Other Crimes,Fraud,Male,46-60,72,45,27,48,24
2001,Urban,Nagaland,Crime Against Children,Trafficking,Male,0-12,641,414,227,563,78
2002,Rural,Bihar,Other Crimes,Fraud,Male,31-45,3500,889,2611,2084,1416
2008,Rural,Uttar Pradesh,Crime Against Men,Extortion,Female,0-12,1146,1078,68,1116,30
2003,Rural,Uttarakhand,Property Crime,Vandalism,Male,60+,5383,4908,475,5072,311
2005,Urban,Kerala,Crime Against Men,Robbery,Male,31-45,8662,6640,2022,7286,1376
2002,Rural,Himachal Pradesh,Property Crime,Burglary,Male,18-30,6886,1623,5263,2446,4440
2009,Rural,Kerala,Crime Against Children,Kidnapping,Female,60+,1044,324,720,489,555
2003,Urban,Haryana,Property Crime,Arson,Male,18-30,8526,3258,5268,4666,3860
2003,Urban,Bihar,Crime Against Women,Domestic Violence,Male,0-12,966,711,255,811,155
2007,Urban,Gujarat,Crime Against Men,Robbery,Male,18-30,8193,2341,5852,2404,5789
2007,Urban,Uttarakhand,Crime Against Men,Murder,Female,0-12,8127,254,7873,1996,6131
2001,Urban,Kerala,Property Crime,Theft,Female,31-45,5263,3914,1349,3953,1310
2001,Urban,Tripura,Crime Against Women,Rape,Female,13-17,6592,28,6564,1591,5001
2007,Rural,Uttar Pradesh,Crime Against Men,Assault,Female,13-17,2847,2655,192,2829,18
2007,Urban,Meghalaya,Crime Against Children,Child Labor,Male,13-17,6710,6319,391,6652,58
2010,Rural,Arunachal Pradesh,Crime Against Children,Child Abuse,Female,46-60,7941,4946,2995,7652,289
2010,Urban,Maharashtra,Property Crime,Arson,Male,0-12,2860,2788,72,2813,47
2003,Urban,Goa,Property Crime,Theft,Female,31-45,1746,401,1345,1547,199
2005,Rural,Maharashtra,Crime Against Men,Extortion,Female,13-17,6133,96,6037,1424,4709
2009,Rural,Gujarat,Crime Against Men,Extortion,Male,0-12,114,51,63,102,12
2008,Rural,Assam,Property Crime,Vandalism,Female,18-30,4666,2370,2296,4058,608
2010,Rural,Punjab,Crime Against Children,Child Abuse,Male,18-30,2700,1765,935,1946,754
2002,Urban,Sikkim,Property Crime,Theft,Female,0-12,7831,7662,169,7779,52
2001,Urban,Gujarat,Crime Against Children,Trafficking,Female,13-17,9148,101,9047,5289,3859
2002,Rural,Haryana,Crime Against Men,Robbery,Female,18-30,2294,1174,1120,1567,727
2007,Urban,Bihar,Crime Against Men,Extortion,Female,31-45,9975,4999,4976,6361,3614
2003,Urban,Kerala,Crime Against Women,Domestic Violence,Female,60+,5228,4102,1126,4341,887
2001,Urban,Jharkhand,Other Crimes,Drug Offense,Female,60+,3899,1798,2101,2129,1770
2002,Urban,Haryana,Other Crimes,Corruption,Male,0-12,9065,4769,4296,8724,341
2002,Urban,Andhra Pradesh,Other Crimes,Fraud,Female,13-17,6934,2501,4433,2742,4192
2001,Urban,Madhya Pradesh,Crime Against Children,Trafficking,Female,0-12,5022,1340,3682,3435,1587
2002,Rural,Bihar,Other Crimes,Cyber Crime,Female,13-17,3947,1844,2103,2952,995
2009,Rural,Odisha,Other Crimes,Corruption,Male,46-60,1496,1012,484,1080,416
2005,Rural,Nagaland,Crime Against Children,Trafficking,Male,60+,5798,1020,4778,1697,4101
2007,Rural,Jammu & Kashmir,Crime Against Men,Assault,Male,31-45,5508,3832,1676,4773,735
2006,Rural,Meghalaya,Crime Against Children,Child Abuse,Male,46-60,7283,6396,887,6899,384
2006,Rural,Uttarakhand,Crime Against Men,Extortion,Female,60+,2291,2019,272,2193,98
2002,Rural,Mizoram,Other Crimes,Drug Offense,Male,0-12,6566,5225,1341,6358,208
2003,Urban,Andhra Pradesh,Crime Against Women,Molestation,Female,0-12,8042,4916,3126,6973,1069
2003,Urban,Odisha,Property Crime,Burglary,Female,18-30,1334,1051,283,1293,41
2005,Rural,Gujarat,Crime Against Men,Assault,Male,18-30,4024,2629,1395,3695,329
2005,Rural,Jharkhand,Other Crimes,Cyber Crime,Female,0-12,8609,4675,3934,7650,959
2003,Rural,Maharashtra,Crime Against Women,Domestic Violence,Female,18-30,1764,1715,49,1763,1
2008,Rural,Odisha,Crime Against Children,Kidnapping,Female,0-12,2516,255,2261,1504,1012
2001,Rural,Gujarat,Crime Against Women,Rape,Female,46-60,1631,665,966,1156,475
2006,Rural,Odisha,Crime Against Women,Dowry Deaths,Male,31-45,9578,7465,2113,7881,1697
2005,Urban,Gujarat,Crime Against Women,Dowry Deaths,Female,46-60,2523,692,1831,1890,633
2009,Rural,Uttarakhand,Other Crimes,Cyber Crime,Female,46-60,3885,2195,1690,3532,353
2005,Rural,Telangana,Other Crimes,Drug Offense,Female,18-30,9073,4396,4677,5174,3899
2009,Urban,Mizoram,Crime Against Children,Trafficking,Female,0-12,7823,1035,6788,3851,3972
2005,Rural,Gujarat,Crime Against Men,Murder,Female,31-45,3649,1740,1909,3059,590
2007,Rural,Uttarakhand,Crime Against Women,Dowry Deaths,Male,46-60,1387,1229,158,1343,44
2004,Rural,Rajasthan,Crime Against Men,Assault,Male,31-45,7779,6264,1515,7691,88
2007,Rural,Tripura,Crime Against Men,Extortion,Male,18-30,7081,2927,4154,6751,330
2004,Urban,Haryana,Property Crime,Arson,Female,0-12,718,91,627,287,431
2009,Urban,Gujarat,Other Crimes,Cyber Crime,Male,13-17,1724,664,1060,808,916
2004,Rural,Chhattisgarh,Other Crimes,Fraud,Female,0-12,7485,1010,6475,4870,2615
2005,Urban,Sikkim,Crime Against Men,Robbery,Male,46-60,6230,3127,3103,4993,1237
2009,Rural,Delhi,Other Crimes,Cyber Crime,Female,31-45,3500,3070,430,3352,148
2005,Urban,Rajasthan,Crime Against Men,Extortion,Male,13-17,3066,1121,1945,2196,870
2006,Urban,Manipur,Crime Against Children,Child Abuse,Male,0-12,2724,815,1909,2042,682
2006,Rural,Himachal Pradesh,Crime Against Men,Extortion,Male,18-30,8245,4828,3417,5066,3179
2001,Urban,West Bengal,Property Crime,Theft,Female,18-30,1832,1236,596,1633,199
2009,Urban,Tripura,Crime Against Children,Trafficking,Female,13-17,9156,684,8472,6510,2646
2008,Rural,Mizoram,Other Crimes,Fraud,Female,18-30,544,322,222,492,52
2005,Rural,Tamil Nadu,Property Crime,Theft,Male,0-12,622,581,41,614,8
2005,Rural,Himachal Pradesh,Other Crimes,Corruption,Male,18-30,7145,3383,3762,6422,723
2005,Urban,West Bengal,Other Crimes,Corruption,Male,0-12,909,267,642,308,601
2008,Rural,Rajasthan,Property Crime,Vandalism,Female,60+,1989,77,1912,1279,710
2005,Rural,Arunachal Pradesh,Other Crimes,Fraud,Male,31-45,6980,2414,4566,5399,1581
2007,Urban,Tripura,Crime Against Women,Rape,Male,18-30,9659,2421,7238,9081,578
2001,Rural,Telangana,Crime Against Men,Assault,Female,18-30,9975,4444,5531,4736,5239
2003,Rural,Chhattisgarh,Crime Against Children,Kidnapping,Male,31-45,9772,6840,2932,8506,1266
2005,Rural,Delhi,Crime Against Men,Assault,Female,31-45,5379,3703,1676,3985,1394
2004,Rural,Chhattisgarh,Crime Against Men,Robbery,Female,0-12,4502,4106,396,4166,336
2009,Urban,Punjab,Crime Against Children,Trafficking,Male,46-60,8575,7594,981,7831,744
2005,Urban,Madhya Pradesh,Crime Against Men,Extortion,Female,13-17,895,365,530,384,511
2005,Urban,Meghalaya,Crime Against Children,Child Abuse,Male,60+,5673,4399,1274,4426,1247
2008,Rural,Jharkhand,Crime Against Women,Molestation,Female,18-30,663,307,356,525,138
2001,Rural,West Bengal,Property Crime,Theft,Male,18-30,8052,5689,2363,5921,2131
2004,Urban,Uttarakhand,Crime Against Women,Dowry Deaths,Female,46-60,2336,2168,168,2210,126
2007,Rural,Sikkim,Crime Against Men,Murder,Female,31-45,7133,5331,1802,6298,835
2005,Urban,Gujarat,Crime Against Women,Rape,Female,46-60,4395,1881,2514,4105,290
2002,Rural,Nagaland,Crime Against Men,Robbery,Male,13-17,2323,592,1731,1852,471
2010,Urban,West Bengal,Crime Against Children,Child Labor,Female,18-30,1604,141,1463,1282,322
2004,Rural,Tripura,Crime Against Children,Child Labor,Male,13-17,2999,369,2630,1555,1444
2001,Urban,Madhya Pradesh,Crime Against Women,Molestation,Male,60+,178,150,28,163,15
2003,Urban,Arunachal Pradesh,Other Crimes,Corruption,Male,46-60,6150,4328,1822,4563,1587
2005,Rural,Karnataka,Crime Against Children,Trafficking,Female,0-12,2834,2770,64,2790,44
2010,Rural,Andhra Pradesh,Property Crime,Burglary,Male,60+,447,235,212,270,177
2006,Rural,Andhra Pradesh,Property Crime,Burglary,Male,60+,4675,3385,1290,3515,1160
2008,Urban,Maharashtra,Other Crimes,Cyber Crime,Female,0-12,134,106,28,125,9
2004,Urban,Delhi,Property Crime,Burglary,Male,18-30,2869,1295,1574,1865,1004
2001,Rural,Telangana,Other Crimes,Corruption,Male,0-12,2325,2247,78,2259,66
2009,Rural,Arunachal Pradesh,Property Crime,Vandalism,Male,31-45,5473,869,4604,1227,4246
2003,Urban,Delhi,Crime Against Women,Dowry Deaths,Male,31-45,8012,3191,4821,7942,70
2004,Urban,Jharkhand,Other Crimes,Drug Offense,Female,18-30,3935,3110,825,3118,817
2008,Rural,Andhra Pradesh,Crime Against Women,Rape,Female,46-60,8019,2651,5368,3423,4596
2007,Rural,Maharashtra,Crime Against Women,Domestic Violence,Male,18-30,8732,3875,4857,8375,357
2007,Rural,Jammu & Kashmir,Property Crime,Vandalism,Female,31-45,6640,2606,4034,4236,2404
2008,Urban,Arunachal Pradesh,Crime Against Children,Kidnapping,Male,31-45,9350,7814,1536,9279,71
2002,Rural,Haryana,Other Crimes,Cyber Crime,Male,13-17,1859,1085,774,1596,263
2008,Rural,Sikkim,Crime Against Children,Trafficking,Male,18-30,8572,3520,5052,6720,1852
2005,Rural,Rajasthan,Crime Against Children,Child Labor,Female,46-60,7393,4342,3051,7111,282
2009,Urban,Jammu & Kashmir,Other Crimes,Drug Offense,Female,13-17,4901,822,4079,942,3959
2009,Rural,Uttarakhand,Crime Against Children,Trafficking,Male,18-30,2917,19,2898,912,2005
2004,Urban,Uttarakhand,Property Crime,Theft,Female,18-30,4503,3488,1015,3894,609
2001,Urban,Karnataka,Other Crimes,Drug Offense,Female,60+,7291,3934,3357,6063,1228
2005,Rural,Madhya Pradesh,Other Crimes,Fraud,Male,31-45,9690,3719,5971,7286,2404
2004,Rural,Kerala,Property Crime,Vandalism,Male,60+,7709,4456,3253,5024,2685
2001,Urban,Delhi,Crime Against Men,Assault,Male,13-17,3056,160,2896,236,2820
2010,Rural,Karnataka,Property Crime,Arson,Female,31-45,268,231,37,243,25
2008,Rural,West Bengal,Property Crime,Burglary,Male,60+,5329,3143,2186,5312,17
2005,Rural,Jharkhand,Property Crime,Arson,Female,60+,6374,5501,873,5910,464
2003,Rural,Telangana,Crime Against Children,Child Labor,Female,46-60,6625,3478,3147,4355,2270
2002,Rural,Nagaland,Property Crime,Theft,Female,31-45,859,210,649,721,138
2010,Urban,Delhi,Crime Against Men,Robbery,Female,13-17,9773,2734,7039,3813,5960
2007,Urban,Chhattisgarh,Crime Against Men,Murder,Male,60+,6217,3101,3116,3490,2727
2009,Urban,Arunachal Pradesh,Crime Against Women,Domestic Violence,Male,13-17,4087,1906,2181,1997,2090
2007,Urban,Uttar Pradesh,Property Crime,Theft,Female,18-30,1416,1174,242,1250,166
2005,Rural,Jharkhand,Crime Against Men,Murder,Female,13-17,7468,1073,6395,6706,762
2010,Rural,Kerala,Crime Against Women,Dowry Deaths,Male,18-30,2455,1512,943,2343,112
2001,Urban,Uttarakhand,Other Crimes,Drug Offense,Female,18-30,8733,321,8412,330,8403
2010,Rural,West Bengal,Other Crimes,Drug Offense,Female,13-17,6323,4141,2182,5378,945
2009,Rural,Uttarakhand,Other Crimes,Cyber Crime,Male,31-45,5011,1192,3819,3294,1717
2001,Urban,Goa,Crime Against Children,Child Labor,Male,13-17,1824,1185,639,1708,116
2007,Rural,Tripura,Crime Against Men,Assault,Male,0-12,2519,1139,1380,2330,189
2001,Urban,Bihar,Crime Against Men,Murder,Female,31-45,6485,4007,2478,4979,1506
2004,Rural,Assam,Other Crimes,Corruption,Female,46-60,1789,858,931,1220,569
2002,Urban,Mizoram,Other Crimes,Drug Offense,Male,60+,6521,6505,16,6505,16
2006,Urban,Jammu & Kashmir,Property Crime,Vandalism,Female,0-12,4870,412,4458,1624,3246
2002,Rural,Odisha,Crime Against Children,Kidnapping,Female,18-30,4736,4564,172,4607,129
2009,Urban,Goa,Other Crimes,Cyber Crime,Female,0-12,665,508,157,555,110
2007,Rural,Bihar,Crime Against Women,Molestation,Female,31-45,3182,264,2918,3071,111
2005,Rural,Gujarat,Other Crimes,Fraud,Female,0-12,9396,4163,5233,7676,1720
2008,Urban,Jharkhand,Crime Against Children,Child Abuse,Male,46-60,2035,722,1313,1688,347
2004,Rural,Andhra Pradesh,Property Crime,Vandalism,Male,31-45,5114,4303,811,4889,225
2005,Urban,Punjab,Crime Against Children,Kidnapping,Female,18-30,6315,4566,1749,5391,924
2003,Rural,Jammu & Kashmir,Other Crimes,Cyber Crime,Male,13-17,6683,983,5700,5159,1524
2002,Rural,Telangana,Other Crimes,Cyber Crime,Female,0-12,3518,2616,902,3182,336
2007,Urban,Bihar,Crime Against Men,Assault,Female,18-30,8836,979,7857,2832,6004
2002,Rural,West Bengal,Other Crimes,Cyber Crime,Male,0-12,1332,225,1107,358,974
2002,Rural,Odisha,Other Crimes,Corruption,Male,0-12,9892,5739,4153,9693,199
2004,Rural,Arunachal Pradesh,Crime Against Men,Extortion,Female,60+,9573,838,8735,8473,1100
2010,Rural,Sikkim,Property Crime,Theft,Male,18-30,9177,4712,4465,6916,2261
2001,Urban,Punjab,Property Crime,Burglary,Male,13-17,5902,3447,2455,4594,1308
2008,Urban,Manipur,Crime Against Women,Dowry Deaths,Male,18-30,4515,1956,2559,2482,2033
2002,Rural,Sikkim,Property Crime,Burglary,Female,13-17,367,314,53,326,41
2007,Rural,Gujarat,Crime Against Women,Domestic Violence,Female,46-60,9997,5025,4972,9207,790
2009,Rural,Mizoram,Crime Against Children,Child Labor,Female,13-17,1380,1303,77,1370,10
2005,Urban,Madhya Pradesh,Crime Against Children,Child Labor,Male,18-30,7679,3680,3999,6259,1420
2001,Rural,Bihar,Property Crime,Burglary,Male,0-12,7855,884,6971,6922,933
2007,Urban,Maharashtra,Crime Against Children,Child Labor,Male,31-45,2503,2390,113,2497,6
2008,Urban,Haryana,Crime Against Men,Robbery,Male,0-12,4593,1498,3095,2232,2361
2001,Urban,Tamil Nadu,Property Crime,Burglary,Female,60+,192,16,176,152,40
2007,Urban,West Bengal,Crime Against Women,Rape,Male,46-60,2435,2325,110,2378,57
2007,Rural,Rajasthan,Crime Against Children,Child Abuse,Female,13-17,9361,5482,3879,6508,2853
2009,Urban,Mizoram,Crime Against Children,Trafficking,Female,0-12,5572,1170,4402,5070,502
2008,Urban,Kerala,Crime Against Children,Trafficking,Female,60+,4611,4238,373,4439,172
2005,Urban,Bihar,Property Crime,Theft,Female,31-45,3198,3054,144,3176,22
2004,Urban,Chhattisgarh,Crime Against Women,Molestation,Male,13-17,9127,3839,5288,6804,2323
2005,Rural,Madhya Pradesh,Crime Against Women,Dowry Deaths,Female,31-45,8334,4723,3611,7754,580
2009,Rural,Nagaland,Other Crimes,Drug Offense,Female,46-60,7427,4787,2640,7067,360
2006,Rural,Sikkim,Crime Against Men,Extortion,Female,31-45,4917,4203,714,4809,108
2007,Rural,Himachal Pradesh,Property Crime,Burglary,Male,13-17,1865,677,1188,824,1041
2004,Urban,Delhi,Property Crime,Vandalism,Male,31-45,5642,2851,2791,4346,1296
2004,Urban,Meghalaya,Property Crime,Theft,Female,0-12,2784,1880,904,2754,30
2001,Rural,Kerala,Crime Against Children,Child Abuse,Male,46-60,3762,3455,307,3719,43
2004,Rural,Nagaland,Crime Against Men,Murder,Female,13-17,7664,1581,6083,1653,6011
2007,Rural,Rajasthan,Other Crimes,Corruption,Female,60+,5942,2452,3490,5235,707
2001,Urban,Uttarakhand,Crime Against Children,Kidnapping,Female,18-30,6667,3493,3174,5289,1378
2001,Rural,Karnataka,Other Crimes,Corruption,Male,18-30,2053,1441,612,1581,472
2009,Rural,Delhi,Other Crimes,Fraud,Female,0-12,2488,1519,969,1886,602
2007,Urban,Goa,Crime Against Women,Molestation,Female,18-30,1134,778,356,965,169
2002,Rural,Punjab,Crime Against Children,Trafficking,Male,60+,9875,9449,426,9806,69
2004,Urban,West Bengal,Crime Against Women,Domestic Violence,Male,13-17,3273,1489,1784,2256,1017
2006,Urban,Goa,Other Crimes,Cyber Crime,Female,31-45,1207,1180,27,1183,24
2010,Urban,Haryana,Crime Against Men,Murder,Male,60+,707,46,661,317,390
2007,Rural,Himachal Pradesh,Crime Against Children,Trafficking,Female,46-60,7449,3847,3602,4490,2959
2003,Urban,Delhi,Crime Against Women,Domestic Violence,Male,13-17,790,198,592,233,557
2004,Rural,West Bengal,Crime Against Men,Murder,Male,46-60,5158,3827,1331,3907,1251
2008,Rural,Madhya Pradesh,Other Crimes,Fraud,Male,31-45,3926,2863,1063,3758,168
2003,Rural,Punjab,Crime Against Children,Kidnapping,Female,0-12,9944,3078,6866,3176,6768
2007,Rural,Maharashtra,Crime Against Children,Child Labor,Female,0-12,1197,197,1000,557,640
2008,Rural,Sikkim,Property Crime,Theft,Female,60+,8497,2481,6016,6158,2339
2008,Urban,Madhya Pradesh,Crime Against Women,Dowry Deaths,Male,18-30,6711,2559,4152,2637,4074
2008,Urban,Nagaland,Property Crime,Vandalism,Male,31-45,8558,5381,3177,6906,1652
2002,Urban,Rajasthan,Other Crimes,Corruption,Male,18-30,8398,6381,2017,6750,1648
2005,Urban,Uttarakhand,Property Crime,Theft,Male,46-60,5907,935,4972,1560,4347
2010,Rural,Bihar,Other Crimes,Fraud,Male,31-45,3836,985,2851,1816,2020
2009,Rural,Chhattisgarh,Property Crime,Arson,Female,13-17,5031,2592,2439,4261,770
2007,Rural,Uttarakhand,Other Crimes,Drug Offense,Male,18-30,3108,2568,540,3022,86
2003,Rural,Chhattisgarh,Crime Against Men,Robbery,Male,18-30,2189,1324,865,1776,413
2003,Rural,Tripura,Other Crimes,Drug Offense,Male,60+,6809,3973,2836,5325,1484
2004,Rural,Jammu & Kashmir,Crime Against Children,Child Abuse,Male,13-17,5704,4295,1409,5555,149
2001,Rural,Haryana,Property Crime,Burglary,Male,46-60,5367,2482,2885,3345,2022
2010,Urban,Punjab,Other Crimes,Drug Offense,Male,46-60,4467,4337,130,4456,11
2007,Rural,Assam,Property Crime,Vandalism,Female,46-60,9201,940,8261,8440,761
2004,Urban,Mizoram,Crime Against Children,Trafficking,Female,18-30,6765,4992,1773,6153,612
2007,Urban,Gujarat,Other Crimes,Drug Offense,Female,13-17,3557,1757,1800,2290,1267
2005,Urban,Maharashtra,Property Crime,Arson,Male,18-30,9402,4454,4948,5128,4274
2004,Urban,Meghalaya,Crime Against Men,Murder,Female,0-12,9277,3794,5483,8784,493
2004,Rural,Maharashtra,Property Crime,Theft,Male,46-60,6773,4909,1864,4960,1813
2010,Urban,Tripura,Property Crime,Arson,Female,60+,7755,4968,2787,6109,1646
2008,Rural,Kerala,Property Crime,Burglary,Male,18-30,3892,3758,134,3878,14
2007,Urban,Jammu & Kashmir,Crime Against Men,Murder,Female,18-30,7814,5576,2238,6545,1269
2002,Urban,Assam,Other Crimes,Cyber Crime,Female,31-45,7510,5917,1593,6923,587
2009,Rural,Tripura,Crime Against Men,Assault,Female,18-30,1224,956,268,1123,101
2010,Urban,Sikkim,Crime Against Men,Murder,Female,0-12,4797,2225,2572,4332,465
2004,Rural,Gujarat,Property Crime,Theft,Male,0-12,6434,1829,4605,2760,3674
2004,Rural,Jharkhand,Other Crimes,Corruption,Female,31-45,9822,1936,7886,4970,4852
2002,Urban,Rajasthan,Crime Against Men,Extortion,Female,0-12,483,2,481,232,251
2003,Rural,Gujarat,Crime Against Men,Murder,Female,60+,1558,1453,105,1517,41
2001,Rural,Tripura,Crime Against Men,Robbery,Male,0-12,7787,5751,2036,6678,1109
2004,Rural,Chhattisgarh,Property Crime,Arson,Female,46-60,5662,1001,4661,4513,1149
2008,Urban,Sikkim,Property Crime,Arson,Female,13-17,8252,3221,5031,7303,949
2003,Rural,Punjab,Crime Against Children,Trafficking,Male,18-30,1729,1094,635,1520,209
2003,Rural,Himachal Pradesh,Other Crimes,Fraud,Female,18-30,6610,1834,4776,2602,4008
2009,Urban,Sikkim,Crime Against Children,Child Labor,Female,46-60,5340,1772,3568,2389,2951
2001,Rural,Rajasthan,Crime Against Women,Domestic Violence,Female,46-60,4089,1494,2595,3095,994
2004,Urban,Nagaland,Property Crime,Burglary,Female,13-17,9782,2775,7007,8674,1108
2009,Urban,Bihar,Property Crime,Vandalism,Female,18-30,4264,2174,2090,2855,1409
2006,Rural,Assam,Property Crime,Burglary,Female,31-45,3428,1472,1956,3314,114
2003,Urban,Mizoram,Crime Against Men,Robbery,Female,0-12,4928,4718,210,4894,34
2003,Urban,Assam,Crime Against Women,Domestic Violence,Female,18-30,6036,2388,3648,3103,2933
2009,Rural,Goa,Other Crimes,Corruption,Female,13-17,4638,2918,1720,4589,49
2006,Urban,Chhattisgarh,Other Crimes,Fraud,Female,13-17,292,70,222,128,164
2004,Urban,Karnataka,Crime Against Children,Trafficking,Male,31-45,2681,1060,1621,2030,651
2009,Urban,Delhi,Other Crimes,Corruption,Male,13-17,246,74,172,170,76
2010,Urban,Meghalaya,Property Crime,Burglary,Female,0-12,4977,4522,455,4665,312
2010,Rural,Karnataka,Crime Against Children,Trafficking,Female,18-30,6082,4285,1797,5148,934
2009,Urban,Himachal Pradesh,Property Crime,Burglary,Female,60+,264,154,110,205,59
2004,Urban,Andhra Pradesh,Crime Against Men,Murder,Female,13-17,8323,6417,1906,7758,565
2005,Urban,Manipur,Property Crime,Vandalism,Female,46-60,926,735,191,757,169
2007,Rural,West Bengal,Crime Against Women,Rape,Female,13-17,9746,9246,500,9366,380
2006,Urban,West Bengal,Property Crime,Theft,Female,0-12,5477,995,4482,1831,3646
2009,Urban,Telangana,Other Crimes,Corruption,Female,18-30,3736,2977,759,3639,97
2003,Urban,Maharashtra,Crime Against Men,Assault,Female,60+,343,282,61,282,61
2003,Urban,Himachal Pradesh,Property Crime,Theft,Female,0-12,8691,434,8257,2970,5721
2008,Rural,Mizoram,Other Crimes,Fraud,Female,13-17,4485,2775,1710,4426,59
2007,Urban,Jharkhand,Property Crime,Theft,Male,13-17,8506,271,8235,7106,1400
2003,Rural,Maharashtra,Other Crimes,Corruption,Female,46-60,2131,1520,611,1701,430
2004,Urban,Jharkhand,Crime Against Men,Assault,Female,60+,854,182,672,420,434
2007,Urban,Telangana,Property Crime,Theft,Female,31-45,8601,8034,567,8419,182
2005,Rural,Goa,Crime Against Women,Rape,Female,0-12,1167,411,756,783,384
2007,Rural,Jharkhand,Crime Against Women,Dowry Deaths,Male,46-60,248,150,98,216,32
2009,Urban,Himachal Pradesh,Crime Against Men,Robbery,Male,46-60,7964,5679,2285,7274,690
2008,Urban,Telangana,Crime Against Men,Extortion,Male,13-17,4166,1181,2985,3914,252
2003,Urban,Meghalaya,Crime Against Children,Child Abuse,Female,13-17,4238,589,3649,1599,2639
2006,Urban,Jharkhand,Property Crime,Burglary,Male,60+,5502,3826,1676,5448,54
2006,Urban,Tamil Nadu,Property Crime,Arson,Male,0-12,9527,8332,1195,8806,721
2009,Rural,Nagaland,Crime Against Children,Child Abuse,Female,46-60,3286,1248,2038,2306,980
2010,Rural,Uttar Pradesh,Crime Against Men,Murder,Male,31-45,5163,301,4862,1906,3257
2006,Urban,Punjab,Crime Against Children,Kidnapping,Male,0-12,8360,4081,4279,8359,1
2009,Rural,Kerala,Crime Against Children,Child Abuse,Male,13-17,8247,7776,471,8164,83
2005,Rural,Odisha,Other Crimes,Drug Offense,Male,18-30,7725,7707,18,7710,15
2008,Rural,Chhattisgarh,Property Crime,Arson,Female,0-12,9918,1122,8796,7834,2084
2002,Urban,Madhya Pradesh,Other Crimes,Cyber Crime,Female,31-45,5983,1949,4034,4516,1467
2003,Urban,Nagaland,Crime Against Men,Murder,Male,60+,809,796,13,808,1
2006,Rural,Mizoram,Crime Against Men,Robbery,Female,60+,4690,1445,3245,4075,615
2004,Urban,Assam,Other Crimes,Drug Offense,Female,46-60,5920,531,5389,1962,3958
2002,Urban,Tripura,Crime Against Children,Child Abuse,Male,46-60,2896,293,2603,1568,1328
2004,Rural,Karnataka,Crime Against Men,Assault,Male,0-12,4882,2974,1908,3151,1731
2009,Rural,Rajasthan,Property Crime,Burglary,Male,18-30,1772,214,1558,760,1012
2009,Rural,Chhattisgarh,Crime Against Children,Trafficking,Female,0-12,3919,879,3040,3220,699
2007,Rural,Manipur,Crime Against Children,Kidnapping,Female,13-17,5561,1745,3816,3753,1808
2004,Urban,Madhya Pradesh,Crime Against Women,Rape,Female,31-45,9265,6004,3261,8160,1105
2001,Urban,Himachal Pradesh,Crime Against Men,Murder,Female,13-17,8263,5286,2977,5456,2807
2005,Urban,Nagaland,Crime Against Children,Child Labor,Female,13-17,6745,3045,3700,4533,2212
2003,Rural,Meghalaya,Crime Against Children,Kidnapping,Male,0-12,9418,7433,1985,7573,1845
2001,Rural,Himachal Pradesh,Crime Against Women,Molestation,Female,13-17,4026,1142,2884,3436,590
2004,Urban,Jammu & Kashmir,Crime Against Men,Extortion,Male,0-12,6328,5921,407,6038,290
2005,Urban,Sikkim,Crime Against Women,Rape,Female,18-30,203,38,165,56,147
2002,Rural,Tripura,Other Crimes,Drug Offense,Male,13-17,6879,262,6617,2099,4780
2009,Urban,Goa,Property Crime,Vandalism,Male,46-60,7114,6232,882,6787,327
2007,Urban,Sikkim,Property Crime,Arson,Female,18-30,651,322,329,645,6
2008,Rural,Haryana,Other Crimes,Drug Offense,Female,46-60,1311,609,702,1227,84
2003,Rural,Gujarat,Crime Against Men,Robbery,Male,0-12,4717,59,4658,2605,2112
2001,Rural,Uttar Pradesh,Crime Against Men,Extortion,Female,60+,3562,434,3128,3188,374
2010,Rural,Nagaland,Crime Against Men,Extortion,Male,18-30,9360,7217,2143,9097,263
2006,Rural,Uttar Pradesh,Crime Against Children,Child Labor,Male,13-17,2120,7,2113,1252,868
2010,Rural,Bihar,Property Crime,Burglary,Male,0-12,1328,745,583,1237,91
2001,Urban,Bihar,Other Crimes,Cyber Crime,Male,13-17,1069,421,648,790,279
2005,Rural,Telangana,Other Crimes,Cyber Crime,Male,13-17,7578,6378,1200,7345,233
2002,Rural,Arunachal Pradesh,Crime Against Women,Molestation,Female,31-45,140,20,120,97,43
2009,Urban,West Bengal,Other Crimes,Corruption,Female,0-12,1445,762,683,1244,201
2007,Rural,Tamil Nadu,Property Crime,Vandalism,Female,46-60,7216,5893,1323,7147,69
2007,Urban,Meghalaya,Crime Against Children,Kidnapping,Male,31-45,1896,1560,336,1849,47
2008,Rural,Jammu & Kashmir,Property Crime,Arson,Female,31-45,6844,3507,3337,6588,256
2006,Urban,Jharkhand,Property Crime,Arson,Male,60+,3069,1224,1845,2380,689
2008,Urban,Andhra Pradesh,Crime Against Women,Molestation,Female,0-12,5710,2073,3637,3278,2432
2003,Rural,Andhra Pradesh,Other Crimes,Cyber Crime,Male,18-30,9518,6600,2918,8821,697
2004,Urban,Arunachal Pradesh,Crime Against Women,Domestic Violence,Male,18-30,3771,2699,1072,2843,928
2002,Urban,Sikkim,Crime Against Children,Child Labor,Male,18-30,7034,919,6115,4849,2185
2008,Rural,Gujarat,Crime Against Children,Trafficking,Female,60+,8435,6674,1761,7479,956
2007,Urban,Mizoram,Crime Against Children,Child Abuse,Female,0-12,1520,1058,462,1067,453
2007,Rural,Tripura,Crime Against Children,Kidnapping,Male,0-12,5947,823,5124,2985,2962
2010,Urban,Maharashtra,Other Crimes,Cyber Crime,Female,60+,5251,365,4886,2732,2519
2008,Urban,Sikkim,Crime Against Women,Molestation,Female,46-60,2214,643,1571,2114,100
2006,Urban,Telangana,Property Crime,Arson,Male,60+,7927,2507,5420,3414,4513
2008,Urban,Meghalaya,Crime Against Men,Robbery,Male,60+,7289,2122,5167,2562,4727
2010,Rural,Karnataka,Property Crime,Vandalism,Male,46-60,9774,7397,2377,9494,280
2001,Urban,Himachal Pradesh,Property Crime,Burglary,Male,46-60,7341,5531,1810,6310,1031
2005,Urban,Himachal Pradesh,Property Crime,Burglary,Male,13-17,618,614,4,614,4
2002,Rural,Himachal Pradesh,Crime Against Women,Rape,Female,46-60,7255,5539,1716,5844,1411
2006,Urban,Bihar,Crime Against Men,Robbery,Female,0-12,2218,444,1774,1591,627
2006,Urban,West Bengal,Crime Against Children,Child Labor,Male,0-12,430,272,158,360,70
2002,Rural,Assam,Crime Against Children,Child Labor,Male,31-45,4180,1577,2603,2260,1920
2008,Urban,Kerala,Crime Against Women,Rape,Female,60+,9598,6743,2855,7833,1765
2010,Urban,Bihar,Other Crimes,Fraud,Female,0-12,4646,1900,2746,2850,1796
2001,Urban,Rajasthan,Crime Against Children,Child Labor,Male,46-60,9038,7616,1422,8661,377
2004,Rural,Gujarat,Other Crimes,Corruption,Male,18-30,4451,742,3709,3641,810
2002,Urban,Haryana,Crime Against Children,Trafficking,Female,46-60,5020,3305,1715,4039,981
2006,Rural,Bihar,Crime Against Children,Trafficking,Male,60+,5722,1821,3901,2698,3024
2005,Rural,Sikkim,Property Crime,Vandalism,Female,0-12,4490,2356,2134,3644,846
2007,Rural,Gujarat,Crime Against Women,Dowry Deaths,Male,31-45,3078,1660,1418,1968,1110
2007,Rural,Rajasthan,Other Crimes,Corruption,Male,60+,8610,5243,3367,7912,698
2007,Urban,Sikkim,Property Crime,Arson,Male,60+,1945,113,1832,600,1345
2009,Rural,Haryana,Property Crime,Theft,Female,46-60,4140,696,3444,3525,615
2005,Urban,Jammu & Kashmir,Crime Against Men,Extortion,Female,60+,3389,1630,1759,2413,976
2004,Rural,Telangana,Crime Against Women,Domestic Violence,Female,31-45,110,5,105,53,57
2009,Rural,Andhra Pradesh,Other Crimes,Fraud,Male,31-45,1536,1104,432,1227,309
2001,Urban,Manipur,Crime Against Women,Dowry Deaths,Male,46-60,5284,715,4569,1689,3595
2003,Rural,Jharkhand,Property Crime,Burglary,Female,60+,9665,4156,5509,7092,2573
2008,Rural,Andhra Pradesh,Other Crimes,Fraud,Male,60+,8599,3574,5025,4323,4276
2007,Rural,Tamil Nadu,Crime Against Women,Rape,Female,0-12,3773,2737,1036,2796,977
2004,Urban,Uttarakhand,Property Crime,Vandalism,Female,46-60,9287,4491,4796,5134,4153
2007,Rural,Sikkim,Crime Against Children,Trafficking,Male,46-60,6720,1203,5517,3130,3590
2007,Rural,Punjab,Property Crime,Vandalism,Male,13-17,2675,2092,583,2627,48
2003,Rural,Karnataka,Crime Against Children,Child Labor,Male,18-30,68,1,67,31,37
2009,Urban,Chhattisgarh,Crime Against Women,Molestation,Male,0-12,5643,2036,3607,4870,773
2002,Rural,Tamil Nadu,Crime Against Men,Assault,Male,31-45,8186,3310,4876,6259,1927
2001,Urban,Tripura,Crime Against Women,Rape,Female,31-45,4158,1279,2879,4099,59
2003,Rural,Uttarakhand,Other Crimes,Fraud,Male,60+,1274,956,318,1166,108
2009,Urban,Kerala,Property Crime,Theft,Male,46-60,2068,300,1768,497,1571
2004,Rural,West Bengal,Crime Against Women,Domestic Violence,Female,60+,1703,742,961,1097,606
2002,Urban,Telangana,Property Crime,Burglary,Male,31-45,2629,189,2440,557,2072
2006,Urban,Rajasthan,Crime Against Women,Rape,Female,31-45,9102,2528,6574,3504,5598
2008,Rural,Arunachal Pradesh,Other Crimes,Fraud,Male,31-45,3615,235,3380,2567,1048
2004,Rural,Kerala,Crime Against Children,Trafficking,Male,18-30,5714,5017,697,5706,8
2001,Rural,Meghalaya,Crime Against Men,Extortion,Male,0-12,3724,644,3080,1310,2414
2003,Rural,Manipur,Property Crime,Arson,Male,60+,2405,811,1594,2233,172
2001,Rural,Uttar Pradesh,Other Crimes,Drug Offense,Male,31-45,5870,1542,4328,2192,3678
2008,Rural,Assam,Property Crime,Burglary,Female,60+,6569,4565,2004,5820,749
2001,Urban,Maharashtra,Other Crimes,Drug Offense,Male,0-12,1879,1719,160,1726,153
2005,Urban,Kerala,Crime Against Women,Rape,Female,0-12,894,816,78,844,50
2003,Urban,Mizoram,Other Crimes,Drug Offense,Male,18-30,928,667,261,819,109
2008,Rural,Manipur,Property Crime,Vandalism,Male,0-12,5652,4988,664,5250,402
2001,Rural,Gujarat,Property Crime,Burglary,Male,60+,1801,186,1615,361,1440
2001,Rural,Uttar Pradesh,Crime Against Women,Domestic Violence,Male,46-60,4309,3100,1209,3241,1068
2002,Rural,Tripura,Other Crimes,Corruption,Female,18-30,840,614,226,701,139
2008,Rural,Tripura,Property Crime,Arson,Female,0-12,2336,94,2242,389,1947
2005,Rural,Rajasthan,Other Crimes,Corruption,Male,31-45,3263,186,3077,1563,1700
2001,Urban,Assam,Crime Against Men,Extortion,Male,0-12,4614,2745,1869,4459,155
2003,Urban,Nagaland,Other Crimes,Drug Offense,Female,46-60,491,132,359,483,8
2002,Rural,Telangana,Crime Against Women,Molestation,Female,31-45,9949,4365,5584,6661,3288
2005,Urban,Mizoram,Crime Against Men,Assault,Male,60+,4468,3038,1430,3928,540
2004,Rural,Jharkhand,Other Crimes,Cyber Crime,Female,31-45,4807,773,4034,3753,1054
2001,Urban,Manipur,Crime Against Children,Child Labor,Male,31-45,5219,3974,1245,4333,886
2002,Rural,Arunachal Pradesh,Property Crime,Theft,Female,60+,8406,2646,5760,3199,5207
2005,Urban,Gujarat,Crime Against Children,Kidnapping,Female,18-30,8420,3896,4524,4847,3573
2005,Urban,Sikkim,Crime Against Women,Domestic Violence,Female,46-60,4880,426,4454,1381,3499
2008,Rural,Punjab,Crime Against Men,Murder,Female,60+,7352,7317,35,7340,12
2003,Rural,Mizoram,Crime Against Men,Extortion,Female,18-30,3150,459,2691,466,2684
2007,Rural,Telangana,Crime Against Women,Rape,Male,46-60,9636,5888,3748,6905,2731
2002,Urban,Arunachal Pradesh,Crime Against Women,Dowry Deaths,Male,13-17,1033,34,999,891,142
2006,Rural,Madhya Pradesh,Crime Against Men,Extortion,Female,13-17,9427,4101,5326,5028,4399
2005,Rural,Tripura,Crime Against Women,Rape,Male,18-30,6536,4306,2230,6308,228
2005,Urban,Himachal Pradesh,Crime Against Men,Robbery,Male,60+,4515,143,4372,3728,787
2007,Urban,Jammu & Kashmir,Crime Against Men,Assault,Male,0-12,1106,513,593,1043,63
2009,Urban,Punjab,Crime Against Men,Murder,Female,60+,2482,1029,1453,2169,313
2003,Urban,Himachal Pradesh,Crime Against Men,Extortion,Male,31-45,6808,3375,3433,3378,3430
2006,Rural,Chhattisgarh,Crime Against Children,Kidnapping,Male,18-30,4578,2764,1814,3399,1179
2005,Rural,Sikkim,Property Crime,Arson,Male,13-17,5429,5405,24,5412,17
2007,Rural,Delhi,Crime Against Women,Domestic Violence,Male,60+,2871,2851,20,2859,12
2001,Urban,Uttarakhand,Property Crime,Vandalism,Male,31-45,5050,3568,1482,4455,595
2004,Rural,Assam,Property Crime,Burglary,Female,31-45,825,117,708,171,654
2004,Rural,Tamil Nadu,Crime Against Men,Murder,Female,18-30,7587,4558,3029,7194,393
2001,Rural,Karnataka,Crime Against Women,Rape,Female,0-12,2539,1991,548,2366,173
2001,Rural,Kerala,Property Crime,Arson,Female,60+,6495,2909,3586,5354,1141
2008,Rural,Meghalaya,Other Crimes,Cyber Crime,Female,46-60,4398,779,3619,3613,785
2008,Rural,Goa,Crime Against Children,Trafficking,Female,18-30,1630,1504,126,1603,27
2002,Urban,Kerala,Crime Against Men,Assault,Male,0-12,3954,268,3686,375,3579
2002,Rural,Jammu & Kashmir,Crime Against Men,Murder,Female,46-60,4317,963,3354,2149,2168
2004,Rural,Bihar,Property Crime,Arson,Female,0-12,5264,966,4298,3628,1636
2001,Urban,Uttarakhand,Crime Against Children,Child Abuse,Female,60+,9974,7917,2057,8255,1719
2010,Urban,Uttarakhand,Other Crimes,Fraud,Male,18-30,313,113,200,233,80
2002,Rural,Punjab,Crime Against Men,Robbery,Female,18-30,6704,3700,3004,6558,146
2002,Rural,Punjab,Crime Against Men,Murder,Male,13-17,4707,2480,2227,2487,2220
2005,Rural,Jammu & Kashmir,Crime Against Men,Murder,Female,60+,1456,1224,232,1360,96
2006,Urban,Kerala,Property Crime,Burglary,Male,60+,1163,996,167,1144,19
2009,Urban,Uttar Pradesh,Crime Against Children,Child Abuse,Male,0-12,8872,4061,4811,7687,1185
2007,Urban,Kerala,Crime Against Men,Assault,Female,13-17,3903,3897,6,3897,6
2007,Rural,Jammu & Kashmir,Crime Against Men,Robbery,Female,13-17,7715,5178,2537,5556,2159
2005,Urban,Nagaland,Crime Against Women,Rape,Female,60+,4533,3625,908,4393,140
2005,Rural,Tripura,Crime Against Men,Assault,Male,13-17,5151,4604,547,4808,343
2001,Rural,Punjab,Other Crimes,Drug Offense,Female,13-17,7825,6826,999,7047,778
2006,Rural,Sikkim,Crime Against Men,Assault,Male,13-17,9633,3710,5923,4678,4955
2010,Urban,Tripura,Crime Against Children,Child Labor,Male,60+,4367,2235,2132,2761,1606
2006,Rural,Tamil Nadu,Crime Against Children,Kidnapping,Male,13-17,3425,1844,1581,1922,1503
2001,Urban,Assam,Crime Against Children,Child Abuse,Female,46-60,314,239,75,245,69
2002,Rural,Nagaland,Crime Against Women,Rape,Male,60+,6719,677,6042,5500,1219
2010,Urban,Mizoram,Property Crime,Arson,Female,18-30,2868,734,2134,1291,1577
2006,Rural,Sikkim,Other Crimes,Corruption,Female,31-45,2820,79,2741,1499,1321
2007,Rural,Tripura,Crime Against Men,Murder,Male,60+,1249,251,998,1154,95
2008,Rural,West Bengal,Other Crimes,Fraud,Female,13-17,1057,310,747,572,485
2010,Rural,Tripura,Crime Against Men,Assault,Male,13-17,1159,1140,19,1155,4
2004,Rural,Haryana,Crime Against Women,Domestic Violence,Female,31-45,1861,1312,549,1813,48
2002,Rural,Mizoram,Crime Against Women,Rape,Male,31-45,4576,1595,2981,3969,607
2009,Rural,Kerala,Property Crime,Vandalism,Female,13-17,2657,632,2025,846,1811
2004,Rural,Andhra Pradesh,Property Crime,Burglary,Female,18-30,9940,8348,1592,9357,583
2007,Urban,Odisha,Crime Against Men,Robbery,Female,0-12,9415,5776,3639,6651,2764
2010,Rural,Bihar,Other Crimes,Drug Offense,Male,13-17,355,208,147,252,103
2005,Urban,Uttarakhand,Crime Against Children,Trafficking,Female,46-60,5847,347,5500,2819,3028
2003,Urban,Tripura,Crime Against Men,Assault,Female,46-60,5372,2764,2608,4968,404
2008,Urban,Arunachal Pradesh,Crime Against Children,Child Abuse,Male,0-12,7508,1497,6011,2528,4980
2008,Rural,Uttar Pradesh,Property Crime,Theft,Female,31-45,7867,2331,5536,2874,4993
2005,Rural,Odisha,Crime Against Men,Murder,Male,31-45,7393,5818,1575,6594,799
2010,Urban,Kerala,Crime Against Children,Kidnapping,Male,60+,1785,622,1163,1775,10
2002,Urban,Arunachal Pradesh,Other Crimes,Cyber Crime,Male,60+,9905,5410,4495,8348,1557
2005,Rural,Chhattisgarh,Crime Against Women,Dowry Deaths,Female,13-17,8600,3358,5242,6703,1897
2005,Urban,Gujarat,Crime Against Children,Child Labor,Female,31-45,6949,3167,3782,3358,3591
2002,Urban,Jharkhand,Crime Against Women,Dowry Deaths,Male,13-17,3183,1314,1869,2044,1139
2004,Rural,Jammu & Kashmir,Crime Against Women,Molestation,Female,31-45,9190,1189,8001,1638,7552
2009,Urban,Jharkhand,Other Crimes,Cyber Crime,Female,0-12,7454,2225,5229,4150,3304
2010,Rural,Odisha,Crime Against Men,Robbery,Male,18-30,2657,1282,1375,2163,494
2003,Rural,Arunachal Pradesh,Crime Against Children,Child Labor,Male,0-12,2375,1593,782,1937,438
2005,Rural,Arunachal Pradesh,Property Crime,Burglary,Female,0-12,8910,6073,2837,7750,1160
2003,Urban,Sikkim,Crime Against Women,Rape,Male,13-17,4866,772,4094,1827,3039
2002,Rural,West Bengal,Crime Against Men,Assault,Male,60+,3435,194,3241,2662,773
2004,Rural,Uttar Pradesh,Crime Against Children,Child Abuse,Female,60+,8839,6643,2196,8563,276
2005,Rural,Rajasthan,Property Crime,Theft,Male,31-45,8957,3724,5233,6733,2224
2010,Urban,Himachal Pradesh,Other Crimes,Drug Offense,Female,18-30,7871,3085,4786,3268,4603
2003,Rural,Bihar,Other Crimes,Drug Offense,Male,60+,8664,2456,6208,6749,1915
2006,Urban,Meghalaya,Crime Against Children,Child Abuse,Female,0-12,218,33,185,135,83
2004,Rural,Andhra Pradesh,Other Crimes,Drug Offense,Male,18-30,3501,291,3210,2747,754
2001,Urban,Tamil Nadu,Crime Against Women,Rape,Female,31-45,3256,3011,245,3222,34
2001,Urban,Haryana,Other Crimes,Fraud,Female,0-12,984,960,24,968,16
2003,Urban,Assam,Crime Against Men,Extortion,Male,46-60,4026,2643,1383,3007,1019
2007,Urban,Goa,Crime Against Children,Child Abuse,Male,46-60,2012,1709,303,1944,68
2003,Urban,Uttarakhand,Property Crime,Burglary,Female,60+,645,170,475,189,456
2009,Urban,Meghalaya,Crime Against Children,Child Labor,Female,46-60,6064,4193,1871,6041,23
2004,Urban,Meghalaya,Property Crime,Vandalism,Male,18-30,5241,860,4381,4317,924
2001,Rural,Haryana,Crime Against Children,Child Abuse,Male,13-17,2265,691,1574,2077,188
2006,Rural,Arunachal Pradesh,Other Crimes,Cyber Crime,Female,18-30,8084,302,7782,3682,4402
2004,Rural,Sikkim,Other Crimes,Cyber Crime,Female,0-12,8956,2200,6756,5582,3374
2001,Rural,Rajasthan,Crime Against Men,Murder,Female,18-30,9905,7852,2053,9155,750
2007,Rural,Bihar,Crime Against Children,Kidnapping,Female,0-12,4735,4175,560,4397,338
2007,Rural,Nagaland,Crime Against Men,Extortion,Female,18-30,3416,1183,2233,3325,91
2003,Urban,Uttarakhand,Crime Against Children,Trafficking,Female,13-17,4410,3226,1184,3514,896
2004,Rural,Kerala,Other Crimes,Drug Offense,Female,13-17,4798,704,4094,1824,2974
2003,Urban,Mizoram,Crime Against Men,Murder,Male,46-60,2132,947,1185,1250,882
2004,Rural,Andhra Pradesh,Crime Against Children,Child Abuse,Male,60+,2473,805,1668,1910,563
2007,Urban,Telangana,Crime Against Women,Rape,Male,31-45,1970,963,1007,1829,141
2002,Urban,Jammu & Kashmir,Other Crimes,Fraud,Female,13-17,1925,470,1455,1894,31
2008,Urban,Chhattisgarh,Crime Against Children,Trafficking,Female,31-45,5210,4993,217,5164,46
2005,Rural,Jharkhand,Crime Against Children,Child Labor,Female,31-45,8110,7819,291,7830,280
2004,Rural,Himachal Pradesh,Property Crime,Burglary,Male,31-45,1323,75,1248,1262,61
2001,Rural,Meghalaya,Crime Against Women,Rape,Female,60+,2720,1749,971,2335,385
2009,Urban,Tripura,Crime Against Children,Child Labor,Female,46-60,4665,2484,2181,4242,423
2009,Urban,West Bengal,Property Crime,Theft,Male,13-17,8381,3144,5237,4276,4105
2005,Urban,Nagaland,Crime Against Women,Domestic Violence,Male,0-12,4741,2641,2100,3740,1001
2002,Urban,Telangana,Property Crime,Arson,Male,0-12,3471,3415,56,3428,43
2008,Rural,Jammu & Kashmir,Crime Against Children,Trafficking,Female,46-60,3665,1118,2547,1220,2445
2006,Urban,Sikkim,Other Crimes,Corruption,Female,31-45,8759,5941,2818,7010,1749
2002,Urban,Odisha,Crime Against Men,Murder,Female,13-17,8156,1855,6301,5375,2781
2005,Rural,Haryana,Crime Against Children,Trafficking,Male,18-30,2429,82,2347,1728,701
2008,Urban,Uttarakhand,Other Crimes,Fraud,Male,0-12,9261,4759,4502,5135,4126
2004,Rural,Gujarat,Other Crimes,Drug Offense,Female,13-17,5674,2097,3577,4549,1125
2002,Rural,Telangana,Crime Against Children,Child Abuse,Female,18-30,3344,401,2943,2133,1211
2008,Rural,Uttarakhand,Crime Against Women,Rape,Male,46-60,4188,2622,1566,3177,1011
2009,Urban,Andhra Pradesh,Property Crime,Theft,Female,13-17,7791,7529,262,7582,209
2005,Rural,Meghalaya,Crime Against Women,Rape,Male,46-60,6009,5403,606,5772,237
2008,Urban,Chhattisgarh,Other Crimes,Fraud,Female,13-17,2514,603,1911,1337,1177
2003,Urban,Mizoram,Crime Against Children,Kidnapping,Male,0-12,8266,4747,3519,5738,2528
2007,Rural,Odisha,Crime Against Men,Extortion,Male,18-30,77,17,60,60,17
2004,Rural,Goa,Crime Against Children,Child Labor,Female,13-17,333,246,87,290,43
2001,Rural,Mizoram,Crime Against Women,Rape,Male,0-12,1140,587,553,882,258
2003,Rural,Madhya Pradesh,Property Crime,Vandalism,Female,60+,6858,4311,2547,6784,74
2006,Rural,Odisha,Property Crime,Arson,Female,46-60,4066,1812,2254,3167,899
2005,Rural,Haryana,Property Crime,Arson,Female,18-30,7927,2645,5282,5885,2042
2004,Urban,Tripura,Crime Against Women,Molestation,Female,31-45,3736,1598,2138,1754,1982
2007,Rural,Assam,Crime Against Men,Robbery,Male,18-30,1656,1550,106,1560,96
2009,Urban,Chhattisgarh,Other Crimes,Cyber Crime,Female,46-60,4799,702,4097,2350,2449
2008,Rural,Karnataka,Crime Against Children,Trafficking,Female,46-60,8709,7083,1626,7387,1322
2007,Rural,Jammu & Kashmir,Other Crimes,Cyber Crime,Female,31-45,2284,1498,786,1683,601
2008,Urban,Haryana,Property Crime,Arson,Female,0-12,6241,5693,548,5853,388
2008,Urban,Tripura,Other Crimes,Fraud,Male,60+,2590,1796,794,2371,219
2002,Urban,Kerala,Other Crimes,Fraud,Female,13-17,5690,4912,778,5099,591
2009,Rural,Uttarakhand,Crime Against Men,Extortion,Female,13-17,717,29,688,622,95
2004,Rural,Gujarat,Other Crimes,Fraud,Male,0-12,3846,1844,2002,2630,1216
2008,Urban,Arunachal Pradesh,Property Crime,Arson,Male,18-30,6200,5943,257,6007,193
2008,Rural,Gujarat,Crime Against Women,Dowry Deaths,Female,18-30,1190,434,756,1069,121
2005,Urban,Mizoram,Crime Against Women,Dowry Deaths,Female,31-45,5879,5601,278,5625,254
2007,Rural,Andhra Pradesh,Other Crimes,Fraud,Male,0-12,2268,1250,1018,2217,51
2010,Urban,Karnataka,Other Crimes,Fraud,Female,18-30,1178,595,583,981,197
2002,Rural,Uttarakhand,Crime Against Men,Murder,Female,60+,7096,850,6246,1814,5282
2007,Urban,Punjab,Property Crime,Theft,Male,60+,3917,1881,2036,2105,1812
2003,Urban,Jharkhand,Crime Against Women,Domestic Violence,Male,60+,6481,5459,1022,5777,704
2006,Urban,Tripura,Crime Against Women,Molestation,Male,46-60,9408,340,9068,8960,448
2010,Rural,Tamil Nadu,Crime Against Women,Domestic Violence,Male,18-30,631,443,188,623,8
2007,Urban,Jharkhand,Crime Against Women,Rape,Male,0-12,9637,4841,4796,7029,2608
2006,Urban,Manipur,Crime Against Men,Assault,Male,46-60,1126,773,353,951,175
2007,Rural,Maharashtra,Crime Against Women,Rape,Male,13-17,172,91,81,95,77
2002,Urban,Sikkim,Crime Against Children,Trafficking,Male,18-30,5780,1319,4461,4410,1370
2001,Rural,West Bengal,Crime Against Children,Child Labor,Female,31-45,7532,5846,1686,5914,1618
2001,Urban,Jammu & Kashmir,Crime Against Children,Kidnapping,Female,31-45,7359,4007,3352,5758,1601
2002,Urban,Telangana,Crime Against Men,Extortion,Female,60+,4442,2754,1688,4439,3
2005,Urban,Punjab,Property Crime,Vandalism,Female,46-60,5366,5056,310,5154,212
2001,Urban,Maharashtra,Other Crimes,Fraud,Female,46-60,2278,1853,425,2213,65
2007,Urban,Goa,Crime Against Men,Assault,Female,60+,4417,1608,2809,3475,942
2007,Rural,Chhattisgarh,Other Crimes,Cyber Crime,Male,18-30,5985,3992,1993,5884,101
2007,Urban,Haryana,Property Crime,Vandalism,Female,60+,6648,3702,2946,4632,2016
2005,Urban,Sikkim,Property Crime,Burglary,Male,13-17,3868,2253,1615,3440,428
2003,Rural,Tripura,Property Crime,Arson,Male,18-30,6120,4541,1579,4747,1373
2005,Urban,Arunachal Pradesh,Other Crimes,Corruption,Female,31-45,8434,3796,4638,7468,966
2001,Rural,Maharashtra,Crime Against Children,Trafficking,Female,46-60,4905,1673,3232,4272,633
2009,Urban,Goa,Property Crime,Arson,Female,46-60,1893,1363,530,1409,484
2004,Rural,Delhi,Crime Against Women,Domestic Violence,Male,0-12,8379,8218,161,8227,152
2005,Urban,Maharashtra,Crime Against Women,Molestation,Female,46-60,1511,1103,408,1381,130
2003,Rural,Haryana,Other Crimes,Drug Offense,Female,18-30,1417,1052,365,1275,142
2004,Urban,Gujarat,Crime Against Children,Kidnapping,Male,46-60,7209,2857,4352,6269,940
2006,Urban,Andhra Pradesh,Other Crimes,Corruption,Female,0-12,4166,2241,1925,3443,723
2009,Urban,Goa,Crime Against Children,Child Labor,Male,13-17,6883,5313,1570,5758,1125
2008,Rural,Telangana,Crime Against Women,Domestic Violence,Female,31-45,7530,2232,5298,3528,4002
2006,Rural,West Bengal,Property Crime,Theft,Male,13-17,3028,2652,376,2963,65
2005,Urban,Haryana,Crime Against Women,Rape,Female,31-45,3779,1622,2157,1944,1835
2010,Rural,Himachal Pradesh,Crime Against Men,Murder,Male,46-60,3942,2190,1752,3366,576
2004,Rural,Gujarat,Crime Against Women,Rape,Male,60+,469,213,256,333,136
2009,Rural,Chhattisgarh,Crime Against Women,Molestation,Female,0-12,1368,341,1027,828,540
2008,Urban,Rajasthan,Crime Against Children,Kidnapping,Male,46-60,2220,64,2156,2104,116
2001,Urban,Tripura,Other Crimes,Corruption,Male,60+,404,15,389,214,190
2010,Urban,Manipur,Crime Against Women,Molestation,Male,18-30,4550,2974,1576,3234,1316
2008,Urban,Uttar Pradesh,Other Crimes,Drug Offense,Male,0-12,4417,2016,2401,2721,1696
2006,Rural,Odisha,Other Crimes,Cyber Crime,Female,31-45,8789,930,7859,1143,7646
2004,Urban,Rajasthan,Crime Against Children,Trafficking,Male,31-45,6994,4133,2861,4516,2478
2005,Rural,Manipur,Crime Against Women,Molestation,Male,46-60,8350,4168,4182,6093,2257
2008,Rural,Tripura,Other Crimes,Cyber Crime,Female,46-60,9344,1649,7695,4776,4568
2005,Urban,Bihar,Other Crimes,Fraud,Male,60+,3097,118,2979,2374,723
2003,Urban,Kerala,Other Crimes,Corruption,Female,18-30,7564,7209,355,7263,301
2007,Rural,Tripura,Crime Against Children,Child Abuse,Female,0-12,5176,1466,3710,2475,2701
2004,Urban,Kerala,Crime Against Children,Trafficking,Female,18-30,5278,3052,2226,4734,544
2001,Urban,Goa,Other Crimes,Drug Offense,Female,60+,8681,6615,2066,7918,763
2002,Rural,Himachal Pradesh,Crime Against Men,Robbery,Female,31-45,9572,9277,295,9464,108
2004,Urban,Assam,Property Crime,Vandalism,Female,13-17,675,415,260,539,136
2003,Urban,Odisha,Other Crimes,Cyber Crime,Male,60+,3437,1131,2306,1603,1834
2001,Urban,Andhra Pradesh,Other Crimes,Drug Offense,Female,13-17,1977,1508,469,1908,69
2001,Urban,Telangana,Crime Against Children,Child Labor,Female,0-12,1104,140,964,547,557
2004,Rural,Karnataka,Property Crime,Vandalism,Male,60+,2338,2059,279,2230,108
2001,Rural,Uttarakhand,Crime Against Children,Trafficking,Female,46-60,1149,791,358,1134,15
2004,Urban,Telangana,Crime Against Women,Domestic Violence,Female,60+,9836,7772,2064,8125,1711
2007,Rural,Sikkim,Property Crime,Vandalism,Male,13-17,4189,1729,2460,3251,938
2006,Rural,Himachal Pradesh,Crime Against Children,Child Abuse,Male,13-17,4589,3045,1544,4350,239
2003,Rural,Goa,Property Crime,Vandalism,Female,31-45,1781,315,1466,1727,54
2006,Urban,Jammu & Kashmir,Crime Against Women,Dowry Deaths,Male,13-17,8067,1754,6313,7489,578
2002,Rural,Punjab,Other Crimes,Corruption,Female,18-30,5453,3466,1987,3548,1905
2010,Urban,West Bengal,Crime Against Women,Rape,Male,0-12,3233,1991,1242,2606,627
2001,Urban,Jharkhand,Crime Against Women,Dowry Deaths,Male,46-60,2020,134,1886,1950,70
2002,Rural,Maharashtra,Property Crime,Theft,Male,60+,8976,2731,6245,6994,1982
2009,Rural,Assam,Other Crimes,Drug Offense,Female,31-45,4265,4037,228,4098,167
2003,Rural,Maharashtra,Crime Against Women,Molestation,Male,60+,3013,1549,1464,2647,366
2004,Urban,Chhattisgarh,Other Crimes,Drug Offense,Male,46-60,152,104,48,136,16
2004,Rural,Arunachal Pradesh,Property Crime,Burglary,Male,31-45,6494,1020,5474,2201,4293
2008,Rural,Jammu & Kashmir,Crime Against Children,Child Abuse,Male,46-60,3142,1768,1374,2449,693
2006,Rural,Gujarat,Crime Against Men,Murder,Female,31-45,2032,1610,422,1841,191
2010,Rural,Tamil Nadu,Crime Against Children,Trafficking,Male,31-45,6209,4484,1725,5538,671
2007,Rural,West Bengal,Property Crime,Burglary,Female,46-60,4940,682,4258,778,4162
2008,Urban,Goa,Crime Against Women,Dowry Deaths,Male,13-17,4954,4031,923,4313,641
2010,Rural,Himachal Pradesh,Other Crimes,Drug Offense,Male,18-30,5813,2793,3020,4378,1435
2009,Urban,Meghalaya,Crime Against Children,Child Labor,Male,60+,9696,3395,6301,6183,3513
2009,Urban,Goa,Crime Against Children,Kidnapping,Female,46-60,731,692,39,699,32
2006,Rural,West Bengal,Other Crimes,Corruption,Male,46-60,9722,7488,2234,9072,650
2007,Urban,Haryana,Other Crimes,Fraud,Male,46-60,1559,722,837,978,581
2001,Rural,Andhra Pradesh,Other Crimes,Fraud,Male,46-60,1815,248,1567,1194,621
2001,Urban,Manipur,Crime Against Children,Kidnapping,Female,0-12,5783,4040,1743,5290,493
2007,Rural,Goa,Crime Against Women,Dowry Deaths,Female,60+,7011,5250,1761,5826,1185
2007,Urban,Goa,Property Crime,Burglary,Male,60+,8180,7209,971,7305,875
2010,Urban,Bihar,Crime Against Children,Child Abuse,Female,60+,5072,4896,176,4964,108
2004,Urban,Sikkim,Crime Against Women,Rape,Male,60+,8258,1455,6803,7491,767
2001,Rural,Manipur,Other Crimes,Fraud,Female,46-60,6302,1315,4987,3030,3272
2007,Urban,Uttar Pradesh,Crime Against Women,Dowry Deaths,Female,46-60,2855,1102,1753,2636,219
2010,Urban,Telangana,Crime Against Women,Domestic Violence,Male,31-45,6965,3994,2971,5127,1838
2008,Urban,Karnataka,Crime Against Children,Trafficking,Female,31-45,7403,1578,5825,4066,3337
2009,Urban,Punjab,Crime Against Women,Rape,Female,31-45,2196,526,1670,672,1524
2010,Rural,Telangana,Crime Against Men,Assault,Female,46-60,7980,1278,6702,6587,1393
2005,Urban,Kerala,Crime Against Men,Murder,Female,0-12,4832,1913,2919,2742,2090
2002,Rural,Arunachal Pradesh,Crime Against Men,Extortion,Male,0-12,7472,2573,4899,3118,4354
2008,Rural,Andhra Pradesh,Crime Against Women,Domestic Violence,Female,31-45,6823,1239,5584,3953,2870
2009,Rural,Chhattisgarh,Property Crime,Vandalism,Female,46-60,3204,159,3045,630,2574
2007,Rural,Kerala,Property Crime,Burglary,Male,31-45,4195,2062,2133,2308,1887
2005,Urban,Haryana,Crime Against Children,Child Abuse,Male,0-12,673,551,122,644,29
2009,Urban,Jharkhand,Crime Against Children,Child Abuse,Female,31-45,9095,588,8507,9070,25
2002,Urban,Rajasthan,Crime Against Children,Kidnapping,Female,31-45,8865,8596,269,8816,49
2009,Rural,Gujarat,Property Crime,Burglary,Female,13-17,8690,8490,200,8577,113
2006,Urban,Mizoram,Crime Against Women,Rape,Male,13-17,7464,2236,5228,6171,1293
2008,Urban,Mizoram,Property Crime,Vandalism,Male,31-45,1773,1180,593,1302,471
2005,Urban,Chhattisgarh,Other Crimes,Drug Offense,Male,13-17,2469,1415,1054,2393,76
2008,Rural,Jharkhand,Property Crime,Vandalism,Male,13-17,9745,131,9614,5706,4039
2001,Rural,Andhra Pradesh,Crime Against Children,Trafficking,Female,46-60,9691,5390,4301,7859,1832
2002,Urban,Telangana,Crime Against Children,Child Abuse,Female,18-30,1003,1001,2,1002,1
2010,Urban,West Bengal,Crime Against Men,Assault,Male,18-30,3515,1374,2141,1424,2091
2003,Urban,Haryana,Property Crime,Vandalism,Male,0-12,7706,1722,5984,4626,3080
2003,Urban,Bihar,Crime Against Children,Kidnapping,Female,60+,9777,4780,4997,6981,2796
2009,Urban,Goa,Property Crime,Burglary,Male,13-17,7777,5634,2143,7375,402
2007,Urban,Meghalaya,Other Crimes,Drug Offense,Male,31-45,3350,2,3348,1651,1699
2003,Rural,Goa,Crime Against Women,Rape,Male,13-17,9765,4915,4850,7802,1963
2008,Urban,Rajasthan,Crime Against Women,Rape,Male,0-12,7079,5715,1364,6812,267
2001,Rural,Sikkim,Property Crime,Vandalism,Male,60+,9999,2844,7155,3764,6235
2006,Urban,Assam,Property Crime,Burglary,Male,31-45,9191,7671,1520,8048,1143
2010,Urban,Chhattisgarh,Crime Against Children,Child Labor,Male,18-30,8332,4960,3372,6259,2073
2002,Urban,Uttar Pradesh,Other Crimes,Corruption,Female,18-30,965,98,867,200,765
2004,Rural,Haryana,Other Crimes,Corruption,Male,60+,187,66,121,148,39
2003,Rural,Manipur,Crime Against Women,Rape,Female,60+,834,525,309,782,52
2005,Rural,Haryana,Other Crimes,Corruption,Male,31-45,7855,3151,4704,3213,4642
2004,Rural,Karnataka,Property Crime,Arson,Female,46-60,6116,1320,4796,3421,2695
2002,Rural,Maharashtra,Property Crime,Burglary,Male,0-12,9338,5447,3891,7374,1964
2006,Urban,Andhra Pradesh,Crime Against Men,Robbery,Female,13-17,8990,214,8776,5321,3669
2004,Urban,Goa,Crime Against Men,Assault,Female,18-30,1646,388,1258,940,706
2009,Urban,Maharashtra,Crime Against Women,Molestation,Male,31-45,2856,2708,148,2802,54
2005,Urban,Odisha,Other Crimes,Cyber Crime,Male,46-60,4241,195,4046,3721,520
2003,Urban,Himachal Pradesh,Crime Against Men,Assault,Female,18-30,3426,2910,516,2946,480
2010,Urban,Gujarat,Property Crime,Burglary,Female,18-30,3263,289,2974,2548,715
2002,Urban,Tripura,Property Crime,Burglary,Female,18-30,1573,1133,440,1350,223
2010,Rural,Chhattisgarh,Crime Against Women,Dowry Deaths,Male,18-30,8633,5001,3632,7439,1194
2006,Rural,Himachal Pradesh,Crime Against Women,Rape,Female,13-17,7232,5446,1786,5657,1575
2004,Urban,Tamil Nadu,Crime Against Children,Child Abuse,Male,13-17,4779,2270,2509,3830,949
2009,Urban,Uttar Pradesh,Crime Against Children,Trafficking,Male,18-30,6120,558,5562,1590,4530
2007,Urban,Gujarat,Crime Against Men,Robbery,Female,0-12,61,41,20,44,17
2008,Urban,Jharkhand,Crime Against Women,Dowry Deaths,Male,0-12,8343,2185,6158,6630,1713
2001,Urban,Goa,Crime Against Men,Assault,Male,60+,4971,3128,1843,4764,207
2001,Rural,Nagaland,Property Crime,Burglary,Male,31-45,3815,546,3269,1113,2702
2001,Urban,Himachal Pradesh,Crime Against Men,Murder,Female,46-60,6375,6216,159,6232,143
2002,Urban,Punjab,Crime Against Children,Child Abuse,Female,0-12,7686,7071,615,7640,46
2009,Rural,Sikkim,Crime Against Men,Robbery,Male,46-60,544,431,113,535,9
2001,Rural,Manipur,Crime Against Children,Child Labor,Female,31-45,3321,1239,2082,3116,205
2010,Urban,Mizoram,Crime Against Women,Molestation,Female,31-45,2454,634,1820,786,1668
2004,Urban,Telangana,Crime Against Children,Kidnapping,Female,18-30,1695,1519,176,1627,68
2004,Rural,Delhi,Crime Against Children,Child Labor,Male,18-30,6614,5292,1322,6563,51
2009,Rural,Tripura,Crime Against Women,Molestation,Female,13-17,3048,2696,352,2994,54
2004,Urban,Uttarakhand,Crime Against Men,Murder,Female,0-12,1950,1806,144,1874,76
2005,Urban,Jharkhand,Crime Against Men,Robbery,Male,31-45,7510,4313,3197,6232,1278
2005,Rural,Delhi,Crime Against Children,Kidnapping,Female,46-60,4739,1520,3219,2750,1989
2007,Rural,Nagaland,Crime Against Children,Child Abuse,Male,0-12,3846,130,3716,512,3334
2003,Urban,Sikkim,Property Crime,Theft,Female,31-45,122,51,71,113,9
2002,Rural,Tamil Nadu,Property Crime,Theft,Male,0-12,2137,2081,56,2099,38
2001,Rural,Sikkim,Other Crimes,Corruption,Male,18-30,9196,4636,4560,8655,541
2009,Rural,Goa,Crime Against Children,Kidnapping,Female,60+,3830,1129,2701,3329,501
2007,Urban,Jharkhand,Crime Against Children,Child Labor,Male,0-12,693,116,577,627,66
2010,Rural,Nagaland,Crime Against Children,Trafficking,Male,13-17,322,275,47,321,1
2006,Urban,West Bengal,Crime Against Men,Murder,Female,46-60,6002,5,5997,2844,3158
2006,Rural,Tamil Nadu,Property Crime,Burglary,Male,46-60,8908,2631,6277,6123,2785
2007,Urban,Tamil Nadu,Property Crime,Burglary,Female,0-12,4925,705,4220,4087,838
2008,Rural,Gujarat,Crime Against Men,Extortion,Male,13-17,8550,1216,7334,1819,6731
2010,Urban,Haryana,Crime Against Women,Molestation,Male,13-17,1091,517,574,844,247
2002,Rural,West Bengal,Crime Against Men,Extortion,Male,60+,8864,7398,1466,8772,92
2005,Rural,Jharkhand,Crime Against Children,Child Labor,Female,46-60,4303,4053,250,4278,25
2004,Rural,Tripura,Crime Against Men,Murder,Female,31-45,9007,5991,3016,7518,1489
2005,Urban,Uttarakhand,Property Crime,Theft,Male,46-60,4849,1343,3506,2064,2785
2003,Rural,Jharkhand,Crime Against Women,Dowry Deaths,Male,18-30,3202,3164,38,3192,10
2009,Rural,Goa,Crime Against Children,Kidnapping,Male,13-17,3069,2418,651,2735,334
2003,Urban,Karnataka,Other Crimes,Fraud,Female,31-45,4312,731,3581,2006,2306
2009,Urban,Bihar,Crime Against Men,Murder,Female,18-30,9197,4394,4803,7912,1285
2010,Rural,Uttar Pradesh,Property Crime,Vandalism,Female,18-30,2988,2631,357,2773,215
2008,Urban,Nagaland,Crime Against Women,Dowry Deaths,Male,0-12,8047,6226,1821,7174,873
2001,Rural,Madhya Pradesh,Crime Against Children,Child Labor,Male,46-60,315,198,117,231,84
2008,Urban,Manipur,Other Crimes,Cyber Crime,Female,46-60,2564,1186,1378,1258,1306
2008,Urban,Delhi,Crime Against Children,Trafficking,Male,60+,8417,4969,3448,5062,3355
2002,Urban,Andhra Pradesh,Crime Against Women,Domestic Violence,Female,60+,8492,2523,5969,6375,2117
2004,Urban,Bihar,Crime Against Women,Molestation,Male,0-12,5492,2678,2814,4794,698
2003,Rural,Jharkhand,Crime Against Women,Rape,Male,18-30,4176,320,3856,2487,1689
2002,Urban,Assam,Property Crime,Arson,Male,46-60,5730,1591,4139,2602,3128
2009,Rural,West Bengal,Crime Against Children,Kidnapping,Male,46-60,9577,6652,2925,6837,2740
2007,Urban,Uttar Pradesh,Other Crimes,Corruption,Female,13-17,8273,3200,5073,7350,923
2010,Rural,Madhya Pradesh,Other Crimes,Fraud,Male,46-60,2099,489,1610,889,1210
2003,Urban,Tripura,Other Crimes,Drug Offense,Female,18-30,2428,228,2200,1760,668
2002,Urban,Sikkim,Property Crime,Burglary,Female,60+,3840,2237,1603,2784,1056
2007,Urban,Haryana,Property Crime,Vandalism,Female,60+,3204,575,2629,1528,1676
2010,Urban,Kerala,Crime Against Women,Molestation,Male,60+,7215,2981,4234,3825,3390
2005,Urban,Kerala,Other Crimes,Drug Offense,Male,46-60,8851,8732,119,8780,71
2008,Rural,Assam,Crime Against Men,Murder,Male,31-45,3182,3157,25,3157,25
2005,Rural,Arunachal Pradesh,Crime Against Children,Child Abuse,Female,60+,313,212,101,242,71
2005,Urban,Rajasthan,Crime Against Women,Molestation,Female,18-30,5279,557,4722,5093,186
2009,Rural,Tamil Nadu,Crime Against Children,Child Abuse,Male,0-12,9117,5852,3265,7700,1417
2005,Urban,Jharkhand,Property Crime,Vandalism,Female,18-30,9583,729,8854,6375,3208
2006,Urban,Mizoram,Crime Against Children,Child Abuse,Female,60+,1693,861,832,1567,126
2007,Urban,Mizoram,Crime Against Men,Robbery,Male,46-60,7763,5148,2615,7620,143
2005,Rural,Uttar Pradesh,Other Crimes,Drug Offense,Female,46-60,794,640,154,777,17
2001,Urban,Telangana,Crime Against Men,Extortion,Female,18-30,7894,505,7389,1418,6476
2001,Rural,Mizoram,Other Crimes,Fraud,Male,0-12,7450,3016,4434,5177,2273
2004,Rural,Tripura,Property Crime,Burglary,Male,0-12,3067,289,2778,889,2178
2002,Rural,Haryana,Other Crimes,Cyber Crime,Male,31-45,2762,536,2226,984,1778
2008,Urban,Mizoram,Crime Against Women,Dowry Deaths,Female,31-45,5663,475,5188,2663,3000
2009,Urban,Goa,Property Crime,Burglary,Male,46-60,3971,2913,1058,3024,947
2005,Urban,Bihar,Other Crimes,Drug Offense,Female,13-17,6484,3325,3159,4230,2254
2006,Rural,Madhya Pradesh,Crime Against Children,Trafficking,Female,13-17,2127,1650,477,1814,313
2006,Urban,Mizoram,Crime Against Children,Trafficking,Male,13-17,1783,1766,17,1781,2
2007,Rural,Arunachal Pradesh,Other Crimes,Corruption,Female,60+,870,3,867,151,719
2009,Rural,Himachal Pradesh,Property Crime,Theft,Female,0-12,4705,3444,1261,3602,1103
2003,Urban,Tripura,Property Crime,Arson,Female,46-60,500,3,497,381,119
2009,Rural,West Bengal,Crime Against Children,Child Abuse,Female,60+,9133,3122,6011,5533,3600
2008,Urban,Nagaland,Other Crimes,Cyber Crime,Female,46-60,7917,2461,5456,3206,4711
2006,Rural,Telangana,Other Crimes,Drug Offense,Male,13-17,7199,6441,758,7187,12
2001,Rural,Arunachal Pradesh,Crime Against Children,Kidnapping,Female,18-30,7268,5774,1494,6949,319
2002,Rural,Nagaland,Other Crimes,Drug Offense,Female,31-45,4656,4299,357,4423,233
2001,Rural,Manipur,Crime Against Women,Dowry Deaths,Female,46-60,8992,2237,6755,6977,2015
2008,Urban,Tripura,Property Crime,Arson,Male,18-30,4510,1162,3348,3158,1352
2008,Rural,Punjab,Crime Against Men,Murder,Male,13-17,8683,5399,3284,7259,1424
2006,Rural,Jammu & Kashmir,Other Crimes,Corruption,Female,60+,3485,2293,1192,2742,743
2002,Rural,Rajasthan,Crime Against Children,Child Labor,Female,46-60,8891,1531,7360,4098,4793
2004,Rural,Gujarat,Other Crimes,Cyber Crime,Male,31-45,9987,2095,7892,3747,6240
2003,Rural,Punjab,Crime Against Men,Robbery,Female,46-60,6290,3810,2480,5481,809
2010,Rural,Maharashtra,Property Crime,Vandalism,Female,13-17,3862,528,3334,3763,99
2006,Urban,Andhra Pradesh,Crime Against Women,Molestation,Female,31-45,5964,243,5721,5143,821
2007,Urban,Mizoram,Crime Against Children,Trafficking,Male,0-12,6283,878,5405,2592,3691
2009,Urban,Karnataka,Crime Against Children,Child Abuse,Male,0-12,9460,9453,7,9458,2
2004,Urban,Jammu & Kashmir,Crime Against Women,Rape,Male,60+,399,64,335,330,69
2004,Urban,Nagaland,Crime Against Children,Kidnapping,Male,46-60,1809,219,1590,867,942
2003,Urban,West Bengal,Crime Against Women,Dowry Deaths,Male,18-30,4963,3562,1401,3787,1176
2004,Rural,Jammu & Kashmir,Crime Against Children,Child Abuse,Female,60+,9250,5816,3434,7289,1961
2006,Urban,Chhattisgarh,Property Crime,Burglary,Male,31-45,955,272,683,521,434
2007,Rural,Maharashtra,Crime Against Women,Dowry Deaths,Female,31-45,4657,1752,2905,2856,1801
2003,Urban,Punjab,Crime Against Women,Molestation,Male,60+,8247,5330,2917,6003,2244
2006,Rural,Maharashtra,Crime Against Men,Extortion,Female,18-30,2663,1556,1107,1780,883
2008,Rural,Bihar,Crime Against Children,Child Labor,Male,18-30,7688,5532,2156,6981,707
2001,Urban,Himachal Pradesh,Crime Against Men,Robbery,Female,60+,9649,5110,4539,5483,4166
2007,Urban,Haryana,Other Crimes,Cyber Crime,Male,0-12,8066,3187,4879,3337,4729
2004,Urban,Andhra Pradesh,Property Crime,Arson,Female,0-12,5094,1768,3326,2154,2940
2001,Urban,Himachal Pradesh,Other Crimes,Corruption,Female,0-12,1158,794,364,1060,98
2005,Urban,Arunachal Pradesh,Crime Against Women,Dowry Deaths,Male,0-12,3316,148,3168,2176,1140
2006,Urban,Karnataka,Crime Against Children,Kidnapping,Female,18-30,9982,344,9638,9899,83
2001,Rural,Telangana,Crime Against Children,Child Abuse,Male,18-30,9523,9280,243,9374,149
2010,Urban,Uttarakhand,Crime Against Men,Assault,Male,60+,3438,184,3254,479,2959
2007,Rural,Goa,Other Crimes,Fraud,Male,60+,9503,1947,7556,3793,5710
2010,Urban,Odisha,Other Crimes,Fraud,Female,18-30,3959,2663,1296,3854,105
2002,Urban,Telangana,Crime Against Women,Dowry Deaths,Female,31-45,9998,737,9261,9752,246
2006,Urban,Meghalaya,Crime Against Children,Kidnapping,Male,46-60,479,240,239,478,1
2006,Rural,Manipur,Other Crimes,Drug Offense,Male,31-45,8618,5212,3406,7350,1268
2009,Rural,Tripura,Crime Against Women,Dowry Deaths,Male,31-45,1887,1198,689,1427,460
2007,Urban,Andhra Pradesh,Crime Against Children,Kidnapping,Female,18-30,4625,415,4210,2326,2299
2003,Rural,Manipur,Crime Against Men,Extortion,Female,46-60,2710,2221,489,2586,124
2005,Urban,Haryana,Crime Against Women,Domestic Violence,Female,13-17,4871,13,4858,4567,304
2002,Rural,Maharashtra,Crime Against Children,Child Abuse,Female,0-12,6851,4424,2427,5441,1410
2001,Urban,Mizoram,Property Crime,Theft,Female,46-60,9381,873,8508,4389,4992
2006,Urban,Madhya Pradesh,Crime Against Women,Rape,Female,31-45,2218,858,1360,898,1320
2002,Rural,Goa,Other Crimes,Cyber Crime,Female,0-12,8631,7402,1229,7640,991
2001,Rural,Uttarakhand,Crime Against Men,Extortion,Male,31-45,3074,2077,997,2242,832
2004,Urban,Maharashtra,Crime Against Children,Kidnapping,Female,60+,4952,3422,1530,3927,1025
2008,Urban,Uttarakhand,Property Crime,Burglary,Male,46-60,597,586,11,593,4
2003,Rural,Telangana,Crime Against Children,Kidnapping,Female,60+,156,134,22,134,22
2010,Rural,Chhattisgarh,Crime Against Women,Domestic Violence,Male,31-45,9136,4324,4812,7515,1621
2003,Urban,Odisha,Crime Against Women,Domestic Violence,Female,31-45,381,55,326,337,44
2004,Rural,Madhya Pradesh,Crime Against Men,Robbery,Female,60+,4551,2473,2078,2972,1579
2005,Urban,Chhattisgarh,Crime Against Men,Robbery,Female,31-45,8505,3492,5013,4292,4213
2007,Rural,Tripura,Other Crimes,Drug Offense,Male,31-45,5788,1890,3898,5549,239
2001,Rural,Gujarat,Crime Against Children,Child Abuse,Male,60+,2686,2176,510,2469,217
2002,Rural,Assam,Crime Against Children,Kidnapping,Male,60+,7598,5807,1791,6108,1490
2002,Urban,Punjab,Property Crime,Theft,Male,0-12,4517,4140,377,4351,166
2005,Rural,Madhya Pradesh,Property Crime,Arson,Female,60+,6827,464,6363,2221,4606
2005,Rural,Himachal Pradesh,Crime Against Men,Robbery,Male,31-45,1444,330,1114,1061,383
2006,Urban,Jharkhand,Crime Against Men,Murder,Male,31-45,7845,306,7539,2327,5518
2004,Urban,Chhattisgarh,Crime Against Women,Dowry Deaths,Female,13-17,2089,368,1721,1000,1089
2006,Urban,Andhra Pradesh,Crime Against Women,Rape,Male,31-45,4761,1867,2894,4042,719
2008,Rural,Maharashtra,Crime Against Children,Child Abuse,Female,0-12,3587,345,3242,3225,362
2008,Rural,Haryana,Other Crimes,Cyber Crime,Female,18-30,4815,782,4033,899,3916
2006,Urban,Punjab,Other Crimes,Corruption,Female,46-60,6802,271,6531,6387,415
2009,Rural,Tripura,Crime Against Children,Child Labor,Male,60+,7668,3705,3963,5710,1958
2002,Urban,Assam,Other Crimes,Drug Offense,Male,60+,9608,710,8898,6958,2650
2001,Rural,Jammu & Kashmir,Property Crime,Vandalism,Male,13-17,5441,4503,938,4807,634
2002,Urban,Haryana,Property Crime,Burglary,Female,31-45,8887,4951,3936,7795,1092
2010,Urban,Manipur,Other Crimes,Fraud,Male,46-60,4466,3613,853,4269,197
2006,Urban,Tamil Nadu,Crime Against Women,Domestic Violence,Female,31-45,5266,1786,3480,4621,645
2002,Urban,Delhi,Crime Against Men,Robbery,Female,0-12,3301,627,2674,2866,435
2010,Rural,Bihar,Crime Against Men,Extortion,Male,13-17,152,7,145,129,23
2001,Rural,Arunachal Pradesh,Crime Against Women,Rape,Male,60+,4208,3126,1082,3161,1047
2005,Rural,Meghalaya,Crime Against Children,Kidnapping,Male,18-30,8476,6243,2233,7707,769
2009,Urban,Assam,Other Crimes,Corruption,Male,60+,9192,1177,8015,2974,6218
2004,Urban,West Bengal,Other Crimes,Fraud,Male,60+,2251,546,1705,646,1605
2006,Rural,Rajasthan,Crime Against Children,Child Abuse,Female,31-45,3109,1759,1350,1904,1205
2007,Urban,Maharashtra,Crime Against Women,Rape,Male,18-30,751,360,391,693,58
2005,Urban,Tripura,Other Crimes,Corruption,Female,31-45,6969,4836,2133,5308,1661
2010,Urban,Himachal Pradesh,Crime Against Children,Trafficking,Male,60+,4991,4130,861,4179,812
2002,Urban,Uttar Pradesh,Crime Against Men,Assault,Male,13-17,7134,3017,4117,6773,361
2004,Rural,Uttar Pradesh,Other Crimes,Corruption,Male,13-17,620,130,490,472,148
2007,Urban,Tamil Nadu,Property Crime,Arson,Male,0-12,9841,4731,5110,8381,1460
2003,Urban,Sikkim,Crime Against Children,Kidnapping,Male,18-30,489,98,391,180,309
2007,Urban,Punjab,Other Crimes,Cyber Crime,Female,13-17,7651,2753,4898,4267,3384
2005,Urban,Bihar,Crime Against Women,Dowry Deaths,Male,18-30,3314,1433,1881,3087,227
2010,Rural,Haryana,Other Crimes,Cyber Crime,Female,18-30,1219,892,327,944,275
2006,Rural,Bihar,Crime Against Children,Trafficking,Female,60+,6352,5148,1204,5667,685
2001,Rural,Jammu & Kashmir,Crime Against Children,Child Labor,Female,18-30,9587,3815,5772,6169,3418
2002,Rural,Mizoram,Crime Against Men,Robbery,Male,46-60,3906,2772,1134,3038,868
2005,Rural,Tamil Nadu,Crime Against Men,Murder,Female,46-60,9172,1480,7692,5279,3893
2009,Rural,Mizoram,Crime Against Women,Dowry Deaths,Male,0-12,5857,1520,4337,4171,1686
2002,Urban,Jammu & Kashmir,Crime Against Women,Domestic Violence,Male,18-30,5393,1374,4019,5203,190
2010,Urban,Kerala,Property Crime,Arson,Female,13-17,4637,4303,334,4617,20
2009,Urban,Bihar,Property Crime,Theft,Male,18-30,3408,451,2957,2418,990
2003,Urban,Gujarat,Other Crimes,Corruption,Female,13-17,7671,7583,88,7667,4
2001,Urban,Tripura,Crime Against Children,Kidnapping,Male,46-60,7122,1848,5274,6271,851
2001,Rural,Tamil Nadu,Crime Against Women,Rape,Female,31-45,2543,702,1841,865,1678
2005,Rural,Odisha,Crime Against Women,Rape,Male,46-60,3336,1977,1359,3017,319
2007,Rural,Arunachal Pradesh,Crime Against Women,Dowry Deaths,Female,46-60,5289,3477,1812,4896,393
2005,Urban,Odisha,Other Crimes,Drug Offense,Female,31-45,1185,937,248,1111,74
2005,Rural,Tamil Nadu,Property Crime,Arson,Male,13-17,8950,5789,3161,7595,1355
2004,Rural,Chhattisgarh,Crime Against Men,Robbery,Female,46-60,3449,2136,1313,3105,344
2006,Urban,Uttarakhand,Crime Against Men,Assault,Male,31-45,4157,2479,1678,3987,170
2005,Urban,Odisha,Crime Against Children,Child Abuse,Female,18-30,6515,4595,1920,5554,961
2002,Rural,Himachal Pradesh,Crime Against Men,Murder,Male,18-30,2361,1466,895,2041,320
2008,Rural,Jharkhand,Crime Against Children,Child Labor,Female,60+,8720,2924,5796,3191,5529
2004,Rural,Sikkim,Crime Against Men,Murder,Male,18-30,2168,1732,436,1787,381
2004,Rural,Nagaland,Other Crimes,Fraud,Male,0-12,285,166,119,283,2
2001,Urban,Mizoram,Crime Against Women,Domestic Violence,Male,46-60,3895,2753,1142,2974,921
2003,Rural,Uttarakhand,Crime Against Men,Robbery,Male,46-60,3225,97,3128,2626,599
2005,Urban,Maharashtra,Other Crimes,Cyber Crime,Female,18-30,6454,1604,4850,4190,2264
2009,Rural,Jharkhand,Crime Against Children,Kidnapping,Female,46-60,5123,2120,3003,3983,1140
2004,Urban,Kerala,Crime Against Men,Murder,Male,31-45,759,318,441,706,53
2006,Rural,Odisha,Property Crime,Burglary,Male,60+,6018,4253,1765,6016,2
2006,Urban,Gujarat,Other Crimes,Cyber Crime,Female,0-12,9366,3048,6318,3333,6033
2002,Rural,Himachal Pradesh,Other Crimes,Drug Offense,Male,46-60,2685,1408,1277,1696,989
2005,Rural,Karnataka,Crime Against Men,Murder,Male,13-17,3326,3321,5,3321,5
2009,Urban,Mizoram,Property Crime,Arson,Male,46-60,2233,210,2023,1389,844
2005,Urban,Manipur,Crime Against Children,Trafficking,Male,31-45,3084,2758,326,2907,177
2002,Rural,Andhra Pradesh,Crime Against Children,Trafficking,Male,18-30,4316,1150,3166,1915,2401
2002,Rural,Telangana,Crime Against Children,Trafficking,Female,31-45,6773,2585,4188,4206,2567
2006,Urban,Sikkim,Crime Against Women,Rape,Male,0-12,9373,2808,6565,8265,1108
2003,Urban,Sikkim,Crime Against Men,Robbery,Female,31-45,5881,1360,4521,2509,3372
2008,Urban,Jharkhand,Other Crimes,Fraud,Female,13-17,4458,2398,2060,3285,1173
2009,Urban,Telangana,Other Crimes,Corruption,Female,31-45,7448,114,7334,1460,5988
2004,Rural,West Bengal,Other Crimes,Cyber Crime,Male,60+,3331,3133,198,3213,118
2006,Urban,Gujarat,Crime Against Women,Molestation,Male,46-60,2895,217,2678,1622,1273
2002,Urban,Andhra Pradesh,Property Crime,Arson,Female,18-30,2633,2523,110,2581,52
2010,Rural,Tripura,Crime Against Men,Extortion,Female,46-60,506,347,159,352,154
2007,Rural,Punjab,Crime Against Women,Molestation,Male,13-17,7794,6984,810,7478,316
2006,Urban,Kerala,Crime Against Children,Kidnapping,Female,13-17,3358,3160,198,3264,94
2005,Urban,Uttar Pradesh,Crime Against Women,Dowry Deaths,Female,46-60,7504,6522,982,6668,836
2002,Rural,Sikkim,Crime Against Women,Rape,Male,13-17,5181,526,4655,4092,1089
2007,Urban,Manipur,Other Crimes,Fraud,Male,60+,8804,5513,3291,8317,487
2007,Rural,Maharashtra,Crime Against Men,Robbery,Female,60+,8702,8027,675,8655,47
2005,Urban,Himachal Pradesh,Crime Against Women,Rape,Male,46-60,6545,1336,5209,6092,453
2002,Rural,Sikkim,Property Crime,Arson,Male,13-17,1358,1181,177,1260,98
2006,Urban,Nagaland,Crime Against Women,Domestic Violence,Male,31-45,413,257,156,374,39
2007,Rural,Manipur,Other Crimes,Cyber Crime,Female,31-45,739,610,129,673,66
2010,Urban,Assam,Other Crimes,Cyber Crime,Female,18-30,6046,1348,4698,3520,2526
2002,Rural,Jammu & Kashmir,Other Crimes,Fraud,Male,0-12,2344,630,1714,1290,1054
2010,Urban,Kerala,Crime Against Children,Trafficking,Female,46-60,5904,4328,1576,5329,575
2009,Rural,Andhra Pradesh,Crime Against Children,Trafficking,Male,18-30,9629,5897,3732,6725,2904
2009,Rural,Gujarat,Crime Against Men,Robbery,Male,46-60,7120,223,6897,4009,3111
2002,Rural,Chhattisgarh,Other Crimes,Cyber Crime,Female,60+,8549,7266,1283,7758,791
2007,Urban,Jharkhand,Other Crimes,Cyber Crime,Female,13-17,8763,1697,7066,5801,2962
2001,Rural,Andhra Pradesh,Crime Against Men,Murder,Female,31-45,3394,837,2557,3084,310
2009,Urban,Uttarakhand,Other Crimes,Cyber Crime,Female,18-30,5855,3009,2846,5174,681
2010,Rural,Himachal Pradesh,Crime Against Men,Robbery,Female,18-30,6342,5950,392,6170,172
2003,Rural,Nagaland,Crime Against Men,Assault,Male,18-30,6826,6689,137,6766,60
2008,Rural,Assam,Other Crimes,Corruption,Male,18-30,1291,419,872,856,435
2005,Urban,Madhya Pradesh,Property Crime,Theft,Male,60+,5675,2877,2798,3180,2495
2005,Urban,Rajasthan,Property Crime,Vandalism,Female,13-17,8154,4632,3522,7575,579
2006,Urban,West Bengal,Crime Against Men,Assault,Male,46-60,7241,1665,5576,3735,3506
2004,Urban,Karnataka,Crime Against Men,Assault,Male,18-30,4505,1039,3466,3816,689
2008,Urban,Andhra Pradesh,Property Crime,Burglary,Male,0-12,6057,3553,2504,4340,1717
2004,Rural,Jammu & Kashmir,Crime Against Men,Assault,Male,60+,6976,380,6596,1870,5106
2001,Urban,Rajasthan,Crime Against Men,Robbery,Male,46-60,5588,672,4916,1268,4320
2001,Rural,Uttarakhand,Crime Against Children,Child Abuse,Female,31-45,4107,3700,407,3873,234
2003,Urban,Meghalaya,Crime Against Women,Rape,Female,13-17,9186,8044,1142,8294,892
2006,Urban,Telangana,Other Crimes,Drug Offense,Female,46-60,8159,3778,4381,6624,1535
2006,Urban,Chhattisgarh,Other Crimes,Cyber Crime,Female,60+,9085,5570,3515,8960,125
2003,Rural,Jharkhand,Other Crimes,Fraud,Male,60+,9494,5854,3640,7143,2351
2006,Urban,Rajasthan,Crime Against Women,Domestic Violence,Female,60+,6086,4101,1985,5369,717
2005,Urban,Tripura,Crime Against Men,Robbery,Female,0-12,6820,2859,3961,2885,3935
2008,Rural,Chhattisgarh,Crime Against Men,Robbery,Female,31-45,6203,6048,155,6167,36
2006,Rural,Tripura,Other Crimes,Drug Offense,Male,46-60,3381,747,2634,2258,1123
2001,Urban,Gujarat,Property Crime,Burglary,Female,18-30,3500,2671,829,3471,29
2006,Rural,Madhya Pradesh,Other Crimes,Drug Offense,Female,31-45,1223,405,818,1139,84
2005,Urban,Goa,Crime Against Men,Assault,Male,0-12,3021,1232,1789,2742,279
2007,Rural,Haryana,Crime Against Children,Child Abuse,Male,46-60,3594,1048,2546,1660,1934
2008,Rural,Haryana,Crime Against Women,Rape,Female,0-12,5122,3479,1643,5089,33
2009,Urban,Jammu & Kashmir,Crime Against Children,Child Labor,Male,0-12,3253,2332,921,2924,329
2010,Rural,Telangana,Crime Against Children,Trafficking,Male,13-17,9337,7202,2135,8339,998
2006,Rural,Bihar,Crime Against Men,Assault,Male,31-45,2479,806,1673,1310,1169
2010,Rural,Maharashtra,Property Crime,Burglary,Male,13-17,2414,974,1440,1532,882
2001,Urban,Jharkhand,Property Crime,Vandalism,Female,0-12,7365,992,6373,2004,5361
2009,Urban,Tamil Nadu,Property Crime,Vandalism,Female,31-45,7629,165,7464,646,6983
2005,Urban,Sikkim,Crime Against Men,Assault,Male,60+,896,83,813,422,474
2004,Urban,Punjab,Crime Against Women,Rape,Female,18-30,4570,1236,3334,2632,1938
2006,Rural,Mizoram,Crime Against Women,Molestation,Male,60+,5164,2101,3063,2703,2461
2007,Rural,Himachal Pradesh,Crime Against Children,Kidnapping,Male,13-17,8164,7409,755,7787,377
2010,Rural,Gujarat,Crime Against Men,Assault,Male,18-30,79,41,38,51,28
2006,Urban,Arunachal Pradesh,Crime Against Men,Murder,Male,0-12,5847,4554,1293,5099,748
2010,Urban,Maharashtra,Crime Against Children,Kidnapping,Male,0-12,4124,2022,2102,2854,1270
2001,Urban,Meghalaya,Other Crimes,Cyber Crime,Female,0-12,2785,79,2706,2587,198
2008,Urban,Kerala,Property Crime,Vandalism,Male,60+,8908,1595,7313,8750,158
2001,Urban,Sikkim,Other Crimes,Drug Offense,Male,0-12,3700,2943,757,3214,486
2003,Urban,Manipur,Crime Against Women,Dowry Deaths,Female,0-12,6319,816,5503,2689,3630
2006,Rural,Gujarat,Crime Against Children,Kidnapping,Female,13-17,6815,6687,128,6802,13
2002,Rural,Goa,Crime Against Men,Robbery,Male,46-60,2297,497,1800,675,1622
2001,Rural,Maharashtra,Crime Against Men,Murder,Female,13-17,8279,3203,5076,5008,3271
2003,Rural,Uttar Pradesh,Property Crime,Burglary,Male,46-60,9486,5772,3714,8999,487
2008,Rural,Meghalaya,Property Crime,Arson,Male,60+,1958,1263,695,1738,220
2006,Rural,Himachal Pradesh,Property Crime,Arson,Male,31-45,5774,3271,2503,3677,2097
2009,Urban,Kerala,Crime Against Men,Extortion,Male,31-45,5392,4873,519,5178,214
2004,Rural,Gujarat,Other Crimes,Cyber Crime,Male,31-45,4505,549,3956,1894,2611
2005,Urban,Goa,Crime Against Women,Rape,Male,0-12,662,241,421,319,343
2008,Urban,Nagaland,Other Crimes,Fraud,Male,0-12,3867,1173,2694,3756,111
2004,Urban,Andhra Pradesh,Crime Against Men,Assault,Male,18-30,9858,1345,8513,8424,1434
2008,Urban,Tripura,Crime Against Men,Robbery,Female,60+,6084,5594,490,5868,216
2007,Rural,Odisha,Crime Against Women,Rape,Female,31-45,8151,6674,1477,7621,530
2001,Urban,Karnataka,Crime Against Women,Molestation,Female,46-60,9378,6895,2483,8978,400
2003,Rural,Haryana,Crime Against Men,Robbery,Female,60+,2097,1895,202,1913,184
2005,Urban,Arunachal Pradesh,Property Crime,Theft,Male,18-30,8540,1875,6665,7786,754
2005,Urban,Tripura,Crime Against Women,Dowry Deaths,Female,46-60,7914,1933,5981,7370,544
2002,Urban,Punjab,Other Crimes,Corruption,Female,18-30,7455,242,7213,7255,200
2009,Rural,Arunachal Pradesh,Crime Against Women,Rape,Male,13-17,4558,3894,664,4095,463
2008,Urban,Maharashtra,Other Crimes,Fraud,Female,0-12,4169,152,4017,666,3503
2007,Rural,Punjab,Crime Against Children,Child Labor,Female,60+,1199,1024,175,1154,45
2001,Rural,Himachal Pradesh,Crime Against Women,Domestic Violence,Female,60+,7014,3484,3530,5403,1611
2003,Rural,Chhattisgarh,Crime Against Children,Trafficking,Female,18-30,9486,5066,4420,5295,4191
2010,Rural,Jharkhand,Other Crimes,Corruption,Female,18-30,9098,146,8952,7688,1410
2009,Rural,Chhattisgarh,Crime Against Children,Kidnapping,Male,18-30,5639,2175,3464,4839,800
2010,Urban,Uttar Pradesh,Property Crime,Theft,Female,31-45,3907,184,3723,1706,2201
2002,Rural,Gujarat,Crime Against Women,Molestation,Male,13-17,8701,5600,3101,8109,592
2003,Rural,Maharashtra,Crime Against Men,Assault,Male,60+,277,49,228,184,93
2006,Urban,Maharashtra,Crime Against Children,Kidnapping,Female,31-45,720,538,182,543,177
2010,Urban,Rajasthan,Crime Against Children,Child Abuse,Female,13-17,9083,1929,7154,8657,426
2003,Rural,Odisha,Other Crimes,Drug Offense,Female,31-45,6337,4519,1818,4810,1527
2006,Urban,Telangana,Property Crime,Vandalism,Female,13-17,6128,5962,166,6030,98
2001,Rural,Punjab,Other Crimes,Corruption,Male,18-30,6797,3055,3742,4848,1949
2005,Rural,Odisha,Other Crimes,Corruption,Female,13-17,9411,1307,8104,4546,4865
2001,Rural,Manipur,Crime Against Women,Rape,Male,60+,1338,825,513,1008,330
2004,Urban,Jammu & Kashmir,Crime Against Men,Murder,Female,46-60,8512,6302,2210,8194,318
2009,Urban,Delhi,Other Crimes,Corruption,Male,0-12,8463,7854,609,8037,426
2006,Urban,Assam,Property Crime,Arson,Female,31-45,7849,6952,897,7487,362
2006,Rural,Madhya Pradesh,Crime Against Men,Murder,Female,18-30,1867,1771,96,1829,38
2002,Rural,Kerala,Crime Against Children,Child Abuse,Male,60+,7158,1962,5196,5592,1566
2010,Urban,Assam,Other Crimes,Corruption,Male,60+,5906,1858,4048,2870,3036
2006,Urban,Punjab,Crime Against Women,Dowry Deaths,Female,31-45,116,63,53,70,46
2002,Rural,Uttarakhand,Other Crimes,Fraud,Female,46-60,7335,2095,5240,5985,1350
2008,Rural,Uttarakhand,Property Crime,Vandalism,Female,60+,7440,6764,676,6832,608
2006,Rural,Uttarakhand,Crime Against Men,Murder,Male,31-45,9193,1487,7706,5097,4096
2001,Rural,Punjab,Property Crime,Vandalism,Female,18-30,4830,4666,164,4800,30
2007,Urban,Odisha,Crime Against Women,Domestic Violence,Male,0-12,8630,7037,1593,7661,969
2003,Rural,Telangana,Crime Against Children,Child Abuse,Female,18-30,1235,524,711,1097,138
2001,Urban,Telangana,Other Crimes,Cyber Crime,Male,60+,7868,6937,931,7099,769
2001,Rural,Kerala,Property Crime,Theft,Male,18-30,7794,3120,4674,3943,3851
2001,Urban,Madhya Pradesh,Other Crimes,Corruption,Female,46-60,6634,885,5749,4272,2362
2008,Rural,Jharkhand,Crime Against Children,Trafficking,Female,31-45,3219,2826,393,2871,348
2002,Urban,Himachal Pradesh,Crime Against Children,Kidnapping,Male,18-30,7109,2601,4508,3275,3834
2007,Urban,Jharkhand,Crime Against Women,Molestation,Female,0-12,6075,2439,3636,4315,1760
2006,Rural,Gujarat,Property Crime,Burglary,Female,13-17,4150,2362,1788,3639,511
2001,Rural,Arunachal Pradesh,Crime Against Children,Kidnapping,Male,0-12,3820,154,3666,842,2978
2002,Urban,Madhya Pradesh,Property Crime,Arson,Female,13-17,9929,7109,2820,7684,2245
2004,Rural,Bihar,Other Crimes,Corruption,Male,13-17,1251,308,943,1076,175
2001,Urban,Kerala,Property Crime,Arson,Male,18-30,6335,5330,1005,5769,566
2010,Rural,Delhi,Crime Against Children,Child Abuse,Male,0-12,7813,7187,626,7805,8
2008,Urban,Himachal Pradesh,Crime Against Women,Rape,Male,60+,321,109,212,240,81
2010,Urban,Madhya Pradesh,Property Crime,Vandalism,Female,60+,5071,1210,3861,2945,2126
2005,Rural,Jharkhand,Crime Against Men,Murder,Male,31-45,670,615,55,635,35
2007,Rural,Jharkhand,Property Crime,Theft,Female,18-30,7467,3235,4232,4847,2620
2010,Urban,Odisha,Other Crimes,Cyber Crime,Female,60+,4691,4230,461,4306,385
2007,Urban,Nagaland,Crime Against Women,Molestation,Female,60+,2423,1288,1135,1396,1027
2002,Rural,Maharashtra,Crime Against Children,Trafficking,Male,18-30,1658,903,755,1469,189
2010,Urban,Delhi,Other Crimes,Cyber Crime,Male,46-60,9970,5167,4803,7600,2370
2009,Rural,Andhra Pradesh,Other Crimes,Drug Offense,Male,0-12,8102,7936,166,8003,99
2002,Urban,Chhattisgarh,Property Crime,Theft,Male,18-30,6763,4699,2064,5632,1131
2003,Rural,Assam,Crime Against Men,Assault,Female,18-30,9361,1429,7932,9110,251
2004,Urban,Chhattisgarh,Crime Against Women,Rape,Female,46-60,211,136,75,154,57
2001,Rural,Haryana,Crime Against Men,Murder,Female,31-45,7737,1180,6557,7543,194
2009,Urban,Bihar,Crime Against Children,Child Abuse,Male,46-60,6270,3819,2451,3869,2401
2010,Urban,Uttarakhand,Crime Against Women,Dowry Deaths,Female,0-12,5708,5171,537,5564,144
2003,Urban,Madhya Pradesh,Property Crime,Arson,Female,60+,8290,2919,5371,3056,5234
2002,Rural,Andhra Pradesh,Other Crimes,Fraud,Male,18-30,5505,2098,3407,5105,400
2001,Rural,Uttarakhand,Crime Against Children,Child Abuse,Male,13-17,9844,9146,698,9251,593
2008,Urban,Goa,Other Crimes,Corruption,Female,13-17,8140,2467,5673,3976,4164
2001,Rural,West Bengal,Crime Against Men,Murder,Male,46-60,53,30,23,38,15
2004,Urban,Odisha,Other Crimes,Drug Offense,Male,0-12,765,493,272,533,232
2005,Urban,Delhi,Other Crimes,Cyber Crime,Female,46-60,2115,353,1762,1730,385
2007,Rural,Chhattisgarh,Other Crimes,Fraud,Female,0-12,3807,1296,2511,1307,2500
2006,Rural,Bihar,Other Crimes,Cyber Crime,Female,13-17,4662,2262,2400,2349,2313
2004,Rural,Tripura,Crime Against Children,Child Labor,Female,13-17,7596,5344,2252,6243,1353
2007,Urban,Tripura,Property Crime,Arson,Female,31-45,2589,2489,100,2531,58
2009,Rural,Tamil Nadu,Other Crimes,Drug Offense,Female,0-12,5427,2304,3123,5184,243
2003,Rural,Sikkim,Crime Against Men,Extortion,Female,13-17,2051,846,1205,1857,194
2008,Rural,Arunachal Pradesh,Other Crimes,Drug Offense,Female,60+,4847,2870,1977,3316,1531
2002,Rural,Goa,Crime Against Children,Child Abuse,Male,18-30,1725,179,1546,409,1316
2008,Rural,Tamil Nadu,Property Crime,Arson,Female,60+,2083,1931,152,2018,65
2003,Urban,Andhra Pradesh,Crime Against Women,Molestation,Female,60+,9560,5446,4114,5734,3826
2009,Rural,Rajasthan,Other Crimes,Drug Offense,Male,31-45,1773,831,942,1378,395
2005,Urban,Maharashtra,Crime Against Men,Robbery,Male,46-60,6449,2970,3479,5929,520
2006,Rural,Maharashtra,Property Crime,Vandalism,Male,46-60,1423,1239,184,1314,109
2004,Urban,Uttar Pradesh,Crime Against Children,Trafficking,Female,46-60,5759,5116,643,5697,62
2002,Rural,Jammu & Kashmir,Other Crimes,Cyber Crime,Female,0-12,6080,4541,1539,5432,648
2010,Urban,Telangana,Crime Against Children,Child Abuse,Male,31-45,5444,4671,773,5129,315
2002,Urban,Odisha,Crime Against Women,Dowry Deaths,Female,18-30,8492,7416,1076,7994,498
2008,Urban,Assam,Crime Against Women,Rape,Female,0-12,135,16,119,45,90
2004,Rural,Telangana,Crime Against Men,Assault,Female,60+,65,38,27,56,9
2010,Urban,Manipur,Crime Against Men,Extortion,Female,60+,9308,5932,3376,7711,1597
2005,Rural,Chhattisgarh,Crime Against Men,Murder,Male,13-17,5098,3665,1433,3940,1158
2007,Rural,West Bengal,Other Crimes,Corruption,Female,0-12,5474,3254,2220,4502,972
2003,Urban,Assam,Other Crimes,Corruption,Male,0-12,7371,6012,1359,6581,790
2004,Rural,Rajasthan,Crime Against Women,Molestation,Female,0-12,8801,4957,3844,7847,954
2006,Rural,Chhattisgarh,Property Crime,Arson,Female,31-45,9636,7088,2548,9448,188
2009,Urban,Uttarakhand,Crime Against Women,Molestation,Female,60+,7385,2354,5031,4510,2875
2002,Rural,Delhi,Crime Against Men,Robbery,Female,0-12,5254,202,5052,1036,4218
2009,Urban,Haryana,Crime Against Children,Kidnapping,Female,0-12,7646,1773,5873,3270,4376
2007,Rural,Telangana,Other Crimes,Cyber Crime,Female,31-45,4249,2912,1337,3870,379
2004,Urban,Gujarat,Property Crime,Vandalism,Female,13-17,4793,1595,3198,2846,1947
2010,Urban,Assam,Property Crime,Vandalism,Male,31-45,2142,874,1268,1552,590
2003,Rural,Telangana,Crime Against Women,Dowry Deaths,Male,31-45,4653,1734,2919,3719,934
2008,Urban,Goa,Property Crime,Burglary,Female,46-60,4173,2086,2087,4141,32
2009,Urban,Haryana,Crime Against Women,Domestic Violence,Female,0-12,4295,4063,232,4248,47
2006,Urban,Uttar Pradesh,Crime Against Women,Dowry Deaths,Male,60+,6755,4225,2530,4583,2172
2010,Rural,Assam,Crime Against Women,Dowry Deaths,Female,46-60,2229,410,1819,696,1533
2001,Rural,Kerala,Property Crime,Theft,Female,18-30,8145,5441,2704,7043,1102
2003,Urban,Uttar Pradesh,Property Crime,Burglary,Female,18-30,3006,2898,108,2951,55
2006,Rural,Manipur,Crime Against Men,Robbery,Female,0-12,2537,2269,268,2297,240
2003,Rural,Gujarat,Other Crimes,Corruption,Female,60+,2533,1133,1400,2478,55
2006,Rural,Goa,Crime Against Children,Child Abuse,Female,18-30,3424,918,2506,2250,1174
2003,Rural,Chhattisgarh,Crime Against Women,Molestation,Female,46-60,6767,3381,3386,4599,2168
2009,Urban,Karnataka,Crime Against Women,Molestation,Male,0-12,9209,5468,3741,6558,2651
2002,Rural,West Bengal,Other Crimes,Cyber Crime,Female,31-45,7099,3033,4066,5303,1796
2009,Rural,Jharkhand,Crime Against Children,Child Abuse,Female,60+,9958,8309,1649,9585,373
2002,Urban,Maharashtra,Crime Against Women,Molestation,Male,18-30,1689,1582,107,1683,6
2010,Urban,Delhi,Crime Against Women,Dowry Deaths,Male,13-17,6950,1919,5031,6294,656
2001,Urban,Uttar Pradesh,Other Crimes,Cyber Crime,Female,31-45,5794,3300,2494,4934,860
2009,Rural,Jammu & Kashmir,Crime Against Men,Murder,Female,46-60,1865,890,975,1156,709
2003,Urban,Mizoram,Crime Against Men,Robbery,Female,13-17,9082,621,8461,6679,2403
2007,Urban,Tripura,Crime Against Children,Kidnapping,Male,31-45,5074,4652,422,4898,176
2007,Rural,Arunachal Pradesh,Crime Against Men,Extortion,Male,46-60,8286,3910,4376,7750,536
2010,Rural,Odisha,Other Crimes,Drug Offense,Female,0-12,5479,2433,3046,4785,694
2002,Rural,Nagaland,Property Crime,Arson,Female,60+,6199,2167,4032,5698,501
2006,Rural,Nagaland,Property Crime,Burglary,Female,13-17,1324,293,1031,656,668
2006,Urban,Goa,Crime Against Children,Trafficking,Male,0-12,6006,259,5747,1272,4734
2002,Urban,Madhya Pradesh,Crime Against Children,Kidnapping,Female,60+,3418,2081,1337,2753,665
2008,Urban,Nagaland,Crime Against Men,Extortion,Male,31-45,1086,544,542,810,276
2010,Urban,Karnataka,Crime Against Men,Assault,Male,0-12,942,24,918,359,583
2001,Rural,Uttar Pradesh,Crime Against Men,Murder,Female,0-12,7173,792,6381,1336,5837
2002,Rural,Goa,Crime Against Children,Child Abuse,Male,60+,9329,3826,5503,8339,990
2008,Urban,Andhra Pradesh,Property Crime,Theft,Male,46-60,4282,3670,612,3998,284
2002,Rural,Karnataka,Crime Against Children,Child Labor,Female,13-17,1993,1178,815,1255,738
2003,Urban,Mizoram,Other Crimes,Drug Offense,Female,0-12,8093,273,7820,1994,6099
2005,Urban,Sikkim,Crime Against Women,Molestation,Female,60+,2038,1998,40,2010,28
2001,Rural,Jammu & Kashmir,Crime Against Men,Murder,Male,46-60,6776,113,6663,637,6139
2005,Rural,Tripura,Crime Against Children,Child Abuse,Male,18-30,2853,1570,1283,2368,485
2002,Urban,Chhattisgarh,Crime Against Children,Trafficking,Female,18-30,7071,5160,1911,5672,1399
2004,Urban,Nagaland,Crime Against Children,Trafficking,Female,0-12,5669,3005,2664,3205,2464
2006,Urban,Tripura,Property Crime,Theft,Female,18-30,4561,3658,903,4135,426
2006,Rural,Assam,Other Crimes,Drug Offense,Male,31-45,9584,1373,8211,8601,983
2003,Urban,Arunachal Pradesh,Crime Against Women,Rape,Female,0-12,3595,1770,1825,2096,1499
2001,Rural,Manipur,Property Crime,Vandalism,Male,31-45,6218,6004,214,6081,137
2006,Rural,Delhi,Property Crime,Vandalism,Male,46-60,7114,4691,2423,6178,936
2004,Rural,Tripura,Property Crime,Vandalism,Female,31-45,7673,3344,4329,4872,2801
2003,Urban,Punjab,Crime Against Men,Extortion,Male,13-17,2874,1069,1805,2064,810
2004,Rural,Punjab,Crime Against Children,Child Labor,Male,60+,1185,1037,148,1075,110
2009,Urban,Maharashtra,Other Crimes,Cyber Crime,Female,46-60,660,104,556,137,523
2008,Rural,Uttarakhand,Crime Against Children,Kidnapping,Male,0-12,4462,1125,3337,2203,2259
2007,Rural,Karnataka,Other Crimes,Corruption,Male,18-30,6148,3634,2514,5566,582
2003,Rural,Assam,Other Crimes,Cyber Crime,Female,13-17,8905,7064,1841,8708,197
2006,Urban,Rajasthan,Other Crimes,Fraud,Female,0-12,1925,214,1711,1679,246
2002,Rural,Uttar Pradesh,Property Crime,Vandalism,Female,13-17,4535,3193,1342,4431,104
2001,Rural,Delhi,Crime Against Women,Rape,Female,31-45,1619,1448,171,1514,105
2008,Urban,Andhra Pradesh,Other Crimes,Corruption,Female,60+,1200,355,845,1083,117
2004,Rural,Sikkim,Property Crime,Theft,Female,0-12,1974,1845,129,1946,28
2010,Urban,Madhya Pradesh,Property Crime,Vandalism,Female,13-17,1974,1563,411,1800,174
2003,Rural,Kerala,Crime Against Women,Domestic Violence,Female,0-12,879,203,676,316,563
2009,Urban,Kerala,Crime Against Men,Robbery,Male,18-30,6141,5362,779,5784,357
2006,Urban,Assam,Crime Against Men,Murder,Male,0-12,465,295,170,354,111
2002,Urban,Tripura,Crime Against Women,Dowry Deaths,Female,18-30,3791,2151,1640,2399,1392
2005,Urban,Karnataka,Crime Against Women,Molestation,Female,46-60,5438,494,4944,810,4628
2003,Rural,Maharashtra,Crime Against Children,Child Labor,Female,60+,3822,3688,134,3758,64
2010,Urban,Uttarakhand,Property Crime,Burglary,Female,46-60,2252,1730,522,2068,184
2001,Rural,Bihar,Crime Against Men,Assault,Female,60+,5398,3651,1747,4329,1069
2010,Urban,Himachal Pradesh,Other Crimes,Fraud,Male,60+,3347,2127,1220,2329,1018
2010,Rural,Jammu & Kashmir,Crime Against Children,Kidnapping,Male,46-60,3490,2853,637,3180,310
2004,Urban,Jharkhand,Crime Against Men,Assault,Male,60+,824,506,318,804,20
2009,Urban,Mizoram,Crime Against Men,Extortion,Female,60+,1767,972,795,1421,346
2010,Rural,Telangana,Other Crimes,Cyber Crime,Male,13-17,1278,990,288,1192,86
2007,Rural,Goa,Property Crime,Theft,Male,0-12,8492,7744,748,8332,160
2001,Rural,Jammu & Kashmir,Other Crimes,Cyber Crime,Female,31-45,6178,2310,3868,4553,1625
2005,Rural,Tripura,Crime Against Men,Murder,Female,60+,7815,7085,730,7586,229
2001,Rural,Punjab,Crime Against Women,Rape,Female,18-30,5576,5460,116,5502,74
2003,Rural,Tripura,Crime Against Children,Kidnapping,Female,60+,5704,1870,3834,2809,2895
2003,Rural,Manipur,Other Crimes,Corruption,Male,18-30,6562,1338,5224,3538,3024
2009,Rural,Gujarat,Crime Against Children,Trafficking,Female,31-45,7552,3907,3645,6477,1075
2009,Rural,Jharkhand,Crime Against Children,Child Abuse,Female,13-17,7706,6261,1445,6755,951
2008,Rural,Nagaland,Crime Against Men,Robbery,Female,46-60,70,34,36,42,28
2007,Rural,Nagaland,Crime Against Women,Dowry Deaths,Female,0-12,3871,1606,2265,2537,1334
2008,Urban,Telangana,Crime Against Children,Kidnapping,Female,13-17,8506,1654,6852,1788,6718
2004,Rural,Gujarat,Other Crimes,Drug Offense,Female,13-17,5594,4026,1568,4430,1164
2004,Rural,Uttarakhand,Crime Against Children,Child Abuse,Female,31-45,9015,6843,2172,7470,1545
2005,Urban,Madhya Pradesh,Crime Against Women,Dowry Deaths,Male,13-17,5990,1911,4079,2968,3022
2007,Rural,Rajasthan,Property Crime,Theft,Female,18-30,1551,979,572,1416,135
2009,Urban,Kerala,Crime Against Men,Assault,Male,0-12,368,364,4,366,2
2008,Urban,Tamil Nadu,Crime Against Children,Trafficking,Male,60+,7512,635,6877,2757,4755
2001,Rural,Sikkim,Crime Against Children,Child Labor,Female,18-30,4948,3917,1031,4650,298
2006,Rural,Goa,Crime Against Children,Kidnapping,Male,13-17,2303,727,1576,1941,362
2005,Rural,Arunachal Pradesh,Crime Against Women,Domestic Violence,Female,46-60,5247,2621,2626,3335,1912
2008,Urban,Himachal Pradesh,Other Crimes,Drug Offense,Female,18-30,7868,2844,5024,4000,3868
2003,Rural,Assam,Property Crime,Theft,Male,18-30,5627,492,5135,3775,1852
2007,Urban,Manipur,Other Crimes,Corruption,Male,31-45,7905,1071,6834,4745,3160
2004,Rural,Kerala,Crime Against Women,Dowry Deaths,Female,0-12,8198,2028,6170,5562,2636
2010,Rural,Nagaland,Crime Against Women,Dowry Deaths,Male,0-12,2933,1171,1762,2801,132
2009,Urban,Tamil Nadu,Other Crimes,Fraud,Female,13-17,8769,1006,7763,3628,5141
2007,Urban,Tripura,Crime Against Women,Domestic Violence,Female,60+,6735,2161,4574,2908,3827
2004,Urban,Odisha,Property Crime,Theft,Female,60+,6170,5639,531,6116,54
2004,Urban,Sikkim,Crime Against Women,Molestation,Male,13-17,611,454,157,588,23
2002,Urban,Jharkhand,Crime Against Children,Child Labor,Female,31-45,3651,2608,1043,3523,128
2003,Rural,Madhya Pradesh,Other Crimes,Fraud,Male,13-17,6667,3096,3571,5707,960
2007,Rural,Chhattisgarh,Crime Against Children,Kidnapping,Female,46-60,3163,168,2995,356,2807
2001,Rural,Jharkhand,Other Crimes,Cyber Crime,Female,13-17,8036,361,7675,3411,4625
2001,Urban,Rajasthan,Crime Against Children,Trafficking,Male,18-30,9544,8258,1286,8407,1137
2002,Rural,Himachal Pradesh,Crime Against Men,Robbery,Female,46-60,7005,2562,4443,4117,2888
2007,Urban,Bihar,Crime Against Women,Rape,Male,13-17,1461,842,619,971,490
2010,Urban,Maharashtra,Property Crime,Theft,Female,46-60,8535,5867,2668,7557,978
2007,Rural,Karnataka,Crime Against Women,Rape,Male,46-60,8098,683,7415,5273,2825
2002,Rural,Assam,Other Crimes,Drug Offense,Female,18-30,4196,2453,1743,3332,864
2006,Rural,Maharashtra,Crime Against Men,Robbery,Male,18-30,285,52,233,207,78
2005,Urban,Punjab,Crime Against Women,Rape,Male,31-45,1415,1020,395,1058,357
2003,Rural,Telangana,Crime Against Women,Rape,Female,13-17,7019,5841,1178,5950,1069
2006,Rural,Meghalaya,Crime Against Children,Child Labor,Female,46-60,3103,1536,1567,2170,933
2004,Urban,Gujarat,Property Crime,Vandalism,Female,0-12,8646,8572,74,8575,71
2010,Rural,Tripura,Crime Against Men,Extortion,Female,0-12,6293,4410,1883,5367,926
2008,Rural,Jharkhand,Other Crimes,Corruption,Female,13-17,6109,1675,4434,5921,188
2006,Urban,Haryana,Other Crimes,Corruption,Male,60+,8570,2414,6156,3206,5364
2001,Rural,Kerala,Other Crimes,Fraud,Female,13-17,4034,1954,2080,2329,1705
2002,Rural,Maharashtra,Property Crime,Burglary,Female,46-60,3483,3348,135,3441,42
2001,Urban,Manipur,Property Crime,Burglary,Female,13-17,1270,547,723,1001,269
2005,Rural,Uttar Pradesh,Crime Against Women,Domestic Violence,Female,18-30,7613,1973,5640,7267,346
2003,Urban,Chhattisgarh,Crime Against Children,Child Labor,Male,0-12,9619,8064,1555,8613,1006
2006,Rural,Delhi,Other Crimes,Cyber Crime,Female,46-60,3803,1499,2304,3151,652
2010,Rural,Gujarat,Other Crimes,Drug Offense,Female,60+,8668,3522,5146,7426,1242
2004,Urban,Delhi,Other Crimes,Drug Offense,Female,0-12,7773,3095,4678,5221,2552
2003,Rural,Sikkim,Crime Against Women,Molestation,Female,0-12,7719,729,6990,5516,2203
2003,Urban,Karnataka,Property Crime,Theft,Female,13-17,721,552,169,641,80
2010,Urban,Tamil Nadu,Property Crime,Burglary,Male,18-30,7010,640,6370,980,6030
2010,Rural,Assam,Other Crimes,Corruption,Male,46-60,7053,3740,3313,5424,1629
2006,Urban,Goa,Crime Against Men,Robbery,Male,13-17,2117,1185,932,1584,533
2005,Urban,Assam,Crime Against Children,Child Abuse,Male,0-12,5875,2746,3129,5695,180
2010,Urban,Punjab,Crime Against Men,Murder,Male,46-60,7313,3928,3385,6643,670
2002,Rural,Chhattisgarh,Property Crime,Arson,Female,0-12,7113,6862,251,6934,179
2010,Rural,Karnataka,Crime Against Women,Domestic Violence,Male,13-17,5995,5833,162,5969,26
2007,Urban,Jharkhand,Other Crimes,Cyber Crime,Male,13-17,1260,906,354,1117,143
2003,Rural,Bihar,Crime Against Men,Extortion,Male,13-17,4317,2253,2064,4084,233
2001,Rural,Delhi,Crime Against Women,Molestation,Male,46-60,3414,2333,1081,3029,385
2003,Rural,Meghalaya,Crime Against Men,Robbery,Male,60+,373,113,260,142,231
2002,Urban,Mizoram,Crime Against Men,Assault,Male,0-12,1421,422,999,1024,397
2001,Urban,Madhya Pradesh,Crime Against Children,Child Labor,Male,60+,6940,3653,3287,5661,1279
2010,Urban,Andhra Pradesh,Crime Against Men,Extortion,Female,31-45,2084,1469,615,1591,493
2002,Rural,Delhi,Other Crimes,Drug Offense,Female,13-17,8927,4160,4767,5926,3001
2008,Urban,Delhi,Property Crime,Vandalism,Male,13-17,2260,1798,462,1950,310
2002,Rural,Rajasthan,Crime Against Women,Dowry Deaths,Male,13-17,8221,7117,1104,7170,1051
2003,Rural,Madhya Pradesh,Crime Against Women,Rape,Female,0-12,1955,1925,30,1952,3
2007,Rural,Haryana,Crime Against Men,Assault,Female,18-30,7280,5676,1604,6324,956
2001,Urban,Maharashtra,Crime Against Children,Child Abuse,Male,46-60,5432,2652,2780,3753,1679
2001,Rural,Andhra Pradesh,Crime Against Women,Dowry Deaths,Male,18-30,879,563,316,733,146
2005,Urban,Uttarakhand,Crime Against Men,Assault,Female,31-45,4827,11,4816,3583,1244
2006,Rural,Tripura,Other Crimes,Drug Offense,Female,13-17,2576,1575,1001,2218,358
2007,Rural,Gujarat,Crime Against Women,Molestation,Female,18-30,8998,7892,1106,8765,233
2010,Urban,Goa,Crime Against Men,Murder,Male,60+,3896,276,3620,2123,1773
2008,Urban,Sikkim,Crime Against Men,Extortion,Male,31-45,7284,3615,3669,4235,3049
2001,Urban,Sikkim,Crime Against Men,Extortion,Male,46-60,7706,3601,4105,4527,3179
2001,Urban,Mizoram,Crime Against Children,Trafficking,Female,0-12,6533,4596,1937,5891,642
2003,Urban,Tripura,Crime Against Women,Domestic Violence,Male,0-12,7926,7837,89,7915,11
2010,Urban,Kerala,Crime Against Men,Murder,Male,60+,9854,8011,1843,9816,38
2005,Urban,Nagaland,Crime Against Women,Domestic Violence,Male,31-45,9783,6169,3614,6681,3102
